-1,1824,1973,-149,-1,-163,94
-1,1765,1815,-50,-11,-184,46
1,1477,1487,-10,5,309,63
1,1765,1752,13,0,63,55
1,1445,1169,276,2,130,73
-1,1522,1428,94,0,-70,90
-1,1644,1544,100,-1,-55,74
-1,1957,1755,202,-3,-211,93
1,1656,1812,-156,1,26,49
1,1436,1506,-70,9,367,69
0,1878,1940,-62,0,-45,117
1,1824,1811,13,-3,-20,74
1,1653,1395,258,0,125,127
1,1897,1673,224,-1,-8,59
1,1500,1585,-85,1,84,71
1,1938,1880,58,-3,125,93
1,1336,1337,-1,0,98,63
1,1793,1827,-34,1,118,85
-1,1785,1732,53,-6,-35,42
1,1981,1601,380,0,41,97
1,1711,1800,-89,6,130,55
1,1421,1491,-70,3,255,59
1,1849,1728,121,-1,-68,81
-1,1440,1502,-62,1,141,98
1,1548,1415,133,0,223,91
-1,1561,1503,58,1,43,48
-1,1489,1561,-72,-5,-20,86
1,1492,1525,-33,2,46,49
1,1162,1244,-82,9,672,77
1,1627,1633,-6,2,103,77
-1,1360,1722,-362,3,49,48
1,1533,1712,-179,0,163,171
-1,1744,1773,-29,-1,-357,106
-1,1720,1865,-145,-2,-63,54
-1,1871,1714,157,-1,-41,82
-1,1500,1511,-11,-6,-164,54
1,1179,1223,-44,10,475,135
1,1341,1290,51,7,48,40
1,1511,1430,81,0,17,63
1,1577,1331,246,-2,73,51
-1,1472,1504,-32,0,-14,62
0,1725,1785,-60,-1,4,108
-1,1729,1856,-127,-3,-29,42
-1,1668,1907,-239,-11,-159,48
1,1856,1729,127,0,-10,43
-1,1856,1786,70,-13,-68,42
1,1695,1757,-62,2,16,43
-1,1421,1520,-99,-2,-39,56
-1,1556,1525,31,0,-182,100
-1,1270,1646,-376,-8,-197,46
1,1649,1242,407,13,611,63
1,1514,1550,-36,0,294,91
1,1799,1634,165,0,-184,99
-1,1749,1843,-94,0,-9,82
-1,1549,1609,-60,1,29,44
-1,1366,1440,-74,-1,-16,46
-1,1220,1652,-432,-16,-541,74
-1,1627,1806,-179,0,-26,68
1,1731,1517,214,0,-46,101
-1,1621,1661,-40,0,-28,56
1,1706,1570,136,0,56,55
-1,1851,1740,111,-2,-95,62
1,1513,1433,80,0,97,75
-1,1755,1837,-82,0,-30,66
1,1782,1666,116,4,147,49
-1,1888,1771,117,0,34,104
1,1615,1511,104,-5,-329,87
1,1622,1576,46,6,222,49
1,1528,1526,2,-1,104,81
-1,1844,1753,91,1,67,84
-1,1845,1746,99,0,-15,128
1,1656,1431,225,6,227,47
1,1876,1877,-1,-1,27,55
1,1646,1678,-32,-4,-208,69
-1,1510,1805,-295,-1,-44,92
-1,1244,1857,-613,0,-16,64
1,1827,1426,401,0,23,55
1,1624,1503,121,0,39,71
1,1662,1586,76,23,1081,65
1,1832,1752,80,0,25,49
-1,1761,1832,-71,0,-489,120
1,1709,1768,-59,1,530,81
-1,1586,1662,-76,-16,-916,68
1,1830,1423,407,1,30,69
-1,1495,1631,-136,-4,-133,64
1,1672,1577,95,5,1973,139
1,1874,1947,-73,-1,19,85
-1,1630,1783,-153,-1,-81,60
1,1840,1599,241,12,626,65
-1,1754,1886,-132,-3,-33,60
1,1657,1789,-132,-9,-283,117
1,1638,1487,151,-4,-61,45
1,1576,1576,0,0,64,73
1,1913,1663,250,4,150,57
-1,1569,1681,-112,-23,-1103,56
1,1577,1755,-178,-2,3,51
1,1595,1845,-250,1,451,121
-1,1341,1516,-175,-2,-31,52
-1,1553,1698,-145,-11,-423,62
1,1843,1928,-85,0,-29,77
1,1698,1553,145,-1,771,75
1,1887,1934,-47,-1,-146,87
1,1859,1747,112,0,34,63
1,1603,1449,154,-3,-25,61
1,1546,1705,-159,-7,52,77
1,1743,1827,-84,-2,20,77
0,1739,1594,145,-1,273,77
1,1688,1562,126,3,19,45
1,1868,1738,130,1,14,43
1,1500,1732,-232,6,750,107
1,1516,1480,36,-7,-68,55
1,1879,1237,642,1,20,41
1,1815,1222,593,3,13,65
1,1507,1617,-110,1,13,61
1,1542,1404,138,-1,372,159
1,1540,1653,-113,0,26,57
-1,1214,1816,-602,-19,-650,62
1,1878,1243,635,3,52,41
-1,1600,1863,-263,-7,-341,72
1,1599,1734,-135,-4,-160,58
-1,1899,1921,-22,-2,-50,62
1,1817,1207,610,9,486,69
1,1609,1443,166,0,38,55
-1,1554,1564,-10,-6,-89,48
1,1880,1855,25,3,98,49
0,1869,1649,220,0,57,142
1,1814,1717,97,-3,108,141
1,1523,1500,23,5,56,45
-1,1465,1562,-97,1,47,70
1,1521,1539,-18,0,-89,123
-1,1200,1818,-618,-14,-812,78
-1,1659,1920,-261,-4,-79,46
0,1543,1575,-32,0,1138,139
1,1552,1478,74,3,76,54
-1,1889,1932,-43,-1,-319,148
1,1819,1194,625,11,294,51
1,1892,1574,318,0,298,65
-1,1777,1775,2,0,-40,76
1,1567,1544,23,2,118,59
-1,1188,1820,-632,-11,-605,62
1,1802,1734,68,-1,205,123
-1,1756,1548,208,0,87,72
1,1900,1568,332,15,284,41
1,1616,1436,180,0,-24,63
1,1642,1615,27,1,37,45
1,1555,1563,-8,0,123,67
-1,1231,1452,-221,0,12,46
1,1904,1564,340,5,101,51
1,1821,1740,81,-1,-19,49
-1,1880,1941,-61,-1,-33,62
-1,1461,1462,-1,-1,-49,78
1,1899,1565,334,1,8,41
-1,1145,1844,-699,-5,-524,96
1,1839,1724,115,1,9,67
-1,1871,1951,-80,0,58,92
1,1420,1167,253,7,227,61
1,1914,1333,581,17,327,45
-1,1182,1457,-275,-6,-257,56
1,1595,1535,60,0,357,79
1,1709,1547,162,-5,-12,41
1,1378,1483,-105,-1,45,65
1,1709,1547,162,-3,19,55
-1,1716,1848,-132,-4,-212,114
1,1566,1469,97,0,-16,81
-1,1223,1746,-523,-6,-261,72
-1,1561,1604,-43,3,215,68
-1,1140,1848,-708,-9,-431,78
1,1638,1431,207,-1,-43,43
1,1855,1709,146,0,44,65
-1,1622,1654,-32,2,34,56
1,1919,1621,298,-1,1,41
1,1621,1518,103,4,1199,131
-1,1542,1707,-165,2,-8,56
0,1923,1752,171,-1,-338,131
-1,1703,1863,-160,1,50,52
1,1849,1137,712,7,222,55
-1,1570,1470,100,-2,-317,106
1,1925,1654,271,1,250,75
1,1863,1864,-1,0,-4,53
-1,1882,1665,217,0,-149,76
-1,1425,1128,297,-6,-639,108
-1,1347,1643,-296,1,-89,68
-1,1550,1654,-104,1,-67,70
-1,1629,1509,120,7,76,48
1,1870,1696,174,-3,-261,69
1,1768,1830,-62,1,37,56
-1,1765,1715,50,0,82,58
1,1457,1533,-76,-1,205,95
1,1614,1551,63,-1,211,109
-1,1132,1918,-786,-5,-72,42
1,1623,1516,107,10,413,57
-1,1690,1876,-186,0,-84,102
1,1919,1130,789,18,411,51
-1,1726,1958,-232,-7,-149,62
1,1631,1508,123,-1,619,155
1,1882,1685,197,2,262,81
1,1919,1743,176,0,-11,55
1,1281,1647,-366,-1,636,145
-1,1638,1500,138,1,8,46
-1,1562,1556,6,-3,10,112
-1,1524,1888,-364,-1,-42,92
1,1861,1853,8,4,109,50
-1,1803,1665,138,0,-67,88
1,1344,1252,92,2,577,109
-1,1246,1850,-604,-2,-547,100
1,1874,1685,189,2,40,47
-1,1584,1663,-79,-8,29,108
1,1541,1663,-122,2,-18,59
1,1680,1786,-106,-9,-133,117
-1,1283,1224,59,1,-523,132
-1,1643,1786,-143,-1,14,49
1,1627,1316,311,0,-53,47
1,1894,1518,376,-4,-47,45
1,1480,1649,-169,-1,-52,93
-1,1516,1899,-383,0,0,62
-1,1490,1500,-10,-3,-71,52
-1,1887,1623,264,1,168,106
0,1771,1693,78,1,82,119
-1,1516,1896,-380,-8,-96,44
-1,1519,1572,-53,0,-218,113
1,1896,1516,380,0,-48,53
-1,1482,1336,146,0,11,88
1,1696,1768,-72,0,-21,45
-1,1595,1546,49,-1,-247,124
-1,1567,1650,-83,-9,-612,82
-1,1510,1581,-71,-3,-146,72
-1,1623,1683,-60,-7,-137,48
1,1487,1640,-153,-4,-168,61
1,1754,1708,46,-3,285,117
-1,1866,1500,366,-1,-9,52
-1,1513,1907,-394,-5,-487,110
1,1793,1731,62,2,229,79
-1,1469,1425,44,-2,51,60
1,1588,1642,-54,-1,148,77
1,1909,1510,399,4,84,57
0,1851,1940,-89,0,-14,124
-1,1510,1909,-399,0,-9,42
1,1912,1508,404,2,59,51
-1,1557,1590,-33,-3,-255,116
1,1474,1508,-34,0,7,41
-1,1529,1890,-361,1,-74,62
1,1506,1914,-408,-8,-99,43
-1,1629,1502,127,-11,-517,82
-1,1516,1532,-16,-2,-63,55
1,1670,1853,-183,-3,15,63
1,1562,1558,4,1,25,59
-1,1512,1647,-135,1,9,62
-1,1432,1262,170,-4,-63,50
1,1874,1720,154,-2,684,143
-1,1501,1494,7,0,-288,92
-1,1838,1856,-18,0,-36,58
1,1513,1893,-380,0,61,59
1,1608,1036,572,17,701,61
-1,1549,1456,93,-4,-65,40
1,1517,1568,-51,0,0,59
1,1869,1526,343,1,-32,77
0,1865,1633,232,-9,96,117
-1,1473,1480,-7,0,-65,86
1,1957,2036,-79,0,7,101
1,1903,1609,294,0,28,41
-1,1993,1976,17,0,311,126
-1,1523,1872,-349,-9,-132,48
1,1489,1546,-57,-2,-117,75
1,1828,1646,182,0,-3,57
1,1596,1535,61,5,125,49
-1,1516,1879,-363,0,8,42
-1,1304,1648,-344,-1,-146,104
1,1882,1513,369,-1,-38,47
-1,1394,1727,-333,-12,-32,40
1,1993,1959,34,1,-30,73
-1,1500,1500,0,-4,-507,94
-1,1721,1712,9,-2,-47,58
-1,1639,1834,-195,0,55,71
1,1576,1655,-79,9,85,46
-1,1507,1888,-381,-4,-43,40
-1,1530,1625,-95,-2,-201,76
1,1894,1502,392,4,60,49
-1,1461,1679,-218,-5,-46,46
1,1502,1894,-392,-2,-86,63
-1,1502,1720,-218,0,-52,96
1,1841,1758,83,2,126,67
1,1869,1527,342,7,655,89
-1,2007,1931,76,-1,-510,112
1,1684,1417,267,-1,72,77
-1,1517,1282,235,-2,-123,72
0,1520,1876,-356,-11,-1039,108
0,1633,1456,177,3,63,101
1,1965,1989,-24,0,47,49
-1,1242,1537,-295,-6,-571,78
1,1865,1516,349,-1,31,59
-1,1750,1851,-101,0,-8,128
-1,1497,1931,-434,0,-375,80
1,1868,1513,355,-9,105,115
-1,1605,1651,-46,0,6,52
-1,1641,1500,141,-6,-105,52
-1,1506,1875,-369,0,-15,44
1,1574,1461,113,-8,103,105
1,1875,1506,369,-6,81,81
-1,1860,1742,118,0,24,52
1,1223,1521,-298,-9,-210,59
-1,1503,1878,-375,0,-314,94
1,1495,1814,-319,0,-91,101
1,1660,1192,468,0,259,85
0,1547,1656,-109,-5,-515,108
-1,1398,1578,-180,-4,-196,72
1,1584,1394,190,0,42,55
1,1547,1285,262,3,358,75
1,1643,1650,-7,-1,-28,63
1,1348,1159,189,0,-37,83
1,1651,1388,263,16,348,43
-1,1552,1711,-159,1,-56,66
-1,1404,1541,-137,-1,-63,56
-1,1869,1889,-20,0,-83,66
1,1590,1384,206,0,39,73
1,1763,1544,219,1,65,45
1,1345,1384,-39,-1,118,133
1,1657,1361,296,-6,-124,57
1,1716,1357,359,1,2,41
1,1670,1636,34,-2,-167,113
1,1262,1374,-112,-4,-84,53
-1,1682,1429,253,-1,-378,68
1,1374,1262,112,-2,-50,61
-1,1184,1315,-131,0,-473,132
-1,1553,1792,-239,-1,-62,68
-1,1662,1715,-53,-1,-15,80
-1,1639,1655,-16,1,34,44
-1,1440,1336,104,1,22,46
1,1548,1384,164,3,56,99
1,1366,1272,94,2,48,53
-1,1627,1768,-141,0,-84,72
1,1261,1375,-114,-4,-42,45
-1,1467,1626,-159,1,-499,150
1,1351,1492,-141,1,-108,63
1,1359,1280,79,0,428,99
-1,1708,1607,101,0,61,56
1,1550,1100,450,-1,-25,53
-1,1640,1810,-170,-1,23,84
1,1552,1098,454,0,-12,49
1,1612,1637,-25,-1,133,73
-1,1242,1464,-222,1,-45,72
-1,1941,1823,118,1,27,74
1,1350,1677,-327,1,57,73
1,1929,1834,95,-2,-113,71
-1,1644,1724,-80,0,-16,84
-1,1366,1796,-430,-10,-414,70
-1,1640,1668,-28,-2,-28,64
1,1322,1141,181,1,284,67
1,1562,1745,-183,-5,117,85
-1,1636,1513,123,0,198,96
-1,1280,1359,-79,-5,-94,47
1,1881,1626,255,0,150,77
1,1373,1722,-349,11,1235,113
-1,1581,1729,-148,-1,3,62
-1,1519,2162,-643,-2,-34,48
-1,1379,1654,-275,0,-167,86
1,1791,1681,110,0,5,60
-1,1364,1476,-112,-6,-593,74
1,1573,1328,245,-4,-168,97
-1,1735,1777,-42,0,-85,138
-1,2162,1989,173,0,-157,120
1,1629,1553,76,4,160,69
1,1757,1566,191,0,44,71
1,1277,1374,-97,2,52,51
-1,1700,1403,297,1,-431,108
1,1817,1553,264,1,59,71
-1,1528,1589,-61,-4,-367,85
-1,2005,2140,-135,-3,-32,42
1,1435,2045,-610,-1,-28,69
-1,2150,1998,152,0,-21,104
1,1618,1688,-70,-3,203,171
-1,1625,1880,-255,1,-25,40
1,1696,1799,-103,0,44,81
-1,1635,1500,135,-1,-516,112
-1,1655,1329,326,1,3,112
-1,1356,1483,-127,-7,-364,64
-1,1586,1938,-352,2,149,52
1,1545,1273,272,5,305,61
-1,2128,2013,115,0,-187,80
-1,1620,1884,-264,0,-115,104
1,1349,1491,-142,-4,-6,53
1,1775,1536,239,5,94,55
1,1732,1699,33,0,44,55
-1,1727,1448,279,2,19,52
-1,1117,1237,-120,-13,-288,134
-1,1762,1798,-36,-2,-85,98
1,1560,1440,120,1,289,75
0,1591,1324,267,-2,274,81
-1,1889,1616,273,0,22,116
1,1475,1379,96,0,-62,71
1,1583,1294,289,12,154,41
1,1584,1346,238,0,-17,57
1,1994,1618,376,1,147,55
1,1660,1487,173,1,200,113
1,1556,1420,136,0,33,87
1,1520,1410,110,0,57,50
-1,1612,1627,-15,-9,-240,51
1,1589,1332,257,1,51,87
-1,1549,1465,84,-1,-133,129
-1,1742,1886,-144,-1,-73,68
1,1601,1515,86,3,481,151
0,1594,1678,-84,-7,785,113
-1,1615,1809,-194,-1,-53,56
-1,1370,1484,-114,0,-8,72
1,1787,1248,539,14,645,63
-1,1564,1548,16,-3,-55,46
-1,1605,1578,27,0,-152,102
-1,1321,1836,-515,4,184,54
1,1638,1577,61,2,170,77
1,1789,1683,106,0,200,83
1,1674,1560,114,0,158,81
1,1552,1193,359,5,286,69
-1,1632,1482,150,-1,-170,70
-1,1365,1612,-247,-4,-199,64
-1,1996,1500,496,1,16,100
-1,1895,1465,430,0,-1,64
-1,1666,1677,-11,3,34,42
1,1269,1360,-91,-2,216,61
1,1491,1207,284,3,67,59
-1,1698,1521,177,0,-87,124
-1,1234,1796,-562,-9,-181,57
-1,1752,2016,-264,0,-52,66
1,1626,1574,52,0,11,43
1,1286,1349,-63,-4,-64,49
-1,1555,1488,67,-2,170,90
1,1618,1585,33,0,22,69
-1,1360,1618,-258,-8,-211,58
-1,1683,1652,31,-1,-419,140
-1,1688,1655,33,-5,-350,128
-1,1432,1374,58,1,-41,68
1,1680,1479,201,0,88,45
-1,1638,1898,-260,-4,-98,62
1,1536,1592,-56,3,96,51
1,1694,1502,192,7,296,123
-1,2041,1873,168,1,42,52
-1,1676,1810,-134,-1,-76,64
-1,1356,1552,-196,-7,-526,100
1,1690,1557,133,0,-78,97
1,1831,1707,124,0,94,162
-1,1951,2044,-93,0,-301,100
1,1399,1673,-274,2,13,43
1,1937,2059,-122,0,-4,75
1,1704,1536,168,-1,-52,71
-1,1635,1759,-124,0,-1,76
-1,1633,2027,-394,0,-48,74
0,1716,1685,31,-3,-194,108
1,1682,1332,350,-3,-94,49
1,1434,1096,338,2,111,59
-1,1337,1428,-91,-1,-58,62
-1,1320,1350,-30,-6,-453,96
-1,1703,1815,-112,-5,-136,52
-1,1368,1565,-197,-1,-282,68
-1,1699,1496,203,0,-468,130
-1,1313,1328,-15,2,21,50
-1,1495,1463,32,-1,-50,102
-1,1943,2052,-109,0,-69,62
1,1491,1558,-67,0,-15,67
-1,1530,1476,54,0,10,44
0,1688,1550,138,1,152,140
1,1500,1655,-155,-1,-43,53
-1,1500,1340,160,1,140,88
1,1373,1624,-251,9,423,65
1,1340,1420,-80,-3,-33,43
-1,1859,1689,170,-4,-92,70
-1,2028,2109,-81,0,1,74
1,1517,1375,142,2,28,49
-1,1350,1413,-63,-1,50,66
1,1906,1646,260,0,1,46
1,1699,1838,-139,2,85,67
1,1286,1350,-64,-1,155,55
1,2120,2019,101,0,145,101
-1,1514,1531,-17,-1,-59,58
-1,1337,1318,19,-3,-149,68
-1,1701,1468,233,-5,-784,166
1,1566,1413,153,0,153,137
-1,1312,1313,-1,-1,-118,59
1,1823,1715,108,-2,6,41
-1,1160,1167,-7,-2,-30,42
1,1324,1344,-20,-1,-37,57
1,1936,2060,-124,-6,-75,89
-1,1704,1812,-108,0,-164,80
-1,1597,1487,110,-19,-308,42
-1,1483,1516,-33,2,-271,102
1,1696,1574,122,0,30,81
1,1319,1337,-18,2,30,57
-1,1503,1580,-77,1,-26,48
1,1354,1477,-123,6,445,79
-1,1590,1493,97,-6,-92,70
-1,1324,1676,-352,3,80,54
-1,1671,1746,-75,0,-111,68
-1,2064,1676,388,0,-15,52
-1,1769,1586,183,0,-254,95
1,1553,1409,144,4,219,63
-1,1405,1573,-168,0,-380,98
1,1704,1775,-71,0,4,87
1,1714,1492,222,1,2,43
1,1723,1517,206,-2,-50,41
1,1549,1601,-52,0,56,50
1,1631,1500,131,0,35,89
0,1515,1379,136,-3,-3,54
1,1594,1490,104,1,31,73
1,1575,1508,67,1,28,59
1,1637,1390,247,-1,-31,79
-1,1370,1579,-209,-4,-188,68
-1,1308,1699,-391,-17,-344,48
-1,1307,1353,-46,-1,-78,88
-1,1525,1473,52,3,134,56
-1,1088,1308,-220,0,-74,67
1,1534,1197,337,1,446,113
1,1692,1322,370,1,70,87
1,1468,1558,-90,0,40,75
1,1761,1717,44,0,23,73
-1,1617,1659,-42,-5,-394,128
1,1768,1834,-66,4,313,103
1,1481,1602,-121,7,231,67
1,1546,1674,-128,-4,-105,87
1,1497,1586,-89,7,-37,83
-1,1485,1513,-28,-1,-470,106
0,1572,1511,61,-6,-522,83
-1,1512,1426,86,0,-48,125
1,1383,1324,59,-1,-37,51
-1,1680,1695,-15,1,-332,138
-1,1585,1518,67,-1,-20,66
1,1584,1417,167,-3,-37,57
1,1482,1544,-62,-1,0,55
-1,1696,1788,-92,-1,-39,64
1,1570,1505,65,-3,-169,73
-1,1623,1818,-195,-3,-124,52
1,1695,1707,-12,0,117,77
1,1397,1644,-247,2,68,71
1,1314,1222,92,2,83,43
-1,1523,1475,48,-3,-170,80
1,1708,1688,20,3,91,53
-1,1531,1500,31,-1,100,94
1,1582,1516,66,0,-20,51
1,1385,1624,-239,-1,75,53
1,1776,1978,-202,0,21,71
1,1570,1361,209,2,64,49
1,2040,1710,330,2,579,93
-1,1449,1511,-62,5,81,40
-1,1842,1728,114,0,-58,78
1,1590,1573,17,1,109,59
1,1591,1583,8,0,93,71
1,1708,1694,14,0,2,41
1,1677,1796,-119,2,19,53
1,1961,1771,190,2,124,69
1,1521,1474,47,-8,-125,51
1,1572,1602,-30,4,302,89
1,1720,1532,188,-2,-226,91
1,1537,1500,37,1,31,77
1,1530,1503,27,0,178,81
1,1410,1488,-78,0,-129,79
0,1890,1806,84,0,-141,227
1,1570,1603,-33,0,30,51
-1,1585,1403,182,1,29,46
1,1590,1584,6,5,175,83
-1,1951,2011,-60,-1,-135,66
1,1665,1526,139,0,0,43
1,2037,1828,209,2,143,79
-1,1573,1601,-28,-3,-133,74
-1,1464,1565,-101,-1,-48,56
1,1765,1563,202,1,31,61
1,1593,1581,12,-2,-69,63
1,1825,1936,-111,-2,-210,69
1,1655,1393,262,1,541,101
1,1492,1541,-49,4,78,47
1,1555,1500,55,1,105,70
-1,1404,1562,-158,-6,-84,40
1,1438,1435,3,3,38,47
-1,1950,2046,-96,-1,-110,62
-1,1682,1561,121,1,-63,66
-1,1500,1669,-169,1,-445,148
1,1490,1501,-11,-5,-75,67
1,1590,1529,61,13,297,55
-1,1475,1426,49,1,368,78
-1,1726,1702,24,0,-481,102
1,1545,1368,177,-1,-83,51
1,1528,1251,277,2,326,109
1,1500,1438,62,2,141,65
-1,1561,1569,-8,0,-129,100
1,1782,1692,90,2,62,49
-1,1449,1713,-264,-7,-618,68
-1,1557,1771,-214,-2,-931,138
-1,1863,1657,206,-1,-68,118
1,2020,2043,-23,1,69,53
-1,1624,2048,-424,-2,-87,61
1,2130,1714,416,-3,-5,87
1,1517,1424,93,0,138,98
-1,1718,1647,71,-2,-264,88
-1,1512,1449,63,2,293,124
1,2029,2032,-3,2,23,51
1,1500,1523,-23,0,-5,50
1,1600,1501,99,6,64,45
-1,2021,2042,-21,-4,-90,64
1,1370,1353,17,-1,32,43
-1,1712,2133,-421,0,17,78
1,1551,1353,198,-2,-355,91
-1,1695,1887,-192,3,83,68
1,1638,1163,475,2,479,99
-1,1247,1532,-285,-1,-99,72
1,1803,1438,365,2,337,69
1,1367,1185,182,8,168,55
1,1580,1550,30,0,6,48
1,1600,1462,138,-1,132,123
-1,1720,1397,323,-1,18,62
1,2010,2135,-125,0,87,111
1,1583,1026,557,7,159,41
-1,1794,1822,-28,0,-65,106
1,1584,1018,566,15,573,55
-1,1471,1433,38,-2,-25,46
-1,1552,1649,-97,0,-85,80
1,1585,1010,575,7,352,61
-1,1521,1565,-44,-1,-329,154
1,1637,1555,82,-1,30,91
1,1597,1456,141,9,310,61
1,997,1587,-590,-6,-199,59
1,1564,1616,-52,0,209,113
1,1698,1544,154,11,471,67
1,1784,1541,243,-1,-11,47
-1,1524,1303,221,3,-36,56
1,1641,1652,-11,0,2,43
1,1567,1165,402,5,375,79
1,1690,1448,242,-2,89,51
1,1569,1150,419,10,359,49
-1,1549,1683,-134,-3,-384,82
1,1998,1546,452,4,417,83
-1,1538,1733,-195,-1,42,78
-1,1572,1567,5,-2,-15,62
-1,1505,1323,182,-2,-331,104
1,1443,1694,-251,1,34,83
-1,1304,1500,-196,1,63,70
-1,1529,1455,74,-1,-238,88
1,1676,1578,98,-3,-8,55
1,1889,1646,243,5,15,43
1,1570,1685,-115,-2,-265,85
-1,1375,1191,184,3,165,106
-1,1559,1500,59,-4,-453,72
1,1543,1750,-207,-2,-66,51
-1,1464,1500,-36,-5,-121,46
-1,1674,1527,147,-3,-23,54
1,2208,1966,242,3,24,45
1,1500,1651,-151,0,37,93
1,1670,1585,85,0,88,85
-1,1456,1446,10,-3,-88,60
1,1799,1699,100,-3,239,71
-1,1576,1678,-102,2,59,56
-1,1358,1312,46,-5,-670,84
1,1261,1500,-239,8,114,41
-1,1686,1568,118,-8,-133,50
-1,1641,1767,-126,-7,-6,40
1,1258,1442,-184,2,19,41
0,1512,1469,43,0,-35,132
1,1327,1344,-17,0,15,53
-1,1577,1657,-80,0,-23,82
-1,1583,1672,-89,-1,-80,62
-1,1304,1664,-360,-5,-228,54
1,1286,1508,-222,0,-7,55
1,1729,1634,95,1,109,53
1,1852,1622,230,1,3,79
-1,1216,1096,120,2,68,76
1,1471,1510,-39,-7,-312,97
-1,1402,1383,19,-1,-34,56
-1,1322,1424,-102,0,-15,56
1,1933,1567,366,0,38,77
-1,1301,1667,-366,-7,-594,84
1,1494,1487,7,-3,-95,131
1,1377,1500,-123,5,196,53
1,1722,1641,81,0,5,51
1,1936,1395,541,5,148,53
1,1345,1495,-150,1,203,81
1,1626,1738,-112,0,27,63
-1,1618,1896,-278,-3,-153,70
-1,1667,1507,160,-3,-368,108
1,1388,1242,146,2,-59,53
-1,1536,1551,-15,-2,-33,48
1,1964,1393,571,0,2,43
1,1321,1423,-102,-3,2,51
-1,1670,1807,-137,-1,-443,124
-1,1536,1711,-175,0,-10,109
-1,1496,1397,99,-2,-77,58
-1,1980,1927,53,-1,-57,70
-1,1520,1613,-93,0,25,80
-1,1750,2216,-466,-1,-16,48
-1,1402,2218,-816,-14,-251,50
1,1583,1727,-144,6,208,65
1,1562,1564,-2,-1,-32,57
-1,1500,1333,167,-16,-783,64
-1,1402,1448,-46,1,14,42
-1,1500,1435,65,-1,-3,50
1,1793,1650,143,-5,-28,59
1,1459,1391,68,0,4,49
-1,1390,1963,-573,-11,-305,56
1,1827,1642,185,0,52,55
-1,1450,1316,134,-14,-547,62
1,2009,1968,41,0,-21,69
1,1437,1575,-138,-5,-167,57
1,1636,1543,93,4,169,57
-1,1281,1444,-163,-4,-458,80
1,1274,1441,-167,-5,-217,73
-1,1552,1623,-71,-10,-93,48
1,1450,1596,-146,3,120,59
-1,1441,1832,-391,-5,-170,58
1,1434,1172,262,20,637,59
0,1599,1459,140,-1,-5,72
1,1380,1188,192,-2,-144,67
-1,1604,1654,-50,-1,-457,122
-1,1349,1336,13,0,-36,100
-1,1444,1180,264,5,125,134
-1,1161,1439,-278,-1,-22,72
1,1640,1318,322,-1,41,93
-1,1727,1734,-7,2,6,74
0,1331,1433,-102,-2,-18,46
1,1443,1152,291,2,215,57
-1,1471,1439,32,-1,-13,49
1,1789,1553,236,0,68,55
-1,1835,1943,-108,-3,-6,52
-1,1291,1364,-73,-2,-191,123
1,1447,1468,-21,0,-33,99
1,1550,1526,24,0,55,61
-1,1459,1548,-89,0,27,62
1,1634,1602,32,-1,33,75
1,1566,1573,-7,0,20,67
1,1755,1424,331,6,121,51
1,1543,1538,5,-1,-26,55
1,1572,1631,-59,1,3,41
1,1962,1774,188,2,485,135
-1,1553,1855,-302,0,42,78
-1,1421,1205,216,1,-108,102
1,1858,1550,308,0,94,55
1,1581,1557,24,0,24,95
1,1481,1495,-14,13,298,55
1,1815,1590,225,15,383,45
-1,1298,1302,-4,0,-62,62
-1,1372,1848,-476,-7,-402,80
1,1820,1632,188,1,178,119
-1,1562,1452,110,-2,-731,126
-1,1286,1520,-234,-6,-268,58
1,1493,1483,10,1,483,205
1,1500,1546,-46,6,137,59
1,1659,1511,148,1,297,91
1,1548,1380,168,6,488,87
-1,1826,1843,-17,1,-2,50
-1,1545,1953,-408,-6,-30,46
1,1527,1453,74,1,124,66
1,1546,1661,-115,0,30,63
1,1955,1543,412,-1,-61,109
1,1862,1538,324,2,111,65
-1,1583,1668,-85,-2,33,58
-1,1286,1425,-139,0,-489,114
-1,1661,1486,175,2,256,88
1,1541,1958,-417,4,95,67
1,1870,1816,54,0,29,59
-1,1282,1194,88,-8,-233,56
1,1865,1534,331,-3,-199,75
-1,1560,1936,-376,-5,-71,58
1,2041,2150,-109,1,72,91
-1,1939,1557,382,1,36,52
1,1492,1500,-8,-3,-107,51
1,1477,1221,256,-4,-31,45
1,1579,1915,-336,0,44,77
1,1891,1600,291,2,68,53
1,1218,1267,-49,1,230,63
1,1081,1334,-253,1,38,59
-1,1505,1478,27,-2,-309,116
-1,1597,1373,224,-2,-133,72
1,1596,1895,-299,-2,-37,45
-1,1417,1497,-80,-9,-257,60
1,1525,1526,-1,-8,-277,93
1,1542,1639,-97,1,334,101
1,1620,1547,73,18,286,47
-1,1691,2096,-405,1,38,50
-1,1267,1559,-292,-3,-305,78
-1,1807,1893,-86,3,-180,104
0,1689,1685,4,-1,-72,117
1,1670,1585,85,-1,344,103
-1,1276,1554,-278,4,70,58
1,1254,1239,15,-3,-1,45
1,2078,2099,-21,1,91,101
1,1463,1560,-97,0,19,51
1,1538,1815,-277,8,40,43
-1,1513,1536,-23,4,102,46
1,1666,1216,450,2,46,51
-1,1509,1490,19,-2,-64,50
-1,1680,1500,180,-1,-514,112
1,1685,1689,-4,1,67,69
1,1721,1787,-66,0,159,121
-1,1360,1463,-103,-7,-399,60
1,1517,1500,17,8,239,47
-1,1598,1500,98,0,-222,106
1,1546,1501,45,4,96,47
-1,1492,1562,-70,0,-86,74
-1,1271,1558,-287,-2,-408,78
1,1632,1214,418,-2,-43,53
1,1490,1555,-65,3,459,83
1,1678,1494,184,1,79,55
-1,1364,1629,-265,-1,-263,78
1,1584,1730,-146,1,510,87
1,1586,1200,386,4,97,41
-1,1295,1713,-418,-2,-90,54
-1,1600,1650,-50,-3,-176,54
1,1938,2092,-154,1,63,65
-1,1453,1626,-173,2,-166,84
-1,1505,1634,-129,-4,-67,88
1,1530,1511,19,2,603,135
1,1528,1391,137,3,282,57
-1,1813,1881,-68,-4,-253,84
1,1839,1571,268,0,4,87
1,1662,1631,31,0,75,59
1,1577,1582,-5,-8,-197,69
1,1484,1473,11,-1,-54,49
1,1545,1416,129,0,29,57
1,1632,1447,185,0,33,43
-1,1493,1552,-59,-6,-85,52
-1,1446,2083,-637,-5,-197,64
-1,1184,1314,-130,-10,-202,45
-1,1684,1629,55,0,0,54
-1,1620,1642,-22,0,-69,78
1,1675,1472,203,2,82,67
-1,1527,1638,-111,0,47,60
-1,1441,1569,-128,2,63,74
1,1650,1587,63,-2,-130,85
1,1561,1483,78,6,116,45
-1,1408,1567,-159,-5,-404,70
-1,1899,1804,95,-1,-244,78
-1,1339,1439,-100,-8,-379,78
1,1869,1669,200,-1,-17,47
-1,1488,2088,-600,-5,-154,80
1,1653,1589,64,-2,-24,46
-1,1570,1609,-39,-3,-264,82
1,1682,1470,212,-1,184,101
1,1684,1962,-278,0,92,69
1,1290,1165,125,-2,-49,49
1,1578,1663,-85,-3,208,65
-1,1623,1646,-23,0,117,108
1,1573,1519,54,1,16,49
1,2089,1487,602,4,61,43
-1,1556,1500,56,-1,-12,44
-1,1501,1540,-39,1,-215,140
1,1664,1903,-239,7,100,49
1,2090,1486,604,0,10,59
1,1620,1560,60,-1,-11,79
1,1702,1806,-104,2,109,55
-1,1565,1663,-98,-10,-300,62
-1,1298,1517,-219,-6,-224,62
-1,1485,2091,-606,-4,-208,70
1,1575,1463,112,3,60,47
1,1639,1520,119,4,160,61
-1,1523,1668,-145,-6,-6,40
-1,1817,1872,-55,1,447,146
1,1673,1840,-167,6,388,83
1,1557,1671,-114,0,22,69
-1,1629,1614,15,2,-89,130
1,1522,1293,229,3,78,57
1,1514,1525,-11,4,178,59
1,1716,1765,-49,1,209,97
1,1513,1646,-133,-2,-33,49
1,1676,1692,-16,-4,-212,63
1,1464,1413,51,2,65,58
-1,1483,1408,75,1,-74,62
1,1457,1106,351,3,858,97
1,1403,1319,84,1,62,67
-1,1617,1593,24,-5,-53,42
1,1770,1571,199,0,-2,41
-1,1287,1527,-240,3,21,44
1,1528,1528,0,6,93,53
1,1728,1732,-4,0,230,121
1,1317,1316,1,2,235,87
-1,1271,1444,-173,-1,-109,118
1,1532,1282,250,0,-4,59
-1,1470,1461,9,-5,-674,96
1,1739,1553,186,-2,68,73
1,1477,1427,50,6,326,61
-1,1889,1809,80,-8,-711,110
-1,1571,1705,-134,0,7,44
1,1541,1483,58,8,174,59
1,1792,1625,167,-2,123,109
-1,1565,1223,342,3,438,96
1,2219,1355,864,1,22,47
-1,1551,1605,-54,-2,-26,48
-1,1265,1590,-325,-4,-114,52
-1,1553,1474,79,3,204,78
-1,1976,1880,96,1,127,82
-1,1550,1653,-103,-8,-45,40
-1,1512,1620,-108,-3,-218,72
-1,1615,1542,73,4,-107,114
1,1745,1690,55,2,115,81
-1,1277,1690,-413,-2,-199,83
1,1565,1683,-118,3,232,77
-1,1532,1498,34,4,245,76
-1,1583,1601,-18,0,-59,70
1,1454,1259,195,2,60,45
-1,1586,1875,-289,-6,-72,58
-1,1879,1582,297,2,264,90
-1,1496,1508,-12,9,448,82
-1,1547,1555,-8,-6,-305,62
1,1363,1358,5,0,925,93
-1,1535,1562,-27,2,18,48
1,1516,1572,-56,1,49,51
-1,1510,1573,-63,-2,-15,44
-1,1267,1262,5,3,276,138
1,1439,1487,-48,9,320,53
-1,1460,1539,-79,-4,-97,44
1,1275,1413,-138,-2,-11,51
1,1713,1764,-51,2,109,65
-1,1602,1859,-257,0,-25,108
-1,1500,1544,-44,0,0,76
1,1688,1584,104,-2,171,113
1,1345,1509,-164,0,40,49
1,1519,1485,34,0,397,103
-1,1717,1733,-16,0,-221,144
1,1611,1299,312,4,51,45
-1,1620,1555,65,-1,-9,82
-1,1720,2027,-307,0,8,52
-1,1287,1615,-328,0,-313,82
1,1638,1512,126,3,86,65
-1,1527,1590,-63,2,185,114
-1,1303,1921,-618,-3,-147,82
1,1542,1250,292,-1,57,91
-1,1567,1606,-39,-1,-39,58
1,1618,1276,342,12,623,77
1,1484,1474,10,0,8,43
-1,1461,1628,-167,-3,-44,56
1,1516,1531,-15,0,24,69
1,2031,1696,335,0,11,49
-1,1364,1568,-204,-1,-81,56
1,1267,1622,-355,-5,-308,75
-1,1704,1616,88,0,30,90
-1,1876,1590,286,1,6,50
-1,0,1050,-1050,-16,-223,50
1,1570,1603,-33,-2,-28,55
1,1676,2035,-359,-2,12,65
1,1589,1552,37,1,50,47
-1,1302,1206,96,-11,-58,56
1,1662,1528,134,-3,215,87
1,1705,1603,102,0,-1,67
-1,1634,1453,181,3,97,62
1,1282,1338,-56,10,683,96
-1,1649,1489,160,4,170,48
-1,1187,1665,-478,1,-163,72
-1,1284,1590,-306,0,-43,58
1,1687,1546,141,1,18,119
-1,2012,1796,216,-4,-238,78
-1,1599,1462,137,2,41,46
1,1474,1617,-143,5,342,87
1,1594,1280,314,3,114,67
-1,1632,1507,125,-3,24,46
1,1921,1331,590,4,190,57
1,1597,1276,321,-3,-134,67
-1,2036,1833,203,0,-427,88
-1,1790,1964,-174,0,-129,88
1,1647,1495,152,1,350,75
1,1690,1774,-84,0,-37,51
1,1922,1523,399,0,-3,69
1,1602,1493,109,2,35,53
-1,1595,1857,-262,0,-45,88
1,1434,1584,-150,1,529,97
-1,1635,1527,108,-3,-41,44
-1,1518,1521,-3,-1,-606,159
-1,1888,1992,-104,-4,-33,50
-1,1500,1369,131,-6,-361,80
1,1601,1385,216,-1,-13,41
-1,1520,1925,-405,2,71,48
1,1694,1539,155,0,841,87
-1,1606,1379,227,1,128,102
-1,1483,1610,-127,-4,-93,44
1,1861,1630,231,-2,-64,81
1,2002,1851,151,0,-2,45
1,1504,1104,400,1,93,44
-1,1272,1928,-656,-4,-141,60
1,1574,1488,86,1,197,71
1,1515,1631,-116,5,366,111
1,1658,1758,-100,0,326,81
1,1929,1518,411,-3,-68,53
1,1704,1699,5,0,41,61
-1,1700,1532,168,-8,-535,86
1,1617,1474,143,-2,-92,79
1,1823,2010,-187,-3,79,99
1,1971,1784,187,-1,63,67
-1,2042,2041,1,-2,-14,40
-1,1702,1786,-84,0,11,64
1,1379,1554,-175,-9,-229,45
-1,1267,1591,-324,-5,-75,44
1,1591,1674,-83,1,139,83
1,1687,1715,-28,-3,70,65
1,1617,1620,-3,1,38,57
1,1594,1263,331,0,16,51
-1,1931,2032,-101,-3,-457,102
1,1466,1624,-158,4,182,53
1,1360,1385,-25,-3,-64,95
-1,1259,1598,-339,-1,80,48
0,1530,1532,-2,0,123,132
1,2040,1921,119,2,317,83
-1,1517,1480,37,-1,-7,60
1,1685,1549,136,4,201,75
-1,1568,1507,61,-5,-115,60
1,1601,1255,346,1,44,57
1,1608,1485,123,2,120,77
1,1669,1521,148,3,96,53
-1,1779,1978,-199,4,-49,82
0,1787,2002,-215,0,-95,127
1,2009,1836,173,-2,-44,55
1,1654,1542,112,3,266,72
1,1691,1541,150,1,105,97
-1,1679,1620,59,-1,-164,80
1,1252,1604,-352,-1,-58,53
1,1554,1397,157,-2,-6,55
-1,1919,1818,101,0,9,74
0,1661,1520,141,-9,-3,110
-1,1431,1454,-23,-8,-317,74
0,2016,1960,56,0,69,73
-1,1530,1532,-2,-6,-150,64
-1,1613,1620,-7,-2,-130,82
1,1996,1793,203,0,11,49
1,1346,1561,-215,-4,-59,99
-1,1962,2014,-52,3,16,40
-1,1517,1339,178,-1,-23,60
1,1500,1542,-42,3,62,47
1,1891,1665,226,-3,12,49
1,1460,1300,160,1,182,83
1,1950,2047,-97,-4,39,61
-1,1524,1655,-131,0,-173,140
1,1714,1862,-148,0,-127,99
-1,1512,1653,-141,-2,-17,52
1,1698,1794,-96,0,0,65
1,1788,2002,-214,0,41,119
-1,1286,1521,-235,-4,-460,80
1,1464,1420,44,3,199,59
1,1617,1592,25,7,857,93
1,1444,1450,-6,9,174,43
0,2033,1967,66,0,-262,121
1,1545,1555,-10,-1,-56,69
1,1536,1590,-54,-2,-90,45
1,1535,1500,35,-2,204,77
1,2046,1602,444,-2,50,59
1,1969,2031,-62,0,5,71
1,1501,1393,108,-1,79,79
0,1153,1395,-242,7,-375,184
1,1712,1534,178,-1,234,89
-1,1911,1883,28,0,-36,56
1,1665,1517,148,0,212,135
1,1614,1500,114,-1,-199,77
1,1732,1880,-148,0,3,43
-1,1374,1186,188,-9,-611,78
1,1444,1450,-6,2,698,115
1,2019,1985,34,-7,-98,73
-1,1542,1557,-15,1,267,100
-1,1372,1630,-258,-1,-191,66
1,1863,1749,114,0,-22,73
-1,1600,2048,-448,-1,-260,110
-1,1415,1589,-174,-2,-262,68
1,1696,1356,340,1,364,79
1,1717,1528,189,-1,51,69
-1,2028,1973,55,0,-15,76
-1,1666,1743,-77,1,8,154
-1,1744,1657,87,2,8,56
1,1641,1317,324,0,-12,53
-1,1341,1542,-201,-11,-232,48
1,1637,1278,359,0,-3,43
1,1595,1408,187,3,293,97
1,1988,2016,-28,0,25,95
1,1439,1188,251,0,108,83
-1,1509,1559,-50,-2,-164,70
-1,1743,1912,-169,-4,-117,95
1,1894,1866,28,0,-35,89
-1,1283,1649,-366,-7,-132,72
1,1741,1871,-130,0,8,101
1,1821,1394,427,4,99,59
-1,2004,2001,3,0,-22,106
1,1856,1758,98,2,348,107
-1,1240,1662,-422,-9,11,56
1,1723,1522,201,5,416,93
0,1443,1584,-141,0,-232,92
0,1602,1402,200,3,401,85
-1,1648,1818,-170,-4,-167,60
1,2050,1599,451,-2,30,63
-1,1561,1674,-113,0,25,96
1,1568,1530,38,3,-24,67
1,2013,1994,19,0,5,75
-1,1329,1159,170,2,-61,82
1,1378,1326,52,3,121,69
-1,1318,1555,-237,1,-92,74
1,1667,1224,443,2,6,45
0,1684,1554,130,-9,-13,73
1,1918,1737,181,1,28,63
-1,1749,1864,-115,-3,-207,92
-1,1781,1985,-204,0,196,118
1,1499,1510,-11,2,340,95
0,1984,2025,-41,0,-53,136
1,1305,1095,210,3,38,43
-1,1211,1672,-461,4,168,66
1,1309,1758,-449,0,-29,59
1,1591,1539,52,-1,-10,55
1,1728,1516,212,3,147,67
-1,1558,1679,-121,0,-28,94
1,2024,1985,39,3,85,47
1,1676,1199,477,-1,-12,61
1,1684,1653,31,-2,110,103
-1,1730,1924,-194,-3,11,66
-1,1619,1846,-227,-4,-77,46
1,1686,1670,16,1,80,67
1,1435,1233,202,14,251,45
-1,1519,1578,-59,-3,-103,40
1,1976,2034,-58,0,47,63
-1,1597,2052,-455,-4,-203,56
1,1733,1511,222,0,-113,87
1,1297,1407,-110,-10,-211,53
-1,1662,1642,20,-2,-111,66
1,1831,1422,409,5,460,103
1,1579,1247,332,3,341,81
-1,1823,1798,25,-5,-94,62
1,1872,1740,132,0,427,125
-1,1189,1680,-491,0,42,76
-1,1706,1614,92,0,-517,102
1,1314,1447,-133,1,73,77
1,1444,1508,-64,3,108,65
-1,1511,1587,-76,0,-62,66
-1,1811,1809,2,0,58,90
-1,1656,1650,6,-4,-261,60
-1,1689,1550,139,2,101,70
-1,1979,1990,-11,-2,-80,58
1,1547,1562,-15,4,27,45
1,1738,1506,232,5,157,71
-1,1692,1755,-63,0,-239,72
1,1331,1277,54,0,7,41
-1,1782,1498,284,0,157,104
1,1732,1879,-147,-1,-32,79
-1,1602,1731,-129,2,91,74
1,1531,1215,316,6,130,41
-1,1694,1804,-110,0,-119,146
0,1743,1633,110,0,-541,84
1,1583,1408,175,2,60,43
-1,1412,1786,-374,-4,-27,54
1,1612,1351,261,2,178,92
-1,1171,1568,-397,-7,-109,54
1,1550,1559,-9,1,39,51
1,1839,1545,294,1,46,63
-1,1651,1924,-273,-1,32,40
-1,1552,1660,-108,0,-58,100
1,1346,1195,151,0,-16,77
1,1565,1502,63,-3,-62,45
-1,1804,1614,190,-2,-74,60
1,1501,1648,-147,-9,-653,97
-1,1632,1765,-133,-1,-24,56
-1,1494,1514,-20,1,10,82
-1,1740,1636,104,-1,-377,86
-1,1513,1595,-82,0,-9,86
-1,1444,1702,-258,-2,-39,52
1,1851,1748,103,-3,24,47
-1,1621,1758,-137,0,23,88
1,1991,2067,-76,1,-18,51
-1,1370,1343,27,0,15,72
-1,1594,1693,-99,-3,-45,50
-1,1787,1820,-33,1,42,80
1,1409,1317,92,17,375,47
1,1800,1536,264,2,94,69
-1,1783,1904,-121,0,-313,138
1,1740,1859,-119,0,166,185
0,1775,1815,-40,-1,-57,112
1,1548,1561,-13,1,31,45
1,2051,2005,46,-5,32,95
1,1725,1650,75,0,-5,67
1,1811,1686,125,-2,84,125
1,1562,1512,50,-2,-54,91
-1,1789,1772,17,-2,-45,44
1,1500,1394,106,5,325,71
-1,1570,1574,-4,0,-1,54
-1,1593,1605,-12,-4,-436,110
1,1709,1366,343,4,359,89
-1,1995,2062,-67,-8,-160,56
-1,1625,1701,-76,0,-18,90
1,1574,1561,13,6,395,89
1,1271,1188,83,6,71,48
-1,1645,1539,106,7,128,42
1,1512,1508,4,-2,-8,61
-1,1986,1992,-6,0,-77,78
1,2149,1842,307,1,265,111
1,1432,1150,282,3,535,75
-1,1571,1573,-2,-3,-111,88
1,1553,1787,-234,0,-1,67
-1,1827,1871,-44,-1,-44,64
1,1679,1818,-139,0,19,49
-1,1437,1334,103,-1,-19,52
1,1733,1584,149,-9,-177,89
-1,1280,1178,102,2,-28,70
1,2070,2010,60,0,8,73
1,1621,1407,214,7,266,67
-1,1421,1500,-79,0,20,49
-1,1533,1512,21,0,-176,68
0,1814,1976,-162,-1,4,113
1,1461,1326,135,-4,-44,53
-1,1882,1817,65,-6,-83,52
1,1864,1641,223,0,1,61
1,1804,1694,110,0,27,57
-1,1365,1579,-214,-5,-186,62
0,1585,1643,-58,-1,319,159
1,1578,1764,-186,-1,44,49
-1,1500,2093,-593,3,312,176
1,1593,1710,-117,0,20,59
-1,1637,1869,-232,1,6,46
1,1372,1542,-170,2,202,69
-1,1401,1553,-152,-9,-198,52
1,1468,1319,149,-1,2,45
-1,1831,2136,-305,0,-89,86
-1,1844,1669,175,-5,-5,60
-1,1738,1616,122,-1,-31,54
1,1628,1360,268,6,126,45
1,1874,1632,242,1,31,61
1,1477,1627,-150,7,122,49
0,1647,1439,208,-2,-181,142
-1,1633,1525,108,2,-74,84
-1,1545,1614,-69,-5,-316,80
1,1734,1593,141,-2,0,71
-1,1686,1811,-125,0,8,134
-1,1521,1541,-20,-3,-206,72
0,1607,1638,-31,14,1583,122
-1,1684,1780,-96,0,-15,46
1,2014,1668,346,10,723,97
1,1637,1608,29,4,404,83
1,1541,1632,-91,1,-73,93
-1,1440,1543,-103,0,-575,140
-1,1683,1893,-210,1,23,42
-1,1595,1648,-53,2,-509,100
1,1683,1500,183,6,582,83
-1,1658,1583,75,2,439,82
-1,1508,1631,-123,0,-208,91
-1,1673,1564,109,-2,-344,88
1,1903,2017,-114,0,229,109
-1,1403,1738,-335,0,-31,102
1,1631,1615,16,16,626,65
-1,1579,1659,-80,2,57,78
1,1615,1631,-16,1,408,109
-1,1667,1570,97,-1,-43,68
-1,1472,1711,-239,-3,-501,140
0,1629,1619,10,2,1445,150
1,1604,1773,-169,-2,14,127
1,1661,1711,-50,-2,317,139
0,1620,1629,-9,10,1202,150
1,1918,1585,333,2,67,63
1,1759,1555,204,0,207,101
0,1495,1273,222,-2,-291,98
1,1628,1620,8,0,479,121
1,1921,1612,309,0,-10,41
1,1680,1620,60,0,96,107
-1,1609,1641,-32,0,1,54
0,1721,1478,243,0,-333,172
-1,1599,1582,17,-8,-943,102
1,1757,1622,135,0,25,55
1,1925,1631,294,-9,-15,69
1,1641,1549,92,0,162,77
1,1628,1928,-300,1,182,93
1,1594,1587,7,2,-9,95
1,1909,1647,262,0,3,69
1,1610,1548,62,1,163,105
-1,1647,1909,-262,0,13,68
-1,1516,1605,-89,-8,-161,58
-1,1287,1434,-147,-4,-222,78
1,1913,1643,270,-2,-139,75
-1,1289,1753,-464,-7,-126,46
1,1689,1528,161,3,204,80
-1,1896,1968,-72,0,-151,128
0,1229,1544,-315,-14,-229,51
1,1653,1579,74,12,285,43
-1,1819,1907,-88,0,-135,74
-1,1461,1538,-77,-6,-191,56
-1,1552,1517,35,-1,-268,120
-1,1657,1764,-107,-6,-253,62
1,1542,1500,42,3,345,59
-1,1653,1570,83,-3,279,114
1,1655,934,721,4,366,61
-1,1363,1611,-248,-1,-76,56
1,1391,1232,159,-2,-49,55
-1,1648,1749,-101,8,439,82
-1,1637,1583,54,-6,-299,74
-1,1283,1489,-206,-4,-312,88
-1,1602,1769,-167,1,-24,80
1,1760,1500,260,-2,-28,53
1,1804,1532,272,4,125,41
1,1583,1637,-54,0,140,79
-1,1016,1475,-459,-7,-531,84
1,1772,1616,156,0,7,49
-1,1432,1517,-85,-1,46,58
-1,1618,1595,23,-1,58,86
1,1623,1596,27,-4,-205,75
1,1628,1500,128,2,396,81
1,1753,1773,-20,2,68,97
-1,1977,1887,90,0,10,70
-1,1656,1633,23,-1,-73,72
1,1634,1414,220,0,148,59
-1,1226,1398,-172,1,116,85
-1,1541,1868,-327,-2,-384,105
1,1651,1558,93,0,43,61
-1,1621,1580,41,-2,-56,52
-1,1412,1404,8,-1,-3,50
1,1820,1975,-155,-1,6,65
-1,1806,1668,138,2,-174,118
-1,1963,1778,185,-1,10,64
-1,1558,1632,-74,-5,-243,66
-1,1588,1809,-221,-1,-31,66
1,1340,1427,-87,0,34,43
-1,1378,1635,-257,-5,-212,58
-1,1761,1765,-4,1,23,104
-1,1546,1530,16,-6,-130,51
-1,1586,1684,-98,-5,-604,98
-1,2376,1662,714,-1,-122,70
1,1608,1500,108,-1,-161,77
1,1646,1672,-26,1,69,57
1,1401,1275,126,7,601,107
1,1915,1794,121,3,24,43
-1,1715,1674,41,0,86,76
-1,1667,1550,117,-5,-80,55
1,1583,1012,571,4,171,49
-1,1901,1822,79,0,-31,82
-1,1776,1750,26,-1,-77,58
-1,1630,1640,-10,-3,-69,46
1,1643,1130,513,1,529,73
-1,1764,1641,123,0,4,52
-1,2029,2109,-80,0,-17,62
-1,1584,1532,52,0,36,60
-1,1639,1865,-226,-3,-49,68
-1,1264,1009,255,9,205,50
1,1557,1309,248,0,289,107
1,1607,1661,-54,-1,-10,44
1,1495,1636,-141,-3,-219,77
-1,1504,1545,-41,1,-36,76
1,2120,2020,100,0,70,89
-1,1658,1660,-2,0,-21,54
-1,1526,1622,-96,4,73,50
-1,1578,1736,-158,0,-317,124
1,2012,2130,-118,0,-5,55
-1,1500,1706,-206,-5,-207,68
1,1635,1500,135,0,-2,57
1,1644,1590,54,2,76,53
-1,1597,1561,36,-6,-91,50
-1,1243,1410,-167,0,-23,60
-1,1718,1862,-144,0,-321,98
-1,1656,1671,-15,-4,-64,94
1,1823,1631,192,0,-73,95
1,1603,1664,-61,-3,141,85
-1,1638,1806,-168,0,-25,72
-1,1762,1887,-125,2,62,62
1,1418,1637,-219,-2,-191,87
1,1615,1282,333,6,1073,129
1,1756,1338,418,1,259,79
-1,1561,1308,253,-6,-72,46
1,1654,1592,62,4,176,65
-1,1207,1489,-282,1,5,50
-1,1461,1241,220,0,-46,82
1,1547,1525,22,0,6,41
1,2166,1500,666,3,101,93
-1,1277,1555,-278,-5,-146,44
1,1946,1895,51,0,-19,81
-1,1764,1607,157,0,78,126
-1,1580,1528,52,-4,-285,130
1,1618,1605,13,-3,-356,123
-1,1529,1303,226,2,-164,116
1,1645,1681,-36,-3,-17,59
-1,1500,1633,-133,-5,-44,43
1,1917,1800,117,0,89,103
-1,1635,1781,-146,0,-7,46
-1,1511,1872,-361,0,-27,58
-1,1556,1402,154,0,-6,44
-1,1664,1272,392,5,151,60
1,1791,1949,-158,0,55,63
1,1630,1509,121,-1,-21,73
-1,1502,1424,78,-1,-265,138
1,1314,1382,-68,-1,-62,117
1,1949,1791,158,1,21,75
1,1500,1306,194,-3,-295,89
1,2205,1895,310,5,107,45
1,1593,1078,515,7,323,65
0,1784,1955,-171,0,255,122
-1,1669,1788,-119,0,-48,104
-1,1620,1569,51,-1,-53,48
1,1610,1503,107,4,146,49
-1,1951,1790,161,0,7,40
-1,1595,1657,-62,2,106,68
-1,1458,1500,-42,-2,-131,68
-1,1638,1655,-17,0,-14,56
-1,1683,1451,232,-5,21,60
-1,1600,1639,-39,0,-56,67
-1,1823,1921,-98,-12,-374,88
1,1790,1873,-83,2,22,43
1,1649,1494,155,-6,21,81
-1,1668,1604,64,-3,-72,116
1,1929,1814,115,1,99,53
1,1496,1629,-133,5,111,41
-1,1706,1935,-229,0,5,65
-1,1567,1608,-41,0,-207,76
-1,1806,1936,-130,-2,-54,108
-1,1847,1544,303,-3,-44,40
1,1811,1721,90,2,-27,43
-1,1840,1849,-9,-2,-40,42
1,1594,1615,-21,-1,-21,47
1,1612,1403,209,0,8,73
1,1692,1758,-66,3,155,51
-1,1992,2168,-176,0,-2,50
-1,1511,1829,-318,0,13,76
1,1936,1807,129,-1,19,73
-1,1519,1744,-225,1,107,116
-1,1812,1658,154,-1,-193,250
-1,1540,1541,-1,2,-25,100
1,1866,1787,79,1,89,83
1,1613,1661,-48,-2,-71,63
-1,1943,1799,144,-5,348,144
-1,1708,1586,122,-2,-97,58
-1,1618,1476,142,0,-501,136
-1,1331,1462,-131,0,-25,54
1,2034,2136,-102,0,46,133
1,1557,1650,-93,0,26,79
1,1815,1928,-113,-1,93,67
-1,1714,1763,-49,-2,-669,138
1,1776,1852,-76,1,0,61
-1,1796,1662,134,-4,-93,52
1,1633,1500,133,1,37,49
1,1928,1815,113,-1,23,81
-1,1538,1488,50,1,44,58
1,1772,1955,-183,0,-54,57
-1,1778,1880,-102,-2,-50,52
-1,1528,1755,-227,-3,-146,74
1,1636,1717,-81,-5,-11,47
1,1705,1508,197,6,545,121
1,1749,1383,366,-4,258,107
1,1318,1413,-95,2,2,40
-1,1886,1770,116,-2,-22,43
1,1807,1751,56,-8,-104,49
-1,1836,1758,78,0,-32,96
1,1808,1863,-55,-1,-61,61
-1,1387,1332,55,0,484,88
1,1728,1771,-43,-1,215,135
1,1741,1826,-85,1,58,67
1,1523,1316,207,0,317,87
-1,1337,1690,-353,-4,-462,122
1,1610,1730,-120,8,304,57
1,1596,1470,126,-3,233,123
1,1502,1134,368,4,128,41
1,1878,1948,-70,-1,-34,73
1,1677,1780,-103,1,110,101
-1,1298,1654,-356,1,-370,126
1,1628,1452,176,0,169,79
-1,1322,1598,-276,-1,-79,60
1,1578,1930,-352,11,437,69
1,1674,1795,-121,-4,143,113
1,1657,1485,172,3,62,44
1,1501,1686,-185,0,196,72
-1,1529,1516,13,0,26,56
1,1576,1539,37,3,54,45
-1,1625,1594,31,-1,-4,52
-1,1710,1671,39,0,-217,80
-1,1872,1914,-42,0,-27,94
-1,0,1517,-1517,0,8,44
1,1923,1680,243,8,220,57
1,1705,1606,99,14,801,69
-1,1516,1780,-264,0,4,70
-1,1529,1641,-112,-3,-113,54
-1,1598,1713,-115,-13,-478,68
1,1646,1466,180,0,118,81
1,1354,1309,45,2,-25,61
-1,1952,2120,-168,1,25,42
1,1662,1518,144,5,431,81
1,1590,1688,-98,0,92,103
1,1400,1264,136,0,9,49
-1,1635,1702,-67,-7,-61,140
1,1336,1639,-303,-1,13,91
1,1946,2127,-181,4,135,65
1,1649,1522,127,4,326,99
-1,1606,1497,109,-1,-13,98
1,1625,1437,188,7,199,59
1,1698,1639,59,2,72,75
1,1567,1586,-19,1,80,53
1,1444,1439,5,-10,-135,41
-1,1471,1880,-409,0,-418,106
-1,1480,2177,-697,0,-70,76
-1,1765,1691,74,-1,-319,130
1,1601,1583,18,-2,-25,67
1,1749,1721,28,0,103,69
-1,1711,1759,-48,-9,-242,62
-1,1533,1742,-209,-6,-67,48
1,1526,1311,215,2,336,81
-1,1491,1631,-140,-2,-31,46
-1,1692,1778,-86,0,32,64
-1,1956,2117,-161,-2,-16,80
1,1672,1265,407,0,82,65
1,1366,1223,143,-4,-59,99
1,1769,1701,68,2,32,43
-1,1707,1630,77,1,-462,110
1,1778,1517,261,2,15,41
1,1657,1460,197,10,395,63
1,1497,1528,-31,-3,-18,57
1,1569,1612,-43,0,150,55
1,1892,1468,424,2,40,53
-1,1696,1865,-169,-5,-5,40
1,1786,1684,102,-2,72,113
-1,1454,1652,-198,-1,-126,90
-1,1789,1882,-93,1,-303,94
-1,1949,2124,-175,0,-5,62
-1,1500,1561,-61,-2,-226,112
1,1653,1381,272,3,253,102
1,1853,1613,240,3,86,53
-1,1317,1466,-149,-9,-581,84
-1,1895,1689,206,-1,-108,62
-1,1797,1501,296,-7,-118,52
-1,1305,1443,-138,-1,-590,142
1,1605,1676,-71,-1,46,65
-1,1254,1421,-167,-1,-114,80
1,1801,1521,280,-2,252,119
1,1579,1533,46,0,90,99
1,1517,1658,-141,0,-31,69
-1,1263,1675,-412,-13,-369,66
-1,1355,1400,-45,-3,-80,50
1,1873,1821,52,1,-9,139
-1,1289,1473,-184,-3,85,44
1,1755,1943,-188,-5,2,53
-1,1794,2150,-356,-6,-276,84
1,1706,1874,-168,1,54,55
1,1528,1350,178,1,137,71
-1,1309,1480,-171,0,-108,62
-1,1690,1707,-17,-2,272,94
-1,1202,1169,33,18,339,110
1,1843,1669,174,3,120,54
-1,1495,1617,-122,0,-9,69
-1,1640,1537,103,-2,-165,74
1,1717,1731,-14,0,95,105
1,1513,1602,-89,1,28,43
-1,1729,1726,3,-5,-585,124
-1,1515,1389,126,3,-267,136
-1,1574,1496,78,-6,-58,50
-1,1280,1349,-69,0,-92,70
1,1626,1536,90,-3,20,53
1,1545,1467,78,1,133,63
1,1552,1136,416,11,405,55
1,1738,1718,20,0,17,51
1,1487,1465,22,0,-41,59
-1,1447,1521,-74,-3,-847,102
1,1625,1510,115,1,307,107
-1,1663,1352,311,3,93,54
-1,1650,1873,-223,-3,-41,48
1,1401,1272,129,5,67,51
1,1527,1634,-107,0,-21,63
1,1358,1264,94,0,150,83
1,1529,1426,103,1,517,145
1,1484,1502,-18,3,180,45
-1,1253,1623,-370,2,-30,94
-1,1404,1501,-97,-5,-570,146
-1,1616,1583,33,-3,-1471,140
1,1546,1247,299,3,375,95
-1,1207,1667,-460,0,-49,58
-1,1551,1496,55,-2,-182,106
-1,1534,1646,-112,-6,-59,67
1,1848,1647,201,0,427,199
-1,1462,1434,28,-8,-150,82
1,1419,1298,121,3,362,125
1,1624,1646,-22,3,67,43
-1,1609,1655,-46,0,-118,100
1,1673,1424,249,3,75,49
1,1634,1636,-2,-1,-25,45
-1,1269,1383,-114,-1,-603,112
-1,1315,1592,-277,-1,-593,82
-1,1551,1790,-239,2,-244,100
1,1696,1509,187,4,89,47
1,1732,1891,-159,1,51,107
1,1635,1246,389,0,16,47
1,1796,1546,250,-4,-61,61
-1,1625,1645,-20,-1,-66,100
-1,1276,1605,-329,0,-214,82
-1,1450,1509,-59,-4,-438,98
-1,1239,1447,-208,-15,-232,46
1,1472,1391,81,2,245,71
1,1720,1581,139,1,16,55
-1,1541,1726,-185,0,-45,62
-1,1739,1595,144,-1,12,44
-1,1371,1555,-184,0,3,72
-1,1229,1453,-224,-11,-697,92
1,1674,1596,78,-2,-51,45
1,1336,1271,65,5,545,93
1,1596,1674,-78,6,659,112
0,1619,1756,-137,0,-19,66
1,1458,1219,239,-4,-376,85
1,1749,1408,341,4,74,41
-1,1912,1871,41,1,22,46
1,1839,1878,-39,-1,108,127
1,1575,1535,40,-1,14,49
1,1500,1490,10,-6,-194,55
-1,1455,1625,-170,-2,-140,56
-1,1372,1641,-269,0,-170,76
1,1625,1632,-7,0,602,127
1,1611,1844,-233,1,9,137
-1,1410,1852,-442,0,-403,140
-1,1307,1600,-293,-1,-130,116
1,1492,1462,30,-2,69,55
-1,1883,1893,-10,-2,-378,134
-1,1857,1752,105,0,-233,66
-1,1444,1476,-32,2,-393,138
1,1766,1897,-131,-1,-77,73
1,1523,1373,150,6,57,40
1,1978,1606,372,0,52,75
1,1854,1401,453,1,52,53
1,1605,1642,-37,3,-8,57
1,1458,1075,383,9,683,65
1,1813,1369,444,0,94,77
1,1649,1221,428,1,19,44
-1,0,1100,-1100,-12,-335,58
1,1621,1640,-19,3,83,63
1,1366,1385,-19,-7,-85,77
1,1598,1651,-53,-6,155,89
1,1697,1535,162,-1,21,69
1,1938,1696,242,0,192,75
1,1671,1632,39,0,60,87
-1,1638,1525,113,0,-11,56
-1,1609,1782,-173,-8,-123,46
1,1463,1055,408,14,457,79
-1,1604,1671,-67,-2,-369,116
-1,1540,1622,-82,7,273,74
1,1625,1633,-8,0,137,77
1,1697,1378,319,15,211,45
1,1475,1401,74,2,202,65
-1,1527,1789,-262,-4,-106,54
1,1620,1645,-25,0,855,179
1,1762,1676,86,2,48,47
1,1591,1631,-40,-2,83,59
-1,1551,1523,28,-3,-32,54
-1,1374,1323,51,-2,-590,106
-1,1715,1876,-161,0,-27,66
-1,1046,1465,-419,-20,-546,42
1,1793,1587,206,-4,9,51
-1,1467,1038,429,9,255,56
-1,1618,1635,-17,0,-123,74
-1,1707,1682,25,0,-919,130
-1,1695,1691,4,0,-3,110
1,1553,1603,-50,6,151,53
1,1566,1223,343,2,116,65
1,1392,1333,59,0,897,147
-1,1607,1531,76,-2,-866,142
1,1581,1799,-218,0,74,89
-1,1392,1465,-73,-11,-137,108
-1,1483,1591,-108,-1,-427,128
1,1461,1223,238,0,53,103
1,1500,1827,-327,1,131,61
-1,2125,1590,535,-5,-62,52
-1,1119,1446,-327,-22,-392,42
-1,1500,1395,105,3,118,60
1,1431,1460,-29,5,455,95
1,1709,1621,88,2,251,69
1,1500,1668,-168,2,42,57
1,1612,2100,-488,6,239,71
-1,1677,1795,-118,-8,14,68
-1,1662,1610,52,0,-6,70
-1,1428,1564,-136,-2,-419,90
1,2076,1633,443,6,192,61
-1,1292,1625,-333,0,-166,82
-1,1502,1350,152,-4,-487,76
-1,1631,2078,-447,-5,-62,48
-1,1661,1712,-51,0,176,92
1,1456,1088,368,10,438,61
1,1689,1703,-14,1,-3,49
0,1685,1976,-291,-3,-45,41
1,2080,1630,450,-8,-11,73
-1,1500,1444,56,-3,-1013,172
1,1887,1523,364,4,58,45
-1,1722,1636,86,0,-12,48
1,2050,2071,-21,0,354,191
1,1613,1542,71,1,35,57
-1,1638,1486,152,3,-192,126
1,1620,1497,123,-1,-39,71
1,1500,1500,0,3,219,65
1,1707,1554,153,-3,-95,89
-1,1080,1459,-379,-6,-338,64
-1,1658,1779,-121,-1,-164,68
1,1715,1534,181,2,23,49
1,1352,1580,-228,-3,-87,41
1,1561,1556,5,-2,-24,49
-1,1731,2057,-326,-4,-585,112
-1,1394,1487,-93,1,37,86
1,1473,1680,-207,-8,-200,55
1,2061,1728,333,3,-25,45
1,1849,1714,135,2,114,50
-1,1472,1571,-99,-1,-147,138
1,2082,1568,514,3,171,71
1,1806,1091,715,1,374,97
-1,1545,1571,-26,-2,-114,72
1,1458,1368,90,5,178,55
-1,1746,2064,-318,-1,-47,58
1,1462,1072,390,4,3,61
1,1923,1624,299,0,22,55
1,1260,1370,-110,-1,78,63
-1,1738,1909,-171,-2,-98,78
1,2083,1806,277,1,33,47
-1,1356,1707,-351,5,167,56
-1,1635,1584,51,-3,-147,112
-1,1362,1358,4,-6,-263,112
1,1968,1705,263,-2,186,63
-1,1668,1760,-92,-1,-27,62
-1,1360,1507,-147,-3,56,104
-1,1622,1751,-129,-1,-33,55
1,2088,1802,286,3,67,49
-1,1065,1464,-399,-7,-244,66
1,1645,1520,125,-2,-66,43
-1,1427,1627,-200,0,6,40
1,1491,1282,209,-1,108,75
1,1566,1710,-144,3,84,47
1,1798,2093,-295,-1,-80,71
1,1758,1615,143,3,133,81
-1,1410,1583,-173,-7,-331,68
1,1495,1370,125,8,1007,117
1,1323,1580,-257,1,13,61
-1,1362,1583,-221,-1,-56,64
1,1171,1500,-329,13,242,43
1,1401,1395,6,3,468,109
0,2069,2070,-1,0,-7,99
1,1629,1552,77,2,117,58
1,1633,1384,249,1,6,47
1,1547,1303,244,2,300,131
1,1467,1059,408,16,2135,109
1,1400,1242,158,3,116,51
-1,1590,1278,312,4,-53,112
-1,1579,1673,-94,0,-12,54
-1,1662,1604,58,-2,-52,47
1,2070,2068,2,2,21,41
1,1889,1661,228,1,272,98
1,1972,1872,100,1,-16,51
1,1500,1349,151,4,586,89
1,1974,1608,366,4,140,63
1,2055,2083,-28,3,-116,105
1,1636,1660,-24,-1,700,119
1,1510,1355,155,5,165,49
1,1437,1354,83,3,272,81
-1,1516,1584,-68,-7,-587,76
1,1629,1356,273,2,352,105
1,2069,2069,0,1,79,77
1,1605,2005,-400,0,79,119
1,2069,1743,326,0,145,103
1,2056,2082,-26,-2,-58,57
1,1220,1500,-280,-3,-236,91
-1,1355,1590,-235,-3,39,62
-1,1313,1290,23,-4,-569,96
-1,1400,1602,-202,-12,-444,48
1,2068,2070,-2,1,78,57
-1,1585,1835,-250,0,-246,98
-1,1344,1445,-101,1,63,76
-1,1597,1616,-19,-6,-286,44
-1,2057,2081,-24,-1,-13,120
1,1607,1392,215,9,201,41
1,1499,1517,-18,1,252,121
-1,1489,1882,-393,-11,-515,122
1,1810,1298,512,-2,317,91
1,2092,2046,46,0,126,77
1,1595,1327,268,0,-13,65
-1,1550,1771,-221,0,-219,160
-1,1660,1506,154,-12,-184,44
1,1377,1618,-241,1,84,49
1,1631,1586,45,1,26,55
1,1467,1412,55,8,1153,121
1,1767,1720,47,0,9,67
0,1815,1656,159,4,65,125
1,1357,1343,14,17,855,69
1,1599,1403,196,8,687,81
1,2035,1656,379,4,356,71
-1,1395,1605,-210,-14,-431,56
1,1910,1832,78,1,95,77
1,1656,1379,277,0,-68,83
-1,1504,1346,158,1,-30,52
1,1305,1599,-294,1,229,109
-1,1708,1506,202,-3,-599,132
1,1613,1343,270,5,877,113
1,1544,1599,-55,-5,-89,71
1,1649,1611,38,2,745,115
-1,1581,1520,61,0,-213,86
-1,1332,1367,-35,-8,-242,56
-1,1310,1288,22,0,33,132
-1,1270,1488,-218,-7,-71,40
-1,1707,2038,-331,-2,-347,92
1,1556,1503,53,9,836,77
1,1600,1374,226,1,29,57
1,1820,1987,-167,2,43,57
-1,1403,1507,-104,0,-68,60
-1,1422,1581,-159,-8,-234,118
-1,1392,1422,-30,-1,-113,118
-1,1710,1777,-67,-2,3,46
1,2041,1676,365,0,-9,57
-1,1619,1622,-3,-1,-315,148
1,1478,1493,-15,0,501,111
1,1608,1561,47,0,2,69
1,1665,1641,24,0,-4,41
1,1540,1529,11,0,-16,59
-1,1836,2002,-166,1,35,52
-1,1391,1388,3,-1,-41,58
0,1615,1587,28,0,63,144
-1,1322,1372,-50,-3,-186,52
1,1778,1641,137,0,-81,91
-1,1378,1535,-157,-12,-198,54
1,1375,1500,-125,-4,-85,63
-1,1296,1622,-326,-1,-550,78
-1,1519,1971,-452,0,-116,68
-1,1542,1588,-46,-1,-272,102
1,1786,1700,86,0,-11,46
-1,1591,1682,-91,-2,-234,96
1,1643,1289,354,5,53,55
-1,1651,1660,-9,-3,-189,90
1,1473,1461,12,9,1215,217
-1,1702,1545,157,-5,-531,128
1,1539,1614,-75,-3,69,59
-1,1574,1758,-184,0,249,110
1,1609,1371,238,-1,256,73
1,1597,1532,65,1,91,53
-1,1520,1808,-288,-1,-32,60
1,1606,1314,292,0,-10,47
-1,1397,1199,198,6,192,90
-1,1665,1658,7,1,-10,81
0,1482,1396,86,1,-175,148
-1,1252,1386,-134,0,19,84
1,1400,1294,106,4,85,41
1,1810,1972,-162,0,9,45
-1,1523,1606,-83,0,-88,100
1,1626,1460,166,-1,-45,51
1,1601,1336,265,6,291,53
-1,1534,1395,139,0,-177,88
-1,1660,1776,-116,-3,-157,74
1,1882,1657,225,-4,90,83
-1,1693,1686,7,-2,-62,46
-1,1627,1654,-27,-1,-739,140
1,2109,1456,653,0,291,83
1,1951,1750,201,2,50,47
-1,1367,1308,59,-4,-135,84
1,1663,1675,-12,4,128,62
1,1677,1547,130,4,160,61
1,1452,1496,-44,6,408,63
-1,1455,1958,-503,-3,-79,42
-1,1777,2007,-230,-8,-155,44
1,1580,1371,209,16,428,51
-1,1641,1614,27,-5,-163,70
1,1631,1876,-245,1,236,85
-1,1778,1542,236,-9,-275,64
0,1422,1474,-52,-6,-567,109
1,1500,1297,203,6,155,51
1,1852,1835,17,2,32,47
1,1481,1373,108,-2,66,55
1,1959,1640,319,0,264,67
1,1613,1297,316,4,493,145
-1,1773,1858,-85,-1,-67,60
1,1618,1556,62,0,53,71
-1,1755,1947,-192,-4,-14,46
1,1361,1085,276,15,677,71
1,1648,1250,398,13,417,53
-1,1500,1487,13,0,38,60
-1,1630,1696,-66,-3,-487,128
-1,1352,1671,-319,-6,-253,98
-1,1630,1688,-58,0,10,58
1,1756,1953,-197,-4,23,67
-1,1637,2118,-481,-3,-204,62
1,1657,1322,335,0,41,73
1,1560,1445,115,4,253,69
-1,1472,1424,48,-11,-397,64
1,1666,1547,119,0,-83,97
1,1567,1661,-94,-3,38,97
1,1871,1750,121,2,108,61
1,1643,1525,118,4,54,47
1,1627,1333,294,1,253,105
-1,1868,1764,104,0,-111,88
-1,1622,1777,-155,0,-169,92
-1,1463,1649,-186,-14,-288,44
1,1500,1698,-198,2,62,81
-1,1491,1500,-9,-4,-345,74
-1,1435,2120,-685,-2,-368,82
0,1674,1595,79,-1,75,119
1,1655,1424,231,6,432,49
-1,1395,1660,-265,-4,-723,84
1,1742,1879,-137,0,116,131
1,1615,1648,-33,-3,-10,53
1,2120,1433,687,5,193,59
-1,1664,1500,164,1,30,64
1,1459,1437,22,3,167,69
1,1597,1348,249,14,391,41
1,1852,1778,74,7,378,73
1,1584,1574,10,-1,-70,87
-1,1615,1470,145,-9,-199,74
1,1656,1470,186,0,242,97
1,1496,1318,178,5,276,65
0,1654,1776,-122,3,423,94
-1,1670,1942,-272,0,-7,42
1,1948,1366,582,0,13,45
1,1738,2124,-386,0,89,53
-1,1517,1568,-51,-3,-137,66
1,1627,1534,93,0,15,83
1,1683,1770,-87,0,-13,65
1,1716,1539,177,1,14,49
1,1572,1426,146,2,485,79
1,2093,1761,332,-3,8,43
1,1464,1226,238,1,108,109
-1,1500,1522,-22,-5,-330,68
1,1491,1500,-9,-1,13,45
1,1936,1669,267,1,13,51
1,1378,1380,-2,0,-18,41
0,1624,1673,-49,4,1070,206
-1,1365,1949,-584,-6,-404,84
1,1641,1755,-114,-1,-11,43
1,1578,1507,71,-1,26,94
-1,1595,1567,28,-3,-15,48
-1,1538,1378,160,0,-6,96
1,1631,1511,120,3,115,49
-1,1419,1498,-79,3,-293,156
1,1814,1849,-35,0,-15,77
0,1698,1620,78,-2,-15,116
-1,1675,1953,-278,-3,-63,68
1,1837,1758,79,-1,4,51
1,1715,1276,439,4,188,53
-1,1635,1505,130,-9,-846,110
1,1869,1624,245,0,6,77
1,1639,1684,-45,-1,165,93
-1,1696,1656,40,-1,-48,86
-1,1809,1878,-69,-2,-49,48
1,1389,1364,25,2,76,47
1,1863,1717,146,0,54,81
-1,1144,1410,-266,0,7,48
-1,1624,1500,124,1,11,66
-1,1665,1671,-6,0,-6,52
-1,1749,1845,-96,0,-62,92
-1,1610,1250,360,-7,-291,58
1,1592,1410,182,7,333,53
1,1620,1582,38,3,198,71
1,1740,1621,119,-2,-3,51
1,1731,1394,337,7,414,85
1,1703,1672,31,3,384,97
-1,1500,1500,0,-5,6,140
-1,1490,1520,-30,-2,-91,46
-1,1500,1966,-466,-1,-618,110
1,1627,1524,103,5,81,45
-1,1723,1417,306,2,-125,118
1,1873,1683,190,5,260,64
-1,1352,1399,-47,1,-194,72
1,2097,1431,666,0,-4,49
1,1630,1572,58,-9,-13,105
1,1414,1462,-48,0,10,57
1,1968,1462,506,0,201,119
-1,1414,1637,-223,-5,-92,58
1,1452,1579,-127,1,344,111
1,1546,1509,37,7,284,69
1,1517,1635,-118,0,74,101
1,2098,1490,608,1,759,103
1,1826,1570,256,5,295,83
-1,1436,1971,-535,-1,8,44
1,1755,1440,315,0,2,41
-1,1656,1191,465,-4,-102,60
-1,1565,1468,97,0,-40,82
1,1502,1704,-202,3,96,59
1,1429,1298,131,-2,-27,61
-1,1557,1479,78,-8,-19,41
1,1785,1945,-160,0,-15,67
1,1973,2099,-126,0,0,47
1,1881,1656,225,1,-40,57
1,1556,1432,124,7,177,51
1,1638,1489,149,-2,-129,55
-1,1684,1586,98,-5,-299,93
-1,1482,1551,-69,1,-269,84
-1,1204,2076,-872,-6,-53,40
-1,1613,1642,-29,0,-100,114
-1,1275,1559,-284,-8,-170,42
1,1645,1551,94,-2,-69,55
-1,1697,1273,424,0,-435,104
-1,1406,1408,-2,-1,-67,64
1,1687,1520,167,6,68,41
1,1929,1804,125,-1,488,99
1,2076,1969,107,-1,-3,43
-1,1543,1654,-111,-14,-552,64
1,1563,1747,-184,-2,-22,47
1,1250,1446,-196,-2,-64,67
-1,1662,1535,127,-17,-938,72
1,1627,1561,66,0,16,77
1,1632,1565,67,1,-121,69
-1,1531,1643,-112,1,13,42
-1,1795,1936,-141,-2,-184,82
-1,1421,1519,-98,-5,-312,64
1,1952,1651,301,0,6,61
1,1707,1682,25,-3,47,79
1,1550,1646,-96,8,502,75
1,2088,1327,761,1,41,95
1,1853,1822,31,1,439,109
1,1673,1554,119,0,26,71
-1,1636,1563,73,0,-16,62
-1,1670,1600,70,-6,8,62
-1,1900,1500,400,2,-38,106
-1,1653,1623,30,-1,-34,143
1,1650,1357,293,5,68,45
1,1637,1530,107,-4,-89,69
-1,1884,1768,116,1,13,50
-1,1427,1501,-74,-7,-50,40
-1,1652,1756,-104,0,-255,164
1,1411,1335,76,-3,42,63
1,1943,1717,226,3,213,77
-1,1712,1948,-236,-1,-90,78
1,1535,1474,61,-5,-149,89
1,1637,1715,-78,0,3,93
1,2089,1778,311,-3,-37,49
1,1657,1613,44,-5,-144,53
1,1706,1681,25,2,235,85
1,1469,1388,81,3,748,91
1,1464,1522,-58,4,280,65
-1,1782,1830,-48,0,-160,90
-1,1425,1625,-200,1,34,84
-1,1564,1370,194,2,31,148
1,1465,1616,-151,4,815,173
1,1409,1342,67,15,576,53
1,1672,1137,535,4,30,43
-1,1349,1579,-230,-10,-583,88
1,1592,1413,179,6,76,46
-1,1555,1641,-86,-3,-88,56
1,1410,1524,-114,0,-207,121
0,1500,1513,-13,0,30,98
1,1477,1568,-91,0,88,85
1,1823,1787,36,7,217,57
-1,1417,1730,-313,0,-17,84
1,1512,1670,-158,2,69,57
-1,1430,1707,-277,0,-84,62
1,1785,1677,108,1,670,135
1,1528,1635,-107,-1,39,57
1,1652,1385,267,2,95,67
0,1666,1604,62,2,-26,236
1,1562,1617,-55,0,205,97
1,1718,1422,296,1,86,55
0,1434,1679,-245,0,-381,218
1,1516,1679,-163,-2,387,137
-1,1862,1956,-94,1,-488,106
-1,1790,1936,-146,1,25,54
-1,2003,1863,140,-7,-7,44
-1,1600,1469,131,-1,3,42
-1,1656,1801,-145,-4,-414,76
-1,1527,1653,-126,-2,-32,44
1,1881,1598,283,-1,41,93
-1,1377,1769,-392,-1,-8,48
-1,1320,1647,-327,-3,-203,94
0,1414,1728,-314,0,-114,124
-1,1644,1577,67,0,-26,80
-1,1347,1413,-66,1,145,174
-1,1886,1862,24,-3,-142,70
-1,1953,1773,180,0,12,76
1,1768,1316,452,6,282,53
1,1876,1693,183,3,90,51
1,1809,1649,160,0,427,141
-1,1387,1280,107,2,51,48
1,1437,1429,8,-1,48,59
1,1869,1953,-84,1,63,65
1,1666,1549,117,3,43,51
1,1547,1692,-145,0,43,115
-1,1522,1528,-6,-1,21,70
1,1776,1542,234,-10,-8,99
-1,1547,1770,-223,-2,-94,72
1,1699,1964,-265,-2,-18,75
1,1943,1877,66,1,16,65
-1,1523,1675,-152,-11,-466,64
1,1541,1536,5,0,59,59
1,1787,1832,-45,9,285,77
1,1422,1660,-238,-2,-106,59
1,1882,1694,188,0,36,61
0,1636,1718,-82,1,23,111
1,1500,1483,17,2,141,71
1,1698,1500,198,3,85,57
-1,1537,1781,-244,-6,-448,112
-1,1520,1500,20,-2,-193,84
-1,1665,1785,-120,-1,-32,64
-1,1449,1754,-305,-10,-480,66
-1,1630,1590,40,-1,59,122
-1,1337,1424,-87,0,20,62
1,1642,1303,339,3,334,73
-1,1512,1685,-173,0,11,56
-1,1626,1621,5,6,68,42
-1,1427,1817,-390,-4,-75,48
-1,1625,1803,-178,-1,-29,50
1,1654,1719,-65,-4,14,55
1,1375,1348,27,9,222,49
1,1658,1333,325,8,183,49
1,1555,1531,24,0,614,159
1,1500,1575,-75,0,46,57
-1,1774,2094,-320,1,30,64
1,1708,1430,278,0,15,41
1,1576,1346,230,3,16,45
0,1506,1845,-339,0,43,115
-1,1615,1654,-39,0,-96,72
1,1789,1566,223,4,269,65
1,1741,1783,-42,0,144,77
1,1711,1638,73,-2,26,65
1,1457,1514,-57,3,234,77
1,1551,1530,21,-6,-17,43
1,1561,1830,-269,-1,181,115
-1,1677,1939,-262,0,10,42
-1,1588,1622,-34,-1,-43,68
-1,1667,1774,-107,0,41,102
-1,1657,1694,-37,-4,-239,73
1,1512,1720,-208,2,19,43
1,1645,1552,93,-2,-120,77
-1,1299,1786,-487,-2,-75,60
-1,1723,1740,-17,0,-31,51
-1,1700,1577,123,0,31,120
-1,1564,2123,-559,1,-16,72
1,1664,1630,34,5,95,47
1,1983,1905,78,0,-16,97
1,1328,1434,-106,6,194,53
-1,1392,1599,-207,0,39,80
1,1687,1516,171,8,178,53
1,1525,1500,25,8,91,45
-1,1612,1770,-158,-1,-45,80
-1,1753,1804,-51,-1,-135,92
-1,1624,1987,-363,1,-16,64
-1,1626,1579,47,-1,-165,76
1,1751,1712,39,3,194,73
-1,1519,1562,-43,-8,-220,60
-1,1337,1481,-144,5,-183,98
-1,1385,1604,-219,-1,-112,82
1,1580,1702,-122,1,278,99
-1,1521,1627,-106,-4,-449,154
1,2037,1944,93,-3,-32,47
1,1622,1280,342,6,270,67
-1,1647,1500,147,1,-75,86
1,1385,1387,-2,-2,-138,73
1,1379,1531,-152,-4,-28,55
1,1492,1498,-6,0,157,83
-1,1277,1625,-348,2,42,58
1,1661,1500,161,-1,-1,48
-1,1532,2124,-592,-1,-23,46
1,1848,1701,147,0,5,43
-1,1591,1777,-186,-8,-621,118
-1,1515,1398,117,0,-1,52
-1,1683,1634,49,-4,-116,92
1,1482,1484,-2,0,-5,87
-1,1572,1683,-111,0,-429,150
1,1715,1563,152,-2,231,71
-1,1034,1485,-451,-22,-447,48
1,1581,1208,373,9,957,107
-1,1635,1741,-106,0,-15,56
-1,1294,1722,-428,-6,-443,104
-1,1578,1404,174,0,-211,130
0,1682,1619,63,0,-59,122
-1,1203,1584,-381,-5,-259,70
-1,1824,1501,323,0,-187,202
-1,1680,1557,123,-5,-157,56
0,1781,1930,-149,-1,-35,76
1,1799,1526,273,-3,-39,43
1,1713,1630,83,0,31,91
1,1459,1205,254,0,41,79
-1,1586,1198,388,6,530,88
-1,1399,1946,-547,0,-143,60
-1,1724,1608,116,0,-3,96
-1,1292,1487,-195,1,86,46
1,1650,1586,64,-1,-11,43
-1,1238,1566,-328,-9,-430,60
-1,1472,1310,162,-11,-1183,136
1,1440,1424,16,0,0,79
-1,1686,1676,10,2,-97,70
0,1569,1232,337,2,371,79
1,1791,1202,589,1,19,45
-1,1623,1708,-85,-3,-4,52
-1,1232,1569,-337,-9,-441,68
-1,1621,1663,-42,-1,5,58
-1,1659,1577,82,1,2,48
1,1485,1413,72,0,212,97
1,1702,1891,-189,1,145,101
1,1572,1248,324,-3,400,71
-1,1717,1335,382,-1,-68,90
1,1477,1611,-134,1,89,57
-1,1242,1575,-333,-17,-675,62
-1,1514,1353,161,-5,-117,60
1,1579,1237,342,4,232,57
1,1593,1351,242,-1,47,121
-1,1231,1582,-351,-19,-560,50
-1,1418,1460,-42,2,72,82
1,1582,1231,351,20,881,69
0,1357,1696,-339,0,-297,90
-1,1483,1560,-77,-3,-99,64
-1,1226,1585,-359,-15,-872,78
-1,1583,1717,-134,2,38,50
1,1804,1616,188,0,278,97
1,1768,1511,257,4,140,53
1,1588,1222,366,1,334,91
-1,1690,1926,-236,0,-40,64
-1,1790,1584,206,0,49,100
1,1614,1407,207,3,192,69
1,1217,1591,-374,1,51,69
1,1687,1404,283,-2,-3,83
0,1598,1568,30,6,1137,142
-1,1619,1482,137,0,14,50
1,1780,1201,579,19,285,47
1,1571,1462,109,-3,-16,51
-1,1809,1918,-109,-1,-192,74
1,1464,1507,-43,1,403,115
-1,1400,1691,-291,-3,-303,170
-1,1500,1597,-97,2,80,54
1,1950,1767,183,-2,174,125
-1,1603,1367,236,-2,-37,48
1,1641,1721,-80,6,559,107
-1,1529,1563,-34,-7,-202,50
-1,1527,1464,63,3,98,72
-1,1582,1500,82,0,-677,104
1,1336,1449,-113,2,535,89
-1,1753,1918,-165,-1,-236,102
-1,1617,1490,127,-1,-32,48
-1,1695,1599,96,1,-309,108
-1,1930,1864,66,0,-10,74
-1,1684,1603,81,1,116,104
1,1761,1801,-40,2,153,69
1,1486,1342,144,1,61,83
1,1746,1401,345,0,408,89
1,1478,1514,-36,-1,53,97
-1,1059,1330,-271,-5,-124,46
1,1507,1618,-111,2,44,59
1,1392,1645,-253,1,-27,83
1,1956,1798,158,-1,-11,67
-1,1724,1686,38,0,-109,124
1,1768,1439,329,8,106,45
1,1694,1734,-40,4,330,79
1,1749,1398,351,3,51,45
-1,1502,1491,11,0,-1,64
-1,1602,1657,-55,2,-118,98
-1,1592,1637,-45,-5,-94,44
-1,1599,1690,-91,0,-53,52
1,1258,1352,-94,-2,250,77
1,1752,1396,356,5,81,51
1,1772,1244,528,4,133,57
-1,1647,1582,65,-4,107,56
1,1575,1334,241,-5,-20,67
-1,1655,1707,-52,0,4,56
1,1830,1604,226,2,148,85
-1,1477,1612,-135,-2,-190,120
1,1925,1881,44,1,124,85
-1,1590,1706,-116,-1,4,56
1,1755,1393,362,3,209,75
1,1491,1705,-214,-1,-11,45
-1,1616,1680,-64,-2,-70,58
1,1821,1329,492,2,573,133
1,1579,1592,-13,3,200,67
1,1658,1672,-14,-3,78,71
-1,1788,1778,10,1,148,100
-1,1379,1242,137,-4,-108,50
1,1500,1662,-162,1,106,89
-1,1634,1411,223,-4,-482,100
-1,1500,1482,18,-2,-142,58
-1,1670,1634,36,2,33,128
1,1687,1509,178,-2,-10,73
-1,1731,1801,-70,-3,-66,100
-1,1264,1510,-246,-1,-149,74
1,1791,1338,453,15,484,55
1,1861,1676,185,1,29,119
1,1317,1144,173,6,536,101
1,1758,1390,368,6,298,53
1,1717,1363,354,5,531,103
1,1669,1660,9,1,357,115
-1,1869,1934,-65,-1,-24,70
-1,1619,1721,-102,0,-302,120
1,1597,1702,-105,0,85,63
1,1424,1398,26,6,466,73
1,1683,1627,56,0,-4,77
-1,1469,1693,-224,-3,-154,98
-1,1761,1387,374,0,-23,50
-1,1557,1677,-120,1,43,74
1,1776,1291,485,3,153,55
-1,1510,1370,140,-2,-438,106
1,1680,1649,31,0,-9,51
-1,1638,1691,-53,-1,-21,42
-1,1622,1503,119,2,82,74
1,1738,1609,129,-1,-109,83
1,1700,1629,71,-2,25,79
1,1671,1580,91,1,263,139
-1,1454,1515,-61,0,207,92
-1,1583,1569,14,-1,-251,114
0,1180,1432,-252,0,85,107
-1,1670,1883,-213,-2,-134,68
1,1430,1204,226,0,4,43
1,1709,1608,101,0,207,85
-1,1290,1777,-487,-12,-225,44
1,1518,1591,-73,0,-11,47
-1,968,1324,-356,-9,-445,98
0,1467,1409,58,5,99,44
-1,1239,1514,-275,3,268,74
1,1779,1288,491,8,115,43
1,1746,1749,-3,2,134,67
-1,1340,1735,-395,-1,-107,68
1,1698,1512,186,6,416,55
-1,1664,1901,-237,0,-221,118
-1,1461,1532,-71,-2,-90,70
0,1617,1557,60,5,498,99
-1,1858,1913,-55,-1,-215,84
-1,1600,1954,-354,-4,-73,72
1,1780,1686,94,0,33,50
-1,1328,1823,-495,-3,-346,78
1,1957,1597,360,-3,162,79
1,1717,1788,-71,1,19,45
1,1325,1220,105,-2,-272,103
1,1917,1704,213,1,171,107
1,1179,1246,-67,-1,-17,41
-1,1612,1729,-117,0,-108,56
1,1433,1289,144,1,-132,87
-1,1595,1960,-365,-4,-175,64
-1,1524,1426,98,-4,-265,80
1,1613,1711,-98,5,198,65
1,1963,1592,371,3,77,53
1,1739,1191,548,4,173,55
1,1847,1948,-101,-1,-37,61
1,1737,1605,132,4,83,43
-1,1327,1675,-348,-4,-140,58
-1,1589,1966,-377,0,283,106
1,1741,1595,146,0,14,57
1,1996,1598,398,0,95,67
1,1743,1706,37,0,11,51
-1,1759,1797,-38,2,-7,56
1,1566,1054,512,9,566,89
-1,1587,1752,-165,0,-5,70
-1,1934,1864,70,2,57,58
1,1415,1441,-26,1,73,85
-1,1190,1500,-310,0,-61,58
1,1595,1999,-404,0,128,173
-1,1551,1969,-418,-2,-174,70
1,1859,1659,200,1,38,89
1,1738,1753,-15,-1,-28,63
1,1500,1615,-115,-1,-132,81
1,1971,1543,428,-1,32,59
-1,1536,1498,38,0,3,44
1,1470,1324,146,1,28,63
-1,1806,1695,111,-3,-61,108
1,1552,1699,-147,0,22,95
-1,1608,1541,67,1,-84,96
1,1650,1383,267,2,254,69
-1,1969,1616,353,-1,-187,90
1,1742,1750,-8,-3,-49,62
-1,1510,1523,-13,7,178,50
-1,1493,1683,-190,-2,-318,92
1,1682,1567,115,0,139,71
1,1680,1588,92,1,108,73
-1,1950,1923,27,0,36,128
-1,1625,1500,125,0,-9,48
1,1804,1636,168,1,233,105
1,1739,1753,-14,7,249,71
1,1441,1519,-78,5,34,44
1,1730,1602,128,8,45,41
-1,1316,1694,-378,-2,-161,84
1,1674,1575,99,-9,112,112
1,1462,1317,145,-4,-83,53
1,1711,1939,-228,0,76,83
-1,1525,1500,25,-1,42,122
1,1963,1813,150,-2,69,61
-1,1534,1499,35,-10,-35,40
-1,1567,1683,-116,-6,-615,128
0,1313,1486,-173,9,395,59
-1,1610,1569,41,3,47,86
1,1455,1574,-119,4,779,133
1,1500,1883,-383,0,-60,89
-1,1464,1742,-278,-1,-166,108
1,1689,1771,-82,0,421,117
1,1572,1571,1,-1,-215,103
1,1748,1804,-56,1,34,54
-1,1730,1921,-191,-2,-81,60
-1,1176,1571,-395,-3,-130,66
-1,1614,1583,31,3,-56,80
-1,1954,1828,126,0,-6,58
-1,1500,1678,-178,-1,-89,52
1,1480,1319,161,0,174,99
-1,1364,1503,-139,-3,-206,72
-1,1536,1668,-132,0,-99,80
1,1970,1677,293,-1,28,71
-1,1597,1602,-5,-5,-96,52
1,1359,1239,120,-4,-104,49
-1,1836,1565,271,-2,-223,100
1,1745,1629,116,3,353,123
-1,1932,1926,6,2,26,58
-1,1548,1890,-342,-5,-64,46
1,1483,1366,117,0,13,59
-1,1625,1635,-10,-11,-20,40
1,1578,1532,46,-4,-284,79
1,1634,1721,-87,1,72,91
0,1724,1841,-117,0,20,134
0,1229,1368,-139,-4,397,97
1,1614,1592,22,2,197,79
1,1610,1747,-137,3,490,109
1,1538,1812,-274,0,26,75
1,1453,1487,-34,0,-180,95
1,1622,1753,-131,-1,68,77
1,1974,1921,53,1,15,57
1,1580,1586,-6,0,-56,65
1,1719,1582,137,2,168,87
1,1722,1624,98,2,114,71
-1,1433,1752,-319,-4,-122,82
-1,1500,1585,-85,-11,-170,42
1,1715,1637,78,0,143,79
1,1356,1310,46,-5,-107,61
1,1574,1593,-19,0,-7,103
1,1503,1235,268,0,3,59
1,1738,1637,101,4,196,73
-1,1580,1586,-6,-1,-20,56
-1,1688,1583,105,-2,44,82
1,1625,1864,-239,0,2,60
-1,1838,1728,110,-1,-123,118
1,1938,1912,26,1,25,51
1,1598,1568,30,9,488,69
1,1229,1189,40,0,18,43
-1,1785,1791,-6,-1,-333,118
1,1629,1746,-117,2,42,53
-1,1612,1789,-177,-4,-78,40
1,1485,1241,244,2,49,55
-1,1312,1402,-90,-19,-611,56
1,1919,1907,12,-1,45,81
1,1641,1541,100,0,641,123
1,1766,1880,-114,-1,-86,73
-1,1629,1781,-152,-2,-37,42
1,1648,1660,-12,0,-6,87
1,1558,1616,-58,-3,-249,89
1,1436,1560,-124,7,646,91
-1,1242,939,303,2,-7,50
1,1604,1571,33,0,-1,53
-1,1608,1730,-122,-1,-133,86
-1,1744,1824,-80,-1,-31,58
1,1572,1303,269,1,40,49
1,1514,1539,-25,-2,-216,89
1,1832,1703,129,-3,76,79
1,1902,1838,64,0,51,59
-1,1580,1236,344,2,76,64
-1,1500,1807,-307,0,-8,88
0,1601,1574,27,0,-199,99
1,1497,1512,-15,-4,-22,93
-1,1026,1220,-194,2,-7,64
1,1552,1645,-93,5,210,63
-1,1655,1859,-204,-1,-185,114
1,1516,1646,-130,-4,-9,43
0,1539,1505,34,0,7,47
-1,1734,1822,-88,-4,65,106
1,1654,1634,20,0,512,117
1,1878,1600,278,0,162,83
0,1771,1778,-7,-1,-141,94
-1,1611,1576,35,-12,-133,128
-1,1347,1343,4,5,422,90
-1,1627,1414,213,2,41,58
1,1605,1375,230,0,92,53
1,1457,1311,146,-1,-2,43
1,1519,1599,-80,0,25,56
1,2131,1976,155,0,76,117
1,1499,1302,197,-1,-184,77
1,1434,1322,112,6,146,45
-1,1967,2138,-171,-7,-75,40
1,1500,1644,-144,-1,15,55
-1,1611,1496,115,-6,-351,70
1,1297,1510,-213,3,111,67
-1,1529,1294,235,-9,-49,42
1,1791,1569,222,0,40,61
-1,1529,1294,235,-7,-498,96
-1,1417,1569,-152,-1,-577,158
-1,1611,1668,-57,-3,-158,84
-1,1774,1896,-122,0,16,106
-1,1444,1317,127,-2,-124,70
1,1640,1669,-29,-4,-27,59
-1,1593,1428,165,-4,-70,48
1,1455,925,530,1,31,46
1,1380,1336,44,0,49,91
-1,1498,1551,-53,-7,23,40
1,1963,1639,324,2,-73,87
1,1572,1270,302,0,-21,83
-1,1634,1500,134,-3,-127,72
-1,1700,1564,136,3,147,106
-1,1551,1591,-40,1,26,62
1,1543,1500,43,0,28,57
-1,1417,1500,-83,0,5,68
1,2133,1793,340,0,58,97
1,1758,1852,-94,0,11,72
-1,1430,1576,-146,-2,-97,46
0,1341,1737,-396,-10,-45,40
-1,1790,2136,-346,-6,-16,44
1,1500,1500,0,4,34,43
-1,1662,1658,4,-5,-132,62
1,1684,1639,45,1,125,90
1,1760,1082,678,-1,-7,47
-1,1500,1601,-101,7,209,66
-1,1551,1757,-206,0,-65,84
-1,1554,1764,-210,1,35,66
1,1455,1374,81,1,47,51
1,1427,1482,-55,0,-2,41
1,1636,1645,-9,0,20,65
1,1904,1767,137,-1,-5,63
-1,1501,1770,-269,1,-34,88
-1,918,1457,-539,3,166,76
1,1500,1764,-264,0,10,103
0,1712,1834,-122,-4,-132,61
1,1936,1457,479,0,37,87
1,1603,1525,78,0,101,88
-1,1351,1309,42,2,30,52
1,1358,1529,-171,0,-71,53
-1,1775,1780,-5,0,-21,90
-1,1496,1655,-159,0,-619,158
-1,1652,1637,15,-1,-146,157
-1,1967,1763,204,2,12,64
-1,1250,1579,-329,-23,-423,42
1,1561,1534,27,0,211,61
-1,1326,1469,-143,7,287,78
1,1422,1495,-73,-10,-193,47
-1,1524,1571,-47,-1,-113,96
-1,1246,1587,-341,-4,-347,74
1,1948,1754,194,3,112,51
-1,1629,1671,-42,-3,-107,65
-1,1429,1583,-154,0,-165,74
-1,1551,1529,22,2,63,60
1,1423,1339,84,2,36,49
1,1787,1782,5,0,12,67
-1,1633,1938,-305,-5,12,88
0,1514,1351,163,-3,-241,130
-1,1572,1496,76,0,146,68
1,2125,2067,58,0,-4,41
-1,2067,2125,-58,-1,-27,62
-1,1474,1540,-66,4,215,86
-1,1856,1752,104,-1,-19,108
-1,2135,2057,78,-2,119,89
1,1500,1465,35,1,115,93
0,1771,2145,-374,0,-59,154
-1,2072,2121,-49,2,13,52
1,1357,1509,-152,9,441,77
1,2121,2072,49,-3,59,137
-1,1465,1418,47,-3,-149,68
-1,1577,1599,-22,0,-6,62
-1,1487,1095,392,0,-705,136
1,1516,1510,6,3,202,91
1,1589,1330,259,-6,-297,83
0,1738,1595,143,1,-41,165
1,2061,2131,-70,5,111,73
1,1777,2138,-361,9,492,117
1,1763,1677,86,0,-17,63
1,1551,1750,-199,-3,155,109
1,1563,1053,510,1,299,85
-1,1761,1721,40,0,35,62
-1,1476,1474,2,0,-19,50
-1,2117,2076,41,-1,-218,104
1,1798,1343,455,0,70,69
1,1747,1531,216,3,219,99
1,1499,1315,184,3,73,59
1,2090,2104,-14,2,365,83
1,1954,1557,397,-1,-69,85
1,1766,1749,17,-1,-44,69
1,1715,1366,349,11,769,75
-1,1857,2102,-245,-4,-2,44
1,1545,1493,52,0,245,93
-1,1559,1553,6,0,-115,76
1,2107,1824,283,0,-45,63
-1,1369,1811,-442,-3,-281,74
-1,1824,2107,-283,-1,-20,52
-1,1465,1538,-73,0,2,52
1,1682,1493,189,-2,-60,63
-1,1340,1800,-460,-4,-509,100
1,1575,1660,-85,0,6,51
-1,1325,1594,-269,1,21,42
-1,1813,1346,467,-2,-87,50
-1,1553,1957,-404,1,110,92
-1,2046,1876,170,-4,-666,112
-1,1688,1813,-125,-1,237,124
1,1483,1555,-72,-7,-270,51
-1,1500,1475,25,4,115,52
0,1229,1442,-213,4,-49,113
-1,1570,1299,271,-9,-361,56
1,1795,1593,202,-8,-2,49
1,1526,1661,-135,1,62,67
1,1719,1500,219,1,53,65
1,1625,1329,296,6,111,47
1,1748,1831,-83,1,96,71
-1,1504,1817,-313,3,113,80
1,1776,1753,23,2,18,45
-1,1543,1800,-257,0,-58,62
-1,1588,1678,-90,0,-55,114
1,1942,1642,300,1,-21,53
1,1720,1509,211,0,81,61
1,1695,1580,115,1,-8,51
0,1609,1614,-5,-1,13,116
-1,1456,1541,-85,0,7,50
0,1540,1676,-136,-3,-305,112
-1,1678,1945,-267,0,-294,146
1,1805,1509,296,-1,45,121
-1,1741,1786,-45,-2,-42,60
-1,1210,1411,-201,-1,-348,96
-1,1399,1552,-153,4,59,44
-1,1692,1669,23,0,26,66
-1,1802,1751,51,0,-170,88
1,1639,1838,-199,0,20,55
1,1868,1632,236,1,8,67
1,1484,1809,-325,2,273,99
-1,1614,1610,4,0,-15,54
-1,1559,1362,197,-2,-107,54
1,1725,1411,314,0,72,61
-1,1703,1634,69,0,-74,80
-1,1448,1566,-118,-1,-161,90
1,2092,2098,-6,0,106,55
1,1361,1615,-254,-1,2,71
-1,1559,1638,-79,0,-265,82
-1,1381,1742,-361,0,-138,98
1,1729,1087,642,0,171,57
0,1864,1721,143,-4,-227,115
-1,1762,1436,326,-2,-54,60
1,1818,1680,138,1,53,64
1,2086,2103,-17,1,179,115
1,1799,1533,266,-1,173,113
1,1271,1315,-44,0,7,55
-1,1390,1760,-370,-6,-287,68
1,1463,1202,261,12,183,41
-1,1672,1544,128,0,-41,76
1,1550,1648,-98,-2,209,109
-1,1317,1444,-127,-3,-212,112
-1,1387,1467,-80,-4,-59,47
-1,1601,1498,103,-1,-63,54
-1,1086,1730,-644,-1,-202,74
1,1959,1462,497,-1,0,45
-1,1585,1601,-16,0,-59,89
1,1440,1482,-42,6,883,121
-1,1585,1315,270,-3,-413,96
0,1781,1788,-7,2,58,54
-1,1607,2093,-486,-5,-96,48
1,1564,1632,-68,-1,125,139
1,1729,1301,428,1,271,83
1,1570,1468,102,-8,349,141
1,1476,1378,98,3,146,57
-1,1456,1826,-370,-1,-140,64
-1,1658,1304,354,1,-252,70
-1,1730,1385,345,1,14,66
1,1489,1621,-132,-2,-30,45
-1,1236,1394,-158,-1,-401,98
1,1741,1736,5,0,124,129
1,1464,1468,-4,-1,-58,63
1,1508,1697,-189,-2,58,51
1,1453,1429,24,12,379,57
1,1401,1237,164,5,565,89
-1,1641,1829,-188,0,-6,50
-1,2044,2139,-95,-1,-274,102
1,1757,1464,293,0,19,55
1,1611,1565,46,2,299,73
-1,1590,1744,-154,0,-6,72
1,1355,1131,224,3,288,83
1,1873,1717,156,0,-37,63
-1,2011,1957,54,-1,76,106
-1,1194,1408,-214,3,58,58
1,1635,1446,189,2,57,47
-1,1591,1686,-95,1,-361,112
-1,1660,1834,-174,0,-17,92
1,1731,1500,231,9,229,43
-1,1418,1706,-288,-1,-100,58
1,1424,1308,116,2,131,87
0,1788,1781,7,-9,-287,64
1,1903,1606,297,1,62,83
1,1357,1461,-104,9,248,53
1,1679,1529,150,3,347,107
1,1825,1665,160,0,-20,59
1,1567,1427,140,0,-39,136
-1,1731,1648,83,0,-246,74
1,1538,1500,38,5,48,51
-1,1602,1907,-305,-1,-89,112
1,1127,1232,-105,15,389,51
-1,1360,1324,36,1,-8,50
1,1998,1892,106,-6,-63,47
-1,1384,1544,-160,-6,-65,40
0,1761,1780,-19,0,-48,112
1,1961,2091,-130,-3,-22,71
-1,1489,1555,-66,-1,-110,70
1,1463,1372,91,5,195,59
1,1546,1515,31,2,468,121
1,1310,1209,101,6,130,45
0,1711,1539,172,0,-52,143
1,1365,1069,296,0,213,117
-1,2006,1884,122,0,-58,61
1,1264,1493,-229,-1,47,49
1,1665,1443,222,1,64,101
1,1780,1761,19,1,120,55
-1,1390,1486,-96,1,14,52
-1,1794,1751,43,-9,-147,74
-1,1686,1840,-154,-1,-25,80
-1,1505,1556,-51,-1,-26,128
-1,1551,1419,132,-9,-247,58
1,1751,1791,-40,3,134,85
1,1694,1568,126,2,272,72
-1,1611,1910,-299,-2,-82,55
-1,1481,1565,-84,0,1,46
1,1501,1413,88,6,223,45
1,1525,1299,226,0,16,49
1,1566,1496,70,1,106,107
-1,1283,1445,-162,-11,-459,72
1,1472,1574,-102,1,33,47
-1,1914,2076,-162,0,-66,110
-1,1297,1451,-154,-12,-485,52
-1,1787,2035,-248,-4,-86,56
1,1643,1398,245,-3,-28,51
-1,1433,1535,-102,0,13,54
0,1495,1367,128,1,-376,98
-1,1367,1541,-174,1,16,44
-1,1618,1456,162,-5,-36,40
-1,1708,1626,82,1,-126,98
-1,1411,1361,50,-7,-482,86
-1,1487,1576,-89,9,403,78
1,1775,1766,9,0,17,55
1,1559,1486,73,-1,413,115
-1,1363,1410,-47,2,88,62
1,1846,1679,167,2,49,47
1,1555,1464,91,-4,-76,71
-1,2040,1721,319,0,-454,122
1,1714,1415,299,0,-3,63
1,1653,1717,-64,-1,-3,69
1,2149,1977,172,5,304,113
-1,1673,1853,-180,-1,29,86
-1,1465,1543,-78,2,99,52
1,1585,1478,107,-3,-237,111
-1,2082,1907,175,-2,-112,78
-1,1548,1740,-192,-4,-489,118
1,1663,1564,99,-3,41,91
-1,1971,2157,-186,0,-66,64
0,1403,1509,-106,-2,-147,144
1,2006,1822,184,0,119,139
1,1402,1395,7,5,99,73
-1,1559,1411,148,1,-289,96
1,1964,2022,-58,0,12,67
1,1377,1491,-114,1,107,53
1,1471,1593,-122,-1,262,87
1,1746,1978,-232,1,454,143
-1,1552,1440,112,0,-19,50
-1,1542,1580,-38,0,36,68
-1,1634,2007,-373,-1,-6,66
1,1577,1485,92,0,26,93
1,1596,1393,203,1,166,69
-1,1380,1328,52,-4,-110,52
1,1719,1522,197,0,11,95
1,1560,1539,21,-1,265,111
1,1796,1823,-27,5,473,77
1,1959,1632,327,-1,38,45
1,1476,1412,64,2,87,71
1,1477,1586,-109,8,357,69
-1,1628,1963,-335,-1,62,112
1,2010,2115,-105,0,16,99
1,1763,1414,349,0,313,87
1,1869,1655,214,3,39,48
-1,1926,1475,451,5,-15,90
0,1479,1538,-59,-10,-89,102
1,1378,1491,-113,5,115,51
1,2026,1966,60,0,413,87
1,1423,1344,79,2,96,47
1,1436,1238,198,-1,-19,53
-1,1420,1531,-111,7,45,76
-1,1783,1777,6,0,18,68
1,1796,1818,-22,-1,20,63
1,1566,1594,-28,4,296,81
1,1863,1563,300,0,338,109
1,1817,1536,281,-5,-170,45
1,1583,1593,-10,1,441,157
1,1621,1686,-65,2,-9,40
1,1828,1528,300,0,198,41
-1,1585,1422,163,0,-2,40
-1,1194,1339,-145,-2,-28,58
1,1680,1582,98,0,-76,71
1,1833,1524,309,-2,-26,47
1,1881,2006,-125,-1,-5,61
1,1838,1520,318,2,169,41
-1,1516,1606,-90,-3,-323,78
1,1438,1560,-122,0,11,47
-1,1648,1555,93,-7,-297,122
1,1842,1516,326,-3,-75,49
1,1688,1574,114,-1,-84,65
1,1842,1516,326,-1,-53,49
1,1758,1822,-64,-5,8,51
1,1538,1453,85,6,388,77
-1,1566,1512,54,0,-86,58
-1,1554,1695,-141,-1,-17,42
1,1223,1374,-151,-4,119,63
1,1656,1718,-62,0,437,91
1,1444,1550,-106,0,30,69
-1,1540,1709,-169,11,767,114
-1,1992,1990,2,-2,-1,42
1,1807,1773,34,0,165,105
-1,1454,1485,-31,0,-219,80
1,1696,1615,81,0,210,115
1,1715,1534,181,-2,-8,109
0,1528,1721,-193,6,257,125
-1,1820,1973,-153,0,-54,62
-1,1906,2062,-156,-4,-196,64
-1,1612,1503,109,4,92,48
-1,1916,1950,-34,0,1,64
-1,1527,1736,-209,0,-553,136
1,1715,1534,181,2,158,67
1,1681,1351,330,0,61,63
1,1504,1353,151,3,88,61
1,1762,1513,249,-9,53,125
1,1296,1517,-221,4,603,117
1,1986,1807,179,-4,-143,103
1,1727,1522,205,1,84,61
1,1239,1209,30,14,343,53
1,1029,0,1029,11,424,57
-1,1517,1732,-215,-2,-69,68
1,1498,1444,54,-4,-260,87
1,1737,1511,226,-3,43,49
-1,1801,2082,-281,-2,-79,60
-1,1511,1737,-226,-2,-62,54
-1,1991,1899,92,-2,-61,62
1,1979,1813,166,1,22,49
0,1525,1642,-117,-6,-49,141
-1,1704,1743,-39,-1,-83,102
0,1641,1639,2,0,8,176
1,1767,1371,396,-1,-28,67
1,1697,1336,361,1,129,73
1,1742,1506,236,2,45,85
-1,1530,1524,6,-5,-109,60
-1,1346,1684,-338,-7,-158,44
-1,1797,2093,-296,-1,-51,84
-1,1511,1235,276,1,-63,88
-1,1745,1684,61,8,204,78
-1,1617,1793,-176,-4,-170,60
1,1535,1514,21,2,98,57
1,1914,1978,-64,1,-47,81
-1,1502,1747,-245,0,-10,68
-1,1499,1545,-46,2,0,50
-1,1315,1817,-502,-2,-30,44
1,1867,1734,133,-3,8,63
-1,1249,1368,-119,0,-501,150
1,1313,1819,-506,-4,-155,75
-1,1794,2103,-309,-2,-131,64
1,1493,1756,-263,-4,340,95
-1,1598,1486,112,0,-23,92
1,1497,1338,159,1,375,97
1,2112,1790,322,4,70,59
1,1587,1632,-45,1,22,51
1,1737,1512,225,1,147,91
1,1778,1780,-2,-9,368,151
-1,1503,1331,172,0,-137,58
-1,1787,2120,-333,-2,-147,96
1,1647,1553,94,-7,-442,73
1,1506,1742,-236,-3,-59,69
1,1487,1350,137,-5,177,77
-1,1467,1595,-128,-3,-697,116
-1,1700,1694,6,-4,-191,82
-1,1341,1494,-153,-4,-140,50
1,1724,1525,199,2,-80,99
-1,1639,1695,-56,1,-643,160
1,2127,1784,343,1,47,67
1,1643,1660,-17,-1,-26,43
-1,1334,1795,-461,4,318,72
1,1699,1600,99,1,16,41
1,1742,1669,73,0,146,89
-1,1471,1591,-120,-10,-159,52
1,1499,1340,159,4,748,99
-1,1519,1729,-210,-1,-100,70
1,1796,1332,464,10,114,43
-1,1332,1796,-464,1,-154,78
1,1376,1493,-117,4,271,67
1,1506,1691,-185,-4,120,107
-1,1508,1523,-15,-2,-42,52
1,1453,1561,-108,2,180,73
-1,1745,1661,84,-1,-124,68
1,1711,1789,-78,-5,96,105
0,1711,1607,104,0,21,83
-1,1328,1800,-472,5,21,54
1,1537,1497,40,-9,-18,61
-1,1405,1298,107,-10,-694,82
1,1501,1535,-34,0,1,63
-1,1965,1937,28,1,205,80
-1,1600,1546,54,2,46,62
1,1802,1327,475,-11,-206,53
1,1754,1395,359,15,752,61
-1,1465,1768,-303,0,-5,50
-1,1487,1549,-62,0,1,54
-1,1445,1511,-66,0,-18,80
1,1325,1418,-93,1,33,75
1,1549,1487,62,4,161,59
-1,1730,1803,-73,-1,-160,70
-1,1332,1505,-173,-2,41,64
1,1704,1629,75,0,-210,103
-1,1546,1469,77,-2,-261,102
1,1450,1342,108,0,-96,63
1,1757,1376,381,0,1,55
-1,1772,1694,78,-2,-114,84
1,1462,1471,-9,-1,325,121
-1,1610,1708,-98,-1,-69,94
1,1332,1403,-71,0,-51,59
0,1558,1586,-28,-1,53,72
-1,1279,1473,-194,-8,-294,60
-1,1272,1246,26,3,434,92
-1,1500,1649,-149,-7,-296,67
-1,1453,1590,-137,2,-326,130
-1,1388,1348,40,-1,-18,62
-1,1382,1487,-105,-5,-49,48
-1,1776,1782,-6,1,-6,124
1,1363,1375,-12,15,1329,87
-1,1511,1325,186,-1,-103,122
-1,1742,1720,22,1,63,132
1,1765,1722,43,-11,-21,99
-1,1303,1456,-153,-13,-828,90
-1,1555,1382,173,0,-82,67
-1,1473,1614,-141,-4,-246,114
-1,1775,1712,63,3,9,134
1,1376,1296,80,3,357,69
1,1667,1760,-93,-1,599,141
1,1679,1592,87,-1,-8,43
1,1287,1386,-99,-10,-520,51
-1,1725,1459,266,-3,-83,76
1,1423,1370,53,0,93,71
1,1473,1440,33,5,108,65
1,1479,1241,238,0,376,105
1,1259,1212,47,6,133,45
-1,1541,1720,-179,-2,-152,88
1,1765,1831,-66,0,427,137
1,1730,1715,15,3,52,43
-1,1434,1537,-103,2,-136,82
1,1716,1559,157,0,16,51
1,1657,1548,109,3,208,97
-1,1466,1259,207,-8,-86,110
-1,1530,2117,-587,-6,-396,72
-1,1429,1726,-297,1,70,78
-1,1704,1741,-37,-3,-184,60
1,1706,1836,-130,1,27,47
1,1569,1357,212,1,118,71
-1,1535,1396,139,-2,-93,86
1,1706,1836,-130,0,11,87
1,2118,1529,589,-5,1,55
1,1302,1604,-302,3,667,111
-1,1687,1744,-57,-1,-211,100
-1,1762,1947,-185,-1,-147,82
-1,1434,1620,-186,-1,-120,92
1,1525,1437,88,-2,-3,45
1,1947,1762,185,1,308,113
-1,1259,1653,-394,0,-79,70
-1,1450,1555,-105,-8,-371,78
-1,1441,1426,15,-6,-228,66
0,1681,1585,96,1,-11,130
-1,1626,1418,208,0,-16,48
1,1744,1518,226,1,162,73
1,1441,1563,-122,-1,-100,93
-1,1886,1955,-69,-3,-9,40
-1,1449,1483,-34,-3,-443,108
1,1729,1521,208,0,139,95
-1,1503,1667,-164,-4,-105,40
1,1457,1583,-126,-13,-136,45
1,1438,1423,15,-1,-56,69
1,1966,1877,89,0,25,83
1,1512,1443,69,1,42,44
1,1778,1758,20,0,-6,69
1,1923,2099,-176,0,-74,77
1,1838,1778,60,1,165,85
-1,1869,1977,-108,1,-22,80
1,1597,1496,101,-3,3,46
1,1319,1449,-130,-2,39,83
0,1553,1532,21,1,365,101
1,1674,1696,-22,2,304,98
-1,1766,1861,-95,2,53,52
1,2008,1528,480,6,605,87
-1,1488,1490,-2,-2,-64,46
-1,1439,1720,-281,-1,-130,64
1,2009,1758,251,-1,27,63
-1,1461,1411,50,1,48,62
1,2014,1754,260,1,45,51
1,1684,1495,189,3,433,177
1,1531,1252,279,8,102,41
1,1789,1587,202,0,157,121
-1,1656,1488,168,0,-21,92
1,1439,1294,145,0,228,95
1,1519,1461,58,1,35,53
-1,1318,2018,-700,-3,-15,76
1,1689,1494,195,4,483,78
0,1552,1629,-77,0,61,77
-1,1803,2072,-269,0,-26,92
1,2019,1313,706,1,24,71
1,1539,1576,-37,1,95,73
-1,1456,1626,-170,-7,-108,68
-1,1848,1883,-35,0,10,46
1,1553,1646,-93,7,38,46
-1,1634,1340,294,5,188,48
-1,1476,1497,-21,-8,-19,56
-1,1540,1548,-8,-5,-486,88
-1,1817,1866,-49,0,-135,98
-1,1794,1859,-65,1,-26,68
1,1620,1323,297,1,69,59
1,1089,0,1089,3,222,81
-1,2020,1737,283,-4,-58,42
1,1450,1170,280,3,730,129
1,1870,1612,258,-2,-46,49
-1,1783,1876,-93,-5,-148,58
-1,1529,1530,-1,0,18,52
1,1500,1497,3,5,192,61
-1,1484,1658,-174,-2,-178,62
1,1778,1716,62,0,-127,235
1,1581,1795,-214,1,331,121
1,1885,1303,582,-1,-40,61
1,1490,1690,-200,0,-56,77
-1,1489,1696,-207,0,-31,56
-1,1541,1517,24,-7,-157,52
1,1515,1513,2,2,463,143
-1,1287,1888,-601,1,29,40
-1,1675,1745,-70,0,-16,50
1,1335,1500,-165,1,97,73
1,1609,1567,42,1,39,47
1,1807,1493,314,-3,308,105
1,1562,1358,204,0,48,75
1,1646,1706,-60,0,-26,67
1,1999,1765,234,2,38,83
1,1889,1463,426,-2,-34,51
1,1635,1510,125,-3,65,81
1,1892,1461,431,0,106,61
1,1587,1488,99,-6,-129,53
-1,2081,1941,140,-2,-44,70
-1,1378,1598,-220,0,-7,48
1,1869,1416,453,1,202,87
-1,1636,1641,-5,-3,-1503,172
1,1454,1500,-46,6,340,91
1,1529,1490,39,-6,20,71
1,957,1062,-105,1,14,43
1,1934,1417,517,4,175,59
-1,1811,1670,141,-9,-610,108
-1,1684,1500,184,-2,-55,60
-1,1773,1894,-121,1,-3,64
1,1665,1320,345,0,544,93
-1,1554,1511,43,0,10,54
1,1871,1389,482,1,78,81
1,1622,1280,342,3,303,105
-1,1545,1722,-177,1,1,182
0,1604,1644,-40,1,587,97
0,1710,1935,-225,-1,-93,113
1,1780,1666,114,1,72,83
-1,1572,1288,284,2,308,102
-1,1602,1983,-381,-1,-19,48
1,1702,1463,239,4,219,71
1,1500,1477,23,-2,-189,71
1,1631,1508,123,5,230,87
1,1903,1253,650,20,800,63
1,1479,1539,-60,1,-44,61
1,1712,1591,121,2,140,75
-1,1624,1301,323,-3,-497,112
-1,1463,1309,154,-5,-11,67
1,1600,1705,-105,0,-54,95
1,1669,1308,361,1,315,79
1,1546,1262,284,12,243,49
1,1893,1997,-104,0,34,59
1,1691,1707,-16,2,86,69
-1,1532,1542,-10,0,-87,66
1,1911,1980,-69,-1,-1,103
-1,1911,1980,-69,-2,-164,80
-1,1796,1500,296,-4,-170,54
-1,1664,1586,78,0,-20,70
-1,1792,1674,118,-1,15,128
-1,1957,1953,4,2,38,70
-1,1837,1800,37,3,8,40
1,1523,1476,47,-3,19,81
1,1538,1528,10,0,122,77
-1,1609,1985,-376,-4,-113,52
-1,1688,1600,88,-1,-181,72
1,1302,1503,-201,18,223,41
-1,1316,1470,-154,-8,-108,44
1,1878,1771,107,7,400,68
1,1510,1511,-1,5,181,69
1,1635,1594,41,0,6,55
-1,1315,1477,-162,-5,-145,60
1,1313,1326,-13,1,-70,113
-1,1491,1891,-400,-1,-36,42
1,1287,1591,-304,-3,-48,61
-1,1176,1346,-170,-14,-236,44
1,1891,1491,400,1,46,69
-1,1571,1365,206,1,39,78
1,1459,1445,14,1,212,71
1,1796,1723,73,1,17,47
1,1896,1485,411,3,21,41
-1,1582,1310,272,-5,-30,42
-1,1352,1168,184,8,178,70
-1,1756,1763,-7,2,-8,56
1,1430,1510,-80,-3,-167,67
1,1400,1341,59,1,41,53
1,1871,1510,361,-4,22,62
-1,1774,1746,28,-2,65,60
1,1495,1477,18,12,180,41
-1,1381,1342,39,0,-5,48
-1,1506,1875,-369,-5,-99,44
1,1645,1662,-17,1,8,43
-1,1444,1507,-63,7,-495,102
-1,1581,1594,-13,0,15,60
1,1851,1483,368,0,-18,57
-1,1843,1795,48,0,-14,50
-1,1499,1521,-22,-9,-156,52
1,1851,1481,370,-1,-42,61
1,1516,1417,99,3,309,60
1,1408,1092,316,6,256,65
-1,1554,1502,52,-3,-30,52
1,1854,1855,-1,1,563,117
-1,1395,1525,-130,0,-110,58
-1,1189,1554,-365,2,-43,66
-1,1434,1707,-273,5,307,152
-1,1525,1395,130,0,-14,56
-1,1878,1503,375,2,-25,58
1,1657,1649,8,1,-19,59
-1,1435,1478,-43,-1,-23,54
0,1614,1360,254,-1,-67,119
1,1867,1840,27,-1,624,103
-1,1516,1539,-23,-9,4,60
1,1719,1488,231,6,87,47
-1,1334,1273,61,0,-184,72
1,1808,1830,-22,0,111,69
-1,1568,1760,-192,-3,-96,84
-1,1433,1486,-53,-1,-87,60
1,1826,1879,-53,-2,-241,101
-1,1443,1531,-88,-1,-10,56
1,1363,1482,-119,-1,-52,63
-1,1411,1551,-140,0,-83,64
-1,1864,1843,21,-3,-95,56
1,1505,1404,101,-8,-79,69
-1,1500,1540,-40,-3,-78,50
1,1858,1851,7,1,63,55
-1,1694,1815,-121,-4,-108,54
-1,1500,1637,-137,-3,-366,68
-1,1893,1513,380,-2,-36,62
1,1378,1366,12,-1,-17,53
-1,1522,1664,-142,-4,-183,70
-1,1394,1508,-114,2,101,60
1,1430,1070,360,8,99,43
-1,1471,1561,-90,-1,-18,60
1,1515,1671,-156,5,416,111
-1,1572,1541,31,-5,-261,82
1,1874,1871,3,-2,-91,67
-1,1750,1822,-72,0,-6,66
-1,1699,1831,-132,-3,-242,76
1,1389,1308,81,-1,-36,44
1,1858,1885,-27,0,-584,131
-1,1689,1804,-115,-2,-46,54
1,1838,1554,284,1,47,54
-1,1381,1643,-262,-13,-250,40
-1,1873,1872,1,6,74,46
-1,1872,1873,-1,0,-25,60
-1,1433,1662,-229,1,36,54
1,1675,1655,20,0,156,83
-1,1862,1885,-23,1,39,58
-1,1535,1818,-283,-2,-71,40
1,1480,1648,-168,7,269,71
-1,1531,1897,-366,1,71,66
-1,1359,1510,-151,-3,-65,74
-1,1644,1838,-194,-6,-372,86
-1,1528,1900,-372,-1,-13,60
-1,1516,1812,-296,-3,-72,52
-1,1900,1528,372,1,156,84
-1,1550,1903,-353,-4,-126,53
1,1903,1550,353,6,150,53
-1,1668,1495,173,0,-97,90
1,1843,1639,204,10,395,61
0,1321,1513,-192,-5,-236,68
1,1055,1413,-358,-8,-63,77
1,1853,1906,-53,-5,-13,47
-1,1332,1506,-174,3,13,60
-1,1855,1903,-48,-4,-83,54
1,1485,1618,-133,-1,-5,61
1,1585,1630,-45,-3,-18,45
-1,1680,1349,331,0,-38,58
1,1914,1846,68,0,76,55
1,1784,1823,-39,0,-10,41
1,1846,1914,-68,0,-12,77
-1,1899,1858,41,1,-186,112
1,1870,1885,-15,-2,-10,57
1,1796,1622,174,-2,343,133
1,1885,1870,15,-2,-194,85
-1,1762,1601,161,0,6,56
1,1823,1961,-138,0,4,43
1,1881,1873,8,0,194,85
-1,1723,1747,-24,1,26,54
-1,1415,1738,-323,4,29,40
-1,1861,1891,-30,-2,65,62
-1,1194,1548,-354,-9,-337,58
1,1121,1497,-376,-1,565,129
1,1802,1820,-18,-2,-82,62
-1,1812,1835,-23,-4,-111,58
1,1558,1412,146,1,213,99
1,1571,1633,-62,1,11,45
-1,1191,1268,-77,-8,-190,42
-1,1634,1679,-45,-1,-108,64
-1,1814,1710,104,-4,-111,63
-1,1389,1428,-39,-6,-218,66
-1,1401,1438,-37,0,-39,60
1,1584,1523,61,2,5,41
-1,1680,1689,-9,-5,-96,56
1,1724,1800,-76,0,7,45
-1,2041,1855,186,1,77,68
0,1602,1505,97,0,-161,102
-1,1855,2041,-186,-1,-207,90
-1,1552,1624,-72,-1,-53,70
1,1456,1438,18,-2,-218,73
-1,1699,1980,-281,0,-135,116
1,1732,1709,23,-3,-104,61
1,1402,1322,80,-1,24,91
1,1404,1459,-55,2,135,58
1,2048,1849,199,3,81,49
1,1738,1384,354,-1,27,49
1,1992,1695,297,1,49,75
-1,1513,1658,-145,0,4,46
-1,1843,2055,-212,-3,-74,46
-1,1837,2061,-224,-1,-118,72
-1,1371,1801,-430,-1,-61,64
1,2003,1261,742,26,617,43
1,2067,1832,235,2,430,89
1,1502,1587,-85,-5,1,55
-1,1832,2067,-235,-6,-91,66
1,1675,1559,116,0,95,81
-1,1835,1845,-10,-5,-196,92
1,1477,1081,396,4,225,65
-1,1827,1901,-74,0,83,54
-1,1419,1713,-294,-6,-55,64
1,1599,1487,112,0,-4,45
0,1416,1407,9,1,-326,183
1,1599,1447,152,1,21,41
-1,1906,1973,-67,0,40,80
1,1504,1418,86,0,158,97
-1,1818,2073,-255,-1,-40,62
-1,1607,1740,-133,0,-36,54
1,1717,1414,303,-7,-121,41
-1,1264,1487,-223,-1,-207,114
1,1813,2078,-265,-7,-71,45
1,1408,1167,241,5,172,50
-1,1557,1813,-256,3,69,60
-1,1665,1856,-191,0,-40,84
-1,1422,1589,-167,-3,-304,82
1,2056,1692,364,4,242,67
-1,1981,2114,-133,-1,-49,46
1,1833,1552,281,7,247,71
-1,1410,1721,-311,-8,-34,40
-1,1552,1833,-281,-1,-30,60
1,2059,1689,370,-1,7,55
1,1479,1369,110,0,220,105
-1,1539,1700,-161,-1,-668,130
-1,1679,1909,-230,-3,-165,80
1,2125,1974,151,1,37,45
1,1945,1828,117,3,94,85
1,1629,1843,-214,-5,-205,57
1,1843,1629,214,-1,1,63
-1,1409,1755,-346,1,197,74
1,1644,1409,235,2,82,57
-1,1823,1608,215,2,-5,52
1,1608,1624,-16,0,74,57
-1,1357,1441,-84,-4,-43,44
1,1590,1434,156,-3,-3,137
1,1997,1271,726,10,289,63
-1,1558,1506,52,-11,-302,62
-1,1617,1550,67,0,-8,42
1,1804,1626,178,3,573,121
-1,1331,1745,-414,-6,-426,70
1,1759,1406,353,2,51,64
1,1365,1435,-70,1,8,63
-1,1598,1565,33,0,88,88
-1,1407,1862,-455,-3,-129,91
-1,1577,1581,-4,0,-18,46
-1,1329,1727,-398,-16,-1151,80
-1,1596,1566,30,-3,-36,46
1,1566,1596,-30,-5,-39,41
1,1968,1903,65,0,-8,53
1,1580,1578,2,1,275,75
1,1683,1403,280,1,60,65
-1,1679,2005,-326,-1,-47,46
1,1519,1545,-26,9,201,60
1,1400,1493,-93,-1,-84,49
1,1837,1676,161,1,7,61
-1,1567,1594,-27,-1,-2,42
1,1669,1434,235,2,331,87
-1,1326,1660,-334,-3,-108,70
-1,1526,1629,-103,0,13,66
1,1608,1556,52,4,353,91
1,1670,1844,-174,1,36,63
1,1844,1670,174,6,312,79
1,1068,1587,-519,-1,11,49
-1,1546,1620,-74,-1,-34,50
0,1487,1999,-512,-1,-199,186
1,1531,1525,6,2,355,67
-1,1850,1664,186,-3,-241,64
-1,1500,1863,-363,-1,-70,70
-1,1680,1832,-152,-4,-205,60
1,1664,1424,240,0,92,91
-1,1604,1405,199,-1,-443,124
1,1241,1291,-50,4,379,81
1,1679,1475,204,0,13,51
-1,1529,1641,-112,-1,-234,90
1,1537,1633,-96,-5,63,75
-1,1840,1674,166,3,167,80
1,1460,1372,88,2,28,47
1,1690,1822,-132,3,68,55
1,1822,1690,132,0,-59,47
1,1729,1543,186,-1,5,71
1,1683,1806,-123,-3,32,51
1,1786,1867,-81,0,15,71
1,1791,1697,94,1,-72,101
1,1400,1495,-95,0,67,69
1,2154,1650,504,0,-9,49
-1,1689,1799,-110,-4,-10,94
1,1893,1935,-42,4,210,55
1,1568,1626,-58,1,428,115
-1,1914,1704,210,0,55,90
1,1470,1615,-145,3,64,49
1,1808,1681,127,2,65,77
-1,1649,2156,-507,1,-13,56
1,1867,1905,-38,2,150,71
1,1482,1271,211,6,532,101
0,1674,1815,-141,-3,55,102
-1,1486,1742,-256,2,-42,58
1,1811,1678,133,2,-61,93
1,2157,1647,510,2,220,67
1,1671,1818,-147,8,157,45
-1,1511,1422,89,-4,-374,123
-1,1323,1358,-35,-7,-909,96
-1,1808,1893,-85,0,-229,88
-1,1646,2159,-513,-3,-190,106
1,1802,1687,115,-1,-6,59
1,1690,1548,142,0,-31,53
1,1687,1802,-115,5,139,53
-1,1568,1243,325,-7,-69,46
1,1810,1701,109,-1,-75,83
1,1540,1547,-7,-2,38,63
-1,1719,1852,-133,0,-9,52
1,1423,1418,5,0,123,105
1,1747,1497,250,14,327,55
-1,1500,1534,-34,0,3,78
-1,1693,1818,-125,-1,6,96
-1,2160,1644,516,0,-276,92
1,1573,1628,-55,0,1,53
1,1698,1542,156,-1,-147,89
1,1902,1797,105,-1,-4,43
-1,1686,1826,-140,0,-214,90
-1,1493,1751,-258,0,-143,88
1,1496,1538,-42,-4,-47,79
1,1833,1679,154,-1,-39,83
1,1671,2132,-461,2,156,109
-1,1712,1860,-148,-2,-37,60
1,2063,1561,502,-9,-33,83
-1,1437,1720,-283,0,-89,140
1,1673,1839,-166,5,169,57
1,1839,1673,166,-1,-54,71
-1,1923,1909,14,0,-15,68
-1,1666,1846,-180,-4,-378,90
1,2105,1698,407,5,67,45
1,1489,1615,-126,0,420,109
1,1434,1121,313,-2,-26,53
1,1376,1437,-61,-3,25,97
1,1925,1685,240,0,7,45
-1,1655,1857,-202,2,210,82
-1,1395,1883,-488,0,-48,70
1,2108,1696,412,2,258,69
1,1863,1649,214,4,7,49
-1,1660,1573,87,3,132,76
-1,1424,1389,35,0,2,42
0,1644,1868,-224,1,237,93
1,1395,1559,-164,-1,-25,42
1,1785,1944,-159,0,-6,43
1,1392,1559,-167,5,503,131
1,1862,1651,211,9,867,99
1,1908,2110,-202,0,-7,41
-1,1402,1631,-229,-2,-142,78
1,1705,1693,12,-2,-7,41
-1,1888,1977,-89,1,-106,80
1,1645,1867,-222,1,-61,113
-1,1931,2088,-157,-2,-121,52
-1,1705,1867,-162,0,-115,84
-1,1504,1609,-105,-2,-298,70
1,1849,1663,186,5,170,75
1,1726,1695,31,3,35,57
-1,1716,1679,37,-5,-299,80
1,1671,1600,71,-1,84,79
-1,1657,1855,-198,3,420,86
-1,1726,1695,31,-3,-22,68
-1,1642,1397,245,2,52,80
-1,1859,2149,-290,-1,-129,96
1,1861,1651,210,-1,-99,77
-1,1714,1710,4,0,-310,104
1,1708,1327,381,2,231,111
-1,1809,1787,22,3,102,48
-1,1542,1506,36,-1,10,42
1,1866,1646,220,0,-36,85
1,1807,1706,101,-2,-123,97
1,1746,1710,36,0,-12,109
1,1616,1496,120,12,169,45
1,1798,1798,0,1,27,43
-1,1572,1324,248,0,-125,118
-1,1420,1853,-433,-5,-147,70
-1,2062,1934,128,-2,-284,88
1,1509,1601,-92,-5,-192,63
1,1702,1680,22,0,42,63
1,1488,1624,-136,-1,-68,73
-1,1721,2100,-379,0,-58,72
1,1809,1787,22,-5,-78,53
1,1267,1304,-37,1,-39,47
-1,1530,1699,-169,-1,55,48
1,1641,1500,141,-1,391,113
-1,1505,1524,-19,0,52,82
-1,1416,1587,-171,-10,-10,40
1,2103,1718,385,3,102,63
1,1777,1819,-42,0,-42,71
1,1601,1405,196,11,460,61
-1,2004,2040,-36,0,66,144
1,1647,1521,126,1,277,109
1,2153,1985,168,2,43,73
-1,2056,1959,97,0,-124,86
1,1646,1550,96,5,409,140
0,1740,1617,123,2,162,102
-1,1514,1654,-140,-1,-17,54
1,1284,1256,28,2,430,87
1,1609,1534,75,0,86,71
-1,1500,1715,-215,2,73,46
1,1807,1610,197,-1,30,69
-1,1613,1500,113,-4,-365,182
-1,1681,1921,-240,0,-492,122
-1,1320,1181,139,6,-75,64
1,1766,1701,65,0,-11,49
-1,1979,2161,-182,-1,-15,50
-1,1760,1896,-136,-5,-127,90
-1,1775,1925,-150,0,-10,42
1,1243,1297,-54,2,68,75
1,1692,2106,-414,-6,-51,41
-1,1617,1555,62,-1,-29,50
-1,1594,1849,-255,-2,-130,182
-1,1583,1533,50,-1,-14,42
0,1711,1519,192,0,99,116
-1,1648,1873,-225,-1,178,118
-1,1585,1853,-268,-1,-97,108
-1,1246,1561,-315,-6,-5,56
-1,1267,1309,-42,2,36,50
1,1774,1973,-199,0,-8,53
-1,1660,1857,-197,-2,-84,54
1,1607,1483,124,-4,-107,47
1,1306,1235,71,6,122,61
-1,1524,1524,0,-1,-185,104
-1,1576,1626,-50,-11,-140,96
-1,1719,1754,-35,-1,-13,70
-1,1905,1863,42,-2,-125,70
1,1636,1589,47,7,389,70
-1,1524,1662,-138,-2,-79,58
-1,1225,1317,-92,9,135,46
-1,1571,1647,-76,-1,-235,120
-1,1652,1541,111,-6,-305,84
1,1635,1698,-63,-3,-109,73
-1,1615,1833,-218,2,135,78
-1,1721,1821,-100,-3,-540,120
1,1569,1555,14,2,47,47
-1,1377,1655,-278,-6,-325,64
-1,1621,1507,114,2,87,56
1,1523,1469,54,2,79,53
1,1829,1711,118,3,67,59
1,1601,1591,10,8,198,63
1,1206,1337,-131,-10,-367,61
-1,1580,1641,-61,-5,-193,73
-1,1500,1483,17,0,-285,86
-1,1369,1406,-37,-2,-53,62
1,1596,1505,91,-2,-38,45
1,1822,1720,102,0,45,65
-1,1439,1784,-345,0,-45,76
-1,1660,1333,327,2,43,42
1,1651,1564,87,-1,-19,55
1,1504,1507,-3,2,34,43
-1,1774,1956,-182,0,19,58
1,1577,1511,66,0,-4,57
1,1361,1480,-119,11,379,46
0,1550,1659,-109,1,-303,133
1,1676,1642,34,1,15,53
-1,1319,1223,96,-3,-71,62
1,1839,1525,314,0,13,49
-1,1498,1350,148,-8,-161,42
-1,1610,1790,-180,0,-116,74
-1,1814,1962,-148,-15,-213,40
1,1756,1741,15,4,110,51
-1,1503,1508,-5,2,-153,62
-1,1807,1856,-49,-1,-320,118
1,1612,1724,-112,1,36,65
-1,1257,1292,-35,-2,-33,46
1,1656,1556,100,2,377,119
1,1766,1555,211,2,69,69
1,1704,1499,205,-5,99,55
1,1519,1492,27,0,54,59
1,1439,1500,-61,1,120,65
1,1632,1563,69,0,46,79
-1,1519,1398,121,2,192,100
1,1514,1642,-128,-3,-133,83
-1,1882,1692,190,0,-8,65
1,1529,1482,47,1,607,169
-1,1500,2052,-552,-3,-80,58
0,1555,1710,-155,1,134,111
-1,1367,1626,-259,1,-108,68
1,1749,1781,-32,0,327,159
1,1946,1648,298,-2,-52,47
1,1459,1354,105,6,167,57
-1,1751,1560,191,1,-2,74
-1,1685,1870,-185,0,-100,75
1,1772,1630,142,0,150,116
1,1784,1801,-17,0,7,49
1,1580,1982,-402,5,437,79
-1,1543,1865,-322,0,18,40
1,1472,1539,-67,0,141,95
1,1515,1553,-38,0,79,81
0,1710,1602,108,0,7,60
-1,1472,1623,-151,0,88,114
-1,1781,1783,-2,0,4,52
-1,1803,1865,-62,-1,-89,78
-1,1790,1969,-179,0,-24,66
1,1241,1083,158,-1,51,57
-1,1604,1658,-54,0,-48,84
1,1803,1346,457,9,225,51
-1,1620,1639,-19,1,29,58
1,1358,1408,-50,6,232,63
-1,1257,1376,-119,-3,-66,58
-1,1921,1868,53,0,-6,56
1,1784,1975,-191,-1,-16,61
1,1824,1645,179,0,71,93
-1,1395,1552,-157,-3,-20,43
1,1504,1239,265,9,200,49
-1,1344,1807,-463,-4,-318,68
-1,1485,1410,75,-7,-123,50
0,1389,1558,-169,-4,22,51
1,1627,1541,86,0,2,59
1,1778,1672,106,6,159,50
-1,1302,1551,-249,3,-139,96
1,1650,1688,-38,2,149,79
1,1935,1910,25,1,27,75
1,1415,1499,-84,-2,-38,43
1,1513,1305,208,6,241,57
1,1648,1620,28,3,149,67
-1,1079,1506,-427,-8,-392,76
1,1246,1332,-86,-7,-500,85
1,1695,1673,22,2,180,93
-1,1643,1330,313,-4,-200,78
-1,1430,1563,-133,14,387,54
1,1702,1761,-59,-1,17,55
-1,1724,1651,73,0,-170,100
-1,1399,1633,-234,-8,-193,46
-1,1677,1500,177,-1,-429,128
-1,1422,1788,-366,-6,-384,84
1,1638,1394,244,0,14,51
0,1824,1731,93,3,110,129
-1,1548,1398,150,-6,-231,64
-1,1500,1585,-85,0,228,196
-1,1900,1946,-46,-1,-120,62
1,1395,1470,-75,-4,-239,45
-1,1388,1643,-255,-1,-26,50
1,1674,1492,182,0,1,71
1,1638,1662,-24,2,68,115
-1,1419,1791,-372,0,-365,116
-1,1652,1632,20,-3,-233,76
-1,1298,1519,-221,-1,-163,84
-1,1701,1675,26,3,-34,86
-1,1748,1715,33,0,-331,82
-1,1648,1992,-344,-1,-299,100
1,1473,1424,49,-5,189,107
1,1788,1655,133,4,307,75
1,2125,1571,554,-1,95,93
-1,1427,1326,101,-1,-13,46
1,1996,1645,351,23,736,51
1,1362,1211,151,3,48,41
0,1743,1813,-70,-1,-173,197
1,1645,1996,-351,-1,-15,129
0,1661,1700,-39,2,1545,237
-1,1571,1525,46,-3,-77,64
1,1955,1891,64,1,148,131
-1,1481,1570,-89,0,33,64
-1,1441,1603,-162,-12,-399,56
-1,1076,1139,-63,-12,-655,100
1,1691,1544,147,-8,821,135
-1,1429,1464,-35,-2,-203,96
1,1655,1508,147,2,57,49
1,1727,1736,-9,1,24,57
-1,1578,1968,-390,0,-143,78
1,1716,1500,216,5,230,65
1,1733,1807,-74,2,105,69
1,1438,1355,83,-10,-17,59
1,1968,1578,390,2,157,65
-1,1411,1448,-37,-2,40,42
1,1502,1732,-230,2,230,111
1,1265,1413,-148,3,277,89
-1,1575,1971,-396,-6,-88,42
-1,1705,1662,43,-2,-221,88
1,1974,1573,401,14,140,41
1,1760,1673,87,0,2,69
-1,1647,1511,136,-1,-7,44
1,1977,1571,406,-1,198,89
-1,1484,1436,48,-1,-531,150
1,1510,1343,167,-4,-202,79
1,1970,1384,586,1,11,41
-1,1514,1642,-128,1,8,42
-1,1406,1609,-203,-2,-858,128
-1,1794,1771,23,-2,-25,71
-1,1503,1662,-159,-4,-169,58
1,1475,1415,60,5,200,75
-1,1811,1829,-18,-5,-298,74
-1,1667,1568,99,0,11,56
1,1614,1500,114,0,-24,69
-1,1650,1685,-35,1,23,62
1,1746,1653,93,1,25,52
1,1584,1458,126,-1,-15,61
-1,1738,1745,-7,-1,-63,80
1,1059,1328,-269,-1,581,119
-1,1848,1801,47,3,25,84
1,1960,1768,192,0,1,55
1,1456,1670,-214,-1,130,119
1,1739,1695,44,0,-3,51
-1,1325,1380,-55,-1,-33,48
0,1653,1592,61,-1,-413,106
-1,1397,1451,-54,-2,-57,100
-1,1650,1507,143,0,-207,132
-1,1646,1581,65,1,41,46
1,1682,1639,43,3,274,101
-1,1619,1654,-35,0,-755,128
1,1389,1314,75,-4,-9,69
1,1642,1675,-33,0,305,133
-1,1763,1966,-203,0,3,42
-1,1813,1827,-14,0,-125,62
-1,1691,1383,308,9,284,78
0,1567,1694,-127,0,85,108
1,1569,1610,-41,3,206,105
-1,1855,1766,89,1,83,90
1,1663,1538,125,0,754,129
-1,1640,1643,-3,-8,-91,43
-1,1670,1709,-39,2,167,78
-1,1143,1398,-255,-8,-32,40
-1,1395,1399,-4,-2,-1509,180
1,1844,1803,41,0,-7,43
-1,1678,1971,-293,0,-17,54
1,1670,1495,175,1,82,55
1,1617,1289,328,-1,525,113
-1,1745,1974,-229,-1,-285,112
1,1663,1748,-85,1,36,59
1,1658,1719,-61,-3,-54,107
1,1651,1626,25,0,233,91
0,1667,1764,-97,-2,-143,92
-1,1522,1634,-112,-1,-32,62
1,1917,1964,-47,0,48,145
1,1873,1785,88,1,182,73
-1,1673,1705,-32,5,702,102
-1,1734,1460,274,0,-426,144
-1,1573,1686,-113,-5,-20,76
1,1691,1305,386,0,241,63
-1,1740,1975,-235,0,-150,82
-1,993,1138,-145,-10,-188,44
1,1886,1779,107,0,3,49
-1,1755,1689,66,0,-28,114
-1,1783,1900,-117,-1,-101,78
-1,1497,1603,-106,1,-136,94
1,1897,1769,128,0,188,85
1,1369,1721,-352,1,275,69
1,1560,1482,78,-6,241,113
-1,1629,1661,-32,-7,-124,44
1,1837,1559,278,-1,-22,117
-1,1658,1642,16,-4,-64,42
1,1774,1894,-120,0,8,53
-1,1666,1772,-106,0,-229,102
1,1664,1274,390,-1,138,73
-1,1597,1591,6,0,-108,122
-1,1762,1907,-145,0,-77,112
1,1980,1683,297,2,341,111
1,1559,1614,-55,3,349,113
-1,1718,1972,-254,0,-33,68
1,1700,1335,365,-10,66,87
1,1402,911,491,1,72,75
-1,1669,1609,60,3,154,92
-1,1662,1736,-74,-8,-167,40
-1,1271,1465,-194,-3,-281,84
1,1841,1718,123,0,-198,113
1,1916,1755,161,1,37,49
-1,1415,1699,-284,1,26,64
-1,1929,1952,-23,0,-100,130
1,1790,1947,-157,0,15,53
1,1488,1470,18,1,193,59
-1,1611,1557,54,1,-1,42
-1,1879,1976,-97,1,2,46
1,1749,1925,-176,-1,-2,125
-1,1683,1482,201,-7,-231,66
-1,1703,1692,11,-3,-124,90
1,1657,1848,-191,0,4,59
1,1654,1486,168,1,78,63
-1,1652,1791,-139,5,205,148
1,1471,1596,-125,-3,281,75
1,1984,2074,-90,0,81,69
-1,1560,1555,5,-3,-431,164
1,1779,1604,175,1,71,75
-1,1293,1501,-208,-9,-348,64
1,1686,1543,143,-2,704,117
1,1330,1416,-86,7,220,51
1,1799,1645,154,11,94,45
1,1741,1743,-2,1,187,83
-1,1903,1765,138,0,-45,100
-1,1637,1805,-168,-2,-96,62
-1,1634,1524,110,-1,-17,56
1,1788,1991,-203,0,5,73
0,1812,1631,181,-2,35,135
1,1645,1459,186,-1,30,83
1,1962,1919,43,0,1,53
1,1370,903,467,5,233,59
-1,1570,2000,-430,-1,-197,62
-1,1636,1806,-170,-1,-289,116
1,1708,1657,51,2,-81,99
-1,1910,1972,-62,0,-37,64
1,1566,1530,36,1,139,67
-1,1620,2002,-382,-3,-275,74
1,1486,1425,61,0,-92,95
1,1813,1630,183,25,681,49
-1,1711,1586,125,0,-97,92
1,1794,1785,9,0,15,71
1,1776,1918,-142,-1,-21,45
1,1598,1586,12,3,273,93
1,1420,1391,29,2,60,59
1,1973,1805,168,0,3,51
-1,1623,1819,-196,-9,-460,64
0,1979,1618,361,3,259,103
-1,1579,1337,242,-2,-37,54
1,1619,1622,-3,0,-23,41
1,1676,1458,218,4,183,55
-1,1397,1344,53,-5,-113,46
1,1701,1824,-123,0,-2,55
-1,1656,1844,-188,1,26,84
1,1617,1611,6,0,6,53
-1,1501,1725,-224,-2,-155,58
1,1627,1969,-342,-4,573,117
-1,1579,1500,79,-9,18,66
1,1775,1804,-29,-1,123,65
1,1387,1602,-215,0,19,57
-1,1442,2126,-684,0,-78,86
1,1600,1629,-29,-1,96,57
-1,1767,1658,109,-5,-524,82
1,1743,1500,243,5,890,119
-1,1713,1818,-105,-3,-32,44
-1,1931,1892,39,0,34,74
-1,1648,1717,-69,-1,-55,64
1,1566,1542,24,0,56,57
1,1618,1281,337,4,174,43
1,1616,1612,4,-1,-32,61
-1,1700,1826,-126,-3,-346,180
-1,1691,1551,140,-2,-266,111
1,1525,895,630,4,187,53
-1,1793,1979,-186,-1,-217,110
-1,1643,1951,-308,-11,-344,60
1,1436,1297,139,4,371,87
1,1696,1836,-140,0,264,108
1,1601,1628,-27,1,116,61
1,1396,1381,15,0,81,111
-1,1688,1834,-146,-4,-65,42
1,1201,1313,-112,-2,13,57
1,1549,1660,-111,0,-20,59
1,1955,1640,315,-4,-83,83
1,1518,1534,-16,3,73,47
-1,1615,1613,2,1,13,72
1,1503,1439,64,0,39,45
1,1787,1726,61,0,139,113
1,1625,1660,-35,-2,33,80
-1,1636,1958,-322,-1,-150,92
-1,1496,1648,-152,-3,-92,58
-1,1782,1513,269,1,34,106
1,1576,1563,13,4,190,55
1,1929,1811,118,5,420,88
-1,1192,1357,-165,2,164,66
0,1577,1613,-36,-1,52,142
1,1621,1589,32,3,42,49
1,1499,1300,199,1,13,41
-1,1577,1608,-31,-1,-294,120
-1,1384,1497,-113,1,9,60
1,1515,1509,6,0,48,95
-1,1693,1500,193,-1,-82,79
1,1981,1799,182,3,15,41
-1,1664,1693,-29,-1,-30,76
-1,1526,1585,-59,0,-323,114
1,1565,1642,-77,2,56,69
-1,1717,1796,-79,2,4,112
1,1754,1727,27,1,98,111
-1,1891,1987,-96,-1,8,62
-1,1781,1746,35,-1,-11,66
1,1794,1500,294,0,-121,111
1,1484,1134,350,-1,38,49
-1,1630,1966,-336,-1,-155,130
1,1662,1268,394,3,269,87
-1,1552,1587,-35,4,351,92
-1,1292,1411,-119,-2,-42,48
1,1962,1633,329,0,167,71
1,1711,1419,292,2,30,49
1,1812,1646,166,0,277,177
-1,1804,1708,96,-3,-185,78
-1,1606,1500,106,3,146,52
1,1530,1621,-91,0,237,93
1,1596,1614,-18,3,169,73
-1,1711,1477,234,-7,-899,174
-1,1678,1526,152,2,13,40
1,1995,1883,112,0,25,51
1,1690,1660,30,1,52,53
1,1690,1891,-201,0,132,83
1,1791,1722,69,-2,-101,121
-1,1677,1735,-58,-1,-379,122
1,1601,1700,-99,5,204,67
1,1290,1578,-288,-2,8,47
-1,1716,1663,53,-5,-38,46
1,1862,1831,31,-3,13,117
1,1763,1764,-1,1,134,75
-1,1744,1419,325,1,14,46
-1,1640,2127,-487,3,-52,74
1,1665,1416,249,3,47,45
-1,1489,1718,-229,-1,94,76
-1,1567,1663,-96,0,-144,107
-1,1626,1374,252,4,83,40
-1,1616,1837,-221,-2,-571,110
-1,1672,1395,277,4,75,40
-1,1516,1644,-128,1,-9,74
1,1650,1568,82,-1,-25,47
1,1414,1747,-333,8,823,87
-1,1606,1639,-33,-2,-108,60
-1,1411,1684,-273,-3,-128,61
-1,1675,1703,-28,0,5,68
1,2128,2004,124,0,52,101
-1,1310,1602,-292,-3,-35,46
1,1662,1507,155,4,94,48
1,1619,1416,203,1,-44,71
1,1649,1594,55,-1,12,47
-1,1713,1500,213,0,15,50
-1,1640,1818,-178,-2,-166,92
-1,1696,1658,38,0,-175,78
1,1516,1258,258,0,-86,85
-1,1410,1624,-214,0,19,84
1,1635,1500,135,1,28,43
-1,1778,2059,-281,-1,-77,76
-1,1526,1569,-43,0,-30,56
-1,1644,1567,77,2,265,68
1,2063,1774,289,0,84,69
-1,1602,1620,-18,-2,-121,57
1,1500,1669,-169,-1,-33,71
1,1606,1542,64,7,346,51
-1,1515,2002,-487,-4,-55,46
1,1377,1400,-23,7,256,46
1,1630,1404,226,-1,609,135
-1,1556,1648,-92,0,-291,154
-1,1798,1996,-198,1,77,104
0,1659,1628,31,1,110,116
-1,1725,1985,-260,-1,-263,88
-1,1782,1796,-14,0,-24,70
-1,1671,1683,-12,-7,-149,43
0,1515,1651,-136,1,-43,204
1,1735,1616,119,5,664,101
0,1364,1345,19,-1,-150,107
-1,1238,1300,-62,-2,-432,88
-1,1633,1822,-189,-12,-1039,90
-1,1770,1814,-44,0,-74,86
0,1821,1873,-52,-1,37,135
-1,1616,1419,197,-1,-491,88
1,1555,1376,179,0,62,72
1,1684,1438,246,0,59,93
1,1792,1321,471,-3,-81,127
1,1824,1634,190,0,360,69
-1,1674,1703,-29,0,-26,84
1,1694,1660,34,3,63,53
1,1438,1598,-160,-5,-33,73
-1,1410,1198,212,0,24,64
1,2004,1880,124,0,277,115
-1,1711,1693,18,0,8,48
1,1929,1763,166,-1,0,107
-1,1828,2058,-230,-6,-437,94
1,1619,1631,-12,0,201,83
1,1624,1448,176,6,239,71
-1,1630,1448,182,1,-127,75
1,1581,1588,-7,3,977,117
1,1873,1793,80,3,53,45
1,1658,1495,163,6,221,51
-1,1483,1665,-182,6,89,54
-1,1355,1465,-110,-7,-312,66
-1,1774,1772,2,0,-161,140
1,1721,1516,205,5,409,113
1,1628,1830,-202,1,-13,91
1,1714,1641,73,-1,66,55
1,1575,1576,-1,9,398,66
1,1783,1788,-5,-2,-83,59
1,1594,1487,107,-1,8,59
-1,1459,1525,-66,-2,-69,62
-1,1660,1985,-325,0,4,68
1,1560,1420,140,1,34,59
-1,1948,2012,-64,0,-751,120
1,1757,1418,339,-5,-114,65
-1,1488,1473,15,-2,-39,60
-1,1871,1876,-5,2,-1,70
1,1798,1507,291,-2,-15,55
-1,1432,1293,139,-11,-341,104
1,1587,1442,145,-8,-268,59
1,1796,1318,478,1,641,119
-1,1721,1951,-230,0,-187,112
1,1632,1723,-91,0,-8,41
1,1615,1570,45,0,61,67
1,1641,1435,206,-3,-22,61
1,1623,1578,45,2,-54,49
-1,1504,1802,-298,-2,-68,82
1,1709,1646,63,0,6,67
1,1775,1424,351,-8,-330,161
-1,1575,1296,279,-1,-403,116
1,1760,1719,41,0,146,143
0,2023,1535,488,2,397,128
1,1594,1429,165,0,-2,49
-1,1562,1631,-69,1,17,48
-1,1502,1477,25,0,-10,46
-1,1601,1422,179,-8,-869,104
-1,1663,1665,-2,0,-86,114
1,1500,1563,-63,4,631,93
1,1732,1703,29,-6,-52,63
-1,1715,1807,-92,-4,-62,64
1,1391,1798,-407,1,196,75
-1,1545,1406,139,1,-353,146
-1,2011,2138,-127,-2,-8,110
1,1409,1779,-370,-1,-32,53
-1,1886,1936,-50,1,18,48
1,1636,1718,-82,3,680,157
-1,1491,1759,-268,0,45,74
-1,1549,1514,35,0,-198,66
1,1710,1770,-60,-1,13,57
1,1757,1513,244,0,-22,81
1,1697,1569,128,4,195,75
-1,1671,1757,-86,0,-357,134
-1,1310,1229,81,-11,-139,42
0,1693,1458,235,0,-4,168
1,1881,1440,441,-1,24,65
-1,1574,1404,170,1,53,44
-1,1479,1602,-123,2,-321,98
-1,1628,1878,-250,-4,-77,68
0,2140,1827,313,0,-110,131
1,1560,1519,41,2,498,115
-1,1394,1627,-233,-1,-9,50
-1,1758,1830,-72,1,160,86
1,1646,1695,-49,-1,66,63
0,1830,1867,-37,0,95,119
1,1725,1623,102,1,61,83
1,1308,1237,71,3,37,43
-1,1312,1475,-163,-3,-43,44
1,1695,1608,87,0,42,65
-1,1610,1813,-203,2,-41,96
-1,1741,1690,51,1,-351,130
-1,1883,1623,260,-1,-41,48
-1,1574,1784,-210,-4,-211,68
1,1649,1672,-23,1,55,55
-1,1835,2131,-296,0,-69,82
1,1539,1618,-79,3,151,71
-1,1265,1524,-259,4,217,82
1,1610,1130,480,1,247,85
1,1440,1194,246,5,123,47
1,1747,1838,-91,0,1,73
0,1512,1497,15,-5,152,93
1,1644,1389,255,9,240,47
-1,1710,1827,-117,0,-280,90
-1,1892,1929,-37,0,-28,56
1,2135,1832,303,1,62,75
1,1688,1506,182,3,182,59
1,1616,1725,-109,1,166,61
1,1569,1789,-220,5,257,97
-1,1260,1516,-256,-3,-131,52
0,1824,1674,150,0,14,122
1,1509,1493,16,1,160,83
-1,1728,1706,22,-9,-336,86
1,1562,1447,115,-4,-32,41
-1,1481,1536,-55,0,-12,110
1,1331,1416,-85,1,34,53
-1,1144,1603,-459,0,-3,52
1,1818,1679,139,0,6,77
1,1649,1569,80,1,45,67
1,1604,1553,51,-2,23,65
-1,1551,1482,69,-3,-49,46
1,1707,1500,207,-4,123,137
-1,1675,1629,46,-12,-1303,112
1,1866,1831,35,0,75,93
-1,1629,1429,200,3,54,74
1,1302,1353,-51,1,159,93
-1,1497,1538,-41,-2,-149,60
-1,1647,1446,201,-1,-160,84
1,1678,1798,-120,0,17,79
1,1703,1720,-17,0,11,99
-1,1243,1357,-114,0,-31,66
-1,1404,1571,-167,0,-50,54
1,1689,1505,184,3,604,93
1,1942,1880,62,0,-4,75
-1,1679,1475,204,3,113,54
-1,1234,1369,-135,0,17,76
1,1604,1135,469,14,266,41
1,1500,1772,-272,-2,48,51
-1,1559,1622,-63,0,9,46
0,1530,1520,10,0,35,74
-1,1722,1512,210,1,-598,110
-1,1316,1359,-43,-10,-133,48
1,1380,1225,155,0,165,67
-1,1414,1496,-82,4,313,86
-1,1706,1714,-8,1,27,56
-1,1646,1394,252,-14,-63,42
-1,1217,1390,-173,-1,-82,67
-1,1448,1825,-377,0,-238,146
-1,1971,2189,-218,-4,-79,54
1,1713,1452,261,0,-140,115
-1,2195,1966,229,-1,-183,68
1,1525,1305,220,-3,-299,93
0,1605,2000,-395,0,-447,128
1,1500,1445,55,0,53,69
1,1446,1524,-78,1,95,73
-1,1126,1606,-480,-11,-191,50
-1,1724,1641,83,-5,-48,40
1,1717,1584,133,0,4,167
1,1760,1862,-102,-1,414,157
-1,1209,1634,-425,1,36,58
-1,1655,1711,-56,2,-28,78
1,1639,1207,432,1,70,81
1,2082,1991,91,0,8,53
1,1675,1493,182,-6,-227,79
-1,1562,1659,-97,-7,-320,76
1,1391,1139,252,4,144,55
1,1550,1608,-58,7,139,49
1,1399,1205,194,2,-32,75
1,1569,1552,17,1,104,81
1,1982,2090,-108,-3,4,53
-1,1500,1529,-29,-3,-140,60
1,1608,1119,489,-1,444,89
-1,1636,1673,-37,0,-141,86
0,1729,1215,514,6,1901,131
-1,1461,1573,-112,-1,-98,82
1,1198,1407,-209,0,90,69
1,1434,1317,117,6,237,75
1,1577,1642,-65,0,-1,57
1,1720,1646,74,0,39,72
-1,1568,1425,143,0,52,84
1,1509,1590,-81,3,177,54
0,1127,1221,-94,-2,7,116
1,2079,1759,320,2,59,51
1,1383,1219,164,1,54,43
1,1744,1300,444,-2,11,45
-1,1580,1540,40,-3,-53,50
-1,1637,1729,-92,-1,-89,75
-1,1211,1391,-180,2,-56,58
-1,1756,2082,-326,-1,-46,52
-1,1691,1668,23,0,8,52
1,1695,1255,440,11,392,49
1,1132,1396,-264,-5,-46,43
-1,1952,2004,-52,0,-174,128
1,1683,1771,-88,2,233,75
-1,1132,1218,-86,-4,-185,58
-1,1530,1184,346,-5,-366,100
-1,1600,1589,11,0,55,58
-1,1562,1595,-33,6,231,70
-1,1197,1407,-210,2,-61,62
1,1662,1672,-10,-2,-358,141
1,1651,1573,78,-2,-102,55
-1,1112,1609,-497,-3,-331,66
-1,1257,1681,-424,0,-77,68
-1,2085,1999,86,0,6,58
-1,1583,1553,30,-8,-119,42
1,1565,1660,-95,0,266,93
-1,1522,1569,-47,-8,-269,60
1,1414,1512,-98,-3,-85,81
1,1400,1204,196,3,29,45
-1,1471,1376,95,-1,6,68
-1,1759,1810,-51,-1,-17,80
1,1600,1589,11,0,-7,73
1,1646,1496,150,-13,-189,101
1,1866,1807,59,0,69,97
-1,1746,1669,77,0,-59,94
-1,1593,1532,61,-8,-162,48
1,1788,1632,156,1,49,65
-1,1570,1533,37,-8,-729,108
1,1356,1189,167,-1,42,93
1,1838,1524,314,1,146,65
-1,1652,1578,74,-3,-378,94
-1,1661,1688,-27,0,-75,100
1,1763,1350,413,1,86,81
-1,1511,1545,-34,-17,-369,50
1,1704,1489,215,0,30,49
0,1593,1809,-216,0,188,158
-1,1566,1656,-90,4,22,62
1,1390,1386,4,-2,-35,43
1,1765,1500,265,-13,-85,49
1,1160,1371,-211,-1,-429,121
1,1710,1752,-42,-1,-34,57
1,1553,1448,105,0,187,101
1,1600,1483,117,-2,-67,53
1,1861,1623,238,2,120,87
1,1555,1501,54,5,226,55
-1,1438,1268,170,3,189,98
1,1626,1611,15,-2,-22,71
-1,1537,1580,-43,-2,-244,62
1,2080,1770,310,1,44,51
1,1609,1470,139,0,25,115
-1,1711,1652,59,2,-237,98
1,1457,1400,57,4,449,79
-1,1727,1988,-261,0,12,62
1,1506,1500,6,2,120,111
1,1683,1732,-49,3,18,45
-1,1463,1617,-154,-6,-354,94
-1,1639,1633,6,-1,-27,52
1,1491,1365,126,5,654,125
-1,1547,1593,-46,0,-113,138
1,1993,2084,-91,0,60,95
1,1552,1565,-13,-1,34,79
1,1719,1723,-4,-1,-79,51
-1,1629,1766,-137,-4,-213,94
-1,1586,1866,-280,0,-75,82
1,2070,1788,282,0,3,69
1,1776,1789,-13,1,33,57
1,1340,1390,-50,3,732,85
-1,1712,2007,-295,-13,-324,50
1,1502,1517,-15,-5,-112,57
1,1664,1684,-20,3,72,47
1,1625,1527,98,9,268,47
1,1709,1496,213,5,274,89
1,1767,2074,-307,-3,-155,79
1,1363,1360,3,-6,-105,51
1,1849,1789,60,0,108,89
-1,1719,1767,-48,-5,-55,40
-1,1353,1234,119,2,210,94
-1,1270,1491,-221,-2,-102,68
-1,1714,1864,-150,0,-221,110
1,1558,1500,58,0,53,89
1,1468,1598,-130,2,83,53
-1,1586,1465,121,7,89,46
1,1709,1696,13,1,34,99
-1,2066,2001,65,1,23,58
-1,1571,1630,-59,1,10,78
-1,1698,1739,-41,0,7,65
-1,1223,1519,-296,1,-27,120
1,1563,1565,-2,2,2,163
-1,1523,1707,-184,-6,-135,50
-1,1492,1564,-72,0,-658,114
1,2015,2052,-37,-3,-71,49
-1,1738,1591,147,0,-14,56
-1,1889,1788,101,1,69,72
-1,1293,1428,-135,-15,-426,48
1,1376,1353,23,5,307,85
-1,1737,1702,35,-2,-25,42
-1,1508,1528,-20,0,5,104
-1,1636,1954,-318,-2,-238,110
1,1535,1718,-183,0,88,70
1,1713,1774,-61,1,17,43
-1,2040,2027,13,0,50,70
-1,1545,1411,134,-11,-43,40
1,1554,1191,363,5,74,43
1,1514,1487,27,-4,35,57
0,1424,1285,139,4,500,101
-1,1715,1578,137,-3,-105,78
-1,1606,1727,-121,-12,-74,42
1,1260,1250,10,2,402,69
1,2039,1704,335,-6,-186,55
1,1680,1654,26,2,88,73
1,1759,1599,160,2,36,49
1,2042,1735,307,3,34,45
-1,1466,1488,-22,-4,-544,151
-1,1582,1538,44,0,-51,66
-1,1294,1483,-189,-7,-326,60
-1,1731,1652,79,0,60,58
-1,1605,1603,2,4,379,88
-1,1387,1500,-113,0,-172,72
1,1593,1387,206,0,1,47
1,1482,1573,-91,0,28,63
1,1586,1440,146,3,105,59
1,1717,1204,513,10,213,43
1,1608,1664,-56,-3,-39,45
1,1875,1661,214,0,92,79
-1,1624,1667,-43,0,-135,96
1,1459,1682,-223,-4,-220,103
1,1593,1691,-98,-1,-37,49
1,1611,1519,92,0,-1,57
0,1582,1556,26,0,7,55
1,1720,1685,35,0,-8,65
-1,1598,1719,-121,2,61,62
-1,1784,1644,140,0,2,84
1,1698,1529,169,3,265,93
1,1677,1622,55,1,300,109
1,1584,1496,88,1,24,47
0,1633,1517,116,2,111,135
1,1726,1620,106,-4,-219,73
-1,1503,1767,-264,-9,-93,56
-1,1614,1687,-73,0,-78,88
-1,1509,1590,-81,-1,18,56
-1,1200,1613,-413,-3,8,48
1,1611,1735,-124,0,380,111
1,1594,1592,2,0,10,110
-1,1389,1771,-382,0,-36,55
1,1288,1316,-28,6,321,71
-1,1693,1753,-60,-1,-57,68
1,1568,1479,89,3,127,53
1,1632,1543,89,1,108,73
-1,1265,1384,-119,2,66,78
1,1859,1549,310,0,36,63
-1,1678,1765,-87,-4,-202,72
-1,1537,1512,25,0,-13,75
-1,1659,1757,-98,0,-39,60
-1,1418,1429,-11,0,-11,122
-1,1519,1452,67,0,-106,54
1,1719,1627,92,2,513,125
1,1668,1645,23,14,436,57
1,1651,1450,201,4,64,43
1,1697,1774,-77,0,26,63
-1,1787,1872,-85,0,-6,52
1,1834,1520,314,0,179,163
-1,1615,1176,439,-3,-76,60
1,1683,1492,191,2,251,69
1,1476,1571,-95,1,35,53
-1,1758,1477,281,-3,-70,56
-1,1618,1728,-110,3,283,92
-1,1705,1983,-278,0,1,106
-1,1730,1862,-132,1,-143,76
1,1595,1678,-83,1,13,55
-1,1780,2076,-296,-1,-98,78
1,1445,1661,-216,2,120,63
-1,1556,1493,63,-3,-24,42
-1,1292,1470,-178,-1,-276,92
-1,1880,1778,102,0,5,50
1,1398,1275,123,-6,-199,55
-1,1447,1505,-58,-2,-111,74
-1,1387,1736,-349,4,119,54
1,1762,1682,80,-2,-7,57
1,1360,1289,71,5,671,101
-1,1561,1403,158,-12,-537,60
1,1528,1351,177,3,102,51
-1,1430,1551,-121,-4,-124,102
1,1509,1542,-33,0,4,45
1,1719,1612,107,0,-13,52
1,1543,1612,-69,7,952,102
1,1606,1771,-165,-1,198,137
1,1739,1384,355,4,51,51
-1,1661,1611,50,-1,-123,116
-1,1477,1486,-9,-5,-282,68
-1,1688,1366,322,0,8,62
-1,1630,1594,36,-1,-565,130
-1,1670,1499,171,-4,-50,46
-1,1381,1742,-361,-12,-166,52
1,1530,1523,7,2,61,63
1,1641,1677,-36,0,-35,97
1,1663,1609,54,-2,108,111
-1,1615,1689,-74,-1,-68,63
-1,1515,1434,81,-9,-44,42
1,1624,1686,-62,0,72,121
-1,1792,1866,-74,0,27,44
-1,1505,1744,-239,0,9,74
1,1541,1510,31,0,-12,53
-1,1610,1599,11,-2,-295,88
-1,2025,1987,38,0,-46,68
1,1870,1723,147,1,35,93
-1,1599,1523,76,-1,13,102
-1,1738,1564,174,1,30,44
-1,1448,1558,-110,-4,-217,80
-1,1794,1821,-27,0,-5,100
-1,1749,1500,249,0,-5,54
1,1875,1784,91,1,66,61
-1,1499,1552,-53,-2,-46,52
1,1559,1726,-167,0,-16,75
1,1599,1598,1,0,-15,53
-1,1610,1371,239,-2,-57,54
1,1452,1501,-49,0,6,63
-1,1518,1730,-212,2,-12,74
1,1633,1529,104,5,239,73
1,1301,1297,4,0,-26,47
1,1833,1719,114,2,174,65
1,1617,1673,-56,1,305,93
1,1533,1520,13,-1,-32,43
1,1566,1317,249,4,89,47
-1,1999,2012,-13,0,99,100
-1,1628,1282,346,-1,-63,120
1,1568,1260,308,8,576,89
1,1497,1466,31,1,62,63
-1,1654,1806,-152,2,96,90
1,1736,1513,223,0,103,69
1,1487,1595,-108,4,158,94
-1,2028,2264,-236,-1,-25,58
1,1619,1500,119,0,166,69
-1,1508,1741,-233,-9,-338,46
1,2269,2023,246,0,-5,59
1,1500,1392,108,4,98,47
1,1516,1496,20,0,92,65
-1,1622,1545,77,0,-39,108
1,1320,1320,0,-1,-41,57
1,1489,1469,20,0,107,101
-1,2023,1989,34,0,-132,114
-1,1610,1582,28,-2,-72,50
1,1746,1503,243,-2,-51,63
1,2275,2019,256,-1,-3,45
0,1569,1488,81,0,-1,46
1,1346,1416,-70,-10,466,97
-1,1840,1597,243,0,19,66
1,1776,1883,-107,-1,-55,65
-1,2014,2280,-266,1,54,74
-1,1917,2041,-124,0,-14,40
1,1491,1567,-76,1,-39,85
1,1594,1751,-157,1,11,61
1,1716,1246,470,-2,21,67
-1,1877,1661,216,2,-112,116
-1,1558,1672,-114,0,-214,116
1,1501,1497,4,-2,-54,49
-1,2285,2010,275,-3,-208,78
1,1571,1586,-15,6,113,51
1,1456,1508,-52,3,82,63
1,1219,1256,-37,2,266,99
-1,2061,1869,192,-1,-543,154
1,1734,1609,125,5,299,63
-1,2001,2011,-10,-3,150,92
-1,2029,2263,-234,0,20,116
-1,1517,1665,-148,-1,23,40
-1,1553,1506,47,-3,-123,64
1,1625,1633,-8,-3,560,137
-1,1456,1499,-43,1,-68,120
-1,1602,1742,-140,-2,-6,64
1,1483,1500,-17,1,67,73
1,1628,1626,2,1,67,57
-1,2268,2024,244,0,-105,76
1,1879,1784,95,6,108,55
1,2052,1910,142,-2,-63,57
-1,2043,2247,-204,0,-1,78
-1,1749,1595,154,1,-48,74
0,1520,1540,-20,-4,45,96
-1,1505,1611,-106,0,9,58
1,1531,1681,-150,-5,35,71
-1,2022,1990,32,0,-125,74
-1,1712,1874,-162,-10,-233,57
-1,2253,2037,216,-3,-155,62
1,1534,1455,79,1,37,55
1,1303,1386,-83,0,21,65
-1,1611,1732,-121,-3,-107,50
-1,1646,1718,-72,-3,-17,46
-1,1495,1469,26,-6,-865,120
1,2232,2055,177,-1,15,83
-1,1448,1256,192,-11,-343,114
-1,1603,1740,-137,0,10,56
-1,1528,1634,-106,0,-120,74
-1,1704,1608,96,0,-150,70
1,1881,1727,154,1,-44,91
1,1554,1320,234,3,21,41
1,1707,1812,-105,0,-63,61
0,1540,1520,20,0,35,106
-1,2049,2240,-191,0,-2,64
-1,1775,1748,27,-1,-140,103
1,1748,1596,152,1,1,43
1,1903,1974,-71,0,134,127
-1,2002,2010,-8,3,100,76
-1,1786,1548,238,-1,-347,104
-1,1647,1722,-75,-5,-262,108
1,1663,1551,112,0,-3,55
1,2246,2043,203,0,-92,97
1,1755,1590,165,2,77,53
-1,1315,1509,-194,7,105,48
1,1575,1476,99,1,57,73
-1,1773,1927,-154,-1,-118,94
-1,2037,2253,-216,-3,126,114
1,1653,1881,-228,-1,37,73
-1,1409,1306,103,0,-36,56
1,1447,1469,-22,8,234,43
-1,1521,1539,-18,-8,-57,64
-1,1559,1258,301,1,4,62
-1,1584,1761,-177,-1,-34,64
-1,1788,2048,-260,-4,-43,60
1,2259,2032,227,1,93,55
-1,1541,1832,-291,0,-13,64
-1,1460,1567,-107,6,149,56
1,1768,1578,190,0,23,63
-1,2027,2264,-237,0,-31,112
-1,1550,1510,40,0,-17,58
1,1471,1284,187,3,12,61
0,1541,1672,-131,-2,-114,92
0,1524,1483,41,1,-93,138
-1,1452,1465,-13,-3,-143,76
1,1645,1572,73,2,92,63
1,1623,1652,-29,0,130,99
-1,2270,2022,248,0,-25,54
-1,1835,1836,-1,2,-6,105
1,2021,1991,30,1,62,123
1,2052,1587,465,2,219,59
-1,1312,1479,-167,-6,-197,52
-1,1093,1164,-71,-4,-441,96
1,2041,2249,-208,1,12,49
-1,1245,1612,-367,3,-23,62
1,1563,1655,-92,8,925,99
1,1400,1321,79,0,-2,75
-1,2229,2059,170,0,-53,74
-1,1440,1431,9,-2,-43,60
1,1721,1824,-103,-5,283,97
-1,1321,1395,-74,-11,-546,78
1,1798,1764,34,12,268,49
-1,1548,1512,36,-1,-75,72
-1,2076,2210,-134,1,71,90
1,1835,1537,298,3,559,131
-1,1554,1500,54,0,0,40
-1,1597,1477,120,0,-418,114
-1,1590,1625,-35,-12,-127,64
1,1368,1584,-216,2,55,55
1,1539,1337,202,10,205,42
1,1427,1600,-173,1,7,77
-1,1971,1915,56,-3,-73,50
-1,2219,2069,150,-4,-253,96
1,1636,1580,56,-1,-148,107
-1,1328,1413,-85,-1,-847,166
0,1662,1584,78,2,364,142
-1,1382,2139,-757,-1,-58,53
-1,1445,2054,-609,-3,-133,52
-1,2085,2201,-116,-3,4,48
1,1571,1646,-75,4,254,59
-1,1461,1536,-75,-13,-403,66
-1,2209,2077,132,0,-207,86
-1,1632,1584,48,-1,-73,86
1,1825,1829,-4,0,79,101
0,1545,1697,-152,-3,-101,59
-1,1534,1839,-305,-4,-118,58
-1,2093,2192,-99,-1,-55,74
1,1596,1618,-22,1,96,55
1,1544,1397,147,-4,3,63
-1,1487,1461,26,0,-48,136
1,1553,1282,271,9,423,59
1,1720,1660,60,-1,22,69
-1,1635,1720,-85,0,-26,84
-1,1606,1608,-2,0,-15,58
1,1526,1468,58,-1,15,77
-1,1404,1311,93,-4,-131,60
1,1595,1356,239,5,313,73
-1,1842,1993,-151,0,-108,82
-1,1381,1402,-21,-1,-69,70
1,1314,1243,71,0,-16,59
-1,1625,1473,152,0,-1,56
1,1928,1958,-30,-1,-19,49
1,1483,1544,-61,2,132,82
-1,1107,1648,-541,-5,-144,45
-1,1520,1543,-23,-1,-157,74
0,1730,1583,147,-2,19,119
-1,1534,1880,-346,-5,-289,76
1,1603,1741,-138,-3,-404,115
-1,1535,1515,20,0,-182,88
1,1729,1626,103,0,69,125
-1,1939,1946,-7,-1,-17,44
-1,1577,2139,-562,0,-170,94
1,1836,1766,70,0,139,117
1,1756,1817,-61,-5,-7,57
1,1829,2006,-177,0,134,127
-1,1524,1471,53,0,10,62
1,1662,1169,493,1,350,143
1,1620,1701,-81,-2,-158,95
-1,1566,2155,-589,-3,-150,88
1,2140,1576,564,0,3,61
1,1468,1104,364,1,422,87
-1,1351,1544,-193,-6,-250,60
1,1957,1818,139,-3,16,51
1,1711,1565,146,0,65,83
1,1487,1500,-13,3,-65,71
-1,1442,1485,-43,1,-391,98
-1,1640,1772,-132,0,-41,68
1,1633,1592,41,0,24,53
1,1694,1599,95,0,-65,87
1,1640,1533,107,0,124,65
-1,1594,1764,-170,-4,-9,44
1,1322,1302,20,1,304,71
-1,1586,1546,40,0,50,90
1,1678,1261,417,2,174,93
1,1722,1707,15,0,55,97
-1,1724,1417,307,-3,13,52
-1,1486,1382,104,0,-376,84
1,1395,1370,25,0,73,85
-1,1534,1649,-115,-4,-138,70
1,1669,1854,-185,-3,-11,67
1,1525,1185,340,1,362,97
-1,1564,1693,-129,-2,-27,42
-1,1697,1664,33,0,-63,64
-1,1517,1808,-291,-1,-79,77
-1,1783,2153,-370,-3,-68,58
-1,1561,1471,90,-8,-158,66
-1,1834,1719,115,0,79,134
1,1290,1333,-43,5,437,71
-1,1671,1807,-136,4,120,54
1,1620,1163,457,0,-7,65
-1,1657,1600,57,1,-48,68
1,1702,1799,-97,0,-33,153
-1,1526,1658,-132,0,8,60
1,1684,1354,330,0,612,129
1,1664,1500,164,-2,-77,113
-1,1160,1622,-462,7,131,48
1,1495,1433,62,1,341,89
1,1663,1815,-152,-2,-27,85
-1,1540,1494,46,5,36,42
1,1723,1449,274,0,36,126
-1,1645,1928,-283,-1,-188,86
1,1623,1158,465,1,52,45
1,1557,1906,-349,1,57,79
1,1438,1296,142,-1,-49,95
-1,1770,1729,41,0,-41,72
-1,1593,1513,80,0,37,66
-1,1769,1735,34,-1,-47,54
1,1799,1680,119,-1,-52,49
-1,1156,1625,-469,-6,-231,70
-1,1515,1418,97,-3,-164,68
-1,1672,1806,-134,-2,6,72
1,1519,1666,-147,1,25,55
-1,1500,1609,-109,-4,-83,48
0,1507,1245,262,5,427,127
1,1761,1343,418,2,76,59
-1,1506,1657,-151,0,-381,166
1,1626,1154,472,0,0,49
-1,1875,1508,367,8,227,45
1,1814,1664,150,0,-16,71
1,1507,1454,53,2,147,103
-1,1686,1675,11,4,121,100
1,1613,1643,-30,2,20,43
1,1716,1595,121,-1,41,157
1,1349,1320,29,9,312,63
1,1649,1688,-39,0,-160,189
-1,1535,1852,-317,-1,-11,57
1,1630,1150,480,0,82,71
1,1820,1667,153,2,20,63
-1,1528,1779,-251,0,-377,134
-1,1394,1373,21,2,-205,142
-1,1423,1504,-81,-12,-882,102
-1,1418,1727,-309,0,-9,50
1,1365,1412,-47,2,-31,49
-1,1661,1827,-166,0,375,88
1,1288,1445,-157,-1,71,101
1,1618,1679,-61,1,75,61
1,1881,1576,305,0,334,105
-1,1346,1484,-138,-4,-154,52
-1,1380,1595,-215,0,-38,128
-1,1663,1833,-170,-5,-267,78
1,1500,1411,89,0,-142,63
-1,1651,1846,-195,-2,-137,68
1,1941,1873,68,-4,88,84
-1,1406,1402,4,1,33,52
1,1687,1674,13,0,21,85
1,1310,1187,123,-3,-43,69
1,1851,1645,206,0,24,49
-1,1390,1673,-283,-3,-178,67
-1,1530,1445,85,8,426,70
1,1707,1821,-114,0,97,67
1,1539,1389,150,3,212,71
1,1730,1556,174,3,134,61
-1,1640,1857,-217,0,-10,46
-1,1255,1663,-408,-14,-126,46
-1,1268,1404,-136,0,71,92
-1,1788,1857,-69,0,1,68
-1,1385,1383,2,-14,-253,58
-1,1546,1760,-214,-3,-54,62
1,1307,1404,-97,4,98,57
0,1599,1475,124,1,623,93
1,1862,1779,83,-4,-152,57
-1,1418,1392,26,-4,-627,94
1,1719,1666,53,0,134,83
-1,1594,1513,81,-2,-87,84
1,1932,1856,76,1,63,57
1,1631,1528,103,-2,-70,61
-1,1770,1871,-101,0,-13,58
1,1481,1252,229,12,429,49
-1,1573,1885,-312,1,-40,90
1,1734,1797,-63,-1,69,130
1,1411,1500,-89,6,212,53
-1,1611,1764,-153,-1,-155,116
1,1500,1303,197,1,12,43
-1,1839,2152,-313,0,-21,48
1,1879,1761,118,-3,-159,67
-1,1663,1697,-34,0,63,58
0,1275,1421,-146,-3,-141,114
1,1678,1692,-14,10,576,85
1,1394,1352,42,-2,399,131
1,1354,1393,-39,1,446,113
1,1761,1765,-4,3,16,43
1,1114,1232,-118,0,302,85
1,1631,1402,229,-5,-23,51
1,1418,1324,94,-1,294,67
-1,1659,1823,-164,-3,-245,90
-1,1396,1637,-241,-10,-128,52
1,1541,1565,-24,0,284,117
1,1254,1426,-172,0,357,93
-1,1434,1500,-66,-3,-266,80
-1,1240,1568,-328,1,-35,71
-1,1753,1581,172,-1,-125,88
-1,1463,1717,-254,-1,-405,126
-1,1773,1527,246,2,45,74
0,1776,1692,84,0,-21,82
1,1520,1638,-118,2,75,59
-1,1588,1596,-8,4,115,78
-1,1375,1520,-145,1,28,42
-1,1214,1448,-234,0,-150,82
-1,1723,1607,116,0,-319,140
-1,1558,1724,-166,0,-15,52
-1,1484,1488,-4,-7,-194,48
1,1405,1485,-80,-3,-73,43
1,2112,1559,553,0,273,137
1,1653,1444,209,0,17,43
-1,1148,1649,-501,-2,-84,80
-1,1638,1887,-249,0,7,90
-1,1500,1411,89,-8,-52,46
1,1645,1427,218,3,254,73
1,1757,1746,11,-1,127,71
-1,1650,1146,504,4,168,64
-1,1558,2113,-555,-1,-76,80
1,1891,1634,257,2,54,79
1,1499,1463,36,-4,-7,89
-1,1177,1625,-448,0,-22,60
-1,1394,1569,-175,-4,-194,114
-1,1736,1768,-32,-1,-109,80
-1,1630,1895,-265,0,-73,84
-1,1676,1607,69,0,51,66
-1,1613,1694,-81,-1,-93,46
-1,1512,1458,54,-8,-172,48
1,1627,1175,452,3,134,63
1,2114,2179,-65,-3,88,127
-1,1323,1771,-448,0,12,48
1,1900,1625,275,-3,-101,57
1,1978,1796,182,0,4,53
-1,1671,1592,79,0,-75,86
1,1599,1324,275,3,106,55
-1,1172,1629,-457,2,-43,60
1,1703,1604,99,-5,365,79
1,2160,1815,345,1,126,77
1,1553,1042,511,0,72,69
-1,1754,1784,-30,-1,-12,42
-1,1390,1259,131,-3,-234,75
-1,1993,2158,-165,0,2,66
1,1631,1170,461,-1,-18,49
1,1729,1546,183,1,91,71
1,1418,1499,-81,1,85,71
-1,1418,1675,-257,1,36,92
-1,1773,1605,168,-1,-71,82
-1,1572,1624,-52,-4,-90,52
-1,1529,1590,-61,1,21,51
-1,1168,1633,-465,-6,-192,46
1,1736,1658,78,-1,15,67
1,1635,1904,-269,4,219,87
1,1650,1320,330,4,234,60
-1,2168,1987,181,-2,-362,100
-1,1635,1165,470,3,84,42
1,1317,1382,-65,-1,-422,105
-1,1197,1609,-412,-8,-132,62
1,1374,1367,7,5,119,43
-1,1885,1631,254,-2,-103,72
1,1319,1603,-284,3,625,105
1,1530,1652,-122,0,169,139
0,1659,1611,48,0,71,137
1,1773,1453,320,3,167,71
-1,1812,2167,-355,-2,-56,72
1,1743,1640,103,2,39,49
-1,1596,1711,-115,-3,-247,114
-1,1649,1866,-217,0,-59,68
1,1625,1563,62,1,132,91
-1,1722,1890,-168,-5,-129,44
1,1611,1194,417,-9,-44,87
1,1679,1413,266,1,88,101
1,1570,1617,-47,1,66,47
1,1707,1621,86,1,10,61
1,1633,1579,54,5,142,57
-1,1871,1644,227,-7,-83,44
1,1191,1614,-423,-13,-582,59
-1,1379,1666,-287,1,-290,102
-1,1662,1853,-191,0,63,70
-1,1599,1466,133,-14,-307,54
1,1575,1745,-170,0,3,59
1,1718,1557,161,3,292,59
1,1587,1223,364,0,34,47
-1,1859,1656,203,-2,-150,68
1,1555,1472,83,2,15,43
-1,1219,1591,-372,-15,-529,44
-1,1409,1683,-274,-3,48,110
1,1650,1718,-68,-1,475,137
-1,1735,1572,163,-1,-114,132
1,1594,1215,379,0,3,41
1,1592,1375,217,-1,-13,63
1,1330,1524,-194,-2,-82,89
-1,1513,1621,-108,-2,-97,56
-1,1391,2130,-739,-3,-13,84
1,1564,1752,-188,-1,8,47
-1,1409,1453,-44,-1,10,48
1,1635,1346,289,5,65,43
-1,1211,1597,-386,-1,58,42
0,1709,1728,-19,-3,-654,150
-1,1542,1593,-51,0,11,68
1,1605,1508,97,1,219,113
-1,1550,1724,-174,-1,-185,108
1,1588,1516,72,2,91,95
1,1740,1550,190,5,257,77
1,1600,1208,392,12,160,45
1,1991,1449,542,7,91,43
-1,1622,2131,-509,-7,-208,60
-1,1684,1777,-93,-4,-344,96
1,1239,1275,-36,-1,-148,75
1,1432,1297,135,10,429,83
1,1818,1885,-67,-3,101,93
-1,1204,1603,-399,-1,-79,56
1,1734,1604,130,3,119,59
-1,1754,1905,-151,-4,-82,46
-1,1804,1588,216,-6,57,40
1,1688,1404,284,1,59,59
-1,1581,1597,-16,0,14,80
1,1718,1510,208,-4,424,135
-1,1521,1637,-116,2,103,62
-1,1584,1474,110,1,3,132
1,1606,1201,405,3,198,59
-1,1340,1640,-300,1,-174,88
-1,1429,1348,81,-14,-167,50
1,1674,1624,50,0,463,87
-1,1198,1609,-411,-4,-143,52
1,1871,1654,217,2,110,67
1,1828,1500,328,3,56,41
1,1756,1924,-168,-1,-21,73
1,1597,1742,-145,3,51,59
-1,1612,1195,417,-11,-124,40
0,1477,1510,-33,3,437,115
-1,1709,1655,54,-8,-851,108
-1,1604,1686,-82,0,-144,87
-1,1955,1747,208,-9,-247,50
-1,1652,1448,204,0,36,64
-1,1400,1692,-292,0,-40,70
1,1573,1683,-110,0,477,127
1,2173,1871,302,1,58,47
1,1731,1544,187,-4,-290,95
-1,1226,1584,-358,-3,-2,64
1,1781,1839,-58,0,-204,107
-1,1614,1841,-227,-2,-40,46
-1,1663,1623,40,-1,3,62
1,1945,1464,481,0,29,87
1,1602,1532,70,-1,3,49
1,1346,1553,-207,3,765,109
1,1818,1747,71,4,151,61
-1,1557,2132,-575,-3,-88,54
1,1588,1222,366,6,205,67
-1,1587,1669,-82,-7,-81,50
1,1654,1846,-192,-1,122,79
-1,1218,1591,-373,-8,-225,48
-1,1580,1878,-298,-1,-629,110
1,2133,1646,487,-1,-21,71
1,1831,1746,85,-2,-26,57
-1,1505,1724,-219,-1,-62,60
-1,1482,1569,-87,0,-4,100
1,1696,1396,300,2,187,99
1,1677,1578,99,9,185,53
1,1697,1640,57,-1,-171,147
1,1908,1872,36,0,73,83
1,1650,1757,-107,1,33,53
-1,1570,1686,-116,-3,-183,58
1,1594,1214,380,-1,5,49
1,1725,1670,55,1,70,59
1,1668,1835,-167,5,237,65
1,1832,1581,251,0,-27,59
-1,1381,1329,52,-3,-424,90
1,2135,1563,572,19,338,47
1,1663,1374,289,0,52,53
1,1211,1598,-387,4,145,41
1,1762,1845,-83,-1,-46,43
1,1373,1178,195,-1,46,45
1,1538,1737,-199,-1,44,49
1,1819,1685,134,-1,-28,43
-1,1793,1827,-34,-2,-78,72
-1,1263,2136,-873,0,-29,70
1,1523,1611,-88,3,98,53
-1,1738,1839,-101,0,-85,52
-1,1693,1613,80,1,27,52
-1,1505,1597,-92,-8,-18,41
-1,1786,1669,117,1,29,76
1,2136,1826,310,-1,-5,129
-1,1237,1574,-337,-1,-103,54
-1,1504,1774,-270,0,-535,142
1,1262,1381,-119,0,-8,59
-1,1719,1555,164,3,87,100
1,1771,1775,-4,-1,-28,59
-1,1706,1552,154,-2,-536,142
-1,1596,1635,-39,-1,-5,98
1,1578,1232,346,0,36,51
-1,1823,2141,-318,0,-11,66
-1,1478,1392,86,-1,-294,108
1,1790,1719,71,-5,315,97
1,1562,1671,-109,0,64,73
1,2145,1819,326,1,205,111
-1,1729,1599,130,3,49,72
1,1855,1722,133,-3,228,67
1,1582,1438,144,0,193,133
1,1735,1485,250,0,8,49
1,1366,1524,-158,0,-34,47
-1,1605,1396,209,0,-353,152
-1,1577,1816,-239,-3,-49,64
-1,1816,1842,-26,2,112,102
1,1371,1536,-165,-1,-63,75
1,1729,1741,-12,-1,-65,83
1,1821,1572,249,1,507,99
1,1857,2011,-154,-1,18,73
1,1648,1576,72,0,1,47
-1,1489,1487,2,0,174,62
-1,1363,1481,-118,8,167,88
1,1608,1508,100,-4,-89,53
-1,1486,1578,-92,0,-36,76
-1,1568,1826,-258,0,4,44
0,1740,1862,-122,-12,-42,96
1,1703,1463,240,-1,2,59
-1,1524,1612,-88,-4,-290,88
1,1830,1563,267,18,759,65
1,1882,1699,183,1,148,85
1,1993,1616,377,1,18,43
-1,1741,1730,11,-2,-789,106
-1,1559,1835,-276,1,177,90
1,1614,1173,441,4,43,45
-1,1995,1614,381,0,15,58
1,1587,1299,288,-1,-27,47
-1,1451,1422,29,-2,-216,76
-1,1628,1617,11,0,12,42
1,1433,1530,-97,0,132,113
1,1839,1555,284,21,627,51
1,1803,1784,19,-1,56,72
-1,1764,1823,-59,-2,-521,94
-1,1414,1439,-25,2,1,52
-1,1551,1843,-292,-7,-321,84
-1,1484,1288,196,-1,-73,98
1,1858,1744,114,2,71,61
-1,1616,1385,231,-4,-163,62
-1,1469,1477,-8,-1,-28,62
-1,1294,1591,-297,0,-97,102
-1,1668,1559,109,0,22,54
-1,1547,1847,-300,1,-36,62
0,1729,1726,3,0,118,108
1,1620,1515,105,-3,219,141
-1,1743,1853,-110,0,-42,52
1,1708,1634,74,0,-73,43
1,1851,1544,307,1,56,77
-1,1355,1200,155,-17,-468,52
-1,1412,2149,-737,-15,-356,50
-1,1540,1854,-314,-9,-315,54
1,1852,1798,54,-1,-26,53
1,1555,1679,-124,0,-202,121
-1,1472,1619,-147,-4,-50,42
1,1693,1889,-196,-5,-139,87
0,1537,1858,-321,1,58,61
1,1518,1532,-14,-2,-87,47
1,1401,1390,11,4,62,43
1,2150,1448,702,1,20,49
1,1729,1726,3,-1,-89,71
1,1746,1681,65,-1,61,57
-1,1570,1586,-16,0,-189,74
1,1837,1424,413,3,56,57
1,1559,1303,256,1,183,65
1,1400,1421,-21,8,110,45
-1,1972,1849,123,0,-13,76
-1,1448,2150,-702,0,-31,80
-1,1866,1861,5,0,-125,106
-1,1594,1480,114,1,-137,70
0,1716,1736,-20,-1,14,71
-1,1368,1542,-174,-2,-157,72
-1,1658,1955,-297,0,-50,72
-1,1478,1465,13,-1,-30,54
-1,1687,1799,-112,-1,-16,74
-1,1545,1556,-11,-9,-682,96
1,1563,1648,-85,3,129,47
1,1435,1298,137,0,202,87
-1,1784,1811,-27,0,-78,116
1,1959,2151,-192,0,112,67
-1,1716,1740,-24,2,75,92
-1,1596,1865,-269,-5,-860,110
-1,1589,1612,-23,-1,-178,86
1,2142,1469,673,0,10,91
-1,1740,1502,238,-2,-57,48
-1,1391,1568,-177,-2,-136,56
1,1609,1305,304,0,-13,57
1,1420,1839,-419,0,62,89
-1,1578,1634,-56,0,44,98
1,1575,1514,61,1,5,67
1,2128,1331,797,3,86,55
0,1506,1459,47,-5,-112,73
-1,1978,1870,108,3,266,84
-1,1409,1704,-295,-8,-141,52
-1,1653,1392,261,-8,-1,40
-1,1520,1838,-318,-3,-301,100
-1,1872,1855,17,0,-19,134
1,1582,1422,160,6,107,53
1,2144,2128,16,-1,324,153
1,1886,1962,-76,0,26,87
1,1672,1756,-84,-3,49,97
1,1579,1497,82,6,194,77
1,1855,1516,339,3,633,151
-1,1628,1821,-193,0,-17,116
1,1735,1717,18,-1,70,71
0,1727,1515,212,1,159,142
1,1459,1318,141,8,140,45
1,1635,1517,118,6,143,49
1,1528,1626,-98,0,0,47
1,1751,1489,262,-1,151,105
1,1927,1817,110,-1,-83,55
1,1553,1466,87,1,294,149
-1,1589,1796,-207,0,-78,78
1,1890,1869,21,1,45,53
-1,1488,1588,-100,0,-81,70
-1,2114,2160,-46,0,-32,82
-1,1485,1408,77,2,56,60
1,1362,1256,106,4,366,79
-1,1824,1901,-77,1,-355,100
1,1397,1542,-145,8,348,61
1,1558,1410,148,7,281,57
-1,1273,1466,-193,-5,-116,58
-1,1661,1629,32,-3,-638,110
-1,1481,1428,53,-4,-177,56
1,1449,1209,240,6,95,43
-1,1910,1791,119,-2,-417,152
-1,2174,2100,74,4,38,70
1,1529,1301,228,3,556,83
-1,1521,1721,-200,-4,-131,58
-1,1612,1570,42,-1,-16,62
1,1471,1242,229,12,243,45
-1,1756,1862,-106,-3,6,52
-1,1706,1866,-160,0,-201,124
1,1807,1679,128,-1,-3,63
1,1418,1186,232,12,490,63
-1,1808,1861,-53,-3,-179,76
-1,1480,1554,-74,0,-94,68
-1,1842,1895,-53,-2,-71,58
1,1746,1574,172,0,13,43
1,1755,1699,56,-1,-5,69
1,1568,1580,-12,-2,48,73
1,2118,2155,-37,0,4,131
-1,1492,1584,-92,-4,-897,126
1,1340,1329,11,-11,-484,89
-1,1496,1742,-246,0,-12,76
-1,1812,1905,-93,-2,-79,72
-1,1610,1755,-145,-2,-79,57
-1,1476,1463,13,-1,-55,60
1,1504,1460,44,5,233,71
-1,1592,1831,-239,-7,-50,46
-1,1827,1622,205,-1,-237,114
-1,1468,1468,0,2,-276,84
1,2134,1913,221,1,420,101
0,1539,1595,-56,-1,-475,182
-1,1689,1765,-76,0,-59,96
0,1565,1568,-3,0,66,110
-1,1791,1457,334,0,-140,82
0,1579,1517,62,-1,92,105
-1,1908,2138,-230,-9,8,108
1,1873,1700,173,-1,161,133
1,1458,1424,34,1,-2,43
0,1581,1611,-30,-4,-148,53
1,1807,1898,-91,1,319,91
1,1641,1399,242,0,168,107
1,2145,1903,242,0,437,119
1,2141,1587,554,6,764,81
1,1870,1798,72,0,55,95
-1,1722,1814,-92,-3,-147,94
1,1774,1465,309,3,455,103
1,1182,1221,-39,-5,-89,61
1,1770,1579,191,0,-20,49
1,1898,2151,-253,-1,83,95
-1,1583,1814,-231,-7,-270,62
-1,1762,1802,-40,1,21,46
1,1596,1479,117,-5,825,151
-1,1639,1810,-171,-1,-107,114
1,1412,1468,-56,-3,-65,57
1,1610,1649,-39,6,143,47
1,1668,1903,-235,-1,-5,41
1,1738,1821,-83,3,184,77
1,1733,1349,384,4,277,77
0,1568,1620,-52,-3,-113,124
1,2126,1917,209,0,16,43
1,1446,1256,190,7,275,51
1,1592,1582,10,0,-33,47
-1,1299,1441,-142,7,92,48
1,1883,1686,197,2,70,67
-1,1338,1515,-177,-3,-448,72
-1,1911,2133,-222,-1,-24,44
-1,1595,1471,124,0,32,72
1,2133,1911,222,0,25,57
-1,1693,1678,15,1,22,58
-1,1879,1878,1,1,-4,48
1,1356,1247,109,-3,117,119
-1,1610,1586,24,4,63,110
0,1349,1356,-7,-1,-120,80
-1,1906,2140,-234,3,95,60
1,1422,1480,-58,1,58,81
1,1870,1749,121,1,27,45
1,1690,1682,8,1,45,83
-1,1403,1561,-158,2,51,42
-1,1722,1741,-19,1,-47,52
-1,1565,1500,65,-1,0,44
1,1901,1671,230,-2,-577,75
1,1608,1511,97,0,135,85
1,2054,1563,491,6,222,59
1,1556,1185,371,3,46,61
-1,1668,1688,-20,3,-129,104
-1,1729,2116,-387,-1,-2,44
1,1306,1317,-11,5,214,75
-1,1561,1791,-230,0,-176,102
1,1585,1567,18,0,3,84
1,1536,1243,293,1,83,97
0,1776,1200,576,0,-78,100
1,1662,1652,10,0,16,67
1,1845,1758,87,0,86,88
-1,1312,0,1312,0,12,64
-1,1678,1390,288,-1,-323,86
-1,1556,1649,-93,-1,-202,68
-1,1182,1566,-384,-13,-346,68
-1,2119,2025,94,0,-261,160
1,1500,1355,145,0,13,49
-1,1429,1433,-4,1,-213,70
-1,1455,1607,-152,0,-172,104
1,1663,1178,485,2,334,75
1,1684,1692,-8,-1,17,63
-1,1502,1602,-100,-2,-72,59
-1,1710,2055,-345,0,-20,54
1,1851,1642,209,2,185,85
1,1518,1707,-189,0,-63,95
-1,1505,1569,-64,2,122,96
-1,2039,2058,-19,3,9,40
1,1335,1160,175,2,247,61
1,1548,1658,-110,-2,-171,85
1,1363,1265,98,3,300,77
-1,1697,1689,8,-3,14,82
1,1416,1533,-117,-3,-64,47
1,2180,2054,126,0,-7,59
1,1367,1508,-141,2,384,122
-1,1349,1616,-267,-20,-1389,70
1,1452,1500,-48,1,63,59
1,1557,1653,-96,-2,-48,49
1,1767,1540,227,0,3,65
-1,1571,1819,-248,1,36,42
-1,1683,1637,46,3,87,50
-1,1540,2005,-465,-4,-110,60
1,1643,1746,-103,-1,-63,67
-1,1858,1745,113,-4,-169,50
1,1339,1259,80,-2,-61,57
1,1518,1431,87,3,441,123
1,1498,1556,-58,0,-72,49
-1,1701,1684,17,0,-35,66
-1,1478,1627,-149,3,-181,80
1,1658,1668,-10,3,119,164
1,1596,1618,-22,0,4,53
-1,1665,1500,165,-1,-31,84
1,1411,1465,-54,-1,-36,47
-1,1417,1441,-24,-1,127,80
-1,2028,1974,54,0,-16,48
0,1525,1324,201,-1,11,84
-1,1673,1677,-4,-2,-268,89
-1,1318,1455,-137,-2,-261,82
1,1578,1496,82,0,270,76
-1,1503,1250,253,-1,-95,60
1,1981,1831,150,0,54,87
1,1987,2016,-29,0,2,55
-1,1552,1874,-322,-1,-907,118
1,1617,1178,439,2,97,77
-1,1561,1642,-81,1,-8,68
1,1668,1178,490,3,78,51
1,1423,1527,-104,5,314,63
1,1470,1462,8,2,425,103
1,1714,1775,-61,-2,-22,49
1,1681,1586,95,-1,117,65
1,1639,1525,114,5,341,95
-1,1257,1371,-114,0,-110,70
1,1494,1780,-286,1,0,57
-1,1563,1643,-80,-6,-615,82
1,1682,1667,15,3,73,55
-1,1999,2004,-5,0,-15,84
-1,1706,1813,-107,-1,-11,54
1,1296,1146,150,-5,-97,59
1,1813,1530,283,0,-25,69
-1,1103,1465,-362,-2,6,52
-1,1619,1822,-203,0,49,114
-1,1893,1615,278,2,196,96
1,1364,1263,101,4,4,89
1,1668,1578,90,4,246,93
1,1406,1236,170,7,268,59
1,1471,1461,10,2,97,131
-1,1578,1690,-112,-7,-249,66
-1,1492,1493,-1,0,251,76
-1,1346,1285,61,4,193,90
1,1571,1697,-126,-3,247,135
1,1411,1586,-175,0,513,103
1,1828,1618,210,-6,-130,57
1,1631,1363,268,-4,-54,59
-1,1077,1674,-597,4,281,62
1,1539,1656,-117,5,302,72
-1,1967,2046,-79,-2,-71,62
-1,1563,1706,-143,-1,-169,68
-1,1650,1545,105,0,102,78
1,1684,1601,83,0,333,167
-1,1315,1424,-109,-8,-448,70
-1,1676,1674,2,-7,-322,80
-1,1453,1383,70,-6,-434,90
-1,1662,1831,-169,0,-57,92
1,1519,1451,68,0,140,113
-1,1471,1576,-105,-1,-306,106
-1,1536,1317,219,-9,-226,56
1,1543,1512,31,0,-16,83
-1,1258,1194,64,4,163,62
1,1733,1526,207,-3,-256,101
-1,1613,1839,-226,0,-109,78
1,1336,1484,-148,-2,21,121
1,1513,1521,-8,2,172,89
1,1702,1800,-98,4,146,57
1,1497,1702,-205,5,525,109
-1,1772,1679,93,0,50,60
-1,1636,1810,-174,1,31,46
1,1570,1429,141,-1,49,53
-1,1656,1675,-19,-1,-60,55
1,1186,1438,-252,0,208,91
-1,1311,1352,-41,1,-35,66
1,1554,1350,204,3,300,137
-1,1731,1660,71,-1,-37,44
1,1830,1648,182,3,51,43
1,1758,1449,309,1,104,59
1,1338,1379,-41,1,313,112
1,1525,1556,-31,-2,474,103
1,1231,1221,10,21,1174,85
-1,1549,1613,-64,0,48,58
-1,1643,1584,59,1,-57,96
1,1843,1570,273,0,-14,75
-1,1655,1684,-29,-5,-92,49
1,1525,1645,-120,0,333,94
1,1652,1896,-244,-1,-60,113
-1,1619,1892,-273,-3,-78,48
1,1874,1577,297,-2,-9,89
1,1559,1560,-1,0,-11,59
-1,1738,2065,-327,-6,-279,62
-1,1385,1541,-156,-11,-696,70
1,1209,1242,-33,-1,-6,43
-1,1848,1563,285,-4,-359,124
1,1620,1602,18,0,41,61
1,1534,1651,-117,0,153,79
1,1208,1244,-36,2,160,55
-1,1665,1487,178,-4,-152,78
-1,1646,1706,-60,0,-178,73
-1,2027,1764,263,1,57,64
1,2070,1553,517,2,127,61
-1,1392,1636,-244,-1,-263,106
1,1612,1417,195,4,97,53
1,2068,1735,333,1,54,51
-1,1742,1563,179,5,225,84
1,1659,1395,264,0,192,121
-1,1819,2021,-202,-3,0,64
1,1543,1501,42,0,126,43
-1,1637,1716,-79,-7,-49,45
1,1629,1670,-41,-6,-333,75
-1,1469,1504,-35,1,-169,76
1,1513,1465,48,4,72,47
-1,1732,1579,153,-2,-13,104
-1,1506,1535,-29,-3,-223,66
1,1649,1556,93,2,244,93
-1,1540,1636,-96,0,52,110
0,1707,1597,110,-1,-40,81
1,1387,1579,-192,2,148,91
1,1229,1222,7,8,258,55
-1,2101,1952,149,-3,-42,48
1,1594,1714,-120,0,70,47
-1,1500,2066,-566,0,-64,94
-1,1881,1961,-80,1,32,66
-1,1614,2023,-409,0,-18,76
1,1405,1646,-241,0,-1,87
-1,1657,1547,110,-2,-7,94
1,1698,1609,89,3,440,117
-1,1673,1626,47,2,24,74
1,1701,1626,75,-1,-26,49
-1,1446,1269,177,0,-33,102
-1,1396,1612,-216,-4,-272,72
1,1970,1872,98,0,81,63
1,2012,1478,534,4,132,55
1,2070,1783,287,0,25,55
-1,1660,1596,64,-7,-189,40
-1,1529,1553,-24,-6,-476,80
-1,1486,1522,-36,-1,35,70
-1,1292,1315,-23,-6,-208,65
1,1509,1759,-250,1,48,67
-1,1761,1667,94,0,6,46
0,1628,1500,128,5,131,53
1,1707,1600,107,-3,31,67
1,1695,1575,120,0,-2,77
1,1306,1521,-215,-1,-64,101
0,1532,1524,8,1,61,109
-1,1626,1500,126,-5,-90,46
1,1721,1476,245,-3,-60,51
-1,1629,1958,-329,-1,-198,84
1,1687,1500,187,-1,26,41
1,1365,1169,196,7,398,83
1,1514,1459,55,-2,-3,87
1,1894,1860,34,-3,-109,69
1,1703,1660,43,0,100,55
-1,1593,1716,-123,-2,-124,86
1,1785,1790,-5,2,37,47
1,1680,1747,-67,0,87,82
1,1559,1562,-3,7,429,85
1,1470,1276,194,1,51,85
1,1779,1796,-17,-3,385,75
-1,1864,1978,-114,-14,-346,64
1,1450,1524,-74,2,2,43
1,1523,1287,236,0,-52,53
1,1586,1665,-79,0,35,85
1,1643,1562,81,-3,-126,95
1,1624,1425,199,-1,296,143
1,1617,1391,226,2,60,43
1,1671,1516,155,-1,-49,63
-1,1652,1856,-204,-1,-693,118
-1,1843,2072,-229,-6,-28,84
1,1583,1563,20,-5,-115,49
1,1718,1630,88,1,445,149
1,1795,1530,265,0,29,107
1,1864,1654,210,1,323,105
1,1724,1585,139,-2,15,61
1,2013,1907,106,1,10,45
1,1714,1649,65,0,48,59
1,2018,1937,81,0,4,75
1,2006,1917,89,-1,-14,49
1,1733,1330,403,3,42,47
-1,1784,1790,-6,0,-149,92
1,1724,1862,-138,-3,-50,80
-1,1500,1500,0,-6,-227,62
-1,1639,1662,-23,0,104,94
1,1617,1749,-132,-2,25,103
1,1571,1385,186,0,172,63
-1,1523,1566,-43,0,-710,120
-1,1622,1778,-156,-3,-143,104
-1,1905,2014,-109,-1,-30,46
-1,1509,1695,-186,1,-60,94
-1,1540,1514,26,-7,-427,78
-1,1578,1731,-153,-3,-199,82
-1,1838,1894,-56,0,-62,76
0,1646,1686,-40,0,-31,105
-1,1531,1529,2,-1,-149,110
-1,1729,1458,271,-3,-74,60
-1,1815,2022,-207,-1,-202,104
0,1507,1839,-332,-3,-15,131
1,1533,1524,9,0,-9,63
-1,1986,1850,136,1,6,50
1,1907,1828,79,1,25,141
1,1570,1742,-172,0,240,95
-1,1419,1631,-212,-7,-256,62
-1,2082,1837,245,3,75,58
-1,1929,1872,57,-1,-61,116
1,1846,1739,107,1,75,75
1,1800,1630,170,0,70,75
-1,1364,1490,-126,-9,-455,56
1,1919,2028,-109,0,-45,53
1,1745,1854,-109,0,-60,99
1,1735,1510,225,-3,119,85
1,1773,1540,233,3,222,67
-1,1531,1576,-45,-1,-265,90
1,1628,1551,77,-1,-9,53
1,1648,1565,83,-3,-77,98
-1,1891,1917,-26,0,-75,82
-1,1727,1885,-158,-3,-35,108
1,1265,1625,-360,-2,-9,96
-1,1726,1649,77,0,-6,42
-1,1527,1397,130,-4,-411,90
1,1738,1571,167,0,23,67
-1,1637,1499,138,-4,-2,41
1,1971,1662,309,-2,-52,43
-1,1356,1362,-6,-3,-129,54
1,1731,1691,40,0,-6,89
-1,1839,1760,79,0,-8,64
-1,1269,1344,-75,0,-53,64
-1,1503,1562,-59,3,-171,104
-1,1616,1806,-190,-4,-172,76
1,1652,1455,197,4,86,52
-1,1974,2080,-106,0,-36,84
-1,1500,1693,-193,-1,-115,72
1,1676,1505,171,2,54,59
1,1801,1774,27,-1,67,63
1,1564,1834,-270,-4,-110,61
-1,1740,1439,301,-2,-80,64
1,1656,1663,-7,0,81,75
-1,1518,1810,-292,-1,-29,80
1,1700,1397,303,3,84,61
-1,1926,1879,47,0,-114,92
0,1775,1826,-51,0,-21,115
-1,1544,1298,246,-1,-28,68
-1,1194,1229,-35,-7,-267,46
-1,1942,2055,-113,-1,-82,66
1,1357,1428,-71,2,535,129
-1,1519,1619,-100,-1,13,64
1,1781,1537,244,4,320,89
-1,1586,1243,343,-3,-5,56
1,1706,1499,207,2,125,69
1,1893,1915,-22,0,170,77
-1,1512,1540,-28,1,36,46
-1,1002,1412,-410,-2,61,64
-1,1527,1689,-162,0,-536,102
1,1637,1649,-12,0,175,103
-1,1259,1452,-193,-11,-1032,100
-1,1402,1456,-54,-1,-88,88
1,1371,1159,212,6,115,48
-1,1593,1832,-239,-6,-407,74
-1,1522,1658,-136,0,-291,106
-1,1629,1871,-242,0,-90,82
-1,1667,1811,-144,-2,-67,54
1,1665,1657,8,-3,-324,169
-1,1786,2085,-299,0,-343,112
1,1817,1607,210,3,131,127
-1,2013,1809,204,-3,-175,74
-1,1776,1642,134,0,-175,118
1,2062,1935,127,0,20,49
1,1430,1342,88,5,47,45
1,1604,1791,-187,0,60,81
-1,1660,1818,-158,-8,-813,126
1,2089,1980,109,1,6,41
-1,1251,1437,-186,-3,-32,44
1,1820,1433,387,3,74,67
1,1713,1487,226,-9,29,65
-1,1966,1776,190,0,34,62
0,1500,1797,-297,0,-160,200
1,2089,1651,438,1,255,157
0,1416,1284,132,2,411,107
-1,1450,1556,-106,1,52,68
1,1239,1183,56,6,56,45
-1,1406,1569,-163,-7,-327,56
0,1498,1350,148,1,74,111
0,1761,1928,-167,0,-257,149
-1,1714,1514,200,2,116,90
0,1780,1913,-133,4,272,165
1,1564,1439,125,5,389,77
-1,1482,1718,-236,0,-101,60
1,1354,1493,-139,0,-29,61
1,1500,1657,-157,-1,49,70
-1,1413,1727,-314,-5,-287,72
-1,1654,1876,-222,0,-215,114
-1,2042,1834,208,-1,-110,112
-1,1904,1923,-19,1,36,74
1,1345,1435,-90,7,245,63
-1,1581,1574,7,0,-247,84
1,1657,1054,603,5,100,55
-1,1332,1572,-240,1,-27,65
-1,1823,1647,176,0,-2,68
1,1430,1413,17,5,108,53
1,1766,1824,-58,0,8,65
1,1771,1448,323,2,41,49
-1,1644,1607,37,-1,33,80
-1,1812,1779,33,-1,-32,64
1,1530,1720,-190,1,38,65
-1,1427,1413,14,4,-2,60
-1,1996,1988,8,-1,-70,62
-1,1512,1550,-38,0,16,64
-1,1649,1766,-117,0,-46,56
1,1608,1519,89,-1,-26,95
-1,1764,1650,114,-2,-419,122
-1,1267,1362,-95,-1,-153,104
-1,1406,1409,-3,-6,-296,78
-1,1547,1612,-65,1,-151,82
1,1813,1412,401,-2,14,71
-1,1494,1459,35,0,2,50
1,1392,1477,-85,0,-37,65
-1,1649,1547,102,0,-268,72
1,1557,1481,76,-8,112,87
-1,1359,1572,-213,-1,-304,100
-1,1585,1570,15,-2,-83,54
-1,1910,1726,184,1,59,64
1,1800,1689,111,1,17,59
0,1429,1571,-142,-1,170,113
-1,1534,1844,-310,1,-87,82
-1,1519,1439,80,0,-43,88
-1,1685,1484,201,-8,3,44
1,1877,1791,86,0,32,95
1,1476,1371,105,3,473,165
-1,1973,1973,0,0,-14,80
1,1576,1326,250,7,98,45
1,1495,1572,-77,1,681,131
-1,1892,1933,-41,-2,19,62
-1,1581,1574,7,-6,-329,80
1,1515,1323,192,0,-30,41
-1,1642,1493,149,2,84,62
-1,1681,1807,-126,1,-49,78
-1,1430,1408,22,3,16,83
1,1792,1792,0,-1,-12,115
1,1820,1985,-165,-7,-26,47
1,1525,1366,159,1,50,54
1,1949,1795,154,0,163,83
-1,1354,1478,-124,-1,-619,106
-1,1481,1474,7,0,25,54
-1,1584,1758,-174,-3,-264,82
-1,1723,1464,259,0,21,86
-1,1836,2077,-241,-7,-374,66
1,1909,1784,125,3,79,45
-1,1661,1549,112,-3,-127,70
-1,1783,1886,-103,2,37,52
-1,1585,1570,15,0,51,78
1,1392,1268,124,5,124,59
1,1407,1350,57,-3,-53,45
-1,1501,1668,-167,-5,-700,106
-1,1325,1351,-26,-5,-19,42
-1,1858,1795,63,0,-167,72
-1,1253,1304,-51,-1,-253,62
-1,2082,1831,251,3,13,110
1,1520,1393,127,-1,206,109
-1,1780,1803,-23,-2,-143,52
-1,1561,1449,112,-2,24,84
1,1509,1624,-115,2,26,45
0,2006,1668,338,-2,-23,154
1,1410,1500,-90,4,112,45
-1,1312,1742,-430,-2,-79,51
-1,1849,2062,-213,-9,-586,84
1,1844,1703,141,1,113,81
1,1657,1413,244,-1,31,43
-1,1839,1764,75,1,-255,160
1,1813,1770,43,2,208,69
-1,1275,1423,-148,-11,-436,56
1,1665,1743,-78,4,79,57
1,1895,1775,120,1,11,105
1,1607,1524,83,-2,80,153
1,1728,1843,-115,2,212,83
1,1682,1416,266,-3,-97,65
-1,1728,1679,49,-4,-518,92
1,1815,1674,141,1,-7,107
1,1581,1574,7,0,47,113
1,1788,1618,170,5,167,67
0,1482,1704,-222,0,0,95
1,2068,1844,224,2,112,53
1,1635,1809,-174,0,5,43
0,1564,1782,-218,0,163,147
1,1692,1715,-23,-3,-41,67
-1,1532,2073,-541,-4,-162,76
-1,1541,1808,-267,0,8,56
-1,1315,1235,80,-9,-218,52
1,1500,1832,-332,-1,-13,47
-1,1808,1706,102,0,-72,101
1,1906,1962,-56,2,103,81
1,1688,1262,426,13,348,57
-1,1594,1544,50,1,108,70
-1,1412,1687,-275,-16,-264,48
-1,1161,2075,-914,-2,-2,40
1,1823,1760,63,0,215,137
-1,1422,1445,-23,-9,-136,52
-1,1641,1822,-181,0,-292,118
-1,1701,2102,-401,-9,8,72
1,1775,1720,55,-3,-12,71
1,1400,1487,-87,7,312,65
-1,1509,2075,-566,0,6,42
-1,1414,1531,-117,-3,-205,104
1,2074,2107,-33,8,568,99
-1,1415,1601,-186,-3,-169,62
-1,1498,1696,-198,-5,-268,80
-1,1581,1696,-115,0,-106,76
1,1723,1646,77,1,88,65
0,1697,1821,-124,0,-227,155
-1,1563,1592,-29,0,64,80
1,1949,1767,182,-1,202,79
-1,1347,1713,-366,-9,-453,69
-1,1702,2092,-390,-4,-121,60
-1,1750,1734,16,0,-77,100
-1,1362,1485,-123,2,6,60
1,2088,2095,-7,1,238,129
0,1651,1913,-262,0,-624,159
1,1851,1916,-65,4,138,61
1,1943,2043,-100,-1,-15,64
-1,1720,1794,-74,-6,-211,126
1,1701,1244,457,5,173,46
1,1654,1783,-129,-1,14,79
1,1675,1720,-45,-3,295,145
-1,1617,1607,10,-3,20,70
1,1704,1554,150,0,6,45
1,2081,1703,378,-2,406,97
1,1744,1739,5,-1,28,71
-1,1547,1711,-164,-2,-50,142
-1,1668,1701,-33,0,-435,138
1,1903,1761,142,0,6,55
-1,1601,1553,48,0,-241,90
1,2131,1955,176,0,96,103
1,1340,1654,-314,9,289,69
1,1728,1755,-27,0,-363,105
1,1590,1610,-20,3,234,97
1,1539,1534,5,-2,-1,43
1,1798,1820,-22,1,517,118
-1,1337,1314,23,-3,-58,62
-1,1575,1631,-56,-2,-55,48
1,1344,1392,-48,4,103,43
1,1635,1500,135,1,517,89
-1,1462,1579,-117,-1,-110,58
-1,1444,1426,18,0,29,68
1,1556,1142,414,0,236,57
0,1686,1731,-45,0,-41,124
-1,1228,1706,-478,-7,-18,48
-1,1744,1740,4,-1,-378,120
1,1618,1604,14,1,27,47
1,1374,1357,17,13,455,53
1,1658,1564,94,-3,-54,133
-1,1469,1386,83,4,-47,124
-1,1829,1988,-159,-1,-135,94
1,1708,1225,483,2,89,43
1,1519,1626,-107,-5,-84,57
1,1531,1413,118,11,138,47
1,1493,1354,139,1,108,59
-1,1500,1436,64,-6,-280,78
1,1571,1416,155,4,188,45
1,1566,1589,-23,1,369,145
1,2141,1818,323,3,60,53
-1,1903,1922,-19,1,-67,106
1,1641,1761,-120,-3,-149,145
1,1618,1527,91,-1,-4,51
-1,1682,1710,-28,2,-253,120
-1,1518,1725,-207,0,-91,92
1,1393,1427,-34,14,760,73
1,1497,1500,-3,7,165,55
1,1668,1284,384,3,88,61
1,1283,1438,-155,6,294,71
-1,1500,1454,46,-2,-485,98
1,1787,1605,182,0,26,55
1,1731,1672,59,0,212,123
1,1619,1430,189,-5,-240,49
1,1568,1594,-26,0,88,64
1,1671,1615,56,2,166,73
1,1814,1793,21,-3,130,141
-1,1432,1518,-86,-1,-30,51
-1,1518,1751,-233,0,-229,104
-1,1654,1615,39,-2,-104,64
-1,1748,1662,86,-6,-194,76
1,1627,1617,10,1,54,57
-1,1411,1279,132,-4,-60,83
1,1409,1366,43,1,11,47
-1,1911,1669,242,-4,-222,110
-1,1393,1676,-283,-4,-287,70
-1,1500,2103,-603,2,2,88
1,1890,1731,159,0,47,57
1,1640,1701,-61,6,183,62
1,2039,1671,368,1,84,71
-1,1181,1528,-347,-2,-81,53
1,1627,1641,-14,0,119,119
-1,2012,2104,-92,3,-11,50
1,1926,1683,243,-2,-80,61
1,1463,1301,162,11,369,55
-1,1759,1534,225,1,-12,78
-1,1723,1610,113,0,-4,68
0,1543,1816,-273,-1,-29,112
1,2114,2004,110,0,45,71
1,1396,1425,-29,6,238,61
1,1435,1483,-48,0,93,65
1,1593,1202,391,0,55,49
-1,1324,1527,-203,-5,-578,104
-1,1560,1780,-220,-3,-146,110
1,2130,1990,140,-1,63,49
-1,1959,1772,187,0,-19,84
1,1695,1667,28,-1,-50,59
-1,1687,1893,-206,0,-42,86
1,1683,1307,376,0,142,69
-1,1637,1680,-43,-7,-258,60
-1,1810,1331,479,-3,-37,40
-1,1606,1639,-33,-4,-280,70
-1,1724,1638,86,-2,41,96
1,1784,1603,181,1,90,59
-1,1688,1653,35,-5,-158,62
-1,1366,1205,161,-14,-142,42
-1,1469,1630,-161,-1,-36,50
1,1554,1647,-93,2,136,77
-1,1609,1770,-161,1,101,82
1,1630,1752,-122,0,-2,55
1,1142,1352,-210,5,34,45
1,1770,1629,141,7,243,69
-1,1598,1796,-198,0,167,76
-1,1533,1626,-93,0,31,130
1,1541,1398,143,2,595,139
-1,1583,1622,-39,-2,-176,102
-1,1280,1408,-128,2,219,86
-1,1505,1362,143,-1,-301,118
-1,1588,1556,32,-2,604,180
1,1575,1569,6,5,334,81
-1,1899,1681,218,0,-69,85
1,1615,1710,-95,0,41,87
1,1645,1636,9,1,24,57
1,2103,1862,241,0,-10,47
1,1807,1592,215,-6,-83,61
1,1645,1520,125,1,9,49
-1,1448,1550,-102,-2,-382,112
1,1595,1443,152,-3,417,135
1,1334,1638,-304,2,207,95
1,1638,1462,176,-2,92,55
-1,1857,2108,-251,1,25,112
-1,1559,1658,-99,-2,-29,84
-1,1480,1487,-7,1,147,58
-1,1668,1676,-8,0,6,50
-1,1344,1208,136,1,-10,42
1,1881,1777,104,0,-70,87
-1,1569,1629,-60,0,-38,100
1,1554,1696,-142,-1,5,49
1,1618,1532,86,0,435,105
1,1631,1632,-1,4,262,75
1,1567,1416,151,-1,-1,63
1,2111,1395,716,1,438,101
-1,1830,2112,-282,-2,-251,112
1,1621,1490,131,-2,-109,61
-1,1448,1608,-160,-4,-254,78
1,1985,1853,132,0,77,75
1,1724,1657,67,0,101,92
1,2044,1643,401,0,36,71
-1,1456,1645,-189,-5,-129,48
1,1450,1516,-66,4,45,51
-1,1604,1627,-23,-1,-26,68
1,1852,1721,131,2,108,75
1,1628,1394,234,-1,22,77
1,1329,1224,105,10,769,75
1,1787,1793,-6,1,59,53
1,1769,1889,-120,0,-49,79
-1,1706,2112,-406,-1,-44,58
-1,1640,2046,-406,-9,-19,40
1,1682,1512,170,3,158,67
-1,1493,1500,-7,1,49,60
-1,1846,1992,-146,-4,-158,66
1,2116,1826,290,2,48,45
1,1558,1431,127,10,446,59
-1,1747,1552,195,-3,-27,42
-1,1628,1751,-123,0,-307,129
-1,1617,1355,262,-3,-88,54
-1,1598,1602,-4,1,68,60
-1,1490,1421,69,-7,-142,70
1,2114,1818,296,0,2,47
-1,1633,1703,-70,-5,-289,62
1,1638,1500,138,1,108,91
-1,1595,1824,-229,0,-252,104
1,1400,1498,-98,-1,-154,87
1,1874,1783,91,-5,351,135
-1,1191,1121,70,0,-576,180
1,1215,1337,-122,5,576,89
1,1607,1563,44,0,40,93
1,1713,1624,89,8,679,93
1,1567,1601,-34,-1,46,73
-1,1349,1580,-231,0,6,112
1,1391,1400,-9,4,75,47
1,1651,1737,-86,0,-1,43
1,1688,1463,225,14,80,41
1,1572,1403,169,-5,114,57
-1,1657,2103,-446,-4,-182,94
1,1560,1506,54,0,73,93
-1,1138,1500,-362,-5,-88,42
-1,1723,1769,-46,0,-115,106
1,1931,1777,154,2,56,57
1,2064,2073,-9,0,399,99
1,1666,1576,90,0,-3,89
1,1628,1559,69,2,92,61
1,2049,2118,-69,-1,49,65
0,1637,1570,67,-1,187,126
1,1374,1597,-223,0,19,55
1,1716,1759,-43,1,82,85
-1,1471,1593,-122,4,94,54
1,1693,1634,59,-5,105,65
-1,1321,1231,90,-5,-166,56
1,1302,1399,-97,2,95,46
1,1500,1500,0,0,-75,103
-1,1419,1567,-148,2,49,52
1,1648,1734,-86,1,165,97
1,2106,1636,470,4,38,43
0,1392,1578,-186,4,251,113
-1,1714,1859,-145,-3,-132,86
-1,1385,1574,-189,-2,-84,52
-1,1335,1570,-235,-4,-153,50
1,2108,1771,337,0,26,53
1,1698,1652,46,-2,-19,51
1,1742,1647,95,-3,0,45
-1,1625,1703,-78,-1,-16,56
1,1478,1312,166,3,138,57
1,1782,1683,99,0,-21,91
1,1439,1519,-80,1,75,59
1,1687,1721,-34,0,19,59
-1,1413,1486,-73,5,66,46
1,1527,1548,-21,-5,-132,85
-1,1722,1639,83,0,-174,158
-1,1582,1776,-194,-6,-277,66
1,2077,2056,21,6,146,55
-1,1569,1679,-110,-6,-55,42
-1,1306,1895,-589,-2,-320,72
1,1380,1304,76,2,276,85
-1,1573,1412,161,-6,-634,98
1,1764,1601,163,0,145,101
-1,1621,1674,-53,3,62,56
1,1575,1330,245,0,14,59
1,2041,2088,-47,0,43,97
1,1157,1179,-22,5,125,49
1,1415,1500,-85,7,103,49
-1,1450,1503,-53,1,-36,58
1,1392,1392,0,4,121,67
-1,1406,1522,-116,-2,-253,72
-1,1882,1395,487,-3,-76,64
-1,1837,2075,-238,-2,-230,64
-1,1388,1477,-89,-1,-143,84
-1,1402,1271,131,1,27,88
1,1959,1708,251,3,60,47
1,1616,1559,57,-2,-81,45
1,2080,1832,248,-6,-65,49
-1,1165,0,1165,7,-238,90
-1,1500,1653,-153,-10,-231,48
-1,1821,1640,181,0,0,56
0,1398,1406,-8,4,328,91
-1,1389,1321,68,0,-20,54
-1,1616,1793,-177,-2,-271,94
-1,1827,2085,-258,2,38,56
-1,1325,1579,-254,0,-14,46
1,1719,1662,57,4,292,69
1,1644,1619,25,-1,18,47
-1,1513,1553,-40,-6,-298,84
-1,1496,1416,80,-8,-1269,104
1,1576,1560,16,-1,7,47
-1,1608,1655,-47,1,-16,66
-1,1406,1398,8,-4,-443,70
1,1364,1468,-104,0,193,93
1,1406,1440,-34,1,62,64
1,1336,1375,-39,3,24,41
-1,1428,1558,-130,0,49,82
1,1500,1327,173,5,801,119
1,1245,1320,-75,8,433,77
1,1560,1683,-123,0,5,69
-1,1673,1703,-30,5,178,60
-1,1362,1350,12,0,-65,72
-1,1411,1391,20,-1,-573,124
0,1561,1604,-43,-14,-1174,85
1,1652,1629,23,-1,-55,111
-1,1244,1277,-33,-8,-143,48
-1,1656,1594,62,0,-137,150
1,1575,1248,327,6,219,61
1,1618,1418,200,1,51,57
-1,1430,1584,-154,-5,-477,84
-1,2089,2059,30,-4,-56,130
0,1359,1346,13,2,108,117
1,1550,1605,-55,-4,-88,47
0,2126,2112,14,0,20,87
1,1601,1573,28,-2,19,85
1,1451,1379,72,-1,-11,41
-1,1652,1976,-324,-3,-101,64
-1,1703,1902,-199,-4,-252,92
1,1538,1418,120,1,11,43
1,1921,1634,287,6,85,43
1,1406,1398,8,-4,511,163
1,1483,1301,182,1,91,55
1,1603,1235,368,-1,28,55
1,2076,2076,0,-3,25,95
-1,1630,1925,-295,1,-55,78
1,1713,1640,73,-2,58,91
1,1258,1277,-19,-1,128,89
-1,1232,1606,-374,0,40,52
1,1591,1423,168,-1,585,81
1,1362,1432,-70,3,52,43
0,1392,1578,-186,0,-408,128
1,1386,1420,-34,19,502,59
1,1549,1500,49,2,163,71
-1,1907,1698,209,1,-76,102
1,1967,1775,192,-1,-3,49
1,1606,1462,144,4,90,51
1,1608,1229,379,2,-5,59
-1,1489,1589,-100,-2,-28,40
-1,1652,1729,-77,-5,-633,144
1,1590,1398,192,0,67,95
-1,1405,1399,6,-5,78,42
-1,1551,1455,96,3,48,46
1,1770,1623,147,5,128,45
1,1500,1801,-301,-5,-65,53
1,1411,1391,20,3,142,69
-1,1737,1417,320,-6,-220,64
1,1582,1739,-157,1,23,57
-1,1519,1555,-36,-2,-32,52
-1,1415,1597,-182,-5,-197,65
-1,1448,1613,-165,1,20,114
1,1602,1502,100,0,53,59
-1,1627,1515,112,0,-38,72
1,1537,1337,200,4,78,47
-1,1589,1417,172,-11,-146,46
-1,1331,1349,-18,-11,-499,70
-1,1785,1746,39,-1,-81,90
1,1563,1648,-85,1,341,167
-1,1542,1481,61,0,14,54
1,1603,1686,-83,0,-34,53
-1,1335,1377,-42,-1,13,50
-1,1918,1890,28,0,1,82
-1,1295,1504,-209,-11,-177,52
1,1378,1560,-182,1,49,111
-1,1436,1717,-281,-3,-213,67
-1,1168,1584,-416,-1,11,42
-1,1556,1682,-126,-5,-127,42
-1,1663,1644,19,1,127,92
1,1562,1379,183,3,-80,71
1,1847,1758,89,0,53,65
-1,1648,1872,-224,0,9,40
1,1586,1166,420,13,242,53
-1,1734,1744,-10,-3,-89,50
1,1484,1502,-18,-5,-188,77
-1,1579,1510,69,-1,-19,58
1,1529,1645,-116,0,158,95
-1,1500,1347,153,-7,-354,69
0,1778,1500,278,0,-3,110
-1,1643,1739,-96,-1,-165,120
1,1855,1750,105,5,62,41
1,1717,1585,132,-1,-15,40
-1,1549,1408,141,-12,-271,41
1,1877,1642,235,-1,46,69
-1,1610,1494,116,1,38,42
-1,1409,1549,-140,1,10,48
-1,1289,1660,-371,-8,-152,48
-1,1742,1769,-27,1,107,74
1,1887,1784,103,2,138,65
1,1621,1269,352,12,545,59
1,1627,1301,326,2,112,71
1,1557,1724,-167,1,62,71
-1,1333,1402,-69,2,51,56
1,1633,1534,99,5,279,69
-1,1370,1224,146,-5,-118,50
-1,1998,1823,175,-7,-166,74
-1,1596,1742,-146,-4,-34,43
-1,1863,1757,106,0,-57,110
1,1782,1732,50,4,446,95
-1,1618,1610,8,0,-16,83
-1,1563,1485,78,-7,-544,82
1,1543,1582,-39,0,89,79
1,1616,1606,10,-3,369,105
1,2061,1829,232,1,71,133
-1,1557,1386,171,4,38,48
-1,1636,1881,-245,1,-2,88
1,1483,1390,93,3,334,91
-1,1370,1566,-196,0,-48,60
-1,1402,1274,128,-2,-38,52
1,1770,1599,171,1,92,67
-1,1324,1597,-273,0,-14,48
-1,1297,1634,-337,-13,-371,54
-1,1620,1521,99,1,22,76
-1,1500,2112,-612,0,-98,76
1,1251,1634,-383,0,149,79
-1,1723,1794,-71,-2,-112,88
1,1605,1405,200,2,403,89
1,1824,2067,-243,1,443,115
1,1380,1505,-125,-2,-175,63
-1,1269,1500,-231,-1,-202,84
0,1587,1903,-316,-1,17,110
1,1640,1294,346,0,207,61
-1,1525,1626,-101,-1,-72,102
-1,1573,1717,-144,-3,-12,44
1,1786,1714,72,0,85,88
-1,1477,2114,-637,-2,-23,66
1,2043,1841,202,2,49,53
1,1556,1562,-6,1,15,43
-1,1900,1983,-83,-6,-83,60
-1,1397,1611,-214,0,-69,82
-1,1320,1485,-165,-2,-304,82
-1,1765,1942,-177,-1,15,42
0,1705,1796,-91,0,75,135
1,1567,1551,16,0,61,73
-1,1368,1611,-243,2,-44,102
-1,1455,1541,-86,-3,-143,62
-1,1291,1646,-355,-6,-610,88
1,1614,1293,321,-1,84,59
1,1364,1164,200,14,1074,85
-1,1692,1849,-157,3,200,102
-1,1619,1440,179,-3,-24,42
1,1635,1429,206,-2,-34,51
-1,1589,1330,259,4,121,66
-1,1608,1593,15,0,32,108
-1,1775,1891,-116,-1,-136,66
-1,1621,1751,-130,0,-313,96
-1,1887,1611,276,-3,-313,120
-1,1886,1631,255,-4,-33,96
1,1729,1671,58,2,291,145
-1,1595,1627,-32,2,64,46
1,1793,1703,90,0,-130,109
1,1567,1455,112,-4,180,85
1,1601,1805,-204,1,214,93
-1,1158,1370,-212,-1,-303,78
-1,1899,1768,131,0,-28,80
-1,1715,1900,-185,-3,-26,44
1,1531,1463,68,1,499,109
1,1616,1341,275,20,390,47
1,1708,1714,-6,1,269,81
1,1604,1301,303,-3,34,49
1,1781,1626,155,-1,-3,59
-1,1851,1948,-97,-4,-392,82
1,1645,1774,-129,1,25,77
1,1703,1719,-16,1,69,83
-1,1421,1301,120,4,290,94
1,1651,1622,29,1,21,45
-1,1619,1788,-169,1,-28,92
1,1897,1664,233,-2,73,69
-1,1545,1599,-54,-3,-22,92
-1,1662,1776,-114,-4,-87,92
-1,1570,1514,56,-1,-202,80
1,1754,1567,187,2,327,96
1,1619,1458,161,9,341,65
-1,1320,1620,-300,-9,-897,90
1,1725,1889,-164,-9,-6,71
1,1614,1526,88,-1,218,89
1,1466,1390,76,2,105,61
-1,1443,1576,-133,1,195,104
-1,1578,1448,130,-1,-14,54
-1,1708,1714,-6,0,-156,172
-1,1321,1296,25,-1,-39,58
-1,1834,1695,139,0,-173,120
1,1563,1566,-3,-4,-56,55
1,1776,1956,-180,1,-207,107
1,1609,1610,-1,-9,-104,73
0,1725,1661,64,-1,-119,80
0,1782,1884,-102,0,-619,120
-1,1405,1616,-211,-8,-115,50
-1,1758,1861,-103,-2,-289,98
-1,1595,1640,-45,0,-53,82
-1,1153,1375,-222,-20,-779,80
1,1608,1622,-14,1,451,71
1,1576,1116,460,9,144,43
-1,1436,1545,-109,1,-141,114
-1,1651,1902,-251,0,-33,80
1,1574,1645,-71,-2,464,127
-1,1555,1452,103,6,187,92
1,1724,1697,27,3,152,87
-1,1411,1624,-213,0,-64,56
-1,1620,1609,11,2,-91,72
1,1702,1503,199,0,19,63
1,1721,1612,109,-2,-137,65
1,1912,1669,243,-3,-85,49
-1,1528,1598,-70,1,39,80
-1,1556,1688,-132,-1,-195,82
0,1540,1557,-17,2,-26,152
-1,1686,1666,20,0,-499,108
1,1475,1500,-25,3,125,59
1,1622,1609,13,0,-168,127
1,1533,1503,30,2,68,55
-1,1687,1734,-47,-1,-155,80
-1,1691,1553,138,-9,-19,44
1,1612,1496,116,0,404,99
1,1406,1441,-35,8,143,47
1,1750,1865,-115,1,111,53
1,1732,1699,33,1,32,50
-1,1630,1461,169,0,-17,48
-1,1784,1788,-4,-1,-146,78
1,1598,1633,-35,1,648,85
1,1315,1356,-41,-3,-239,63
-1,1587,1723,-136,0,-43,54
1,1743,1678,65,0,134,81
1,1518,1427,91,-1,-18,53
-1,1881,1869,12,0,102,132
-1,1711,1706,5,-2,-111,68
-1,1287,1553,-266,-3,-487,84
1,1613,1428,185,-4,-47,61
1,1519,1500,19,12,268,51
1,1780,1551,229,-1,-71,89
1,1674,1689,-15,-3,-112,61
-1,1466,1542,-76,0,-37,102
-1,1418,1610,-192,-7,-879,104
0,1575,1471,104,0,-514,96
1,1524,1500,24,0,65,87
1,1670,1752,-82,-2,-13,55
-1,1255,1598,-343,-4,-127,52
1,1385,1456,-71,2,32,49
1,1742,1771,-29,1,25,57
0,1692,1578,114,0,-55,90
-1,1699,1549,150,-3,-76,52
-1,1557,1278,279,-1,-194,112
1,1875,1676,199,-2,82,109
1,1580,1519,61,0,34,59
1,1581,1640,-59,-1,-7,59
-1,1388,1603,-215,-1,-65,62
1,1500,1616,-116,3,200,53
1,1739,1683,56,3,189,81
-1,1631,1650,-19,-3,-93,56
1,1760,1756,4,0,80,118
-1,1483,1404,79,-2,-15,50
-1,1646,1758,-112,-9,-189,64
-1,1606,1849,-243,0,-133,90
-1,1622,1648,-26,-3,-553,122
-1,1415,1606,-191,0,26,64
1,1589,1489,100,0,-4,55
1,1526,1601,-75,8,144,41
-1,1482,1585,-103,2,51,100
-1,1558,1685,-127,2,-27,68
1,1674,1748,-74,-5,574,179
-1,1174,1500,-326,-8,-289,58
-1,1609,2050,-441,0,0,72
-1,1688,1500,188,0,61,98
1,1526,1561,-35,-2,113,55
1,1594,1612,-18,6,969,157
1,1314,1539,-225,-1,-59,79
1,1599,1353,246,-1,64,51
1,1565,1170,395,2,55,49
1,1787,1849,-62,0,-205,95
-1,1650,1762,-112,-2,1,50
1,1838,1915,-77,1,27,45
1,2053,1607,446,2,250,81
-1,1540,1586,-46,-3,-123,62
1,1563,1531,32,-2,-78,53
-1,1688,1602,86,8,-375,136
1,1854,1599,255,1,161,73
-1,1693,1551,142,0,-26,106
-1,1148,1202,-54,-3,-755,182
-1,1312,1623,-311,0,-179,88
1,1785,1550,235,1,20,48
1,1328,1339,-11,5,333,77
-1,1605,2055,-450,0,-23,104
1,1619,1625,-6,2,399,107
-1,1677,1744,-67,0,-84,90
1,1572,1347,225,0,10,49
1,1671,1645,26,1,14,51
1,1791,1855,-64,-1,-33,77
1,1250,1258,-8,-6,-135,65
1,2088,1751,337,4,336,87
1,1735,1686,49,6,218,55
-1,1180,1556,-376,-7,-92,76
1,1993,2114,-121,0,179,97
1,1597,1509,88,1,297,109
1,1753,1669,84,0,-9,69
-1,1167,1564,-397,-14,-364,52
-1,1606,1610,-4,-1,51,72
1,1661,1761,-100,0,28,75
-1,1736,1664,72,0,-9,76
-1,1338,1577,-239,3,65,60
1,1904,1642,262,1,811,111
1,2097,2027,70,-1,-22,51
-1,1547,1451,96,-22,-249,40
1,2101,1939,162,0,-25,41
-1,1560,1530,30,0,-7,86
1,1579,1593,-14,2,194,80
-1,1597,2085,-488,-6,-79,42
1,1526,1565,-39,3,88,67
1,1289,1356,-67,-4,-335,89
-1,1728,1787,-59,-4,-19,42
-1,1554,1429,125,0,1,52
1,1814,1768,46,-2,138,113
1,1374,1419,-45,-2,543,113
1,1575,1692,-117,-3,-91,45
1,1940,1651,289,2,22,41
1,1452,1613,-161,0,-34,61
-1,1971,2074,-103,-1,-4,54
-1,1837,1764,73,-2,-83,55
-1,1347,1544,-197,-8,-501,82
-1,1958,1893,65,0,-10,124
-1,1495,1636,-141,4,73,56
1,1578,1542,36,0,70,63
-1,1254,1274,-20,-2,-32,62
1,1720,1537,183,-2,-77,75
1,1784,1497,287,4,85,57
1,1386,1448,-62,2,304,77
-1,1563,1546,17,-1,-246,68
1,1963,2056,-93,2,157,61
1,1759,1824,-65,0,24,129
1,1676,1532,144,0,268,77
1,1642,1555,87,-3,-31,41
-1,1477,1447,30,-2,-10,42
-1,1736,1597,139,-1,-42,66
1,1944,1837,107,2,-11,49
-1,1469,1800,-331,1,17,50
-1,1557,1552,5,0,-2,42
1,1906,2020,-114,0,60,83
1,1458,1177,281,1,95,59
-1,1525,1684,-159,-4,-828,160
-1,1944,1824,120,-1,-52,68
1,1730,1500,230,2,91,57
-1,1278,1343,-65,-3,-34,48
-1,1478,1690,-212,-2,-51,54
-1,1547,1651,-104,-1,-131,90
1,1561,1657,-96,1,18,59
1,1730,1491,239,0,-14,51
1,1612,1698,-86,-3,3,45
1,1684,1430,254,0,-4,51
-1,1467,1618,-151,0,14,64
1,1602,1218,384,5,275,79
1,1977,1801,176,-2,-76,49
1,1666,1625,41,2,64,48
-1,1518,1536,-18,-7,-453,86
1,1552,1708,-156,4,209,49
1,1299,1284,15,-1,-1,51
1,1521,1296,225,1,101,77
1,1929,1578,351,2,18,85
-1,1408,1098,310,3,162,58
1,1463,1295,168,18,150,43
1,1687,1952,-265,1,69,51
1,1575,1309,266,-6,-8,75
1,1500,1164,336,-2,263,109
1,1311,1433,-122,-1,-22,47
-1,1194,1549,-355,-1,-405,74
-1,1794,1869,-75,0,-158,188
1,1585,1415,170,-1,-27,43
0,1819,1595,224,-2,105,117
-1,1173,1472,-299,-9,-398,72
-1,1933,1920,13,-3,6,90
-1,1399,1591,-192,5,134,52
1,1434,1549,-115,-1,6,63
-1,1411,1698,-287,-2,-23,44
-1,1606,1527,79,2,-100,157
1,1858,1523,335,0,103,79
1,1726,1690,36,0,208,95
1,1469,1333,136,1,277,77
1,1794,1460,334,0,79,73
1,1327,1261,66,-5,-82,47
-1,1778,2219,-441,0,10,64
1,1597,1385,212,-4,-12,43
-1,1520,1861,-341,-1,6,60
-1,1692,1570,122,-4,-84,70
1,1603,1536,67,4,118,41
-1,1533,1450,83,0,31,76
1,1668,1603,65,-1,-8,47
-1,1224,1444,-220,0,-42,66
1,1602,1350,252,2,-10,129
1,1703,1255,448,1,65,49
-1,956,1464,-508,1,61,42
-1,1246,1337,-91,-3,-98,48
1,1517,1613,-96,2,20,49
1,2222,1580,642,2,121,81
1,1598,1546,52,13,587,59
1,1695,1579,116,-6,-221,62
-1,1864,1872,-8,-3,-104,66
-1,1532,1516,16,6,437,86
1,1746,1600,146,-1,-35,61
-1,1464,1519,-55,1,-16,64
1,2223,1793,430,0,8,53
1,1580,1507,73,2,25,47
-1,1542,1680,-138,-2,-73,46
1,1678,1666,12,4,86,51
1,1568,1677,-109,-2,84,75
1,1840,1897,-57,-2,149,69
1,1931,1949,-18,-2,30,111
-1,1608,2225,-617,-5,-83,54
1,1304,1245,59,0,3,51
1,1554,1191,363,2,128,61
1,1882,1855,27,-1,-38,81
1,1616,1282,334,-3,-232,121
-1,1494,1380,114,-3,-60,82
-1,1529,1500,29,-7,-749,100
1,1843,1894,-51,1,99,71
1,1499,1537,-38,3,735,135
-1,2228,1791,437,-5,-9,44
-1,1529,1454,75,1,48,68
-1,1760,1687,73,0,-105,110
1,1534,1208,326,-1,17,59
1,1690,1520,170,0,252,95
-1,1589,1642,-53,-1,-40,96
-1,1593,1589,4,0,8,42
-1,1527,1880,-353,-5,-79,48
1,1394,1480,-86,5,345,101
-1,1390,1427,-37,0,-8,52
1,1883,1522,361,0,-20,51
-1,1518,1886,-368,1,10,46
1,2196,1532,664,-1,-14,43
1,1459,1488,-29,0,-3,49
1,1785,1829,-44,2,103,130
1,1503,1500,3,4,210,57
-1,1655,1688,-33,-1,-98,104
1,1889,1513,376,2,340,79
1,1468,1515,-47,9,564,61
0,1498,1514,-16,-1,-294,131
-1,1336,1734,-398,0,11,56
1,1480,1520,-40,-3,74,117
1,1485,1279,206,-1,3,47
-1,1815,2197,-382,-1,-14,44
-1,1892,1760,132,3,-228,112
-1,1279,1621,-342,-4,-141,54
-1,1749,1920,-171,5,-218,72
-1,1663,1647,16,-1,164,110
1,1932,1735,197,3,32,42
-1,1502,1482,20,-7,-282,82
1,1491,1440,51,-9,-246,75
1,1380,1326,54,6,519,79
1,1673,1529,144,0,28,71
1,2201,1812,389,0,-21,75
-1,1218,1516,-298,3,138,82
-1,1384,1222,162,-4,-9,72
-1,1449,1407,42,3,37,40
-1,1416,1567,-151,-5,-534,80
-1,1691,1582,109,-2,-91,62
1,1535,1557,-22,0,-21,55
1,1500,1353,147,12,345,57
0,1606,1445,161,-1,564,250
-1,1877,1890,-13,0,-368,102
-1,1498,1514,-16,-4,-959,126
-1,1811,1865,-54,-3,-43,48
0,1627,1750,-123,2,92,90
-1,1500,1661,-161,-9,-27,88
-1,1476,1124,352,-1,2,76
-1,1725,1937,-212,-5,-60,62
-1,1579,1737,-158,0,-72,78
1,1525,1488,37,5,549,129
-1,1963,1866,97,-2,-320,78
1,1494,1490,4,2,71,77
1,1347,1419,-72,0,-3,57
1,1546,1420,126,0,230,77
1,1542,1295,247,3,161,61
-1,1525,1473,52,1,-186,88
1,1880,1883,-3,0,152,59
-1,1389,1367,22,-10,-63,86
-1,1450,1643,-193,-1,-15,44
-1,1756,1810,-54,-3,-117,62
1,1580,1478,102,7,703,89
1,1828,1892,-64,-7,-357,83
-1,1344,1498,-154,0,349,136
1,1615,1554,61,-1,-217,75
1,1821,1746,75,-3,173,57
1,1520,1214,306,-5,31,63
1,1747,1633,114,0,82,103
1,1479,1505,-26,-1,0,61
-1,1619,1783,-164,0,-57,80
1,1737,1831,-94,1,16,41
-1,1575,1619,-44,0,-39,62
-1,1380,1404,-24,-6,-180,50
-1,1606,1632,-26,-1,-82,64
1,1413,1525,-112,6,616,69
0,1668,1652,16,4,554,218
1,1801,1582,219,9,576,79
1,1563,1596,-33,0,145,167
1,1562,1335,227,3,128,69
-1,1644,1595,49,1,66,68
-1,1494,2082,-588,-1,-69,88
1,1631,1565,66,13,376,55
1,1710,1482,228,0,107,127
1,1679,1884,-205,1,38,65
1,1626,1191,435,2,220,67
0,1570,1471,99,0,363,128
1,1682,1488,194,9,170,47
-1,1609,1630,-21,-2,-112,74
1,1751,2083,-332,0,139,53
1,1620,1754,-134,3,335,145
1,1493,1491,2,8,317,73
1,1671,1625,46,-1,16,59
1,1419,1189,230,4,585,67
1,1408,1432,-24,4,214,67
-1,1818,1695,123,-2,-150,58
-1,1361,1371,-10,-1,102,86
1,1806,1577,229,4,290,65
-1,1527,1609,-82,-1,-96,74
-1,1642,1598,44,1,120,110
1,1686,1476,210,0,65,59
1,1771,1709,62,2,221,105
1,1602,1424,178,1,247,107
1,1625,1570,55,2,52,77
-1,1659,1738,-79,-1,-284,77
1,1480,1504,-24,-4,466,127
-1,1611,1700,-89,-2,-119,90
-1,1758,1444,314,1,106,92
-1,1331,1798,-467,2,-257,130
1,1551,1670,-119,-1,263,109
1,1943,1931,12,0,67,61
1,1523,1316,207,3,72,43
-1,1424,1243,181,-1,-35,52
-1,1615,1681,-66,-15,-440,50
1,1691,1575,116,0,-2,49
1,1812,1504,308,-3,22,57
-1,1731,1548,183,5,378,80
1,2027,1660,367,0,9,57
-1,1598,1581,17,-1,-114,56
1,1541,1708,-167,2,82,69
1,1505,1583,-78,0,164,99
-1,1821,2082,-261,-1,34,80
0,1699,1701,-2,0,107,127
1,1328,1511,-183,7,143,53
-1,1933,1747,186,-5,-57,86
-1,1560,1636,-76,2,-353,122
1,1500,1525,-25,5,347,85
1,1346,1502,-156,4,80,73
-1,1407,1733,-326,-2,2,40
-1,1602,1692,-90,-1,-194,74
1,1450,1261,189,-1,41,149
-1,1460,1492,-32,-3,-97,66
1,1491,1815,-324,0,57,129
1,1346,1347,-1,3,87,67
1,1538,1425,113,-4,-176,93
0,1346,1511,-165,-4,-725,100
1,1548,1536,12,-6,-64,47
-1,1701,1699,2,0,140,140
1,1548,1644,-96,1,-30,55
1,1494,1334,160,0,38,79
-1,1942,2055,-113,-1,-28,52
0,1628,1701,-73,0,209,166
1,1593,1369,224,2,13,61
1,1817,1657,160,0,-16,67
-1,1434,1357,77,2,-214,110
-1,1345,1306,39,-3,-161,96
1,1668,1688,-20,0,19,103
-1,1564,1672,-108,-7,-240,60
1,1647,1469,178,3,66,49
-1,1444,1205,239,-3,-193,66
-1,1359,1598,-239,5,15,48
-1,1517,1627,-110,0,-257,130
1,2005,1921,84,3,56,49
1,1710,1690,20,0,-18,87
1,1698,1461,237,-1,-4,47
1,1510,1436,74,-1,-45,77
-1,1361,1653,-292,-3,-91,50
1,1351,1476,-125,0,-30,65
1,1404,1500,-96,-1,8,59
1,1563,1665,-102,0,135,105
1,1954,1680,274,0,1,55
-1,1212,0,1212,1,4,62
-1,1518,1857,-339,1,-13,88
-1,1913,1824,89,0,-88,100
-1,1765,1913,-148,1,39,66
1,1377,1169,208,3,474,81
1,1721,1783,-62,0,-217,135
1,1728,1466,262,0,88,77
-1,1679,1634,45,1,-98,84
-1,1529,1664,-135,0,-165,122
-1,1650,1580,70,1,-503,150
1,1722,1452,270,0,3,43
-1,1641,1658,-17,1,14,44
1,1511,1462,49,6,357,79
-1,1728,1501,227,3,-5,82
1,1572,1490,82,4,43,43
-1,1413,1524,-111,0,-120,98
-1,1470,1558,-88,-1,-166,92
-1,1547,1324,223,-1,-302,82
1,1696,1522,174,2,453,101
1,1506,1259,247,1,279,82
1,1659,1462,197,-1,-6,41
1,1727,1383,344,3,79,47
1,1734,1837,-103,0,17,75
1,1514,1357,157,-1,-26,63
1,1921,1758,163,0,18,111
1,1796,1563,233,-1,-24,47
1,1344,1369,-25,5,140,46
1,1393,1284,109,0,-5,41
-1,1562,1338,224,-3,-361,126
1,1500,1669,-169,1,-164,51
-1,1452,1520,-68,0,-1,44
1,1581,1456,125,0,153,81
0,1637,1482,155,1,-235,129
-1,1720,1647,73,-4,-119,84
-1,1703,1779,-76,4,45,64
0,1668,1660,8,-1,217,95
-1,1571,1648,-77,2,156,62
1,1823,1748,75,-1,267,99
1,1427,1529,-102,0,43,55
1,1296,1244,52,-10,-1424,135
1,1459,1629,-170,5,168,49
-1,1469,1566,-97,-2,-97,60
-1,1459,1457,2,-1,-117,81
-1,1962,1624,338,-4,-393,122
-1,1436,1443,-7,0,-16,56
-1,1500,1537,-37,0,11,44
1,1617,1703,-86,0,-1,45
-1,1125,1465,-340,4,-375,118
-1,1537,2087,-550,0,-9,74
-1,1657,1709,-52,-1,-32,50
0,1170,1350,-180,-2,-197,98
1,1739,1496,243,0,24,55
1,1658,1630,28,1,479,157
0,1294,1511,-217,-1,237,111
-1,1448,1736,-288,0,-2,54
1,1528,1401,127,1,-281,109
-1,1514,1500,14,-3,-45,46
-1,1623,1665,-42,0,7,46
-1,1405,1396,9,1,-37,78
-1,1425,1454,-29,1,11,62
1,1520,1443,77,3,27,59
1,1652,1500,152,2,168,79
1,1487,1638,-151,3,47,49
1,1284,1593,-309,1,460,91
-1,1328,1254,74,2,51,52
1,1532,1418,114,3,127,63
1,1697,1262,435,2,242,81
-1,1622,1574,48,-1,-345,100
1,1650,1458,192,0,167,129
1,1520,1584,-64,-1,-45,95
-1,1652,1502,150,-8,-194,54
-1,1688,1632,56,0,-94,92
1,1589,1357,232,-3,-10,123
-1,1408,1444,-36,-2,-235,88
-1,1531,1326,205,2,-112,88
1,1941,1739,202,-1,-62,77
1,1563,1464,99,4,137,51
-1,1520,1637,-117,-1,49,74
1,2205,1815,390,-1,-24,75
1,1526,1853,-327,-4,-242,95
-1,1536,1318,218,-12,-114,44
1,1538,1534,4,1,300,65
-1,1603,1658,-55,-1,-212,96
-1,1345,1176,169,-7,-59,64
-1,1519,1544,-25,-1,-50,54
-1,1317,1454,-137,0,31,42
-1,1812,2208,-396,-1,56,70
1,1407,1366,41,5,236,73
-1,1412,1736,-324,-1,-62,122
1,1655,1424,231,-3,25,61
-1,1463,1577,-114,-5,-94,68
1,2088,1831,257,0,129,89
1,1699,1448,251,0,-2,73
1,1434,1195,239,-3,-46,55
1,1469,1382,87,-1,187,52
-1,1594,1670,-76,-3,-234,80
1,1559,1660,-101,-2,492,129
-1,1734,1947,-213,0,-70,94
1,1540,1451,89,-4,72,67
-1,1523,1554,-31,-5,-206,60
0,1522,1516,6,-1,-439,152
-1,1770,1905,-135,0,-193,116
1,1450,1582,-132,8,326,57
-1,1329,1193,136,-5,-141,54
-1,1284,1398,-114,-1,-217,122
1,1385,1543,-158,-4,154,77
1,1466,1500,-34,11,355,61
-1,1409,1445,-36,0,-152,138
1,1703,1500,203,10,386,63
1,1586,1121,465,3,731,101
1,1585,1678,-93,0,-7,49
-1,1475,1826,-351,-6,-711,98
-1,1454,1470,-16,-3,-161,88
1,1300,1347,-47,5,982,105
1,1731,1659,72,0,900,121
-1,1439,1402,37,-5,-341,102
-1,1569,1513,56,1,149,74
0,1392,1772,-380,-5,502,144
-1,1469,1832,-363,-2,-64,50
0,1303,1313,-10,0,-33,112
1,1433,1417,16,8,468,69
1,1548,1355,193,4,64,49
1,1530,1400,130,-2,633,125
1,1628,1610,18,0,-15,63
1,1599,1397,202,8,604,79
0,0,1212,-1212,0,-43,62
1,1209,1314,-105,-1,55,78
1,1726,1474,252,0,21,61
-1,1392,1385,7,1,53,68
1,1493,1835,-342,-1,-381,87
-1,1752,1860,-108,-3,-93,42
-1,1514,1812,-298,-1,80,80
1,1691,1537,154,6,369,81
1,1600,1418,182,-6,-126,107
1,1304,1352,-48,-1,81,95
1,1428,1381,47,0,98,75
-1,1763,1757,6,0,8,44
-1,1814,1261,553,-2,-183,70
-1,1441,1417,24,-3,-160,72
-1,1520,1751,-231,-5,-578,106
1,1510,1729,-219,-5,-112,83
1,1429,1545,-116,3,339,85
1,1717,1577,140,2,48,57
1,1608,1526,82,0,18,51
1,1417,1349,68,0,110,69
0,1650,1470,180,-4,-135,103
1,1805,1632,173,0,7,43
-1,1557,1724,-167,0,-54,70
1,1698,1601,97,1,760,119
-1,1431,1499,-68,-1,286,174
-1,1508,1444,64,-11,-145,42
-1,1711,1529,182,3,135,70
-1,1609,1634,-25,-3,-167,60
-1,1491,1794,-303,-4,-240,70
1,1314,1362,-48,-1,-83,95
-1,1600,1656,-56,0,6,68
-1,1957,1739,218,0,-49,86
1,1547,1593,-46,2,65,71
-1,1645,1694,-49,-5,-220,100
-1,1731,1650,81,-1,-33,53
1,1317,1322,-5,9,1119,143
-1,1476,1731,-255,-16,-205,50
1,1560,1669,-109,-1,-10,75
-1,1600,1709,-109,-7,-267,51
1,1466,1336,130,-4,-77,51
-1,1444,1392,52,-2,216,126
-1,1277,1578,-301,-3,-225,82
0,1880,1486,394,0,-11,159
1,1580,1560,20,-2,-325,81
-1,1768,1752,16,0,-141,178
-1,1570,1672,-102,-4,-96,55
1,1850,1606,244,5,267,73
0,1744,1839,-95,-2,141,125
-1,1730,1966,-236,0,17,50
1,1474,1328,146,-3,-5,43
1,1639,1487,152,0,41,57
-1,1635,1765,-130,0,-271,134
0,1763,1913,-150,1,209,158
-1,1656,1663,-7,2,24,76
1,1362,1412,-50,3,61,45
1,1523,1559,-36,1,427,103
1,1773,1628,145,0,400,123
1,1436,1802,-366,-1,-21,81
1,1450,1412,38,-8,-445,89
-1,1422,1788,-366,-1,-1,66
-1,1740,1467,273,-1,-29,45
0,1294,1329,-35,4,442,127
0,1557,1655,-98,-1,3,132
-1,1516,1562,-46,-4,-262,67
-1,1621,1781,-160,-5,-315,116
-1,1515,1591,-76,0,-76,84
-1,1481,1321,160,-15,-527,70
-1,1324,1354,-30,-4,-216,60
1,1638,1717,-79,-3,50,55
-1,1908,1768,140,0,-2,106
-1,1607,1632,-25,1,166,126
-1,1402,1462,-60,0,-105,110
-1,1332,1310,22,-4,16,94
1,1720,1486,234,3,142,73
0,1573,1152,421,-6,-163,42
-1,1788,1615,173,0,-236,178
-1,1535,1413,122,-2,69,94
1,1657,1509,148,-3,14,59
-1,1601,1878,-277,-5,-470,136
-1,1811,1615,196,0,-73,66
1,1783,1891,-108,0,53,103
-1,1373,1393,-20,1,135,76
1,1674,1641,33,-1,-22,83
-1,1539,1500,39,0,-139,86
0,1320,1408,-88,-2,-443,112
1,1659,1593,66,-2,-65,61
1,1719,1894,-175,0,-11,61
-1,1518,1513,5,-5,-467,109
1,1631,1569,62,3,137,61
-1,1165,1564,-399,-7,-224,56
1,1782,1583,199,2,105,83
-1,1597,1563,34,-4,-277,74
-1,1745,1900,-155,-4,-281,78
-1,1591,1489,102,-2,-1,60
-1,1549,1500,49,0,-38,72
1,1875,1797,78,-1,192,95
-1,1815,1577,238,-3,-451,126
-1,1428,1521,-93,1,9,58
1,1362,1267,95,-2,-228,81
1,1769,1677,92,-1,146,99
1,1938,1756,182,1,422,115
1,1505,1599,-94,0,181,83
-1,1481,1725,-244,-1,-31,44
1,1381,1332,49,-2,-22,111
-1,1488,1403,85,-3,92,90
1,1577,1695,-118,0,7,51
1,1333,1245,88,-3,-55,55
1,1615,1790,-175,0,21,77
1,1561,1614,-53,4,22,49
1,1841,1780,61,1,183,65
-1,1768,1644,124,-2,127,120
1,1209,1298,-89,3,22,51
-1,1500,1656,-156,2,74,62
1,1947,1835,112,-1,138,119
-1,1728,1649,79,-7,-130,52
1,1548,1708,-160,0,8,43
1,1522,1435,87,3,40,41
1,1212,0,1212,1,18,47
-1,1391,1892,-501,-1,60,60
1,1564,1676,-112,1,611,123
-1,1383,1700,-317,-1,2,52
1,1867,1726,141,0,43,57
0,1712,1846,-134,2,109,154
1,1275,1534,-259,2,20,45
1,1570,1727,-157,-9,302,95
1,1415,1298,117,0,-2,47
1,1536,1418,118,0,40,103
1,1673,1648,25,-1,-6,90
-1,1223,1469,-246,-9,-941,82
1,1300,1236,64,4,791,129
1,1600,1620,-20,-1,-43,65
-1,1500,1554,-54,3,81,102
1,1582,1428,154,-2,-85,61
1,2012,1719,293,0,-19,43
1,1290,1397,-107,2,48,63
1,1900,1659,241,0,59,63
-1,1362,1336,26,2,19,42
-1,1433,1589,-156,1,-38,68
1,1581,1642,-61,-9,-6,101
-1,1715,2016,-301,0,-3,40
-1,1227,1734,-507,1,-673,116
1,1426,1289,137,1,79,59
1,1500,1331,169,-3,213,109
1,1376,1583,-207,1,408,73
1,1517,1378,139,4,136,47
-1,1383,1306,77,1,46,50
0,1615,1433,182,-2,41,175
-1,1984,2020,-36,-4,-106,92
-1,1533,1393,140,1,-36,68
1,1637,1837,-200,0,50,73
-1,1348,1367,-19,2,-68,100
-1,1518,1567,-49,-4,-88,58
-1,1827,2162,-335,0,-48,98
1,1564,1423,141,0,151,67
1,1614,1298,316,1,293,125
-1,1583,1604,-21,-3,-114,138
1,2165,1911,254,1,90,95
1,1499,1560,-61,0,447,125
-1,1364,1510,-146,-5,-350,76
-1,1313,1618,-305,10,200,58
-1,0,1212,-1212,0,-82,84
1,1408,1491,-83,5,370,71
-1,1716,1743,-27,0,9,46
-1,1320,1370,-50,-2,-23,60
1,1432,1616,-184,-1,-54,53
0,1670,1340,330,-3,-388,101
1,1580,1659,-79,0,265,75
-1,1474,1218,256,-2,-44,86
1,1150,1500,-350,-6,-59,57
1,1691,1364,327,-8,111,81
1,1546,1512,34,2,240,87
1,1237,1235,2,3,67,45
1,1547,1500,47,4,486,79
-1,1450,1344,106,-1,207,92
1,1508,1536,-28,-2,116,89
-1,1602,1734,-132,-1,-90,90
1,1576,1352,224,4,75,48
-1,1411,1466,-55,0,112,150
1,1502,1556,-54,-4,-108,97
1,1380,1310,70,1,32,67
-1,1629,1919,-290,-2,-1,40
1,1562,1624,-62,-1,96,73
-1,1384,1597,-213,-3,-11,68
1,1622,1500,122,2,171,79
1,1907,2170,-263,0,103,91
1,1409,1500,-91,0,-18,85
1,1500,1326,174,0,677,105
-1,1360,1694,-334,1,-12,68
1,1562,1169,393,1,184,77
-1,1578,1484,94,3,355,112
1,1543,1455,88,0,72,47
1,1592,1225,367,1,95,65
1,1598,1396,202,4,237,87
1,1603,1596,7,0,3,69
1,1223,1337,-114,0,719,121
-1,1727,1711,16,0,-243,136
1,1294,1618,-324,-1,16,51
-1,1653,1810,-157,-3,-159,75
-1,1586,1614,-28,0,48,112
1,1552,1389,163,0,114,79
0,1300,1388,-88,-2,-206,135
-1,941,1321,-380,-5,-75,40
1,1638,1390,248,1,7,44
-1,1721,1732,-11,-2,-696,94
1,1774,1814,-40,-1,-37,47
-1,1237,1223,14,-7,-117,46
-1,1500,1455,45,-2,51,106
-1,1381,1558,-177,-7,-466,78
1,1201,1378,-177,0,499,83
1,1581,1563,18,0,41,100
1,1625,1435,190,3,527,81
0,1320,1606,-286,-4,792,140
1,1564,1374,190,-1,395,155
-1,1661,1510,151,6,-99,122
0,1385,1643,-258,0,297,112
-1,1924,2031,-107,-1,-19,48
1,1235,1225,10,0,28,59
1,1386,1303,83,3,35,71
-1,1344,1579,-235,-1,-121,90
1,1422,1500,-78,-4,-218,83
-1,1169,1323,-154,-3,-39,66
0,1669,1648,21,-3,-97,183
-1,1497,1476,21,-3,-311,86
1,1828,1697,131,1,128,79
1,1724,1715,9,2,99,53
-1,1356,1579,-223,-16,-320,46
1,2039,1917,122,-3,-37,63
1,1579,1284,295,19,965,67
1,1294,1394,-100,-3,-143,69
1,1690,1835,-145,1,173,139
1,1704,1735,-31,-1,-55,77
1,1681,1493,188,3,134,85
-1,1629,1718,-89,3,92,76
1,1621,1426,195,-1,-78,53
-1,1910,2047,-137,0,2,48
1,1553,1617,-64,3,1167,129
-1,1771,1934,-163,-1,-175,100
1,1380,1309,71,4,168,57
-1,1244,1310,-66,-8,-405,66
-1,1621,1573,48,1,8,60
-1,1618,1253,365,-6,-374,86
-1,1322,1503,-181,1,18,70
-1,1300,1389,-89,-4,-277,109
-1,1647,1640,7,-2,-390,84
1,2055,1706,349,2,121,85
1,1603,1239,364,2,548,91
1,1371,1550,-179,1,62,81
0,1391,1348,43,0,-379,112
1,1487,1717,-230,0,11,41
1,1586,1316,270,-1,207,101
1,1648,1511,137,-1,-29,101
-1,1039,1252,-213,-3,-127,58
1,1516,1325,191,1,-10,65
1,1512,1636,-124,1,20,61
1,1601,1567,34,3,24,104
-1,1703,2058,-355,-2,-5,40
1,1896,1515,381,-3,77,51
1,1608,1503,105,0,51,59
-1,2061,1700,361,-8,-582,112
1,1560,1500,60,-4,40,75
-1,1512,1904,-392,1,58,80
1,1500,1810,-310,-7,-17,47
1,1232,1473,-241,4,361,85
1,1911,1510,401,1,423,89
1,1523,1327,196,-3,-11,49
-1,1404,1283,121,-2,-29,64
-1,1366,1326,40,4,88,54
-1,1398,1280,118,1,-345,130
1,1560,1362,198,0,46,57
-1,1562,1530,32,-4,-96,46
1,1663,1683,-20,-9,160,121
1,1803,1734,69,3,90,65
-1,1298,1529,-231,1,11,42
1,1522,1586,-64,4,300,87
1,1534,1276,258,3,85,61
1,1595,1325,270,4,277,49
1,1319,1316,3,0,-1,43
-1,1316,1444,-128,-1,1,72
0,1939,1836,103,0,47,120
1,1539,1637,-98,6,105,53
-1,1285,1500,-215,-4,-211,98
1,1706,1533,173,-2,-8,123
-1,1418,1660,-242,-1,-276,100
1,1267,1722,-455,1,54,55
0,1839,1930,-91,-10,-191,140
-1,1298,1412,-114,0,-36,56
0,1623,1553,70,-3,-58,113
-1,1024,1263,-239,-5,-167,82
-1,1340,1354,-14,-4,-376,98
-1,1579,1495,84,-4,-211,72
1,1249,1461,-212,2,220,79
1,1723,1811,-88,-1,108,63
1,1356,1080,276,4,162,53
1,1923,1842,81,1,58,97
-1,1526,1472,54,-4,-131,78
1,1909,2039,-130,-1,-82,69
0,1603,1500,103,6,432,65
1,1700,1573,127,3,102,47
-1,1430,1458,-28,0,-2,70
1,1556,1620,-64,4,559,145
1,1535,1165,370,-4,178,61
1,1610,1552,58,0,72,91
1,1425,1374,51,-1,-35,43
1,1961,1825,136,1,19,97
-1,1688,1370,318,-4,-211,106
1,1794,1569,225,5,266,69
1,1684,1517,167,0,24,61
0,1597,1298,299,-3,-230,129
1,1817,1977,-160,0,241,109
-1,1509,1566,-57,1,-44,74
-1,1620,1512,108,0,-10,58
1,1798,1740,58,-3,1,49
-1,1550,1280,270,0,-218,102
1,1607,1569,38,1,347,101
1,1616,1573,43,0,98,71
1,2022,1923,99,-3,-323,113
-1,1577,1532,45,-3,-125,126
-1,1565,1708,-143,-1,-513,116
1,1538,1225,313,-3,-9,57
-1,1561,1606,-45,-3,-302,110
-1,1559,1617,-58,-1,-31,80
1,1575,1500,75,0,-2,61
1,1600,1500,100,-1,-14,59
1,1696,1802,-106,0,200,133
-1,1915,2031,-116,0,-3,62
-1,1650,1359,291,-2,-163,84
-1,1667,1712,-45,-10,-89,66
1,1420,1535,-115,0,54,71
1,1549,1626,-77,0,48,99
-1,1541,1789,-248,-3,-343,84
-1,1378,1497,-119,0,-6,61
1,1655,1730,-75,-5,-129,87
-1,1294,1317,-23,-2,-96,52
1,1616,1531,85,0,27,177
-1,1367,1562,-195,1,37,62
1,1794,1731,63,-1,0,45
-1,1476,1393,83,-2,-15,48
-1,1613,1563,50,-5,-489,132
1,1583,1655,-72,10,112,43
1,1443,1271,172,2,193,69
1,1547,1565,-18,-1,146,83
-1,1407,1463,-56,5,145,50
1,1959,1678,281,0,-35,103
-1,962,1584,-622,-24,-227,40
-1,1537,1590,-53,-4,-38,70
1,1509,1506,3,-7,-110,63
-1,1576,1600,-24,1,29,48
-1,1591,1561,30,-2,-121,58
0,1500,1820,-320,0,8,118
1,1412,1285,127,12,352,55
-1,1794,1803,-9,0,-383,132
1,1967,1610,357,0,99,61
-1,1561,1586,-25,-3,-649,160
-1,1351,1540,-189,-2,-92,52
1,1339,1566,-227,-2,-48,53
1,1507,1624,-117,0,-4,53
-1,1345,1551,-206,-8,-536,72
-1,1611,1266,345,-4,-148,104
-1,1388,1315,73,3,28,40
1,1972,1608,364,-3,-122,101
1,1566,1486,80,3,102,59
1,1824,1702,122,-1,-20,103
1,1275,1260,15,1,-15,41
1,1625,1561,64,-1,7,67
-1,1554,1560,-6,-1,-93,86
-1,1161,1437,-276,-1,-2,40
-1,1610,1546,64,-11,-362,104
-1,1605,1976,-371,-2,-26,118
-1,1597,1514,83,3,103,66
-1,1388,1630,-242,-2,-149,70
1,1894,1287,607,9,198,51
1,1419,1209,210,3,192,59
1,1667,1018,649,21,393,43
1,1981,1602,379,1,111,71
1,1478,1574,-96,12,231,43
-1,1282,1558,-276,-1,-19,44
-1,1639,1932,-293,-1,-27,42
1,1658,1488,170,0,103,65
0,1578,1597,-19,-5,-105,146
1,1600,1489,111,1,67,91
-1,1813,1783,30,-4,-114,102
-1,1218,1236,-18,-2,-22,44
1,1589,1482,107,4,61,59
-1,1583,1750,-167,4,23,44
1,1722,1526,196,1,20,43
-1,1886,2000,-114,0,-203,94
1,1527,1418,109,-4,-99,61
1,1668,1560,108,3,285,79
1,1652,1428,224,0,361,129
-1,2014,1879,135,0,175,122
-1,1590,1579,11,3,50,44
1,1482,1609,-127,4,250,69
1,1594,1626,-32,2,132,65
1,1756,1577,179,4,58,49
-1,1308,1491,-183,-4,-155,54
1,1608,1277,331,1,37,43
1,1690,1500,190,16,621,57
1,1714,1786,-72,0,21,56
1,1659,1684,-25,0,4,75
-1,1724,1894,-170,-1,6,60
1,1795,1801,-6,0,192,181
1,1546,1345,201,-2,-116,85
-1,1352,1636,-284,-5,-133,60
-1,1752,1466,286,2,136,96
1,1581,1613,-32,6,232,73
1,1634,1597,37,-1,513,141
1,1476,1573,-97,6,106,61
1,1593,1497,96,1,0,111
-1,1245,1561,-316,2,11,42
1,1988,1717,271,1,40,55
1,1296,1398,-102,0,245,98
-1,1482,1664,-182,1,107,114
-1,1607,2181,-574,-4,-360,88
1,1713,1640,73,-8,-264,61
1,1186,1124,62,0,255,153
1,1767,1566,201,0,9,41
1,1630,1722,-92,6,217,67
-1,1590,1579,11,-1,-575,112
1,1611,1423,188,2,463,117
1,1757,1739,18,0,68,43
-1,1247,1573,-326,-1,-56,62
1,1995,1780,215,0,294,129
-1,1613,2015,-402,-3,-13,40
-1,1535,1488,47,-7,-215,54
1,1645,1708,-63,10,165,67
1,1672,1671,1,1,92,89
1,1597,1489,108,5,170,59
1,1711,1728,-17,0,3,67
1,1772,1586,186,-1,457,137
-1,1327,1629,-302,-2,-89,48
-1,1617,1736,-119,0,15,60
1,1775,1566,209,1,361,139
1,2003,1694,309,8,398,61
-1,1426,1659,-233,-10,-519,78
1,1601,1766,-165,-1,17,57
1,1691,1580,111,1,37,73
-1,1129,1190,-61,0,-3,76
1,1641,1500,141,6,729,103
-1,1664,1421,243,-1,-375,100
-1,1419,1383,36,-8,-536,84
-1,1395,1645,-250,-9,-85,40
-1,1501,1522,-21,-1,-4,112
1,1699,1780,-81,0,48,91
1,1791,1806,-15,0,368,145
1,1606,1532,74,8,157,51
1,1311,1305,6,0,-34,49
1,1500,1572,-72,2,34,51
1,1450,1652,-202,-4,-173,63
1,1645,1439,206,-4,-73,61
-1,1765,2029,-264,-1,2,50
-1,1308,1241,67,-11,-237,50
-1,1713,2008,-295,-5,-344,50
1,1493,1693,-200,0,-88,63
-1,1632,2184,-552,-4,-135,64
-1,1434,1651,-217,0,95,84
-1,1533,1491,42,1,-69,54
1,1671,1671,0,1,239,73
1,2039,1957,82,-5,19,81
1,2014,1325,689,0,-1,41
1,1614,1457,157,3,291,83
-1,1458,1429,29,-3,-33,50
-1,1411,1769,-358,-3,-362,106
1,1778,1609,169,-3,-42,119
1,1702,1476,226,-1,105,125
-1,1727,1573,154,-7,-69,50
-1,1387,1441,-54,0,207,110
1,1503,1520,-17,-4,-150,47
-1,1199,1378,-179,1,307,147
-1,1454,1560,-106,-7,-325,70
-1,1458,1631,-173,-9,-260,60
1,1548,1239,309,-11,-116,45
1,1795,1802,-7,-1,-10,41
-1,1631,1867,-236,0,-204,119
1,1670,1483,187,-1,175,123
-1,1206,1136,70,-2,-746,124
1,1656,1162,494,-6,-47,43
-1,1499,1500,-1,0,-414,114
-1,1621,2186,-565,-3,-3,40
1,1509,1514,-5,0,271,71
-1,1605,1576,29,-12,-170,46
1,1822,1767,55,3,109,41
-1,1450,1418,32,-6,-81,54
1,1716,1292,424,1,78,89
1,1758,1832,-74,7,1285,123
-1,1791,1806,-15,-3,-138,80
1,1417,1374,43,0,-1,121
-1,1197,1568,-371,0,14,54
-1,1366,1495,-129,-7,-98,42
1,1248,1319,-71,3,265,89
-1,1481,1722,-241,3,37,54
-1,1659,1465,194,-2,-6,48
1,1818,1771,47,-2,-372,87
0,1620,1416,204,5,159,57
1,1498,1736,-238,-1,-7,47
0,1990,1999,-9,-1,-177,92
-1,1467,1519,-52,1,-22,56
1,1358,1554,-196,-2,-436,113
1,2048,2053,-5,-1,147,61
1,1536,1483,53,-1,-19,57
1,1442,1367,75,-3,-26,85
1,1784,1603,181,1,33,69
1,1348,1270,78,2,377,93
-1,1824,1880,-56,-3,-238,70
-1,1245,1594,-349,-6,-215,53
-1,1999,1991,8,-1,-112,96
1,1663,1517,146,1,157,77
-1,2004,1988,16,-1,-149,126
1,1343,1431,-88,0,345,131
-1,1791,1597,194,0,-31,66
-1,1555,1437,118,1,211,86
-1,1254,1617,-363,0,-50,61
1,1587,1564,23,-3,-198,99
-1,1572,1628,-56,2,23,42
-1,1891,2059,-168,-1,16,100
1,1374,1470,-96,-1,70,83
-1,1490,1580,-90,-11,-170,52
1,1722,1741,-19,1,96,135
1,1999,1991,8,-3,-168,83
1,1717,1518,199,3,298,103
1,1597,1226,371,1,69,73
-1,1573,1615,-42,-3,-237,102
-1,1543,1500,43,0,15,58
1,1571,1180,391,12,212,45
1,1539,1235,304,-8,-228,49
1,1707,1469,238,0,991,179
1,1666,1457,209,0,212,77
-1,1934,1997,-63,0,-26,52
1,1596,1466,130,10,200,53
-1,1980,2008,-28,-10,-310,53
1,1627,1638,-11,-1,-116,137
1,1771,1415,356,-4,-103,53
-1,2018,1969,49,-1,-487,108
-1,1356,1185,171,-5,-577,90
-1,1614,1773,-159,-3,-71,86
-1,1626,1630,-4,12,312,54
-1,1451,1603,-152,-6,-79,50
-1,1982,2006,-24,-6,-501,186
1,1915,1673,242,0,-140,123
-1,1360,1250,110,-6,-216,60
-1,1551,1933,-382,-6,-154,54
1,1417,1365,52,-4,-8,55
-1,1717,1872,-155,-4,-66,50
1,1607,1189,418,5,121,63
-1,1432,1515,-83,1,32,56
1,1799,1809,-10,-6,-298,59
1,1807,1668,139,0,10,89
1,1588,1482,106,1,52,54
-1,1548,1971,-423,-11,-232,54
0,1518,1397,121,-3,-172,119
0,1211,1599,-388,-1,-7,156
-1,1563,1616,-53,-1,-29,46
-1,1457,1446,11,-2,-259,112
1,1602,1562,40,0,42,75
-1,1510,1672,-162,-1,-78,70
1,1232,1574,-342,7,518,99
1,1973,1546,427,-1,-49,71
1,1812,1513,299,0,143,89
1,1765,1672,93,15,183,41
-1,1564,1328,236,-2,-226,146
-1,1544,1975,-431,2,57,60
-1,1155,1632,-477,-5,-89,46
-1,1548,1925,-377,-1,-339,102
-1,1306,1396,-90,1,-314,80
1,1811,1668,143,0,-204,213
1,1401,1642,-241,3,281,75
-1,1772,1581,191,-1,-108,82
1,1633,1510,123,-1,38,91
1,1427,1532,-105,3,279,103
-1,1603,1481,122,-10,-215,58
1,2153,1884,269,1,36,45
-1,1675,1625,50,-1,-73,60
1,1461,1505,-44,1,201,73
1,1664,1774,-110,1,2,47
-1,1981,1826,155,0,-66,64
1,1595,1693,-98,4,359,101
-1,1683,1945,-262,0,11,68
-1,1244,1790,-546,-6,-544,102
1,1842,1964,-122,0,-13,43
-1,1879,2157,-278,-2,-58,54
-1,1854,1420,434,2,-12,94
-1,1765,1907,-142,0,-278,116
0,1947,1858,89,-4,-343,115
-1,1637,1595,42,-1,-40,58
-1,1928,1546,382,1,117,96
1,1404,1296,108,-6,120,61
-1,1333,1344,-11,1,27,40
-1,1662,1756,-94,2,102,56
1,2066,1874,192,1,63,55
-1,1340,1359,-19,-4,-236,92
-1,1872,1983,-111,-2,-69,48
-1,1860,1944,-84,0,-115,74
0,1680,1503,177,-1,-116,135
1,1378,1264,114,5,133,49
0,1791,1502,289,0,116,118
1,1213,1136,77,3,187,59
-1,1991,1864,127,-9,-130,52
-1,1562,1641,-79,0,30,68
1,1372,1712,-340,0,443,143
-1,1287,1412,-125,-3,-47,66
-1,1625,1645,-20,0,-317,126
-1,1953,1852,101,-3,80,92
1,1764,1653,111,-3,-109,71
-1,1610,1330,280,0,-257,132
0,1548,1238,310,1,51,132
-1,1866,1938,-72,-3,-497,102
1,1698,1494,204,4,37,51
-1,1424,1208,216,3,702,104
-1,1818,1596,222,0,-517,132
1,1687,1639,48,2,307,101
0,1626,1584,42,-4,-65,143
0,1796,1605,191,0,-91,103
-1,1223,1991,-768,-7,-99,46
-1,1708,1865,-157,0,3,80
-1,1640,1506,134,0,-61,62
1,1991,1218,773,3,40,43
1,1553,1521,32,1,14,51
1,1696,1702,-6,-5,-50,49
-1,2081,1875,206,0,-21,68
-1,1213,1992,-779,-9,-189,46
-1,1448,1645,-197,-4,-1,134
1,1945,1964,-19,0,75,65
-1,1001,1311,-310,-9,-275,50
-1,1484,1627,-143,0,-58,74
1,1993,1209,784,4,84,47
-1,1506,1624,-118,1,-254,134
1,1615,1299,316,0,5,71
1,1611,1606,5,0,510,101
-1,1628,1594,34,0,265,82
-1,1720,1659,61,-2,-32,84
1,1518,1470,48,-2,-46,47
-1,1514,1673,-159,-2,-97,78
-1,1678,1500,178,-1,9,130
1,1892,2063,-171,0,-13,59
1,1691,1707,-16,0,29,63
1,1464,1953,-489,2,31,51
-1,1618,1690,-72,-3,-70,50
1,1533,1446,87,7,88,49
1,1697,1544,153,6,825,111
1,1679,1677,2,0,20,55
0,1790,1699,91,1,26,181
1,1826,1618,208,1,11,49
1,1709,1448,261,6,308,63
-1,1757,2175,-418,-2,-54,50
-1,1676,1892,-216,0,-82,78
-1,1508,1342,166,-4,-150,56
-1,1333,1417,-84,-1,-476,142
-1,1511,1563,-52,-3,-38,48
-1,1501,1634,-133,-2,-286,74
-1,1326,1814,-488,-7,-406,81
-1,1461,1471,-10,-10,-369,72
1,2178,1755,423,0,12,51
-1,1533,1780,-247,-7,-703,122
1,1689,1581,108,-2,101,101
1,1898,1671,227,-1,182,147
1,2180,1811,369,0,135,73
1,1706,1565,141,-2,87,95
1,1557,1340,217,4,235,95
1,1375,1434,-59,4,165,65
1,1315,996,319,4,419,69
-1,1624,1585,39,1,-20,78
1,1483,1601,-118,-8,292,99
1,1733,1279,454,-4,-57,83
-1,2184,2081,103,2,61,72
-1,1329,1579,-250,3,61,52
-1,1673,1498,175,0,-355,174
-1,1726,1929,-203,-4,-274,90
-1,1735,1753,-18,-2,-42,46
1,2097,2165,-68,2,55,53
1,1449,1412,37,4,281,73
1,1696,1500,196,-2,-86,113
0,1666,1903,-237,0,54,119
1,1649,1516,133,5,524,87
1,1496,1312,184,2,218,69
-1,1538,1469,69,-7,-519,118
1,2147,1724,423,-8,71,61
1,1815,1876,-61,0,71,83
-1,2150,2119,31,-1,-110,66
1,1526,1537,-11,3,461,107
-1,1264,1984,-720,0,-6,46
1,1896,1673,223,0,65,127
-1,1718,1831,-113,0,-253,116
-1,1647,1587,60,1,3,50
-1,1324,1483,-159,-9,-635,74
1,1609,1283,326,1,162,85
-1,1785,2134,-349,-1,-4,94
1,2049,1672,377,0,86,65
-1,1445,1650,-205,1,38,58
-1,2112,1985,127,0,-179,110
-1,1538,1913,-375,0,-65,68
0,1631,1576,55,0,-14,85
-1,1669,2051,-382,-2,-35,42
1,1689,1556,133,7,691,91
1,1318,1435,-117,0,18,57
-1,1400,1701,-301,-1,-129,114
-1,1465,1479,-14,0,-5,76
-1,1460,1590,-130,-5,-363,86
1,2054,1667,387,0,16,41
1,2141,2003,138,0,-24,67
1,1939,1902,37,0,-81,113
1,1374,1491,-117,2,100,66
1,1534,1500,34,2,159,57
1,1676,1722,-46,-1,-47,75
1,1588,1594,-6,-1,-208,83
-1,1618,1584,34,2,-3,42
1,1603,1665,-62,-1,208,105
1,1607,1622,-15,2,1097,185
1,1696,1557,139,0,98,119
1,1772,1613,159,-4,-21,113
1,1995,2150,-155,-2,-42,59
1,1500,1262,238,-12,-550,111
1,1710,1687,23,-1,-24,55
-1,1333,1569,-236,-2,-197,82
-1,1522,1583,-61,1,105,72
1,1668,1514,154,7,126,44
-1,1613,1489,124,-2,-93,56
1,2130,2013,117,-5,18,57
-1,1948,1890,58,0,0,70
-1,1713,1935,-222,-3,-73,56
-1,1738,1737,1,0,1,67
-1,1693,1775,-82,-11,-607,138
1,2004,2140,-136,0,-7,65
-1,1720,1676,44,-4,-147,64
1,1502,1280,222,4,282,91
0,1578,1629,-51,0,52,106
1,1554,1625,-71,0,165,122
-1,1578,1686,-108,-10,-211,43
-1,1785,1624,161,0,-38,54
-1,1263,1630,-367,-1,-78,80
1,2121,2022,99,0,18,67
1,1674,1814,-140,-3,-103,67
-1,1750,1500,250,-7,-230,50
-1,1460,1617,-157,-9,-165,42
-1,1639,1767,-128,3,40,48
1,1708,1732,-24,1,3,53
1,1452,1389,63,1,97,83
1,2056,1601,455,2,59,65
-1,1675,1676,-1,-5,-122,88
-1,1570,1700,-130,0,-17,115
1,1775,1632,143,-1,-42,65
1,1442,1351,91,0,-15,63
-1,1551,1500,51,1,-95,84
1,1603,1202,401,0,-7,65
1,1596,1665,-69,1,59,95
-1,1625,1783,-158,1,-3,44
-1,1705,1701,4,-2,7,40
-1,1561,1507,54,-4,-295,106
-1,1803,1552,251,0,-28,60
1,1635,1779,-144,7,298,119
1,1460,1402,58,4,129,47
1,1542,1619,-77,0,0,49
1,1831,1824,7,0,5,123
1,1601,1428,173,-1,25,67
-1,1773,1527,246,-3,-63,58
-1,1500,1758,-258,0,-152,120
-1,1587,1334,253,-5,-144,74
-1,1473,1730,-257,-3,-1025,130
-1,1694,1666,28,-4,-100,88
1,1328,1635,-307,1,258,85
-1,1435,1503,-68,0,-20,100
-1,1756,1762,-6,1,6,48
1,1605,1200,405,7,98,43
-1,1565,2166,-601,0,-55,60
-1,1260,1729,-469,0,-334,118
1,1500,1134,366,-1,-94,67
1,1908,2091,-183,0,5,53
-1,1600,1627,-27,0,-183,131
-1,1466,1592,-126,-6,-86,48
-1,1563,1690,-127,-4,-147,106
0,1664,1500,164,0,9,152
-1,1564,1460,104,-9,-61,44
-1,1778,2131,-353,-1,-37,64
0,1602,1509,93,0,111,163
1,1437,1277,160,2,128,57
-1,1607,1508,99,0,-12,70
-1,1772,1613,159,0,-87,80
1,1626,1597,29,3,285,85
-1,1511,1390,121,0,-76,56
-1,1749,1219,530,6,468,72
-1,1605,1916,-311,-8,-45,40
1,1775,2134,-359,-5,-65,57
-1,1458,1600,-142,-3,-91,60
-1,1410,1432,-22,0,11,58
0,1594,1500,94,-2,-42,150
1,1387,1278,109,-2,-176,71
-1,1307,1178,129,4,-261,138
1,1600,1514,86,6,269,87
-1,1933,2110,-177,-2,-615,108
1,1748,1528,220,2,74,57
1,2117,1927,190,-5,292,99
-1,1467,1363,104,2,-386,86
1,1936,1500,436,1,247,117
1,1604,1466,138,-1,-28,93
1,1735,1469,266,0,52,107
-1,1921,2124,-203,-3,-448,96
-1,1670,1551,119,0,34,82
1,1588,1643,-55,-1,26,63
1,1455,1498,-43,7,344,77
1,1258,1382,-124,0,-11,49
-1,1523,1754,-231,2,92,128
1,1556,1697,-141,0,16,73
1,1957,2058,-101,0,62,97
1,1468,1271,197,1,34,45
-1,1682,1525,157,8,106,46
-1,1451,1424,27,-1,-40,42
1,1607,1630,-23,6,223,63
-1,2131,1916,215,1,-696,98
-1,1933,2110,-177,-1,-356,84
-1,1523,1592,-69,-19,-354,46
0,1245,1289,-44,0,-114,96
1,1618,1619,-1,5,458,71
-1,1726,1940,-214,0,-119,86
1,1741,1927,-186,1,-14,61
0,1724,1584,140,-2,-45,107
-1,1910,1734,176,4,-84,94
1,1534,1702,-168,-1,-259,81
-1,1484,1760,-276,1,40,62
-1,1637,1623,14,-1,-67,102
1,1440,1480,-40,5,74,41
-1,1753,1893,-140,3,111,56
1,1607,1590,17,-1,383,83
1,2042,1972,70,0,-165,131
-1,1571,1900,-329,-3,-288,96
-1,1503,1440,63,-12,-213,53
1,1521,1702,-181,-2,-44,41
-1,1257,1512,-255,-8,-224,50
-1,1588,1664,-76,0,-178,136
-1,1571,1682,-111,1,-188,103
-1,1508,1557,-49,-5,-162,76
-1,1585,1558,27,-2,-167,64
-1,1515,1630,-115,-1,-7,60
1,1378,1533,-155,1,166,57
-1,1762,1695,67,-1,-32,48
1,1907,1563,344,0,-10,52
-1,1751,1862,-111,0,-32,62
-1,1720,1500,220,-2,12,48
1,1736,1528,208,0,202,113
1,1682,1324,358,-3,422,77
1,1468,1556,-88,7,130,45
1,1453,1334,119,1,322,79
1,1820,1556,264,7,317,55
1,1367,1339,28,0,145,55
1,1764,1480,284,2,113,57
-1,1237,991,246,-8,-249,50
1,1710,1568,142,0,26,63
0,1719,1421,298,-5,-113,108
1,1726,1804,-78,0,56,61
-1,1542,1482,60,-2,-92,56
-1,1743,1802,-59,0,-399,154
-1,1250,1638,-388,-3,-146,74
-1,1752,1579,173,0,1,76
1,1963,2052,-89,-4,-193,67
1,1612,1462,150,7,259,83
1,1496,1717,-221,1,21,49
-1,1394,1517,-123,-3,-568,104
1,1424,1468,-44,-2,9,77
1,1717,1496,221,0,-14,85
1,2117,1783,334,2,53,45
-1,1282,1476,-194,1,161,80
-1,1368,1578,-210,-4,-309,96
1,0,1226,-1226,-4,-126,61
1,1446,1536,-90,4,122,67
1,1709,1477,232,1,40,59
1,2121,1910,211,3,148,69
-1,1556,1752,-196,-4,-24,40
1,2037,1977,60,0,117,61
1,1507,1277,230,4,570,85
-1,1219,1018,201,-2,53,40
1,1323,1342,-19,0,0,45
-1,1491,1722,-231,-6,-97,47
1,1649,1544,105,0,-13,107
-1,1589,1499,90,-1,-66,84
1,2127,1805,322,3,81,55
1,1351,1523,-172,0,25,55
-1,1727,1486,241,0,-10,56
0,1748,1895,-147,0,-128,218
-1,1802,2131,-329,1,49,64
1,1461,1468,-7,0,17,55
1,1735,1441,294,0,-11,45
-1,1482,1217,265,-6,-163,60
1,1761,1531,230,0,-6,45
0,1458,1599,-141,2,142,113
1,2134,1799,335,0,0,43
-1,1461,1545,-84,-11,-8,74
-1,1626,1780,-154,-3,-42,76
-1,1968,2047,-79,0,-205,138
-1,1796,2138,-342,-2,-20,44
1,1507,1368,139,-3,-48,45
-1,1644,1668,-24,-3,-40,94
1,1595,1537,58,0,-33,91
-1,1570,1441,129,-1,-10,40
-1,1504,1708,-204,-7,-309,59
-1,1833,1518,315,8,302,60
1,1042,1202,-160,-4,-166,55
-1,1507,1507,0,0,-147,100
1,1714,1499,215,0,48,65
0,1741,1537,204,0,-18,106
1,1424,1429,-5,4,31,41
1,1472,1265,207,6,367,67
1,1739,1756,-17,0,14,59
0,1502,1219,283,0,10,88
-1,1457,1618,-161,3,253,88
1,1679,1483,196,0,278,99
-1,1604,1702,-98,-4,-49,46
1,1710,1238,472,5,165,61
-1,1456,1421,35,0,-175,132
-1,1493,1719,-226,-1,-9,46
-1,1733,1440,293,-7,-167,112
1,1716,1542,174,0,193,97
1,1608,1467,141,-6,8,81
-1,1564,1515,49,0,204,98
-1,1494,1500,-6,-5,-657,102
0,1662,1547,115,0,151,164
-1,1852,2056,-204,0,-69,118
-1,1812,1733,79,-1,-57,106
1,1724,1488,236,2,98,75
1,1685,1477,208,0,-9,75
1,1740,1536,204,-1,231,101
-1,1732,1751,-19,-2,18,80
-1,1981,1787,194,0,-51,72
-1,1483,1452,31,-2,24,60
1,1605,1615,-10,0,162,87
-1,1459,1650,-191,2,182,86
1,1547,1356,191,0,-71,93
-1,1759,1619,140,-4,-1201,126
1,1690,1565,125,0,15,121
1,1662,1710,-48,0,31,71
1,1674,1607,67,0,35,61
1,1866,1472,394,0,135,97
1,1600,1475,125,2,273,111
-1,1700,1679,21,-3,-405,104
-1,1404,1736,-332,0,3,48
-1,1856,1738,118,1,-34,68
1,1423,1550,-127,2,43,53
1,1600,1658,-58,0,98,85
-1,1633,1603,30,0,-265,118
0,1527,1549,-22,1,173,86
1,1470,1713,-243,0,113,94
1,1453,1450,3,-1,13,69
-1,1754,1839,-85,-2,-32,52
-1,1697,2063,-366,-1,-111,76
-1,1444,1388,56,-1,-30,52
-1,1529,1500,29,-1,2,48
1,1287,985,302,-1,-12,47
-1,1745,1849,-104,-1,-7,56
1,1698,1676,22,1,525,119
-1,1247,1318,-71,3,52,49
-1,1736,1621,115,0,10,42
1,1437,1244,193,-1,16,59
1,1625,1357,268,1,275,73
1,2066,1695,371,0,323,129
1,1689,1648,41,4,230,73
1,1442,1247,195,-3,21,49
1,1563,1683,-120,-2,342,121
-1,1499,1936,-437,1,-29,60
1,1535,1603,-68,-2,-88,93
1,1501,1475,26,3,282,71
-1,1341,1870,-529,-5,-112,56
1,1207,1447,-240,0,549,95
0,1428,1837,-409,1,39,59
-1,1685,1502,183,-1,10,50
1,1500,1465,35,-3,-67,53
1,1636,1608,28,-1,-18,69
-1,1692,2069,-377,1,-46,58
1,1482,1481,1,4,102,53
1,1938,1842,96,5,178,59
-1,1597,1646,-49,-1,-90,66
1,1443,1386,57,0,32,69
1,2072,1690,382,1,144,85
-1,1834,1946,-112,0,72,70
1,1334,1292,42,1,-134,107
1,1348,1326,22,7,168,115
-1,1656,1560,96,1,8,84
1,1545,1338,207,8,205,53
-1,1665,1708,-43,-3,-211,80
0,1700,1397,303,-2,-79,98
1,1497,1496,1,0,60,97
1,1687,1457,230,6,340,57
1,1736,1548,188,3,220,75
1,1529,1654,-125,-5,13,41
1,1500,1453,47,2,44,47
-1,1587,2096,-509,-3,-84,60
1,1530,1368,162,0,278,148
-1,1997,1944,53,1,21,48
-1,1589,1549,40,0,-6,56
-1,1452,1692,-240,0,0,56
1,2013,1798,215,0,30,81
-1,1484,1509,-25,2,241,106
-1,1452,1642,-190,0,-15,48
-1,1520,1423,97,0,-201,74
1,1720,1757,-37,-1,-6,57
-1,1699,1861,-162,-1,-60,60
-1,1689,1543,146,2,62,44
-1,1499,1457,42,0,-126,84
1,1692,1569,123,0,85,55
1,1576,1537,39,7,629,73
1,1633,1465,168,0,36,65
1,1428,1500,-72,-1,-5,57
1,1697,1448,249,1,450,89
-1,1444,1615,-171,-1,106,98
1,1520,1474,46,1,829,173
0,1629,1487,142,1,79,119
1,1560,1673,-113,0,-5,57
-1,1642,1657,-15,0,-210,122
1,1744,1732,12,2,149,79
-1,1464,1530,-66,0,-75,76
-1,1443,1494,-51,-4,-186,68
1,1702,1537,165,7,33,43
1,1946,1762,184,1,2,57
1,1486,1438,48,1,252,119
-1,1586,1684,-98,-2,-92,64
-1,1532,1603,-71,-2,-438,104
-1,1586,2018,-432,-1,-145,76
-1,1530,1709,-179,-4,-226,79
-1,1625,1711,-86,-11,-169,50
1,1583,1518,65,1,45,83
-1,1639,1500,139,0,38,112
1,1665,1529,136,2,373,129
1,1562,1285,277,0,23,85
-1,1693,1646,47,0,9,67
-1,1620,1646,-26,0,-282,122
1,1715,1699,16,0,-87,97
-1,1496,1948,-452,-1,-321,98
-1,1730,1742,-12,0,-47,78
-1,1344,1356,-12,-8,-395,80
-1,1546,1727,-181,0,-161,76
-1,1975,2097,-122,0,67,78
-1,1584,1842,-258,-8,-135,44
-1,1721,1755,-34,0,5,46
-1,1657,1514,143,-4,-328,82
0,1272,1611,-339,1,220,104
1,1314,1223,91,-1,173,87
1,1494,1243,251,-6,-105,45
1,1705,1479,226,5,319,77
-1,1540,2021,-481,-4,-185,54
1,1508,1592,-84,-3,161,75
1,1827,1869,-42,1,57,61
1,2105,1968,137,0,28,89
1,1565,1681,-116,2,82,73
1,1848,1668,180,0,17,53
1,1546,1535,11,6,476,71
1,1668,1848,-180,1,39,73
-1,1500,1950,-450,0,74,132
1,2023,1961,62,0,18,56
1,1726,1691,35,0,8,73
-1,1736,1686,50,-2,-9,46
1,1446,1499,-53,0,15,73
1,1495,1738,-243,1,323,101
-1,1507,1603,-96,-4,-374,90
1,1589,1602,-13,0,248,85
1,1952,1608,344,1,20,47
-1,1838,2067,-229,0,15,88
1,2034,1686,348,-5,-9,103
-1,1766,1712,54,-1,-31,54
1,1582,1436,146,1,40,61
1,1583,1522,61,-6,-174,67
1,1824,1500,324,0,2,87
-1,1474,1710,-236,-1,-496,100
1,1569,1527,42,-2,31,133
1,1434,1829,-395,1,378,101
-1,1453,1459,-6,-3,-182,54
1,1423,1359,64,-1,-14,45
-1,1534,1782,-248,-5,-49,44
1,1605,1736,-131,0,-83,77
-1,1873,2037,-164,-3,-183,90
-1,1604,1955,-351,-7,-408,68
-1,1683,1809,-126,-4,-69,68
1,1624,1470,154,-4,339,129
1,1491,1470,21,3,127,55
1,1409,1508,-99,6,111,45
-1,1577,1504,73,0,16,70
-1,1610,1708,-98,-1,-180,88
1,1758,1629,129,0,-4,61
1,1819,1675,144,-1,-4,73
-1,1658,1672,-14,-1,11,142
1,1631,1565,66,0,46,47
-1,1953,1866,87,1,42,74
-1,1455,1528,-73,-1,-54,68
1,1513,1592,-79,-1,986,107
-1,1724,1753,-29,-1,-49,76
-1,1700,1682,18,0,-132,116
1,1588,1698,-110,-1,-5,49
1,1519,1562,-43,0,22,61
-1,1545,2044,-499,-2,-441,94
-1,1640,1829,-189,0,18,84
1,1714,1527,187,3,113,71
1,1721,1764,-43,2,82,67
1,1752,1482,270,1,66,45
-1,1282,1611,-329,-3,-259,92
-1,1680,1326,354,0,-86,80
1,1357,1317,40,4,169,65
-1,1548,1532,16,-5,-45,64
-1,1808,2046,-238,-1,24,70
1,1958,1640,318,2,77,69
1,1600,1706,-106,0,119,65
-1,1720,1435,285,1,28,44
1,2167,1500,667,0,-68,167
-1,1261,1224,37,6,154,52
0,1556,1376,180,3,855,120
-1,1937,1938,-1,0,-113,62
-1,1349,1557,-208,-2,-56,76
-1,1579,1527,52,-6,-202,52
1,1714,1756,-42,0,28,69
1,1831,1841,-10,0,1,59
1,1668,1752,-84,1,76,65
1,2051,1803,248,1,26,77
1,1952,1924,28,-4,22,63
0,1514,1460,54,8,643,89
-1,1548,1532,16,-2,-47,66
1,1157,1301,-144,0,4,53
-1,1588,1366,222,-3,-14,52
-1,1578,2113,-535,0,-5,60
1,1387,1596,-209,-2,47,109
1,1956,2098,-142,0,488,113
-1,2036,2098,-62,-7,-157,54
1,1754,1638,116,0,9,67
-1,1650,1874,-224,2,35,61
1,2013,1991,22,0,16,71
-1,1905,2026,-121,0,68,62
-1,1413,1485,-72,0,-18,64
-1,1500,1657,-157,1,3,54
1,2082,2109,-27,0,49,111
1,1415,0,1415,14,358,49
1,1752,1588,164,3,329,155
1,1627,1511,116,-1,259,85
1,1950,1628,322,3,172,73
1,1485,1549,-64,5,620,117
1,1647,1547,100,6,87,43
1,1879,1645,234,1,50,47
-1,1442,1485,-43,-3,-44,44
1,2094,2080,14,0,-79,105
1,1736,1666,70,-1,-136,67
1,1713,1662,51,4,212,69
1,1536,1483,53,13,344,55
-1,1425,1605,-180,-4,-105,58
-1,1899,2066,-167,0,-9,76
-1,1799,1972,-173,-5,-433,142
1,1472,1472,0,-1,410,121
-1,1640,1884,-244,1,20,64
-1,1625,1953,-328,0,-314,80
-1,1500,2068,-568,-3,-156,60
-1,1761,1630,131,-4,-25,42
-1,1533,1655,-122,-1,-174,110
1,1657,1745,-88,3,77,49
1,1377,1552,-175,5,131,45
1,1611,1417,194,16,697,67
-1,2025,2075,-50,-1,36,62
1,1979,1476,503,-3,116,59
-1,2072,1893,179,0,-69,84
-1,1641,1755,-114,0,-46,64
-1,1448,1981,-533,0,34,70
1,1778,1456,322,12,653,89
-1,1444,1601,-157,-6,-39,42
1,2055,1635,420,0,243,113
1,1653,1547,106,-1,104,63
-1,1841,1369,472,-1,-184,72
1,1765,1393,372,-8,-21,45
-1,1746,1888,-142,-10,-128,50
-1,1503,1635,-132,-3,-178,87
0,1983,2070,-87,0,12,95
-1,1693,1394,299,-2,4,44
-1,1500,1322,178,0,-160,86
-1,1555,1815,-260,1,-923,134
-1,1633,1552,81,0,13,68
1,1426,1528,-102,-4,26,103
-1,1759,1457,302,1,-503,122
1,2067,1764,303,-1,81,123
-1,1461,1550,-89,0,-17,56
1,2066,1987,79,0,-55,71
1,1332,1463,-131,11,494,69
1,1794,1560,234,-1,-52,65
1,1986,1463,523,-11,-203,43
-1,1767,1503,264,-2,-113,70
-1,1633,1536,97,0,-18,70
-1,1730,1671,59,-4,-273,95
-1,1156,1449,-293,-7,-141,42
-1,1437,1608,-171,-7,-180,55
-1,1977,2078,-101,-5,-795,130
1,1488,1377,111,-1,7,79
1,1925,1638,287,1,44,60
-1,1622,1698,-76,-5,-61,46
1,1581,1759,-178,1,122,99
1,1763,1544,219,1,18,41
-1,1347,1337,10,0,106,64
-1,1968,2089,-121,0,-20,86
1,1434,1194,240,4,69,45
-1,2048,2071,-23,0,-117,90
1,1824,1878,-54,0,374,111
-1,1369,1645,-276,-4,-199,66
1,1960,2099,-139,-1,-76,99
0,1550,1618,-68,1,238,117
-1,1342,1568,-226,0,-19,74
1,1735,1348,387,0,96,135
1,2037,2083,-46,0,131,73
1,1475,1344,131,0,92,63
-1,1495,1294,201,2,-1023,190
1,1649,1495,154,1,231,109
-1,1598,1497,101,4,50,74
1,2050,1977,73,6,97,45
-1,1515,1468,47,-1,-63,64
1,1780,1723,57,1,-4,72
-1,1365,1646,-281,0,-277,86
-1,1483,1189,294,-4,-390,74
-1,1635,1546,89,-1,-9,44
-1,1680,1933,-253,0,-1,54
1,1967,2060,-93,-2,-295,113
1,1486,1489,-3,-1,-64,97
-1,1423,1648,-225,-1,-655,178
0,1643,1663,-20,-5,-78,46
1,1938,1752,186,0,4,70
-1,1773,1573,200,-2,-64,58
1,1482,1408,74,-1,256,147
1,2079,1916,163,-1,-56,87
-1,1426,2045,-619,-6,-227,82
-1,1559,1621,-62,2,118,70
1,2095,1902,193,0,100,75
1,1616,1552,64,0,269,133
-1,1808,1816,-8,1,-63,62
1,1717,1439,278,3,83,51
-1,1500,1519,-19,-3,-5,44
1,1891,1682,209,0,-34,103
-1,1908,2087,-179,2,19,62
1,1739,1577,162,-2,-172,79
-1,1738,1486,252,0,-10,60
-1,1591,1669,-78,0,-265,106
-1,1709,1787,-78,-3,-181,62
-1,2046,1895,151,2,-58,76
1,1275,1253,22,1,100,62
-1,1590,1753,-163,-4,-23,94
1,1721,1410,311,0,-52,83
1,1671,1374,297,6,355,71
1,1529,1982,-453,0,11,63
1,1500,1363,137,-3,516,101
1,1944,1599,345,0,37,99
1,1913,2030,-117,2,57,103
-1,1742,1865,-123,1,-67,116
-1,1827,1798,29,0,11,76
1,1960,1556,404,0,-31,71
-1,1785,2059,-274,-1,-82,76
-1,1832,1699,133,0,-138,78
-1,1766,1625,141,-1,-12,42
-1,1500,1575,-75,2,1,80
1,1630,1550,80,-1,-270,97
-1,2014,1929,85,-2,-54,50
-1,1457,1500,-43,-6,-252,76
1,1543,1625,-82,8,239,71
1,1761,1584,177,0,15,77
-1,1944,2000,-56,1,73,84
1,1596,1947,-351,-3,108,93
-1,1468,1174,294,1,-133,104
-1,1461,1642,-181,-4,-139,48
-1,1478,1522,-44,-3,46,70
1,1962,1641,321,0,-164,95
1,1471,1670,-199,0,143,103
-1,1388,1725,-337,0,-48,82
-1,2010,1934,76,0,-42,72
1,1623,1276,347,7,935,91
1,1781,1810,-29,0,-24,89
1,1760,1669,91,0,53,57
1,1689,1768,-79,6,254,69
1,1625,1459,166,2,176,97
1,1949,1996,-47,0,-1,65
-1,2014,2063,-49,1,10,62
1,1677,1555,122,-4,17,65
1,1500,2254,-754,-1,185,77
-1,1490,1966,-476,-3,-66,62
-1,1287,1386,-99,-2,-103,66
-1,1983,1962,21,-4,-579,94
1,1926,1616,310,0,-11,57
1,1611,1557,54,-1,17,47
-1,1792,1967,-175,0,-136,108
1,2230,1455,775,-2,62,77
1,2138,2069,69,-1,-295,113
0,1625,1658,-33,-7,451,207
-1,1412,1488,-76,-1,-56,62
1,1704,1532,172,-1,297,107
-1,1676,1897,-221,1,5,58
-1,1684,1789,-105,-5,-284,98
1,1981,1754,227,2,23,49
-1,1414,1975,-561,-7,-411,86
-1,1929,2073,-144,0,74,100
-1,1371,1675,-304,-1,-328,72
1,1793,1771,22,-9,-13,77
1,1728,1587,141,-2,619,151
1,1976,1398,578,0,51,61
1,1608,1425,183,3,376,99
1,1775,1674,101,0,-78,101
-1,1790,2231,-441,-1,-87,116
-1,1526,1711,-185,0,-831,184
-1,1665,1664,1,-14,-208,42
-1,1396,1530,-134,0,-27,68
1,1582,1716,-134,0,117,117
-1,1385,1978,-593,0,-290,100
1,1446,1452,-6,2,565,169
-1,1762,1986,-224,-2,-20,110
-1,1676,1405,271,-1,-12,60
1,1416,1427,-11,-4,110,91
-1,1472,1340,132,4,240,70
1,1438,1385,53,-3,-82,61
-1,1788,2233,-445,1,44,58
-1,1394,1539,-145,-5,-471,93
-1,1562,1746,-184,-2,-38,50
-1,1979,1970,9,-11,-101,96
1,1492,1477,15,1,120,46
1,2080,1922,158,0,-73,61
1,2236,1786,450,-10,-24,49
1,1711,1426,285,1,354,93
1,1734,1527,207,-2,172,73
1,1621,1548,73,4,166,55
-1,1872,1648,224,1,-140,98
-1,1982,1966,16,-5,-233,106
1,1657,1617,40,15,649,61
-1,1784,2239,-455,0,78,98
-1,1374,1448,-74,-5,-361,66
-1,1696,1613,83,0,258,110
1,1667,1607,60,7,362,61
1,1979,1970,9,-1,-134,81
-1,1278,1076,202,-4,-209,108
-1,1683,1789,-106,-1,-44,86
1,1641,1500,141,-2,-43,43
-1,1491,1521,-30,-6,-397,76
1,1760,1989,-229,0,15,67
-1,1959,1991,-32,-2,-159,68
1,1457,1365,92,0,75,65
-1,1500,2243,-743,-3,-78,60
-1,1923,2094,-171,0,12,78
1,1935,2050,-115,0,-4,57
1,1915,1734,181,5,96,45
-1,1736,1675,61,-12,-30,40
-1,1489,1633,-144,0,1,49
-1,1740,1683,57,3,154,90
-1,2002,1949,53,-2,-83,76
-1,1457,1626,-169,0,-63,71
-1,1494,1667,-173,0,-37,64
-1,1640,1787,-147,-6,-189,122
1,1550,1367,183,5,614,79
-1,1662,1542,120,1,-29,146
-1,1688,1721,-33,1,36,68
1,1796,1674,122,0,-158,101
1,1962,1988,-26,0,42,79
1,1664,1696,-32,0,-28,67
1,2244,1489,755,0,44,55
-1,1826,1639,187,-2,-173,106
-1,1728,1921,-193,0,6,50
-1,1466,1678,-212,1,-123,94
-1,1520,1547,-27,-5,-146,110
-1,1597,1752,-155,-1,-40,63
-1,1976,1974,2,0,-145,104
-1,1531,1328,203,1,-154,100
1,1488,1681,-193,-2,19,46
-1,1949,1991,-42,-1,-40,66
-1,1685,1633,52,-8,-202,78
1,1580,1520,60,3,315,105
-1,1643,1504,139,1,45,42
1,1689,1638,51,5,463,123
1,1686,1438,248,0,14,79
1,1985,1964,21,-1,130,73
1,1666,1500,166,3,27,49
-1,1671,1596,75,0,93,102
-1,1974,1795,179,-4,-121,54
-1,1363,1294,69,-4,-176,64
1,1732,1678,54,-1,-7,49
1,2100,1917,183,0,0,67
-1,1804,1571,233,-2,-144,84
1,1624,1260,364,16,289,47
1,1571,1614,-43,-3,57,113
1,1927,1723,204,-2,-44,53
-1,1073,1640,-567,-1,8,41
1,1953,1995,-42,0,37,103
-1,1940,1771,169,0,-13,50
1,1760,1695,65,2,47,51
1,1257,1627,-370,-10,-369,56
1,1956,1679,277,-4,-56,75
-1,1669,1742,-73,-5,-161,54
1,1983,1966,17,4,22,43
-1,1639,1512,127,-3,-322,88
-1,1558,1510,48,-6,-261,62
-1,1498,1360,138,-2,-188,90
-1,1729,1844,-115,-1,-48,70
1,1909,1632,277,0,-2,113
-1,1557,1671,-114,0,-23,52
-1,1587,1786,-199,5,-110,92
-1,1645,1752,-107,-3,-80,40
-1,1519,1412,107,-3,-261,91
1,1707,1865,-158,-1,9,51
-1,1911,2106,-195,-1,-73,102
1,2001,1826,175,3,296,95
-1,1523,1545,-22,-6,-274,52
1,1759,1460,299,1,44,57
-1,1510,1589,-79,0,-92,125
-1,1412,1693,-281,-6,-443,86
1,1285,1128,157,0,208,75
1,1648,1661,-13,0,21,47
1,1792,1516,276,1,20,51
1,1429,1202,227,-1,-96,77
1,1457,1505,-48,1,255,85
-1,1640,1644,-4,0,-199,120
1,1415,1434,-19,-2,-129,65
-1,1512,1796,-284,0,-36,62
-1,2138,1969,169,-2,-79,76
-1,1750,1960,-210,0,-15,74
-1,1571,1781,-210,-8,-349,66
1,1281,1151,130,4,78,53
-1,1493,1494,-1,-3,-92,56
1,1503,1565,-62,6,117,53
1,1614,1304,310,0,46,83
1,1596,1679,-83,0,5,59
-1,1622,1735,-113,0,-17,70
1,1787,1676,111,0,-5,83
1,1625,1361,264,1,85,74
-1,1557,1540,17,0,10,58
1,1482,1548,-66,1,33,43
1,1640,1656,-16,2,336,79
-1,1481,1396,85,-2,-54,64
1,1867,1852,15,-1,-52,95
-1,1591,1654,-63,-2,-179,98
1,2099,2112,-13,0,-29,69
-1,1552,1516,36,-8,-168,42
1,1697,1406,291,1,493,121
1,2246,1611,635,5,204,93
-1,1745,1553,192,-5,-191,86
-1,1957,1906,51,-1,-99,66
1,1572,1636,-64,0,5,65
-1,1611,2247,-636,-2,-150,60
-1,1566,1967,-401,0,-26,76
-1,1597,1610,-13,-7,-493,102
1,1551,1545,6,0,118,99
1,1918,2100,-182,0,153,117
-1,1913,1851,62,0,-18,64
-1,1529,1539,-10,-7,-107,52
1,1969,1340,629,0,-31,61
1,1958,1637,321,0,59,63
1,1467,1638,-171,-4,-368,73
-1,1795,1482,313,-6,-306,76
1,1933,1934,-1,1,60,113
-1,1412,1357,55,-12,-677,72
-1,1743,1815,-72,-3,-45,48
-1,1339,1970,-631,2,40,42
1,1799,1667,132,-1,-50,65
1,1288,1458,-170,0,8,49
-1,1645,1581,64,-1,-140,76
0,1723,1610,113,-1,18,63
1,1971,1339,632,0,-22,71
-1,1775,1834,-59,-4,-174,50
1,1501,1668,-167,0,-6,85
0,1584,1627,-43,0,-23,91
-1,1326,1060,266,3,235,94
1,1787,1707,80,0,10,95
1,1401,1701,-300,0,50,49
-1,1338,1971,-633,-5,-78,68
-1,1526,1634,-108,1,27,49
-1,1549,1519,30,-4,6,46
1,1844,1638,206,-1,343,115
0,1407,1665,-258,0,9,86
0,1576,1628,-52,1,35,79
1,1760,1563,197,1,78,83
-1,1652,1517,135,0,-118,114
1,1972,1337,635,-1,-36,57
1,1717,1573,144,0,41,71
1,1923,1945,-22,0,-21,97
1,1497,1420,77,-2,-64,69
1,1982,1660,322,0,-10,85
1,1807,1628,179,-1,-63,73
1,1626,1585,41,0,108,89
1,1399,1405,-6,5,598,107
1,1743,1609,134,0,195,99
-1,1428,1476,-48,-3,-544,90
-1,1336,1973,-637,1,-7,64
-1,1500,1668,-168,-1,-13,50
0,2112,1934,178,-2,39,122
-1,1661,1733,-72,-2,-46,42
-1,1627,1699,-72,-3,-17,46
1,1974,1336,638,0,14,63
-1,1627,1854,-227,2,-137,80
-1,1656,1682,-26,-2,-197,140
-1,1370,1595,-225,0,-104,90
-1,1534,1562,-28,-7,-513,210
1,1152,0,1152,-4,309,201
-1,1532,1637,-105,0,-19,62
1,1575,1636,-61,-5,125,57
-1,1628,1500,128,0,-34,57
-1,1978,1749,229,-3,-63,50
-1,1335,1975,-640,-3,-16,62
-1,1485,1613,-128,-16,-225,44
1,1645,1524,121,3,85,43
-1,1719,1824,-105,0,-26,66
-1,1708,1618,90,0,-7,84
1,1975,1334,641,3,120,67
-1,1517,1652,-135,-3,-67,44
1,1742,1652,90,4,253,75
1,1586,1501,85,-2,25,85
-1,1588,1717,-129,1,-17,92
1,1659,1510,149,1,180,95
-1,1334,1976,-642,1,46,48
1,1782,1445,337,1,93,53
0,1544,1578,-34,-2,-27,140
1,1620,1476,144,0,19,67
1,1657,1414,243,1,10,41
1,1766,1648,118,0,16,43
1,1977,1333,644,0,0,73
-1,1582,1714,-132,-6,-213,54
1,1958,1496,462,0,80,69
-1,1548,1441,107,0,-36,50
-1,1332,1978,-646,1,43,56
-1,1305,1360,-55,-14,-352,54
1,1694,1499,195,1,191,111
1,1537,1534,3,6,135,45
-1,1519,2078,-559,0,-109,76
-1,1640,1774,-134,0,30,72
1,1945,1650,295,-2,-33,49
-1,1430,1553,-123,0,-134,86
-1,1693,1943,-250,0,9,54
-1,1832,1728,104,0,-229,96
-1,1416,1386,30,-2,-3,40
0,1750,1553,197,-1,-295,161
-1,1515,1640,-125,-1,-161,83
1,1575,1750,-175,0,527,153
-1,1643,1751,-108,-7,-111,47
-1,1939,2083,-144,-2,-116,80
1,1711,1377,334,1,52,43
1,1726,1581,145,3,118,60
-1,1742,1779,-37,0,-199,106
-1,1572,1210,362,2,27,76
1,1530,1731,-201,0,-19,63
-1,1426,1797,-371,-1,-17,44
1,1500,1416,84,0,-81,103
1,1547,1556,-9,2,-132,77
-1,1524,1699,-175,1,-107,70
0,1518,1949,-431,-5,-287,126
-1,1398,1404,-6,-3,-134,100
-1,1812,1732,80,-1,-72,70
-1,1469,1627,-158,-1,11,49
1,1799,1423,376,-1,298,113
-1,1745,1770,-25,1,-94,68
1,2090,1932,158,0,83,89
1,1691,1715,-24,-3,-73,49
-1,1788,1693,95,0,-8,78
-1,2098,1935,163,-3,-31,44
1,1638,1589,49,0,-17,63
1,1715,1629,86,1,36,47
1,1692,1552,140,4,24,41
-1,1330,1295,35,-5,-478,112
-1,1526,1279,247,-10,-210,62
-1,1526,1940,-414,-8,-148,42
-1,1228,1463,-235,-5,-87,44
1,1937,1528,409,3,44,43
1,1699,1528,171,-5,-21,65
1,1942,1524,418,4,158,53
0,1545,1370,175,4,374,97
1,1488,1627,-139,1,32,47
-1,1394,1231,163,-17,-276,40
-1,1582,1449,133,-3,-152,108
-1,1522,1706,-184,0,-9,66
1,1494,1491,3,-3,-205,69
-1,1926,2097,-171,-1,-3,66
1,1767,1500,267,5,46,40
-1,1471,1545,-74,0,2,56
-1,1724,1619,105,-5,-17,40
1,1582,1685,-103,1,140,131
1,1947,1519,428,-1,-100,97
-1,1633,1462,171,-1,-507,108
1,1493,1403,90,-1,-29,57
-1,1299,1507,-208,-2,-71,54
-1,1534,1693,-159,0,164,90
1,1506,1249,257,6,53,43
1,1568,1464,104,1,301,77
-1,1517,1950,-433,-5,-237,63
-1,1712,1646,66,0,51,126
-1,1615,1456,159,4,14,66
-1,1138,1376,-238,-3,-943,144
1,1635,1759,-124,-1,-14,61
1,1698,1663,35,-1,-17,71
0,1620,1649,-29,-1,-153,124
1,1376,1513,-137,16,1075,85
-1,1684,1515,169,-2,-28,52
-1,1495,1772,-277,1,32,44
1,1776,1700,76,-1,3,57
-1,1514,1505,9,-5,-71,62
1,1509,1479,30,-2,517,161
1,1640,1708,-68,0,-19,53
-1,1674,1636,38,0,5,52
-1,1774,1859,-85,-1,-11,46
-1,1463,1601,-138,0,15,52
1,2006,1874,132,0,22,55
-1,2007,2103,-96,-1,6,68
-1,1503,1582,-79,-2,-127,98
-1,1533,1668,-135,1,-45,114
1,1554,1487,67,-2,67,135
-1,1414,1527,-113,0,-68,90
1,1611,1650,-39,-2,163,82
1,1638,1527,111,5,-236,97
1,1516,1503,13,7,278,59
1,1813,1509,304,-1,-131,91
1,1513,1293,220,13,325,55
-1,1483,1528,-45,-1,-14,54
-1,1390,1260,130,-32,-1042,52
1,1705,1648,57,0,157,67
1,1708,1455,253,10,744,85
-1,1765,1815,-50,-4,-197,82
-1,1513,1744,-231,-4,-318,82
-1,1500,1705,-205,-2,77,56
1,1648,1621,27,0,179,107
-1,1789,1998,-209,-2,-27,43
1,1507,1609,-102,-1,104,147
-1,1519,1521,-2,-1,6,66
-1,1618,1662,-44,-1,-222,76
-1,1424,1544,-120,0,-67,52
1,1816,1499,317,-9,61,123
-1,1920,2112,-192,-1,-31,58
1,1630,1715,-85,-2,22,51
1,1500,1319,181,3,117,49
1,1430,1591,-161,-1,331,119
-1,1200,1196,4,-7,-243,52
1,1777,1484,293,0,38,57
1,1288,1518,-230,5,174,57
-1,1563,1691,-128,-1,-24,56
-1,1504,1687,-183,-4,-190,54
-1,1699,1682,17,0,-209,86
1,1701,1655,46,2,54,55
-1,1651,1781,-130,0,-35,86
-1,1502,1597,-95,-6,-77,52
1,1433,1469,-36,-8,-36,63
-1,1154,1684,-530,-3,-696,138
1,1467,1349,118,0,346,137
-1,1638,1711,-73,1,61,66
-1,1707,1648,59,-2,-90,96
1,1376,1283,93,1,153,67
1,1820,1735,85,0,25,57
-1,1621,1624,-3,-2,-107,68
1,1598,1573,25,0,309,167
1,1308,1381,-73,8,556,109
-1,2117,1914,203,-6,-172,94
1,2067,1719,348,0,102,67
0,1534,1406,128,-13,-1046,155
1,1623,1867,-244,-3,-29,53
1,1643,1371,272,0,4,63
-1,1500,1905,-405,-1,-121,125
1,1558,1556,2,3,-61,93
-1,1724,1828,-104,-3,-247,92
1,1514,1500,14,0,-1,45
1,2071,1653,418,1,75,75
1,1710,1611,99,4,195,69
1,1850,1479,371,16,254,41
1,1615,1627,-12,8,189,57
1,1584,1582,2,6,248,45
-1,1774,2003,-229,0,-94,88
-1,1424,1537,-113,1,37,72
1,1889,1874,15,0,0,75
-1,1571,1526,45,-9,-168,56
1,1733,1541,192,-3,-48,47
-1,1757,1722,35,0,-358,106
1,1618,1485,133,6,450,93
1,1602,1602,0,2,123,61
-1,1946,1877,69,0,-4,52
1,1814,1707,107,0,24,93
-1,1242,1296,-54,6,180,42
-1,1530,1662,-132,-1,-154,102
-1,1382,1558,-176,-2,-103,74
1,1624,1494,130,1,135,127
-1,1988,1752,236,-3,-323,82
-1,1180,1740,-560,-3,-93,60
1,1749,1321,428,1,27,63
-1,1517,1429,88,-1,-84,134
1,1437,1214,223,1,51,53
1,1641,1714,-73,0,501,115
1,1895,1545,350,0,18,81
-1,1533,1576,-43,-5,-186,68
1,1704,1650,54,4,169,65
-1,1496,1561,-65,-9,-26,41
1,1704,1355,349,1,61,43
-1,1312,1376,-64,-10,-564,86
1,1890,1933,-43,-2,-40,43
-1,2009,1768,241,1,-233,126
1,1641,1694,-53,-1,-80,83
1,1671,1565,106,1,40,53
1,1532,1542,-10,4,435,107
-1,1589,1476,113,0,-287,164
1,1686,1259,427,0,4,87
-1,1700,1654,46,2,-61,82
1,1767,1511,256,2,188,69
1,1988,1818,170,0,7,89
1,1699,1500,199,-2,-82,91
1,1495,1584,-89,0,-145,89
1,1408,1213,195,3,124,55
-1,1920,1902,18,0,3,42
1,1269,1386,-117,0,39,65
-1,1750,1676,74,-1,-121,68
1,1653,1319,334,7,337,71
-1,1530,1449,81,2,58,56
1,1699,1503,196,0,241,137
1,1238,1469,-231,3,199,93
-1,1450,1676,-226,-3,-144,80
1,1995,1934,61,0,-159,71
1,1698,1656,42,-1,1,119
-1,1529,1916,-387,0,-1,52
-1,1913,1909,4,0,21,84
-1,2013,1990,23,0,-5,72
1,1679,1496,183,1,34,55
1,1556,1569,-13,2,293,81
-1,1641,1472,169,-8,-221,58
-1,1631,1640,-9,-2,-40,50
1,1661,1208,453,0,41,51
-1,1527,2006,-479,-2,-149,102
1,1477,1300,177,1,-10,43
1,1523,1500,23,-3,-153,59
1,1593,1414,179,1,60,55
1,1717,1657,60,2,30,51
1,1346,1385,-39,1,22,41
-1,1525,1922,-397,-1,-99,80
-1,1737,1829,-92,2,-191,76
1,1705,1689,16,-1,155,87
1,1682,1443,239,-1,38,59
-1,1649,1478,171,-4,-128,54
1,1540,1463,77,-1,-15,47
1,1539,1587,-48,0,91,80
1,1600,1407,193,0,-2,45
-1,1451,1257,194,-7,-70,44
0,1656,1401,255,-2,-11,118
-1,1497,1704,-207,-2,-488,106
1,1513,1596,-83,-7,-425,83
-1,1963,2007,-44,-3,-227,82
1,1444,1346,98,-5,-73,58
-1,1606,1515,91,-3,-903,112
-1,1510,1511,-1,-1,-308,78
-1,1530,1573,-43,0,-32,56
-1,1422,1373,49,-2,-160,98
-1,1622,1569,53,-6,-282,66
-1,2018,1957,61,1,88,64
-1,1530,1591,-61,0,3,42
1,1931,1835,96,-2,-90,77
-1,1562,1664,-102,-2,-611,128
-1,1708,1952,-244,-3,-52,46
-1,1689,1663,26,-1,-42,56
-1,1442,1671,-229,-24,-957,68
-1,1557,1550,7,-2,-185,74
1,2004,1881,123,0,-1,63
1,1837,2002,-165,1,49,65
-1,1522,1664,-142,-1,-110,138
1,1739,1521,218,16,818,69
1,1601,1436,165,7,571,85
-1,1437,1370,67,0,-70,161
1,1676,1522,154,4,178,61
1,1500,1360,140,1,83,55
1,1490,1535,-45,0,1,67
1,1685,1417,268,0,134,77
-1,2012,1924,88,-3,-266,92
1,1608,1311,297,3,68,43
-1,1429,1607,-178,-6,-219,62
-1,1349,2099,-750,0,29,64
-1,1516,1666,-150,-2,-323,78
-1,1431,1707,-276,-6,-377,70
1,1510,1500,10,3,177,59
-1,1920,1852,68,0,-8,62
-1,1619,1508,111,1,-86,68
1,1520,1497,23,2,99,79
1,1613,1717,-104,0,9,49
-1,2063,1985,78,3,63,50
-1,1125,1406,-281,-11,-60,42
1,1617,1535,82,0,177,68
1,1874,2007,-133,0,-14,65
-1,1490,1671,-181,3,142,62
1,1338,1453,-115,-1,-1,55
0,1665,1877,-212,-9,-25,142
-1,1744,1676,68,-7,-238,42
1,1789,1349,440,-4,356,119
1,1647,1487,160,3,248,85
1,1564,1509,55,8,210,57
-1,1562,1546,16,-1,-321,152
-1,1522,1503,19,-3,-272,98
1,1695,1731,-36,1,60,61
1,1710,2010,-300,4,65,51
1,1493,1651,-158,1,17,97
1,1726,1242,484,1,0,53
1,1441,1410,31,3,220,57
1,1417,1683,-266,-3,-124,71
1,1991,1889,102,-1,-37,59
-1,1461,1579,-118,-4,-116,54
-1,1677,1496,181,-1,-96,66
-1,1679,1807,-128,0,-285,108
-1,1863,2150,-287,0,-54,132
1,2147,1312,835,-1,-2,57
-1,1656,1587,69,-6,-70,96
-1,1881,1999,-118,-2,-66,52
-1,1628,1791,-163,-1,90,59
1,1437,1582,-145,0,84,65
1,1639,1528,111,0,108,103
1,1719,1874,-155,-2,20,69
1,1713,1713,0,0,195,85
1,1433,1278,155,7,343,71
-1,1525,1771,-246,-2,-429,92
1,1865,1907,-42,-2,-36,75
1,1554,1284,270,6,149,57
1,1714,1329,385,4,172,71
-1,1995,2035,-40,-1,-572,120
-1,1531,1248,283,-8,-54,42
-1,1276,1791,-515,-2,-181,82
-1,1664,1679,-15,2,205,82
1,1631,1421,210,4,72,47
1,1515,1312,203,1,323,75
-1,1231,1728,-497,0,169,112
1,1990,1855,135,2,467,97
-1,1684,1703,-19,1,-16,88
-1,1646,1753,-107,-14,-398,54
1,1463,1526,-63,0,145,77
1,1735,1776,-41,0,29,81
-1,1353,1671,-318,-2,29,64
-1,1702,1728,-26,0,-299,134
1,1639,1766,-127,1,75,81
1,1737,1475,262,0,71,69
1,1894,1936,-42,0,42,73
1,1512,1304,208,0,125,81
1,1705,1516,189,0,-2,71
-1,1654,1737,-83,-10,-211,82
1,1638,1279,359,0,14,47
-1,1877,1627,250,0,-30,76
-1,1372,1507,-135,5,-35,100
-1,1276,1641,-365,-8,-55,44
1,1689,1619,70,1,479,133
-1,1407,1438,-31,-1,-13,60
1,1639,1514,125,0,142,63
1,1704,1809,-105,2,122,51
1,1799,1631,168,-2,53,49
1,1518,1419,99,2,27,47
1,1744,1742,2,-1,48,105
-1,1658,1484,174,-2,-232,136
-1,1689,1603,86,-9,-375,150
-1,1290,1814,-524,-2,-82,64
1,1624,1806,-182,0,208,133
-1,1524,1520,4,-3,-404,94
1,1747,1821,-74,0,2,115
-1,1279,1559,-280,1,-105,66
-1,1793,1274,519,2,62,42
1,1772,1510,262,3,106,57
1,1517,1743,-226,-1,57,77
1,1168,1378,-210,3,67,43
-1,1918,1906,12,0,-153,96
-1,1655,1860,-205,-1,-22,58
-1,1653,1643,10,-2,-204,68
1,1474,1325,149,0,-1,59
1,1510,1613,-103,-5,-128,47
1,1644,1702,-58,0,162,91
1,1652,1488,164,3,223,137
1,1486,1735,-249,-1,-8,55
1,1725,1631,94,2,66,63
-1,1675,1730,-55,-5,-298,76
-1,1640,1421,219,-2,-32,50
-1,1602,1670,-68,0,10,54
-1,1170,2107,-937,0,-99,86
1,1534,1361,173,1,48,53
1,1803,1637,166,0,-55,79
1,1352,1306,46,2,634,111
1,1728,1408,320,12,207,43
1,1884,1787,97,1,-194,101
1,1733,1622,111,1,212,97
-1,1768,1699,69,8,301,66
-1,1359,1531,-172,-5,-32,40
-1,1413,1241,172,-11,-376,71
-1,1760,1687,73,-3,-173,78
1,2107,1168,939,4,263,79
0,1918,1903,15,1,50,115
1,1544,1562,-18,2,118,89
-1,1823,1883,-60,3,134,92
0,1892,1778,114,2,-674,125
-1,1526,1717,-191,0,3,48
1,1480,1206,274,7,215,59
1,1565,1275,290,2,217,83
1,1639,1870,-231,0,0,59
-1,1620,1672,-52,-3,-280,180
1,1732,1710,22,4,93,55
-1,1664,1666,-2,7,119,58
-1,1677,1657,20,0,-4,64
0,1541,1502,39,-2,-757,156
-1,1700,1747,-47,-14,-609,74
1,1782,1889,-107,1,127,67
-1,1641,1527,114,0,15,62
-1,1841,1505,336,-1,-37,52
-1,1670,1665,5,1,28,56
1,1240,1151,89,7,289,73
1,1778,1587,191,-3,-12,43
1,1700,1746,-46,2,156,95
1,1659,1475,184,1,116,61
-1,1798,1875,-77,0,9,42
0,1429,1500,-71,-5,-587,157
1,1902,1917,-15,0,-3,47
1,1756,1903,-147,2,169,89
1,1883,1788,95,-3,-12,59
-1,1648,1600,48,2,124,70
1,1811,1712,99,3,99,55
-1,1484,1306,178,7,135,56
-1,1504,1537,-33,-3,-139,68
-1,1612,1865,-253,0,-24,52
1,1693,1853,-160,0,6,47
-1,1730,1929,-199,-4,-71,70
-1,1779,1891,-112,-3,-180,72
-1,1642,1684,-42,0,88,120
1,1535,1604,-69,-3,-13,41
1,1500,1425,75,-2,-52,53
-1,1607,1625,-18,2,103,60
1,1906,1913,-7,-1,49,51
1,1276,1500,-224,-3,93,77
-1,1596,1690,-94,1,-301,124
1,1676,1612,64,0,33,47
1,1734,1549,185,4,379,101
-1,1883,1730,153,2,28,64
1,1636,1595,41,0,-4,56
-1,1591,1822,-231,-1,-90,80
1,1801,1651,150,1,13,55
-1,1770,1899,-129,-1,25,50
-1,1469,1665,-196,-1,-156,94
1,1997,1870,127,-2,-30,55
1,1500,1595,-95,-1,-84,65
-1,1316,1608,-292,-1,-75,64
1,1640,1661,-21,1,29,45
-1,1837,1709,128,-4,-312,122
-1,1658,1746,-88,-2,-154,90
-1,1464,1419,45,-1,-37,84
1,1576,1712,-136,0,-751,111
-1,1270,1570,-300,3,28,46
-1,1584,1647,-63,2,142,55
1,1906,1763,143,0,13,49
-1,1581,1784,-203,-4,-30,62
-1,2062,1768,294,-5,-21,56
-1,1539,1590,-51,-1,-220,82
-1,1679,1501,178,3,-357,88
0,1819,1704,115,0,45,78
-1,1400,1375,25,1,-591,70
1,1632,1438,194,2,27,45
0,1913,1755,158,-11,-266,132
-1,1561,1608,-47,0,-190,110
-1,1518,1662,-144,0,-119,86
1,1113,1573,-460,0,24,54
-1,1699,1588,111,3,10,40
1,1787,1671,116,0,136,117
-1,1493,1546,-53,0,-15,48
0,1572,1686,-114,0,160,117
1,1760,1908,-148,-9,295,151
1,1633,1586,47,-1,97,151
1,1669,1511,158,-1,70,59
1,1697,1591,106,-6,-268,89
-1,1641,1931,-290,-2,-141,74
-1,1275,1142,133,-7,-207,50
1,1699,1696,3,3,156,65
1,1252,1552,-300,-1,-1,42
1,1387,1306,81,-2,-39,75
-1,1283,1547,-264,-10,-258,46
1,1586,1584,2,-8,239,103
-1,1728,1315,413,0,-210,98
1,1500,1510,-10,11,585,73
-1,1394,1553,-159,-3,23,42
-1,1499,1605,-106,-9,-847,94
1,1958,1614,344,5,496,77
1,1036,1249,-213,-5,-69,69
-1,1639,1830,-191,1,-28,98
-1,1735,1574,161,2,-200,100
-1,1641,1710,-69,1,35,62
1,1508,1234,274,5,202,63
1,1433,1374,59,-3,91,81
1,1641,1730,-89,0,162,113
0,1387,1546,-159,0,8,50
-1,1786,1630,156,-5,-733,120
1,1313,1281,32,10,427,68
1,1903,1642,261,-1,70,63
1,1534,1611,-77,13,451,61
-1,1528,1798,-270,-3,-122,56
1,1392,1530,-138,5,208,85
1,1228,1072,156,8,285,65
1,1491,1597,-106,1,406,93
-1,1364,1297,67,-6,-47,41
-1,1656,1695,-39,1,29,59
1,1596,1712,-116,1,245,96
1,1597,1532,65,2,249,113
1,1634,1230,404,4,59,43
1,1322,1390,-68,0,60,47
1,1672,1637,35,0,113,127
1,1700,1774,-74,-2,-147,113
1,1444,1509,-65,2,75,49
1,1771,1505,266,3,84,105
-1,1312,1356,-44,-3,-447,84
1,1659,1476,183,1,49,55
-1,1408,1238,170,-3,-22,60
-1,1228,1636,-408,-2,-283,66
-1,1612,1647,-35,0,8,66
-1,1369,1334,35,-2,-77,60
-1,1512,1459,53,-4,-181,70
1,1908,1836,72,4,105,45
-1,1705,1655,50,0,-9,74
-1,1484,1592,-108,-1,-22,46
1,1638,1225,413,4,401,123
1,1731,1761,-30,1,34,57
-1,1524,1619,-95,-3,-136,78
1,1455,1465,-10,0,7,64
-1,1827,1918,-91,-1,-156,90
-1,1486,1594,-108,-5,-235,94
1,1690,1615,75,2,537,141
1,1523,1606,-83,4,447,85
-1,1801,2033,-232,0,-73,72
-1,1749,1743,6,-2,3,52
1,1516,1837,-321,4,107,69
-1,1606,1712,-106,-2,-106,68
-1,2079,1714,365,1,19,50
1,1705,1603,102,0,-7,43
-1,1186,1223,-37,-3,-127,54
-1,1363,1582,-219,-3,-85,52
1,1775,1794,-19,0,4,55
-1,1353,1640,-287,-14,-899,80
1,1822,1598,224,0,74,87
1,2038,1796,242,0,10,63
1,1893,1656,237,6,152,51
1,1720,1593,127,0,8,53
-1,1652,1599,53,-1,-276,244
-1,1466,1629,-163,-1,-28,74
0,1787,1782,5,0,0,179
1,2168,1961,207,0,3,57
1,1754,1738,16,1,114,61
1,1499,1472,27,4,234,80
1,1674,1681,-7,3,205,97
-1,1234,1173,61,5,199,62
-1,1346,1351,-5,-1,-36,58
-1,1955,2174,-219,0,-40,60
-1,1585,1598,-13,-8,-274,60
1,1787,1588,199,-3,260,99
-1,1241,1308,-67,7,368,96
-1,1450,1655,-205,-3,-391,102
-1,1928,1705,223,0,3,84
-1,1593,1826,-233,-5,-415,80
-1,1667,1683,-16,0,-19,78
-1,1609,1574,35,-1,-32,52
-1,1614,1529,85,-3,-52,46
1,2180,1950,230,-1,3,53
-1,1476,1665,-189,-4,-128,72
1,1750,1627,123,-1,73,93
-1,1422,1529,-107,2,5,138
-1,1189,1220,-31,-6,-118,84
-1,1587,1596,-9,-3,-312,128
1,1894,1660,234,2,18,49
-1,1589,1564,25,-7,-921,128
-1,1437,1675,-238,0,22,74
1,1792,1755,37,-9,151,97
1,1854,1453,401,6,100,46
-1,1921,1815,106,-10,-234,118
1,1608,1576,32,1,242,91
0,1579,1577,2,-2,197,75
-1,1540,1414,126,6,159,72
1,1639,1588,51,11,275,57
-1,1355,1231,124,-8,-90,44
0,1427,1691,-264,0,58,96
-1,1911,2185,-274,-1,-1,72
1,1405,1551,-146,0,-25,59
1,1671,1526,145,6,781,113
1,1848,1778,70,-4,66,51
1,1441,1213,228,9,152,49
1,1277,1260,17,1,819,117
1,1791,1822,-31,3,55,46
1,1470,1707,-237,2,28,44
-1,1543,1908,-365,0,-128,114
-1,1476,1564,-88,-9,-110,56
-1,1374,1670,-296,-3,-1317,180
-1,1810,1804,6,1,11,50
-1,1808,1701,107,-5,-140,56
0,1518,1421,97,0,-5,74
-1,1266,1514,-248,1,-336,122
-1,1543,1500,43,-2,-21,56
-1,1758,1606,152,0,-91,72
-1,1687,1488,199,0,-161,168
1,1587,1491,96,0,73,51
1,1723,1620,103,-4,-7,77
-1,1519,1712,-193,-1,-24,58
-1,1340,1342,-2,-9,-232,50
1,1292,1414,-122,-2,61,67
1,1474,1522,-48,1,232,99
-1,1515,1573,-58,-1,-43,51
1,1911,1536,375,9,83,42
-1,1815,1799,16,-3,-3,54
-1,1467,1764,-297,2,-90,92
1,1784,2160,-376,5,400,99
1,1612,1319,293,0,29,71
-1,1644,1657,-13,-5,-86,68
-1,1594,1697,-103,1,-13,94
1,1857,1710,147,2,167,61
1,1375,1255,120,-3,-195,119
1,1541,1424,117,12,703,69
-1,1724,1793,-69,0,-21,50
1,1740,1596,144,0,-122,97
-1,2087,2042,45,-5,-34,78
-1,1806,1914,-108,-2,-105,68
-1,1480,1511,-31,-6,-402,76
1,2006,1655,351,0,-76,99
-1,1510,1900,-390,-1,-155,78
1,1367,1452,-85,-2,-80,67
1,1703,1604,99,20,170,41
-1,1329,1354,-25,-4,-185,60
1,1647,1537,110,0,19,49
1,1506,1433,73,1,108,73
1,1485,1214,271,15,998,73
1,1388,1520,-132,0,87,69
1,1588,1552,36,0,7,41
1,1464,1299,165,0,-30,73
-1,1470,2140,-670,0,-47,80
-1,1568,1674,-106,-2,164,90
-1,1469,2140,-671,-1,-3,52
1,2101,1863,238,2,192,83
-1,1655,1294,361,-3,-188,82
-1,1273,1673,-400,-11,-38,40
-1,1768,1675,93,2,-46,80
-1,1584,1532,52,0,13,40
1,1490,1247,243,3,281,65
-1,2012,2073,-61,3,-51,66
-1,1923,1798,125,0,42,83
1,1643,1623,20,0,43,75
1,1545,1461,84,0,8,51
-1,1857,2107,-250,-1,-98,72
1,1597,1552,45,0,2,47
1,1545,1470,75,-2,-12,45
-1,1508,1899,-391,-1,-229,86
1,1470,1615,-145,5,416,71
1,1607,1542,65,0,223,107
1,1589,1189,400,4,526,101
1,1429,1545,-116,-3,-33,43
1,1994,1678,316,-1,66,57
1,1595,1618,-23,-7,41,53
-1,1593,1714,-121,-2,-21,42
1,1500,1674,-174,0,123,98
-1,2113,1851,262,-1,-308,126
-1,1791,1673,118,-2,-540,158
-1,1505,2089,-584,-4,-257,72
1,1681,1616,65,3,490,113
1,1616,1532,84,2,54,85
-1,1407,1366,41,0,-15,58
1,1688,1754,-66,2,570,77
1,1452,1670,-218,-1,-14,80
-1,1560,1813,-253,0,-68,116
-1,2000,1831,169,-1,-91,76
1,1709,1811,-102,0,25,69
-1,1494,1589,-95,2,116,80
-1,1454,1500,-46,-3,-12,42
-1,1724,1583,141,1,-107,166
-1,1624,1523,101,0,-281,92
-1,1507,1726,-219,-5,-258,58
1,1646,1568,78,6,169,62
-1,1673,1500,173,-8,-190,56
1,2090,1440,650,3,613,97
1,1454,1247,207,-3,-95,109
-1,1654,1925,-271,5,-149,136
-1,1319,1331,-12,-1,-97,106
-1,1858,1699,159,0,-160,138
1,1741,1701,40,-3,-41,93
1,1610,1230,380,3,74,55
-1,1439,2091,-652,0,-68,60
1,1810,1617,193,-1,-18,47
-1,1500,1534,-34,-3,-208,60
-1,1380,1394,-14,-2,-224,72
1,1498,1423,75,2,72,81
1,1846,1803,43,0,38,87
-1,1929,1610,319,-2,-109,52
-1,1437,1637,-200,-3,-28,56
1,2091,1370,721,2,105,63
-1,1549,1411,138,0,-50,58
-1,1629,1909,-280,8,436,84
-1,1422,1440,-18,-4,-154,62
1,1605,1265,340,-5,-123,59
-1,1427,1496,-69,-2,-293,70
-1,1320,1729,-409,-1,-154,96
1,1907,1767,140,0,113,96
-1,1567,1685,-118,-9,-153,47
1,1565,1664,-99,-1,-11,45
1,1913,1625,288,6,211,65
-1,1603,1704,-101,-1,42,68
0,1660,1728,-68,0,38,108
-1,1506,1409,97,-3,-154,68
-1,1469,1685,-216,-4,-247,78
1,1611,1612,-1,-3,-227,89
-1,1621,1917,-296,-1,-225,72
-1,1404,1433,-29,-2,-118,56
1,1541,1340,201,6,425,75
-1,1463,1722,-259,-1,-75,54
1,1591,1248,343,15,330,45
1,1618,1538,80,1,8,71
-1,1459,1491,-32,-5,-8,82
1,1479,1632,-153,-2,-59,49
-1,1714,1593,121,-9,-90,122
0,1921,1749,172,-2,-68,81
-1,1351,1768,-417,-2,-200,82
-1,1600,1731,-131,0,-2,40
1,1560,1554,6,0,9,45
1,1405,1368,37,9,274,53
1,1258,1318,-60,6,224,61
-1,1682,1686,-4,0,5,40
1,1777,1916,-139,-1,91,97
-1,1393,1726,-333,0,10,62
1,1626,1502,124,-2,107,79
1,1409,1728,-319,-5,-180,61
1,1601,1622,-21,-1,126,55
-1,1529,1852,-323,0,-2,56
-1,1738,1783,-45,0,-10,80
1,1866,1526,340,-1,-11,57
-1,1635,1451,184,0,-707,128
1,1639,1442,197,4,316,95
-1,1399,1397,2,-3,-60,48
-1,1523,1878,-355,2,57,64
-1,1909,1914,-5,0,-39,101
1,1262,1315,-53,6,483,113
-1,1592,1729,-137,-9,-305,70
1,1611,1695,-84,1,193,115
-1,1471,1530,-59,-1,-37,54
1,1889,1520,369,-1,-52,63
1,1729,1547,182,0,451,133
-1,1594,1460,134,-4,-42,46
-1,1429,1769,-340,-4,-281,66
1,1792,1728,64,-3,-115,95
1,2065,1735,330,0,107,103
1,1597,1370,227,-3,99,129
-1,1517,1899,-382,3,204,72
1,1403,1415,-12,0,-82,89
1,1629,1537,92,-4,-99,67
-1,1407,1582,-175,0,65,74
1,1427,1425,2,-1,87,93
1,1436,1514,-78,0,-9,67
1,1719,1801,-82,0,3,73
0,1645,1757,-112,0,-63,141
1,1651,1476,175,2,152,93
-1,1585,1762,-177,0,-80,66
-1,1855,1732,123,-2,-99,68
1,1678,1628,50,7,47,41
0,1921,1645,276,0,-118,121
1,1671,1719,-48,-1,127,67
1,1414,1404,10,7,708,89
-1,1509,1630,-121,-1,-165,82
1,1841,1785,56,0,-407,96
-1,1579,1903,-324,-2,-20,50
0,1616,1690,-74,3,246,159
1,1499,1450,49,4,106,53
1,1451,1449,2,3,68,57
-1,1708,1903,-195,-4,-178,72
-1,1788,1733,55,1,-28,98
1,1879,1711,168,3,213,76
1,1459,1601,-142,0,655,141
-1,1414,1439,-25,1,50,64
1,1565,1763,-198,2,749,155
-1,1393,1425,-32,0,-526,118
1,1670,1769,-99,4,48,43
1,1440,1510,-70,-2,-95,63
1,1791,1714,77,2,566,93
-1,1449,1404,45,-11,-303,92
-1,1746,1775,-29,0,-6,66
1,1474,1583,-109,0,379,119
-1,1508,1597,-89,-10,-176,48
-1,1495,1454,41,1,-50,90
-1,1602,1610,-8,1,14,48
1,1754,1434,320,0,4,71
1,1647,1771,-124,9,141,40
1,1859,1581,278,6,74,45
-1,1747,1674,73,-18,-739,66
-1,1644,1634,10,-1,-291,149
-1,1518,1543,-25,-1,-344,98
1,1500,1419,81,3,94,47
-1,1603,2107,-504,-1,-83,80
1,1785,1871,-86,-1,6,69
-1,1296,1500,-204,0,-127,78
1,1687,1735,-48,0,315,151
-1,1597,1535,62,-2,-58,71
1,1984,2091,-107,1,127,95
1,1677,1794,-117,0,-10,51
1,1842,1805,37,-1,66,59
-1,1528,1590,-62,-2,-73,46
-1,1625,1545,80,0,-219,78
0,1688,1521,167,1,221,155
-1,1771,1548,223,0,-31,126
-1,1576,1863,-287,-1,-224,118
-1,2075,1602,473,0,-31,52
1,1420,1164,256,1,134,69
1,1138,1316,-178,7,195,47
1,1339,1423,-84,2,121,63
1,1518,1603,-85,-1,172,87
-1,1610,1470,140,0,-4,44
-1,1723,1699,24,0,-771,224
-1,1626,2052,-426,-3,-90,56
1,1559,1161,398,0,51,49
1,2054,2109,-55,9,221,41
1,1794,1852,-58,0,225,93
1,1533,1620,-87,3,188,109
-1,1500,1549,-49,-7,-518,78
0,1291,1295,-4,0,-109,134
-1,1607,1559,48,-3,-238,74
-1,1581,1596,-15,-10,-179,52
-1,2069,1997,72,2,36,96
1,1235,1210,25,6,119,53
1,1867,1571,296,1,473,89
1,1991,1858,133,0,6,41
-1,1710,1712,-2,-6,-471,92
-1,1363,1201,162,-5,-290,61
-1,1353,1281,72,-2,-299,68
1,2010,2054,-44,0,-2,73
-1,1851,1998,-147,-7,-77,62
-1,1577,1582,-5,-6,-231,60
-1,1661,1766,-105,-5,-109,50
1,1571,1590,-19,5,118,49
1,1686,1601,85,1,142,89
1,1722,1700,22,0,170,69
-1,1550,1571,-21,7,168,101
-1,1638,1910,-272,-3,-46,44
-1,1610,1571,39,0,-5,120
1,1593,1706,-113,3,176,60
1,1678,1587,91,-1,469,99
0,2093,2052,41,-1,-446,97
1,1533,1463,70,2,114,69
-1,1839,2011,-172,0,9,52
1,1808,1582,226,-1,-2,53
1,1627,1262,365,1,82,61
1,1674,1585,89,3,201,91
1,1894,1677,217,2,232,93
-1,2053,2092,-39,-2,-10,108
1,1382,1409,-27,0,-1,51
-1,1630,1689,-59,-6,-749,144
-1,1718,1527,191,-2,-213,76
1,1868,1840,28,0,-2,79
-1,1576,1691,-115,-6,-386,76
-1,1585,2042,-457,0,-211,66
1,1545,1635,-90,4,105,41
-1,1513,1616,-103,-2,-27,46
1,2166,1410,756,2,162,81
1,1500,1500,0,6,281,81
1,2103,1607,496,0,4,49
1,1833,1933,-100,2,54,69
1,1484,1499,-15,1,69,59
-1,1269,1185,84,0,-153,64
1,2105,1533,572,-1,56,59
-1,1556,1523,33,0,-165,94
1,1821,1679,142,6,175,47
-1,1296,1210,86,-1,29,46
1,1523,1516,7,0,-21,111
-1,1543,1700,-157,-8,-279,50
-1,2012,2014,-2,0,-33,82
-1,1907,1846,61,-3,-25,50
1,1542,1129,413,1,152,59
-1,2017,1918,99,-1,-26,58
-1,1655,1622,33,-6,-100,65
-1,1225,1614,-389,-1,-49,64
-1,2012,2013,-1,-1,-30,54
1,1721,1731,-10,0,134,113
-1,1880,1878,2,-1,-11,44
1,1512,1629,-117,1,63,85
1,2167,1337,830,3,321,87
1,979,1205,-226,3,137,63
-1,1500,1729,-229,-22,-489,46
-1,1499,1828,-329,0,-160,74
1,1901,1973,-72,0,21,103
-1,2025,2002,23,0,13,80
-1,1505,1700,-195,0,-111,84
1,1707,1537,170,-2,-18,61
1,1562,1452,110,4,154,61
-1,1734,2044,-310,0,31,68
-1,2026,2001,25,0,-198,70
-1,1713,1695,18,0,-8,42
1,1594,1500,94,-1,93,91
1,1223,1617,-394,2,6,51
1,1672,1489,183,8,429,69
0,2013,2012,1,0,-9,91
1,1425,1500,-75,-3,-74,53
1,1595,1249,346,0,30,49
1,1932,1830,102,-1,-21,47
-1,1731,2048,-317,-6,-253,66
-1,1263,1858,-595,-10,-399,62
1,1145,1212,-67,4,102,45
-1,1575,2107,-532,0,18,54
-1,1245,1598,-353,5,298,60
-1,1713,1869,-156,0,-79,112
1,2012,2013,-1,0,19,61
0,1346,1394,-48,5,349,87
1,1662,1113,549,3,89,55
-1,1893,1618,275,1,131,88
-1,1670,1683,-13,0,-3,40
-1,1339,1165,174,0,-103,74
1,1410,1500,-90,-2,-97,51
1,1941,1822,119,-2,17,45
-1,2003,2024,-21,0,-47,64
1,1501,1831,-330,-2,40,107
1,1242,1601,-359,0,-28,61
-1,1419,2108,-689,-1,-168,74
1,1756,1671,85,-1,-65,102
1,1600,1517,83,-1,190,55
1,1660,1720,-60,-1,98,67
1,1733,1485,248,-1,214,123
1,1505,1420,85,10,131,43
0,1550,1557,-7,-1,-89,114
1,1706,1418,288,-1,0,41
1,1570,1698,-128,0,443,185
-1,1468,1499,-31,2,-198,128
1,1693,1678,15,2,47,43
-1,1834,1582,252,-8,-8,73
-1,1706,1728,-22,2,96,68
-1,1694,1738,-44,-2,-77,68
1,1714,1414,300,-15,-220,43
1,1604,1308,296,4,379,87
1,1715,2051,-336,1,2,43
1,1948,1815,133,1,126,99
-1,1333,1353,-20,8,160,42
0,1808,1956,-148,-3,-89,95
-1,1662,1531,131,1,152,72
-1,1606,1776,-170,-5,-21,42
1,1043,1216,-173,1,88,67
-1,1683,1448,235,-6,-137,84
-1,1748,1683,65,2,65,70
-1,1648,1639,9,0,-81,68
1,1538,1571,-33,2,148,71
-1,1608,1766,-158,0,77,74
1,1658,1552,106,-2,-5,49
0,1566,1706,-140,-1,107,127
-1,1643,1705,-62,-3,-19,44
1,2030,1624,406,3,80,71
1,1737,1695,42,-1,1,59
-1,1323,1201,122,-1,-11,66
-1,1707,1672,35,0,-21,64
-1,1746,1500,246,2,-4,56
-1,1684,1858,-174,-2,-212,104
1,1633,1500,133,11,527,57
1,1811,1520,291,0,163,101
1,1392,1348,44,1,81,65
1,1710,1171,539,22,309,43
-1,1550,1546,4,0,-30,63
1,1735,1476,259,-3,-90,89
1,1730,1648,82,-6,-102,63
0,1959,1963,-4,0,7,140
0,1951,1889,62,0,135,126
1,1541,1546,-5,1,360,84
1,1695,1643,52,1,304,137
1,1634,1608,26,0,-6,47
1,1709,1588,121,0,46,59
-1,1686,1747,-61,0,-4,76
-1,1509,1609,-100,1,51,130
1,1562,1500,62,-2,6,63
-1,1635,1642,-7,-5,-459,103
-1,1270,1092,178,2,266,72
1,1724,1525,199,1,193,75
-1,1471,1622,-151,-1,4,58
-1,1517,1815,-298,-2,-173,135
1,1774,1601,173,0,-18,77
1,1678,1595,83,4,78,47
-1,1659,1700,-41,-3,-52,50
-1,1534,1510,24,-1,-36,50
-1,1655,1810,-155,-1,-21,62
1,1544,1666,-122,1,6,53
1,1644,1597,47,0,42,109
1,1286,1402,-116,-4,169,131
-1,1735,1520,215,-6,-47,58
1,1353,1308,45,5,44,41
0,1182,1521,-339,-3,-477,90
1,1242,1387,-145,7,228,58
1,1630,1464,166,-4,-14,41
-1,1557,1524,33,0,52,94
1,1717,1293,424,7,376,63
1,1849,1739,110,1,187,75
1,1766,1711,55,-1,97,59
1,1781,1837,-56,2,117,75
-1,1815,1816,-1,1,46,70
0,1569,1535,34,-2,161,135
1,1747,1397,350,5,459,75
-1,1456,1637,-181,0,16,58
0,1386,1702,-316,0,-139,94
1,1759,1457,302,2,243,85
-1,1551,1542,9,1,-98,70
-1,1595,1650,-55,0,1,107
1,1731,1814,-83,0,20,81
1,1195,1226,-31,-2,40,69
-1,1687,1746,-59,0,-37,72
1,1607,1682,-75,0,-1,53
-1,1701,1776,-75,0,-448,110
1,1618,1501,117,6,388,81
1,1543,1587,-44,0,14,77
1,1660,1537,123,5,143,65
-1,1253,1358,-105,1,89,77
1,1540,1575,-35,-6,-140,71
1,2224,1791,433,1,407,103
-1,1603,1788,-185,-1,-185,130
1,1475,1540,-65,-3,5,49
1,1756,1415,341,0,39,55
1,1705,1086,619,3,104,63
1,1601,1543,58,0,6,69
-1,1644,1450,194,3,22,58
-1,1551,1473,78,1,-57,100
1,1672,1537,135,8,269,45
1,1802,1794,8,-2,-54,67
-1,1871,2003,-132,-7,-143,66
1,1517,1546,-29,5,174,63
1,1587,1500,87,-4,143,59
-1,1572,1683,-111,-1,-681,142
-1,1544,1259,285,1,-106,96
0,1637,1716,-79,-7,-112,101
1,1694,1548,146,0,143,171
-1,1678,1812,-134,-1,-68,81
-1,1417,1549,-132,-3,0,40
1,1159,1624,-465,2,155,61
-1,1624,1615,9,3,63,84
1,1481,1214,267,-1,-3,69
1,1536,1568,-32,0,8,57
1,1867,1256,611,9,357,61
-1,1409,1556,-147,0,12,50
1,1818,1602,216,0,10,49
-1,1481,1644,-163,-6,-154,56
1,1529,1532,-3,1,243,68
1,1553,1563,-10,4,107,45
-1,1412,1759,-347,0,14,70
1,1312,1302,10,1,5,97
1,2010,1864,146,0,88,65
1,1918,1667,251,0,-16,71
1,1695,1434,261,5,741,95
1,1402,1552,-150,1,231,109
1,1512,1025,487,3,222,91
1,1213,1212,1,1,734,128
-1,1533,1481,52,0,-55,109
1,1650,1583,67,0,131,99
1,1692,1555,137,0,155,69
-1,1520,1541,-21,-4,-780,92
1,1418,1536,-118,1,21,43
0,1580,1701,-121,-13,-1005,122
1,1614,1500,114,0,10,63
-1,1509,1408,101,-6,-95,40
1,1705,1735,-30,-1,32,72
-1,1654,1915,-261,-1,-147,90
-1,1625,1698,-73,-4,-314,81
0,1500,1599,-99,0,20,118
1,1500,1551,-51,-4,-50,77
1,1407,1752,-345,-1,-38,73
-1,1588,1535,53,-15,-308,50
1,1696,1579,117,6,477,81
-1,1514,1599,-85,-1,-30,54
0,1604,1500,104,0,-638,249
-1,1597,1474,123,-7,-366,96
0,1665,1557,108,0,14,92
0,1561,1548,13,-7,-903,154
1,1507,1558,-51,2,333,119
1,1548,1699,-151,-2,-253,91
-1,1551,1508,43,-7,-574,76
1,1537,1376,161,6,214,52
1,1487,1533,-46,3,229,87
1,1647,1620,27,0,6,99
1,1504,1401,103,-3,546,97
1,1525,1570,-45,0,-58,79
1,1660,1355,305,4,240,71
1,1824,1276,548,0,-14,77
-1,1605,1621,-16,0,28,58
1,1541,1484,57,1,59,97
1,1609,1505,104,3,119,67
0,1857,2016,-159,0,154,120
1,1522,1539,-17,6,436,99
-1,1558,1589,-31,-4,-454,86
1,1707,1466,241,1,402,101
1,1701,1524,177,8,524,79
1,1671,1555,116,0,19,55
1,2036,1560,476,4,761,95
1,1762,1409,353,2,60,55
1,1365,1663,-298,3,70,49
-1,1634,1716,-82,-3,-42,48
-1,1634,1547,87,6,532,120
-1,1557,2037,-480,-25,-348,42
-1,1724,1924,-200,-1,-316,94
1,1453,1437,16,0,14,49
1,2146,1956,190,0,584,132
1,1754,1681,73,2,63,51
1,1666,1556,110,0,28,65
-1,1343,1612,-269,6,287,80
-1,1671,1763,-92,-1,-54,66
-1,1592,1807,-215,-1,-3,44
1,1815,1832,-17,2,145,63
1,1611,1579,32,1,24,55
-1,1533,1558,-25,-5,-97,44
-1,1674,1548,126,-3,-637,164
1,1409,1489,-80,0,5,53
1,1771,1661,110,0,-2,75
1,1541,1481,60,-3,-146,99
-1,1820,1826,-6,-1,-37,60
-1,1528,1523,5,1,-454,132
-1,1858,1869,-11,0,-166,68
1,1643,1910,-267,2,77,81
1,1635,1509,126,-6,-104,115
-1,1224,1724,-500,-19,-327,48
1,1742,1359,383,0,22,47
1,1721,1411,310,2,62,59
-1,1488,2155,-667,0,-87,92
1,1586,1297,289,2,277,127
1,1837,1810,27,6,138,56
1,2001,1697,304,0,-14,43
1,1822,1373,449,1,57,56
-1,1347,1500,-153,0,-125,62
-1,1500,1576,-76,0,-198,134
1,1599,1601,-2,2,50,55
-1,1813,2101,-288,0,-11,58
1,1346,1402,-56,-1,-42,51
-1,1726,1622,104,-2,47,114
-1,1800,1847,-47,-1,-52,46
-1,1933,1916,17,1,31,56
-1,1552,1590,-38,0,-94,64
1,1423,1475,-52,-6,-246,103
1,1455,1452,3,-10,-3,49
1,1487,1829,-342,-3,-167,81
1,1360,1409,-49,-2,212,114
1,1563,1652,-89,-3,50,59
-1,1582,1681,-99,-3,-123,55
-1,1856,1790,66,0,0,48
0,1880,1893,-13,1,126,79
-1,1524,1559,-35,-5,-256,70
1,1862,1714,148,7,-206,95
1,2008,1459,549,-2,-60,61
-1,1849,1641,208,-2,-447,140
1,1706,1869,-163,5,300,55
1,1689,1574,115,-3,-26,66
1,1611,1637,-26,0,-2,57
-1,1481,1610,-129,-1,13,48
1,1656,1504,152,1,132,57
1,1852,1726,126,0,105,99
-1,1641,1636,5,3,-304,102
-1,1578,1880,-302,0,36,106
1,1576,1478,98,1,247,99
1,1623,1634,-11,4,103,43
-1,1390,1369,21,-1,35,64
1,1803,1843,-40,0,19,63
1,1699,1621,78,1,164,85
-1,2105,2044,61,-1,-1029,140
-1,1359,1462,-103,-3,-408,72
1,2060,2091,-31,0,20,65
1,1584,1487,97,7,106,43
-1,1831,1815,16,4,488,108
1,1535,1614,-79,-1,259,117
1,1679,1574,105,0,-101,77
1,1607,1425,182,11,210,47
-1,1722,1553,169,0,-27,104
1,1635,1633,2,-5,-113,71
-1,1441,1607,-166,1,11,44
-1,1312,1315,-3,-5,-156,64
1,2123,1568,555,0,138,101
1,1531,1136,395,4,58,46
1,1630,1697,-67,-8,-226,65
-1,1759,1894,-135,-4,-67,46
-1,1663,1967,-304,-1,-44,84
-1,1571,1648,-77,-10,-272,74
-1,1479,1592,-113,0,-43,88
1,1901,1752,149,2,22,43
1,1810,1779,31,0,-26,91
1,1919,1951,-32,0,147,67
1,1826,1820,6,-5,176,89
-1,1637,1413,224,-1,-16,40
-1,1432,1558,-126,-2,8,40
-1,1652,1785,-133,-1,-138,86
1,1816,1659,157,0,155,131
-1,1745,1907,-162,0,-60,60
1,1540,1473,67,4,85,46
1,1711,1646,65,10,651,89
1,1643,1714,-71,-2,-277,97
1,1891,1785,106,1,-12,41
-1,1337,1579,-242,-6,-90,57
1,1584,1684,-100,0,-5,123
1,1467,1506,-39,1,62,89
-1,1332,1500,-168,0,-15,58
-1,1860,2077,-217,-3,-592,102
1,1551,1571,-20,1,234,73
-1,1628,1903,-275,-1,-212,80
-1,1214,1722,-508,5,34,50
1,1880,1893,-13,-1,59,53
1,1810,1837,-27,0,81,75
-1,2083,2084,-1,0,5,58
1,1620,1562,58,2,469,123
-1,1288,1372,-84,-3,-162,56
1,1516,1463,53,-3,-65,67
1,1603,2011,-408,-1,-15,67
-1,2097,1854,243,-14,-333,54
-1,1513,1525,-12,-8,-350,70
-1,1370,1434,-64,0,8,44
-1,1728,1594,134,2,76,80
-1,1962,2071,-109,1,-12,60
1,1545,1431,114,1,93,51
-1,1739,2125,-386,0,-73,67
-1,1712,1561,151,-1,-146,96
1,1769,1820,-51,-1,-63,72
1,1556,1457,99,1,41,51
1,1825,1821,4,-1,-54,67
1,1892,1882,10,3,89,53
-1,1798,1939,-141,-1,-120,96
-1,1873,2076,-203,1,61,88
1,1690,1637,53,-2,-48,53
1,1471,1677,-206,-3,-31,59
1,1578,1229,349,3,94,65
1,2129,1737,392,5,195,65
-1,1656,1646,10,0,1,56
-1,1600,1548,52,-5,-339,88
1,2071,1811,260,-2,-130,65
-1,1608,1327,281,-5,-90,42
1,1457,1598,-141,2,53,45
-1,1553,1629,-76,0,-21,82
-1,1854,1945,-91,-1,-16,50
-1,1591,1500,91,-1,-243,110
-1,1405,1452,-47,-2,-20,52
1,1765,1770,-5,0,241,81
1,1811,1836,-25,0,85,51
-1,1424,1378,46,1,48,66
1,1661,1658,3,0,15,65
-1,1479,1566,-87,0,-125,94
-1,1533,1526,7,-1,9,86
1,1734,1794,-60,0,53,85
1,1659,1641,18,0,42,69
-1,1443,1354,89,-2,10,58
-1,1565,1478,87,-3,-240,64
-1,1589,1884,-295,-4,12,44
1,1953,1843,110,-1,-103,81
1,1645,1566,79,2,74,91
-1,1581,1585,-4,-2,-171,68
-1,1955,2091,-136,-1,-10,58
-1,1415,1381,34,-1,-46,68
1,1341,1362,-21,10,79,45
-1,1552,1574,-22,-4,-236,70
-1,1727,2069,-342,-1,64,92
1,1712,1602,110,0,69,63
1,1493,1489,4,-1,187,97
1,1824,1822,2,4,98,67
1,1629,1553,76,2,109,57
-1,1759,1702,57,-3,-167,64
0,1782,1899,-117,2,39,65
1,1638,1544,94,1,294,110
1,1637,1671,-34,0,485,111
-1,1948,2099,-151,-5,-251,86
-1,1748,1720,28,-14,-891,116
1,1868,1639,229,-1,-28,91
-1,1689,1395,294,2,127,66
-1,1776,1922,-146,3,-22,66
-1,2106,1942,164,6,37,126
-1,1294,1657,-363,2,-7,54
1,1615,1702,-87,1,35,115
0,1652,1828,-176,0,27,60
1,1596,1544,52,-1,4,55
1,1634,1873,-239,-4,-99,51
1,1376,1373,3,0,83,69
-1,1407,1477,-70,7,257,58
-1,1755,1891,-136,0,-69,94
-1,1228,1596,-368,-6,-219,52
-1,1550,1640,-90,-5,-588,94
-1,1519,1297,222,0,-41,48
1,1854,1652,202,1,25,55
-1,1351,1557,-206,-8,-566,82
1,1477,1716,-239,-1,4,46
1,1931,1961,-30,1,72,75
-1,1500,1561,-61,-4,-97,48
-1,1895,1785,110,-1,-7,62
-1,1477,1638,-161,0,136,118
-1,1647,1860,-213,1,-77,116
-1,1670,1726,-56,-7,-90,49
1,1469,1526,-57,-1,174,97
1,1733,1746,-13,0,327,73
-1,1663,1726,-63,0,-4,54
1,1957,2089,-132,0,86,93
0,1721,1658,63,0,-37,155
-1,1318,1502,-184,1,43,64
1,1735,1605,130,0,-45,171
-1,1287,1628,-341,-6,-136,48
1,1377,1430,-53,0,41,55
-1,1381,1448,-67,-9,-193,58
1,1470,1461,9,2,214,83
1,1587,1736,-149,3,215,75
1,2073,1707,366,0,234,71
-1,1356,1599,-243,6,96,48
-1,1778,1746,32,-3,53,46
-1,1637,1870,-233,-8,-36,44
1,1393,1403,-10,0,77,71
1,1776,1471,305,1,184,117
-1,1444,1571,-127,-5,-51,60
1,1412,1411,1,0,259,81
-1,1509,1236,273,-4,-91,106
-1,1423,1502,-79,-3,86,112
-1,1646,1582,64,-1,-60,68
-1,1735,1745,-10,-1,-370,124
-1,1338,1278,60,-1,-131,68
1,1661,1607,54,0,32,93
-1,1641,1659,-18,-1,-60,62
1,1471,1460,11,-9,-370,73
-1,1866,1735,131,0,-3,40
1,1337,1098,239,-2,376,171
1,1713,1093,620,1,46,61
1,1637,1504,133,6,429,87
1,1511,1321,190,7,424,77
1,1467,1568,-101,-6,481,169
1,1648,1384,264,-1,-43,51
1,1617,1500,117,1,7,41
-1,1940,1913,27,0,-399,152
-1,1427,1906,-479,-6,-32,44
1,1658,1576,82,0,-2,45
1,1387,1397,-10,3,80,55
-1,1625,2076,-451,-5,-281,58
-1,1446,1481,-35,0,-11,44
1,1494,1455,39,-1,340,73
-1,1839,1876,-37,5,224,72
1,1635,1598,37,1,201,95
-1,1568,1672,-104,0,-286,110
1,1876,1606,270,1,76,105
-1,1345,1299,46,-1,-653,124
1,1574,1524,50,0,110,87
-1,1091,1716,-625,-1,-54,48
-1,1392,1380,12,1,51,60
-1,1431,2077,-646,-13,-300,54
-1,1470,1482,-12,0,72,100
1,1885,1656,229,0,46,113
-1,1332,1499,-167,-9,-268,49
1,1886,1829,57,2,296,115
-1,1980,1802,178,-1,-50,78
1,1374,1622,-248,0,166,69
-1,1896,1934,-38,-4,-231,70
-1,1651,1776,-125,0,-30,70
1,1256,1324,-68,3,0,41
1,1513,1482,31,0,121,91
1,1646,1547,99,1,71,49
-1,1440,2078,-638,-7,-71,52
-1,1633,1574,59,-1,-138,140
-1,1644,1689,-45,0,5,58
-1,1491,1432,59,1,-92,88
-1,1882,1833,49,-1,-435,120
1,1819,1521,298,0,-39,47
1,1874,1530,344,0,46,47
1,1757,1725,32,0,131,75
1,2079,1471,608,2,98,63
1,1456,1280,176,6,212,97
1,1750,1684,66,0,215,141
1,1439,1655,-216,0,-10,69
1,1259,1251,8,-8,-9,75
0,1670,1631,39,-2,243,152
1,1811,1823,-12,2,41,53
1,1837,1413,424,1,65,63
1,1669,1697,-28,0,4,73
1,1849,1586,263,-1,143,81
1,2080,1466,614,0,86,77
1,1632,1291,341,0,-3,47
1,1634,1459,175,-7,-76,51
1,1783,1637,146,3,117,95
-1,1644,1600,44,3,81,88
-1,1684,1793,-109,-2,-166,72
-1,1517,1681,-164,-3,-112,52
1,1603,1314,289,5,256,89
-1,1452,1642,-190,-8,-139,50
-1,1446,1575,-129,-1,-88,70
1,1523,1413,110,4,213,71
1,1600,1493,107,-2,-67,79
-1,1446,1534,-88,-2,-93,62
-1,1488,1654,-166,-3,-223,90
1,1644,1562,82,2,17,48
1,1624,1698,-74,3,105,65
-1,1483,1542,-59,1,-14,56
-1,1718,1943,-225,0,16,92
-1,1651,1542,109,2,-1,40
0,0,1183,-1183,-9,-847,80
-1,1517,1825,-308,-4,-262,74
1,1551,1654,-103,-2,-101,73
1,1581,1385,196,1,121,71
1,1270,1447,-177,-2,1,43
-1,1288,1635,-347,-2,-95,60
-1,1707,1776,-69,-3,-131,58
1,1362,1536,-174,-3,-137,69
-1,1500,1637,-137,1,58,52
0,1481,1398,83,1,30,98
1,1660,1572,88,1,60,81
1,1358,1201,157,2,106,67
1,1653,1715,-62,0,114,101
-1,1449,1478,-29,0,-56,62
-1,1472,1523,-51,1,72,104
1,1500,1585,-85,4,22,45
1,1500,1566,-66,-4,138,57
-1,1724,1833,-109,-2,-401,130
1,1747,1631,116,7,51,41
1,2156,1154,1002,1,43,57
1,1602,1480,122,0,545,95
0,1233,1329,-96,6,361,124
1,1399,1560,-161,2,22,47
1,1990,1846,144,-3,112,125
-1,1549,1365,184,4,158,58
1,1812,1964,-152,2,77,57
1,1718,1438,280,-1,-10,43
1,1544,1342,202,-3,11,59
1,1590,1500,90,1,60,51
-1,1641,1154,487,3,46,56
-1,1586,1616,-30,-4,-91,66
-1,1969,2156,-187,0,-14,74
-1,1438,1440,-2,-3,-71,40
1,1499,1615,-116,-5,16,127
-1,1326,1389,-63,-2,-137,75
1,1962,1575,387,0,112,83
-1,1202,1087,115,-1,-9,40
1,1199,1252,-53,0,4,47
-1,1618,1525,93,0,-237,66
0,1600,1804,-204,1,77,56
-1,1754,1708,46,-1,-47,80
-1,1457,1760,-303,-2,-209,72
1,1572,1965,-393,-1,-87,79
-1,1523,1755,-232,-2,-148,71
-1,1403,1664,-261,-1,-163,112
1,1965,2139,-174,3,12,45
1,1330,1208,122,1,29,45
1,1603,1612,-9,1,36,53
1,1526,1473,53,0,19,65
1,2139,1965,174,0,66,113
1,1716,1549,167,-1,136,93
-1,1526,1451,75,-1,-89,58
1,1657,1631,26,2,153,97
1,1941,1597,344,0,-9,53
-1,1764,1701,63,-3,-5,43
-1,1626,1599,27,1,41,66
1,1563,1536,27,5,194,65
-1,1593,1944,-351,-1,-28,44
1,1715,1750,-35,-2,72,81
1,1618,1763,-145,3,78,49
-1,1959,2145,-186,-1,-67,66
0,1522,1638,-116,0,32,71
-1,1734,1723,11,-2,-70,66
1,1948,1590,358,-3,-97,57
0,1841,1726,115,0,-47,114
-1,1722,1869,-147,-1,-49,66
1,1729,1453,276,0,-23,67
1,1574,1437,137,3,281,199
-1,1583,1587,-4,-2,-46,60
-1,2152,1954,198,0,76,136
1,1370,1457,-87,0,533,127
-1,1668,1618,50,0,7,46
-1,1449,1766,-317,-3,-152,78
1,1761,1621,140,0,240,137
-1,1722,1840,-118,1,7,54
1,1451,1409,42,4,127,55
1,1576,1574,2,-5,-179,151
-1,1598,1477,121,-13,-1169,124
-1,1348,1473,-125,-1,-6,42
1,1514,1623,-109,0,-21,89
1,1862,1680,182,-5,70,71
-1,1423,1488,-65,0,-95,82
-1,1615,1408,207,-4,-340,86
1,1780,1848,-68,0,-12,63
1,1733,1770,-37,0,-6,109
-1,1584,1532,52,-8,-552,88
-1,1533,1475,58,0,14,74
-1,1635,1530,105,-1,2,49
-1,1670,1900,-230,0,-2,40
-1,1755,1738,17,-2,-18,70
1,1500,1539,-39,0,-14,97
-1,1715,1627,88,1,-600,128
-1,1571,1575,-4,-11,-446,70
-1,1600,1460,140,1,6,48
1,1562,1543,19,2,102,91
-1,1399,1262,137,1,-94,86
-1,1742,1824,-82,1,16,46
-1,1536,1616,-80,-5,-134,62
1,1970,2133,-163,0,11,119
-1,1313,1383,-70,-1,88,72
1,1728,1675,53,0,13,53
-1,1572,1641,-69,-8,-138,52
1,2054,2116,-62,5,251,75
1,1618,1714,-96,0,398,156
0,1530,1655,-125,0,-9,91
-1,1794,1586,208,-1,-147,76
0,1833,1734,99,0,-5,75
-1,1222,1236,-14,-6,-544,80
1,1835,1796,39,2,150,73
1,1237,1266,-29,-1,-11,55
1,1415,1551,-136,0,1,53
-1,1771,1771,0,0,-291,164
-1,1378,1328,50,-14,-343,46
1,1403,1475,-72,4,135,55
-1,1505,1614,-109,-3,-82,46
1,1724,1828,-104,2,65,65
-1,1608,2181,-573,-1,-11,46
1,1639,1635,4,-2,12,57
1,1768,1381,387,0,537,155
-1,1684,1948,-264,-1,0,44
-1,1595,1523,72,-2,-60,56
-1,1412,1640,-228,-15,-943,76
-1,2101,2069,32,0,-72,110
-1,1591,1543,48,-2,-63,52
1,1776,1424,352,7,278,69
-1,1737,1830,-93,0,-22,90
1,1652,1406,246,7,222,49
-1,1730,1568,162,-1,-290,102
1,1550,1556,-6,0,18,79
0,1651,1534,117,1,51,69
1,1629,1468,161,0,51,85
0,1599,1649,-50,-1,-55,52
-1,1477,1649,-172,-2,-77,56
-1,1693,1680,13,0,-45,94
-1,1391,1628,-237,2,46,54
-1,1612,1632,-20,-7,-181,54
1,2088,1731,357,2,15,41
-1,1738,1859,-121,-4,-72,88
1,1632,1385,247,10,387,59
-1,1556,1427,129,-5,-53,42
0,1674,1868,-194,-1,-27,148
1,1838,1729,109,3,68,53
1,2091,1728,363,0,12,57
1,1460,1403,57,-2,112,125
-1,1779,1642,137,1,94,78
1,1563,1372,191,0,-29,79
-1,1553,1401,152,-1,-130,72
-1,1637,2082,-445,-1,-304,74
-1,1313,1396,-83,-1,-61,52
1,1601,1648,-47,-1,23,83
-1,1444,1687,-243,1,3,44
-1,1368,1362,6,1,-3,92
-1,1381,1635,-254,5,166,60
1,1927,1997,-70,0,143,109
-1,1538,1647,-109,-3,-20,114
1,1725,2094,-369,4,58,63
1,1573,1480,93,-3,331,131
-1,1694,1782,-88,0,-98,92
1,1636,1536,100,-1,64,95
1,1642,1505,137,9,249,57
1,1337,1272,65,-2,30,69
1,1640,1691,-51,-6,-172,61
-1,1439,2084,-645,-6,-140,50
1,1557,1345,212,0,32,65
1,1690,1666,24,0,-23,41
-1,1605,1535,70,1,26,42
-1,1782,1952,-170,-2,-84,54
0,1456,1542,-86,-3,193,150
-1,1614,1691,-77,-5,-163,64
1,1867,1730,137,-3,37,53
-1,1656,1740,-84,3,267,100
-1,1738,1813,-75,0,-2,96
-1,1459,1382,77,0,-23,64
-1,1657,1763,-106,-3,-367,100
1,1654,1158,496,8,563,87
1,1707,1401,306,-1,-144,79
1,1400,1317,83,-4,-113,73
-1,1643,1647,-4,-10,-129,46
-1,1251,1500,-249,0,-6,40
-1,1703,1655,48,0,10,52
-1,1545,1661,-116,0,-71,98
1,1346,1338,8,-9,-251,55
-1,1532,1669,-137,0,-1,62
-1,1678,1663,15,-5,-130,52
1,1653,1658,-5,-6,-112,63
1,1844,1789,55,0,79,77
-1,1519,1579,-60,7,-279,104
1,1647,1665,-18,1,420,87
1,1319,1367,-48,-8,-182,233
-1,1632,1787,-155,-3,-17,44
-1,1653,1659,-6,-5,-412,100
1,1772,1650,122,0,-6,59
1,1984,1895,89,6,57,41
-1,1556,2085,-529,-5,-161,56
-1,1597,1708,-111,-4,-332,82
-1,1759,1525,234,0,77,84
-1,1699,1547,152,0,1,70
-1,1675,1807,-132,0,-1,76
-1,1761,1733,28,-8,-125,40
-1,1545,1639,-94,0,15,88
1,1581,1500,81,6,145,43
1,1658,1654,4,8,637,125
1,1597,1331,266,-3,104,81
1,1734,1535,199,-4,110,97
1,1860,1580,280,0,8,59
1,1992,1885,107,2,46,77
1,1373,1209,164,7,686,91
1,1701,1787,-86,0,-14,57
1,2086,1646,440,0,116,74
1,1850,1958,-108,0,-428,113
1,1863,1752,111,0,13,43
1,1722,1447,275,9,241,51
1,1544,1740,-196,3,269,79
0,1262,1245,17,2,101,64
1,1442,1345,97,0,74,109
-1,1593,1714,-121,0,-294,72
1,1862,1680,182,0,185,131
1,1472,1539,-67,10,1084,89
-1,1779,1688,91,0,-213,78
1,1308,1409,-101,-3,-138,64
1,1607,1389,218,-10,-260,97
-1,1562,1485,77,-2,-50,64
1,1606,1311,295,1,-41,43
1,1777,1499,278,-5,-100,55
1,1559,1666,-107,0,421,105
1,1774,1588,186,0,157,64
-1,1439,1747,-308,0,-27,63
-1,1669,1643,26,-3,-7,44
-1,1648,1537,111,-1,-6,78
-1,1668,1691,-23,0,-53,128
-1,1367,1530,-163,-6,-145,58
-1,1562,1650,-88,-4,5,46
1,1864,2000,-136,-1,16,87
-1,1500,1513,-13,-1,-20,42
-1,1723,1289,434,-2,-441,150
-1,1470,1487,-17,-1,-38,56
0,1555,1650,-95,0,30,126
-1,1153,1576,-423,-19,-507,50
-1,1701,1883,-182,-1,-55,76
-1,1715,1642,73,0,-104,128
-1,1379,1379,0,1,-175,110
-1,1593,1645,-52,-2,-35,82
1,1619,1182,437,0,11,59
1,1641,1771,-130,1,184,69
-1,1245,1262,-17,-7,-410,74
1,1575,1542,33,-4,-140,61
1,1557,1796,-239,-4,-45,43
1,1745,1780,-35,-1,129,95
1,1828,2068,-240,1,19,93
0,1549,1332,217,-1,0,40
-1,1536,1675,-139,-3,-291,118
1,1582,1151,431,-1,741,83
0,1308,1462,-154,1,-113,156
1,1765,1776,-11,0,-130,101
1,1645,1569,76,-5,-7,51
-1,1551,1561,-10,-4,-101,50
-1,2090,1985,105,0,-50,108
-1,1589,1655,-66,0,-268,96
1,1256,1453,-197,-1,98,113
1,1581,1150,431,0,75,57
-1,1575,1576,-1,-5,-136,52
1,1859,1889,-30,0,176,113
1,2050,1847,203,6,300,67
-1,1433,1610,-177,-3,-46,48
1,1677,1683,-6,0,5,71
-1,1799,1584,215,-6,-182,46
1,1734,1246,488,1,53,65
1,1585,1524,61,12,498,66
-1,1516,1512,4,2,15,72
-1,1841,2055,-214,-5,-187,92
-1,1449,2073,-624,0,28,58
-1,1586,1614,-28,-2,-204,98
1,1411,1410,1,-2,-1,41
-1,1510,1382,128,-1,-133,126
-1,1580,1664,-84,-3,-593,106
1,2061,1836,225,0,12,61
-1,1702,1691,11,-3,-908,162
1,1423,1350,73,-1,-50,53
1,2141,1917,224,-2,32,99
-1,1701,1913,-212,-1,22,56
1,1583,1606,-23,2,45,55
-1,1506,1388,118,-1,-338,88
-1,1598,2074,-476,1,2,72
1,1737,1495,242,-1,-81,79
1,1361,1284,77,-2,230,68
1,1777,1429,348,-5,-124,91
-1,1575,1500,75,-4,-107,52
-1,1781,1642,139,-14,-233,64
-1,1565,1716,-151,-3,-151,52
-1,1830,2066,-236,0,-7,48
-1,1455,1584,-129,1,5,42
-1,1603,1671,-68,-1,-46,60
-1,1314,1529,-215,4,128,126
-1,1331,1427,-96,7,94,50
-1,1639,1608,31,-5,-201,130
-1,1500,1546,-46,-3,-398,82
-1,1877,1871,6,-4,-169,64
1,1551,1631,-80,1,90,103
-1,1243,2148,-905,0,-44,98
-1,1542,1730,-188,4,324,130
1,1357,1367,-10,0,265,121
1,1558,1425,133,3,155,71
-1,1658,1803,-145,-3,-25,48
1,1815,1785,30,1,155,63
1,1624,1148,476,-1,-38,61
1,1146,1007,139,10,805,79
1,1457,1313,144,2,29,57
1,1507,1571,-64,-2,-34,49
-1,1544,1612,-68,0,-41,136
-1,1810,1651,159,1,-191,118
1,1621,1627,-6,1,226,83
1,1868,1842,26,0,19,105
1,1342,1263,79,9,348,59
-1,1537,1540,-3,-9,-104,52
1,1566,1500,66,-2,-61,51
-1,1592,1578,14,-6,-254,66
1,1691,1672,19,-2,-6,55
1,1791,1376,415,3,214,75
1,1615,1632,-17,2,112,105
-1,2130,2085,45,0,-59,118
-1,1549,1526,23,2,-12,40
-1,1428,1502,-74,-3,-60,46
-1,1407,1456,-49,-2,-257,96
-1,1410,1880,-470,-5,-125,56
1,1500,1685,-185,3,134,77
-1,1604,1532,72,-1,-71,82
1,1540,1519,21,-1,-52,59
1,1650,1615,35,3,50,57
-1,1500,1217,283,2,-6,136
1,1982,1946,36,-4,163,83
1,1566,1577,-11,1,248,73
1,1508,1551,-43,7,368,79
1,1371,1139,232,5,106,49
-1,1639,1732,-93,-4,-57,54
-1,1494,1645,-151,-3,-193,64
1,1537,1529,8,1,-19,42
-1,1609,1588,21,-5,-187,62
-1,1927,1726,201,0,-2,48
-1,1417,1474,-57,0,-177,104
1,1876,1760,116,0,101,91
-1,1516,1534,-18,-1,-70,108
-1,1499,1730,-231,-6,-137,52
1,1576,1585,-9,-2,77,93
1,1730,1476,254,0,-23,67
-1,1772,1644,128,1,85,108
-1,1800,1659,141,1,4,124
-1,1507,1739,-232,-9,-444,74
-1,1500,1521,-21,2,72,58
1,1936,2002,-66,-2,29,137
-1,1419,1376,43,-4,-61,62
1,1548,1518,30,-6,-112,57
1,1795,1162,633,16,222,43
-1,1778,1836,-58,0,-282,88
1,1585,1405,180,1,23,47
-1,1545,1506,39,-1,-151,132
1,1269,1302,-33,6,668,105
-1,1529,1335,194,0,-102,60
-1,1186,1459,-273,-1,-293,88
-1,1796,1753,43,-1,-40,58
1,1754,1487,267,5,127,55
1,1945,1739,206,0,65,95
-1,1706,1584,122,2,49,70
1,1483,1408,75,0,194,61
-1,1909,1885,24,-1,-44,114
1,1737,1583,154,3,78,61
-1,1257,1323,-66,0,-35,80
0,1527,1516,11,-4,-227,125
1,1884,1879,5,-3,2,103
1,2093,1862,231,1,530,95
1,1674,1600,74,1,106,83
1,1518,1533,-15,10,403,67
1,1545,1630,-85,3,91,51
-1,1502,1744,-242,-11,-399,68
1,1735,1681,54,1,65,93
-1,1558,1576,-18,6,237,110
1,1744,1511,233,4,434,99
1,1572,1684,-112,9,100,45
1,1759,1492,267,2,156,71
-1,1448,1527,-79,0,24,76
1,1224,1370,-146,-1,515,147
-1,1464,1521,-57,-4,-113,48
-1,1897,1896,1,0,11,78
1,1571,1278,293,0,146,135
1,1670,1601,69,-1,99,145
0,1556,1561,-5,-7,-258,64
-1,1691,1666,25,0,-278,122
1,1950,1742,208,0,6,115
1,1392,1215,177,-4,-11,121
-1,1535,1399,136,1,48,76
1,1616,1558,58,-1,-37,71
-1,1591,1587,4,0,-85,84
-1,1399,1463,-64,-1,-71,140
-1,1534,1738,-204,0,-58,101
-1,1544,1782,-238,3,-537,108
-1,1381,1587,-206,-1,145,80
1,1763,1730,33,-1,25,77
-1,1308,1328,-20,0,28,48
1,1703,1679,24,0,222,125
-1,1473,1521,-48,-1,-135,78
-1,1810,1759,51,-1,-78,88
-1,1497,1509,-12,-3,-292,72
0,1908,1886,22,0,25,124
1,1650,1161,489,9,567,71
1,1745,1307,438,-2,-12,41
0,1556,1597,-41,-1,-92,143
1,1784,1749,35,0,24,63
1,1506,1079,427,1,51,49
1,1672,1536,136,1,112,85
1,1632,1758,-126,0,305,163
1,1672,1392,280,5,209,63
1,2042,1789,253,1,188,81
-1,1857,1762,95,0,25,92
-1,1530,1432,98,-5,-66,41
1,2088,1952,136,0,15,53
-1,1539,1482,57,-3,-406,121
1,1776,1842,-66,1,50,53
-1,1493,1592,-99,-5,-897,90
1,1486,1516,-30,2,26,43
1,1771,1798,-27,4,167,75
-1,1768,1738,30,1,-327,146
-1,1784,2046,-262,0,-3,52
-1,1746,1859,-113,2,117,117
-1,1449,1500,-51,-1,-40,58
1,1549,1626,-77,5,312,115
1,1942,1858,84,0,-13,77
-1,1504,1528,-24,1,-6,64
1,1703,1725,-22,0,-2,87
-1,1339,1399,-60,-1,-90,56
-1,1710,1740,-30,-5,-24,68
1,1956,1802,154,-3,-34,117
1,2212,1687,525,0,67,79
1,1508,1519,-11,0,12,53
1,1886,1907,-21,0,20,79
1,1459,1121,338,9,376,85
-1,1747,1845,-98,-7,-124,50
1,1945,1773,172,0,-5,65
-1,1389,1393,-4,-3,-110,80
1,1547,1452,95,-2,-119,57
-1,1308,1652,-344,-4,-206,104
-1,1686,2214,-528,-2,-7,46
1,1601,1485,116,-5,-54,67
1,1560,1494,66,0,27,51
-1,1853,1738,115,0,321,112
1,1630,1715,-85,-3,-160,61
1,1454,1412,42,0,265,101
-1,1756,1737,19,-5,-703,114
-1,1713,1814,-101,3,27,64
-1,1485,1586,-101,0,-105,70
1,1729,1589,140,4,590,119
-1,1483,1580,-97,-3,-338,92
-1,1536,1663,-127,-3,-373,106
1,1591,1557,34,1,50,67
1,1521,1305,216,6,66,45
-1,1408,1329,79,2,52,68
-1,1645,1688,-43,0,2,72
1,1668,1507,161,6,166,45
-1,1285,1245,40,0,-377,96
-1,1608,1476,132,-7,-805,114
-1,1596,1678,-82,-4,-30,40
-1,1072,1654,-582,-15,-120,44
1,1555,1433,122,-4,-91,47
-1,1526,1404,122,-4,-122,76
-1,1697,1635,62,-4,-451,136
1,1745,1674,71,-2,84,75
1,1716,1514,202,-1,12,63
1,1982,1940,42,-2,-30,45
0,1787,1540,247,-8,129,91
-1,1631,2099,-468,-5,-394,84
1,1760,1465,295,1,117,69
1,1465,1119,346,2,1021,139
-1,1949,2101,-152,-2,-53,56
1,1753,1849,-96,2,77,69
-1,1655,1472,183,0,8,40
-1,1753,1748,5,-1,-335,106
1,1684,1649,35,0,34,47
1,1546,1460,86,4,82,41
-1,1389,1575,-186,0,22,74
-1,1590,1483,107,-3,3,42
1,2096,1992,104,0,36,75
1,1755,1484,271,2,138,91
1,1378,1371,7,5,76,49
1,1940,1509,431,-1,-371,131
-1,1588,1697,-109,-5,-63,46
1,1638,1694,-56,4,172,63
-1,1382,1356,26,0,-49,53
1,1562,1691,-129,0,-15,69
1,1497,1558,-61,-1,-13,65
-1,1492,1570,-78,-2,156,86
1,1293,1431,-138,2,-1,49
-1,1462,1764,-302,0,-279,108
1,1835,1767,68,-2,247,105
1,1737,1489,248,-9,210,97
1,1433,1510,-77,0,-28,49
1,1725,1525,200,-9,-4,85
1,1584,1679,-95,0,-36,73
-1,1775,1754,21,3,82,64
1,1673,1768,-95,7,140,49
1,1585,1500,85,-4,-87,107
1,1601,1360,241,0,3,45
1,1652,1682,-30,-2,116,75
0,1787,1797,-10,-1,-105,89
1,1942,1406,536,4,3,45
1,1388,1451,-63,12,487,57
-1,1742,1708,34,0,-722,112
-1,1554,1333,221,0,-117,82
0,1530,1510,20,-1,-127,122
1,1944,1212,732,0,6,45
1,1585,1435,150,9,506,83
-1,1496,1581,-85,-3,-64,50
-1,1464,1670,-206,-3,-28,42
-1,1665,1733,-68,1,-63,63
1,1383,1255,128,4,130,48
1,1874,1738,136,2,136,63
0,1674,1365,309,0,127,125
-1,1520,1577,-57,-2,-118,61
1,1768,1458,310,7,357,73
1,1511,1529,-18,4,269,83
1,1945,1665,280,2,-17,83
-1,1159,1444,-285,-6,-302,58
1,1737,1770,-33,-1,298,105
1,1468,1431,37,6,109,47
1,1596,1663,-67,-2,-234,125
-1,1438,1402,36,6,311,90
-1,1928,2110,-182,-1,-32,74
1,1640,1268,372,-1,-28,129
1,1734,1523,211,1,29,73
-1,1661,1950,-289,-3,54,64
-1,1631,1601,30,1,46,59
-1,1730,1795,-65,0,-251,118
1,1500,1675,-175,1,49,45
-1,1570,1616,-46,-5,-304,112
1,1391,1330,61,1,78,50
1,1612,1259,353,-9,-366,77
-1,1375,1389,-14,0,-23,64
1,1523,1326,197,0,-8,47
1,1667,1694,-27,-5,-36,55
1,1547,1780,-233,-9,-59,43
1,1955,1657,298,-1,133,65
0,1583,1665,-82,2,-160,127
1,1922,2116,-194,0,71,91
1,1778,1586,192,1,117,67
-1,1425,1547,-122,-1,-58,68
-1,1538,1736,-198,3,-8,60
1,1785,1623,162,1,126,65
-1,1420,1478,-58,-3,-198,76
1,1402,1256,146,11,466,107
1,1763,1656,107,1,130,129
-1,1586,1663,-77,5,282,88
1,1401,1365,36,4,239,109
1,1528,1314,214,2,101,57
1,1959,1505,454,5,267,69
-1,1721,1849,-128,0,-238,132
1,1579,1794,-215,0,-37,83
1,1425,1309,116,1,127,89
-1,1494,1750,-256,-2,-473,110
-1,1502,1962,-460,-3,-87,50
1,1500,1466,34,9,316,71
-1,1671,1576,95,1,20,86
1,1747,1601,146,2,102,105
-1,1759,1745,14,1,83,66
1,1657,1480,177,-1,230,111
-1,1346,1741,-395,0,-434,116
-1,1938,2099,-161,0,-213,108
1,1862,1687,175,0,10,61
-1,1416,1448,-32,-10,-188,58
1,1592,1533,59,1,302,65
-1,1775,1452,323,-4,-266,74
1,1586,1256,330,1,175,75
0,1895,1598,297,-3,-59,120
-1,1964,1990,-26,-1,44,86
1,1810,1676,134,-1,225,91
-1,1626,1830,-204,-8,-397,100
1,1400,1583,-183,-2,-41,45
-1,1501,1530,-29,1,-475,148
-1,1673,1621,52,-2,-270,108
1,1856,1989,-133,-9,-1,57
1,1714,1754,-40,2,-65,107
-1,1601,1532,69,-3,-136,64
1,1524,1602,-78,0,630,91
-1,1355,1411,-56,-7,-88,46
-1,1787,1746,41,-3,-122,96
-1,1474,1663,-189,0,-57,92
1,1587,1538,49,6,331,65
1,1524,1464,60,2,17,51
-1,1685,1950,-265,0,1,46
1,1760,1565,195,0,2,63
1,1932,2105,-173,0,80,101
1,1805,1530,275,4,635,137
-1,1587,1752,-165,-1,-75,66
-1,1809,1900,-91,0,-28,80
1,1421,1345,76,1,88,73
-1,1395,1581,-186,-12,-190,70
1,1384,1474,-90,-3,62,83
1,1784,1678,106,-1,-175,87
0,1669,1590,79,-1,16,82
1,2112,1925,187,-3,0,51
1,1578,1344,234,3,57,49
1,2092,1612,480,0,277,99
1,1758,1742,16,4,71,47
-1,1669,1817,-148,0,21,88
-1,1413,1516,-103,-5,-226,66
1,1748,1754,-6,1,11,43
-1,1631,1674,-43,1,-19,70
1,1442,1354,88,-2,-61,47
-1,1472,1753,-281,-7,-243,62
-1,1541,1959,-418,-6,-278,70
1,1758,1519,239,-10,-440,87
-1,1238,1433,-195,-1,-334,88
1,1726,1577,149,-8,251,151
1,1771,1738,33,3,186,61
0,1856,1601,255,3,162,135
1,2093,1790,303,0,28,67
-1,1255,1487,-232,-6,-69,44
-1,1550,1468,82,1,-99,66
-1,1743,2089,-346,-3,-40,54
-1,1643,1595,48,-4,-20,72
-1,1373,1666,-293,1,-162,70
1,2019,1417,602,-2,-34,47
1,1653,1607,46,0,-139,87
-1,1798,1858,-60,0,-5,46
1,1911,1842,69,0,74,67
-1,1526,1337,189,10,-69,120
1,1336,1430,-94,4,119,59
-1,1455,1648,-193,-3,-74,47
-1,1427,1641,-214,-1,-117,64
-1,1680,1868,-188,-1,-144,114
-1,1587,1737,-150,0,-47,120
-1,1396,1675,-279,-2,-78,58
1,1319,1192,127,10,366,53
-1,1714,1814,-100,-2,-158,92
1,1665,1414,251,-3,-170,69
-1,1603,1472,131,-3,-73,50
1,1068,1314,-246,2,83,47
1,1752,1471,281,1,136,119
1,1806,1618,188,2,36,48
1,1906,1660,246,-3,-33,43
1,1601,1196,405,1,29,53
-1,1580,1570,10,0,-110,102
0,1694,1710,-16,1,-64,72
-1,1176,1468,-292,-20,-171,42
1,1450,1514,-64,1,245,73
1,1878,1893,-15,2,116,61
1,1648,1500,148,2,193,127
-1,1911,1655,256,-7,-829,118
-1,1574,1679,-105,-2,-49,56
1,1626,1379,247,0,417,129
-1,1816,1633,183,0,-77,78
-1,1508,1404,104,-5,-123,88
0,1444,1404,40,4,275,57
-1,1892,1673,219,3,70,48
0,1687,1566,121,-1,202,96
-1,1638,1599,39,-1,-64,68
-1,1814,1643,171,0,-28,58
0,947,0,947,11,1138,97
1,1393,1221,172,-1,51,87
1,1531,1534,-3,-3,-305,89
1,1873,1691,182,6,227,45
1,1873,1691,182,-1,60,53
1,1471,1171,300,8,532,89
1,1699,1530,169,-3,-15,69
-1,1300,1327,-27,2,-2,48
-1,1568,1604,-36,-3,-63,56
1,1349,1413,-64,5,238,69
1,1957,1780,177,-4,36,81
1,1879,1685,194,-1,-21,69
0,1877,1873,4,-1,-595,97
1,1710,1694,16,-2,55,75
1,1885,1679,206,-3,83,65
1,1691,1402,289,1,-22,85
1,1627,1698,-71,-1,119,137
-1,1831,1577,254,-6,-129,48
1,1470,1401,69,-14,-279,45
-1,1408,1669,-261,-2,-114,66
-1,1546,1658,-112,4,106,64
1,1780,1500,280,0,-4,45
-1,1603,1791,-188,1,8,72
-1,1754,1666,88,-4,-45,48
-1,1197,1500,-303,-10,-673,127
-1,1850,1889,-39,-1,-303,100
1,1558,1213,345,1,32,55
-1,1591,1664,-73,-2,-43,52
1,1583,1637,-54,0,76,69
-1,1614,1774,-160,0,-56,96
1,1740,1680,60,-1,467,73
-1,1593,1729,-136,4,42,44
-1,1807,2146,-339,0,-171,78
1,1666,1374,292,0,-7,42
1,1646,1600,46,0,8,45
-1,1122,1467,-345,-1,-87,90
-1,1749,1671,78,8,232,44
1,1304,1414,-110,6,614,91
-1,1673,1579,94,4,396,110
-1,1394,1501,-107,3,-24,84
1,1611,1590,21,-1,48,63
-1,1450,1258,192,-9,-23,40
-1,1824,1739,85,-6,-135,54
-1,1551,1587,-36,-9,-30,64
1,1694,1582,112,-2,-113,171
1,1666,1548,118,0,31,49
-1,1598,1659,-61,-10,-254,56
1,1329,1807,-478,-4,-150,105
-1,1877,1739,138,1,64,102
-1,1659,1598,61,3,450,88
1,1470,1117,353,5,221,55
-1,1781,1524,257,-4,-242,100
-1,1251,1364,-113,3,-449,120
1,1643,1550,93,0,123,107
-1,1385,1541,-156,-11,-73,40
1,1614,1646,-32,-4,-172,91
1,1674,1747,-73,-1,18,47
1,1598,1312,286,1,69,69
1,2150,1554,596,0,7,69
0,1784,1719,65,0,49,117
1,1651,1599,52,5,276,75
-1,1646,1463,183,-1,-66,82
-1,1634,1630,4,-8,-175,96
1,1571,1593,-22,1,124,99
-1,1999,1467,532,-9,-13,60
-1,1462,2142,-680,0,-18,70
1,1644,1623,21,-2,-68,61
1,1702,1799,-97,-5,-304,77
-1,1421,1466,-45,-2,-559,114
1,1399,1335,64,0,147,91
1,1436,1354,82,0,248,87
1,2151,1553,598,0,44,65
1,1612,1657,-45,-1,-31,53
1,1656,1348,308,-6,547,97
1,1651,1431,220,1,270,111
1,1674,1602,72,0,57,96
-1,1541,1576,-35,-5,-267,76
1,2142,1506,636,1,28,49
-1,1386,1574,-188,-3,78,104
-1,1687,1873,-186,0,-17,68
1,1473,1649,-176,8,164,59
-1,1795,1568,227,0,-63,68
-1,1657,2143,-486,0,-72,78
-1,1733,1676,57,0,-46,72
1,1551,1416,135,-1,163,83
0,1780,1671,109,1,63,110
-1,1777,1899,-122,-4,-318,90
1,1715,1601,114,0,-8,117
-1,1372,1733,-361,-1,-13,60
-1,1539,1761,-222,0,-1,42
-1,1489,1856,-367,-3,-41,46
1,1957,1655,302,0,25,67
1,1706,1858,-152,0,23,75
-1,1480,1628,-148,0,-160,80
-1,1708,1879,-171,0,-120,100
-1,1681,1544,137,-2,-22,84
1,1767,1659,108,0,60,107
1,1656,1426,230,1,411,93
-1,1408,1466,-58,-9,-361,78
1,1661,1808,-147,3,216,67
1,1723,1545,178,3,226,89
1,1662,1503,159,-3,74,191
-1,1652,1961,-309,0,88,78
1,1770,1337,433,2,49,55
1,1640,1384,256,5,82,47
0,1697,1761,-64,2,43,67
-1,1568,1751,-183,0,-357,128
1,1596,1453,143,5,600,107
0,1607,1649,-42,1,-494,157
-1,1462,2152,-690,0,9,58
-1,1586,1604,-18,-2,-5,42
1,1354,1416,-62,4,39,79
1,1871,1486,385,1,82,77
1,1727,1660,67,0,52,55
1,1561,1422,139,-8,39,71
-1,1358,1764,-406,-4,-214,78
0,1203,0,1203,-13,-1085,148
-1,1701,1497,204,0,-70,88
-1,1722,1835,-113,1,-388,118
1,1530,1457,73,3,109,61
-1,1537,1698,-161,-2,-188,78
-1,1891,1965,-74,-3,-166,70
-1,1369,1520,-151,1,116,70
1,1772,1885,-113,3,220,75
-1,1882,2043,-161,-10,-146,54
1,1782,1624,158,0,31,119
1,1757,1562,195,0,14,53
1,1631,1576,55,2,145,99
-1,2051,1875,176,0,227,86
-1,1648,1975,-327,-1,-32,68
-1,1493,1522,-29,2,-583,140
-1,1721,1918,-197,-3,-319,86
0,1476,1399,77,2,67,104
-1,1531,1839,-308,0,-53,90
-1,1892,2032,-140,-8,-386,66
1,1643,1483,160,-1,-7,59
1,1398,1356,42,-2,-29,49
1,1597,1634,-37,-1,17,77
1,1557,1500,57,1,13,59
-1,1871,1906,-35,3,-96,112
-1,1456,1520,-64,-34,-547,44
-1,1729,1759,-30,3,19,84
-1,1878,2047,-169,-1,-66,62
-1,1625,1488,137,-4,-56,90
1,1533,1683,-150,3,107,65
1,1651,1775,-124,0,-4,41
-1,1787,1500,287,0,-360,170
1,2054,1871,183,1,102,83
-1,1790,1713,77,-4,9,44
1,1774,1862,-88,0,14,47
-1,1676,1936,-260,3,107,62
-1,1564,1701,-137,-1,-32,52
-1,1636,1864,-228,0,67,72
1,1856,1642,214,12,909,75
-1,1363,1659,-296,-15,-531,56
-1,1401,1724,-323,-2,-40,57
1,1533,1599,-66,-3,-124,63
-1,1865,2061,-196,-1,-397,122
1,2125,1982,143,1,16,55
1,1770,1559,211,-1,-85,81
-1,1411,1398,13,0,-22,86
1,1849,1789,60,-2,-86,73
-1,1713,1604,109,2,-76,76
1,1629,1590,39,0,306,81
1,1648,1619,29,3,420,81
1,2068,1859,209,1,375,115
-1,1630,1606,24,-1,-57,58
1,1618,1698,-80,1,119,81
1,1527,1450,77,-1,422,133
-1,1666,1512,154,-2,-173,74
1,1591,1271,320,9,156,45
-1,1775,1737,38,-2,-820,147
1,1891,1974,-83,0,-128,99
-1,1613,1854,-241,2,52,48
1,1557,1415,142,0,261,122
1,1396,1351,45,-11,-438,53
-1,1636,1645,-9,0,-248,106
-1,1415,1474,-59,0,-230,92
1,1859,1607,252,-4,-63,45
1,1617,1548,69,-2,-138,127
1,1742,1959,-217,0,15,65
-1,1916,1861,55,-4,-53,46
-1,1623,1756,-133,-3,-191,96
-1,1650,1500,150,0,1,88
-1,1642,1572,70,0,-10,54
-1,1547,1585,-38,-7,-189,48
1,1636,1666,-30,0,55,105
-1,1359,1768,-409,-1,247,126
-1,1681,1940,-259,-4,-66,48
-1,1958,1386,572,-4,-171,52
1,1763,1775,-12,-4,513,95
1,1776,1778,-2,0,52,113
-1,1843,1779,64,-1,-14,64
1,1559,1579,-20,-1,-33,61
1,1944,1587,357,5,233,74
1,1626,1266,360,17,630,63
-1,1367,1286,81,-1,-226,70
-1,1510,1500,10,2,34,126
-1,1592,1872,-280,0,6,46
-1,1537,1711,-174,-8,-169,74
1,1683,1542,141,-5,-81,55
1,1728,1822,-94,0,318,117
-1,1874,1903,-29,-3,6,40
-1,1715,1940,-225,0,-53,86
-1,1290,1379,-89,-3,-108,50
1,1876,1587,289,6,-1,42
1,1666,1666,0,2,175,72
1,1683,1629,54,4,627,101
0,1580,1639,-59,-3,-345,171
-1,1582,1880,-298,-1,-64,52
-1,1280,1585,-305,-7,-470,86
-1,1294,1515,-221,-11,-549,70
1,1369,1440,-71,4,392,149
-1,1504,1610,-106,1,139,70
1,1884,1578,306,1,92,71
1,1913,1864,49,0,-16,89
-1,1454,1618,-164,9,283,88
-1,1408,1662,-254,0,-117,80
1,1693,1526,167,0,-5,47
-1,1499,1410,89,0,-23,62
-1,1564,1655,-91,-3,-47,118
-1,1621,1500,121,0,-134,76
-1,1747,1653,94,-18,-482,58
1,1774,1789,-15,3,159,91
-1,1574,1887,-313,1,30,52
-1,1520,1699,-179,-5,-23,70
1,1472,1788,-316,2,100,59
-1,1792,1827,-35,-1,-182,76
1,1535,1690,-155,2,175,79
-1,1756,1520,236,0,-13,66
1,1194,1126,68,3,55,43
-1,1394,1625,-231,0,7,66
-1,1634,1753,-119,0,73,88
-1,1750,1632,118,0,1,62
-1,1891,1570,321,-6,-168,54
1,1595,1481,114,1,155,81
0,1682,1758,-76,0,-40,114
1,1393,1388,5,-1,-16,105
-1,1746,1611,135,2,-763,104
1,1786,1632,154,-1,36,52
1,1440,1536,-96,0,197,71
-1,1678,1718,-40,0,50,106
1,1588,1643,-55,0,-32,118
1,1667,1404,263,0,68,79
-1,1531,1450,81,-6,-89,60
1,1741,1325,416,0,8,55
-1,1631,1381,250,6,123,46
1,1706,1316,390,16,341,49
1,1870,1484,386,-3,-63,67
1,1732,1352,380,-2,-43,61
-1,1715,2074,-359,0,-138,76
-1,1428,1610,-182,-3,-248,78
-1,1854,1922,-68,1,26,54
-1,1354,1476,-122,-10,101,96
-1,1482,1872,-390,5,188,60
1,1544,1166,378,0,45,67
-1,1839,1782,57,-2,-38,86
-1,1624,1572,52,0,-1,152
1,2077,1712,365,-7,131,97
1,1798,1777,21,3,81,57
-1,1616,1639,-23,0,-10,54
-1,1428,1827,-399,0,-14,52
0,1710,1642,68,1,-69,127
-1,1710,1767,-57,-2,-69,66
1,1709,1674,35,-6,254,99
-1,1400,1672,-272,-3,-163,76
1,1743,1631,112,0,175,99
1,1645,1478,167,2,-22,51
1,1556,1521,35,3,153,71
-1,1738,1500,238,2,119,86
-1,1516,1686,-170,-2,-84,60
-1,1633,1662,-29,-1,-222,107
-1,1868,2072,-204,0,-61,70
-1,1884,1716,168,0,-62,74
1,1629,1317,312,-10,-338,75
0,1947,1857,90,-4,-263,114
-1,1551,1442,109,0,-202,96
-1,1412,1950,-538,-3,5,54
-1,1330,1517,-187,-11,-353,65
1,1759,1797,-38,0,21,69
1,1650,1440,210,-1,-38,63
1,1495,1531,-36,-5,-178,97
0,1860,1944,-84,0,-27,90
-1,1576,1532,44,-2,-149,68
-1,1600,1560,40,-1,-216,124
1,1646,1772,-126,4,120,71
-1,1657,1641,16,-3,-172,72
-1,1942,1863,79,0,-234,96
1,1617,1518,99,6,29,41
1,1528,1432,96,-2,111,67
1,1617,1640,-23,2,121,65
1,1312,1760,-448,-8,-248,65
1,1800,1569,231,0,104,97
-1,1862,2078,-216,-4,-15,43
-1,1477,1509,-32,-1,-155,54
1,1656,1419,237,0,131,81
-1,1624,1362,262,2,43,66
-1,1927,1976,-49,1,178,92
1,1791,1502,289,1,32,43
1,1784,1771,13,0,53,61
-1,1542,1460,82,0,192,70
-1,1523,1590,-67,-12,-394,68
-1,1262,1458,-196,-4,-112,52
-1,1615,1655,-40,0,-10,112
-1,1917,1562,355,0,29,72
-1,1626,1951,-325,-1,-94,54
1,1526,1475,51,21,1154,83
1,1552,1476,76,11,383,53
-1,1795,1856,-61,0,25,74
-1,1437,1610,-173,-1,-174,60
-1,1899,1580,319,3,14,48
-1,1469,1641,-172,-9,-645,60
1,1418,1473,-55,1,2,51
-1,1564,1444,120,0,-12,72
1,1805,1622,183,1,144,65
1,1900,1828,72,0,459,115
1,1732,1867,-135,0,30,74
-1,1522,1498,24,-2,-43,70
-1,1668,1955,-287,-1,-90,100
1,1647,1463,184,5,574,107
-1,1601,1879,-278,-2,-213,90
-1,1544,1337,207,8,114,62
1,1596,1428,168,-1,-61,65
1,1562,1563,-1,0,-13,45
-1,1541,1986,-445,-2,-111,72
-1,1490,1585,-95,1,40,62
-1,1679,1809,-130,0,-3,78
-1,1623,1727,-104,0,-46,90
1,1883,1597,286,0,20,53
-1,1535,1654,-119,-5,-461,96
1,1539,1212,327,-4,-7,41
1,1464,1401,63,1,109,58
1,1672,1500,172,1,121,62
1,1652,1643,9,-8,-176,89
1,1811,1616,195,0,52,81
-1,1593,1616,-23,-3,93,46
-1,1553,1572,-19,0,44,110
-1,1662,1527,135,0,-178,110
1,1339,1665,-326,0,445,103
1,1819,1631,188,8,81,45
-1,1420,1514,-94,-1,-38,68
-1,1542,1430,112,-7,-24,42
-1,946,1391,-445,-12,-654,84
-1,1616,1661,-45,0,-8,42
-1,1447,1458,-11,1,-32,84
1,1697,1667,30,-1,63,114
-1,1887,1987,-100,-5,-147,83
1,1627,1581,46,3,109,61
1,1824,1625,199,-1,41,59
1,1234,0,1234,3,284,95
1,1507,1490,17,0,20,81
-1,1543,1645,-102,-3,-181,62
-1,1645,1588,57,1,-11,44
-1,1605,1886,-281,-1,-90,84
-1,1571,1637,-66,-3,-40,56
-1,1752,1839,-87,0,315,80
-1,1588,1737,-149,0,22,50
1,2145,1870,275,-1,-15,74
-1,1654,1535,119,9,299,60
1,1226,1166,60,7,52,41
1,2083,1959,124,0,179,119
1,1664,1565,99,0,-37,53
1,1390,1489,-99,7,64,45
-1,1512,1477,35,-6,-403,100
1,1665,1468,197,2,350,103
1,1476,1652,-176,0,13,59
1,1866,1561,305,-4,-20,51
1,1752,1721,31,1,290,85
1,1851,1747,104,1,116,85
1,1549,1638,-89,2,148,73
1,1817,1607,210,-3,-37,99
1,1692,1377,315,1,292,127
1,1328,1627,-299,0,103,83
-1,1557,1869,-312,-7,-126,58
1,1624,1563,61,-1,182,101
-1,1615,1670,-55,0,-3,44
1,1542,1017,525,11,1031,93
1,1680,1573,107,-5,281,171
-1,1727,1818,-91,0,-67,82
-1,1390,1353,37,-3,-245,72
-1,1575,1852,-277,-2,-20,52
-1,1554,1633,-79,-2,-239,76
-1,2072,1385,687,0,21,72
-1,1359,1462,-103,1,-10,52
-1,1752,1496,256,0,9,54
-1,1118,1266,-148,-14,-808,74
1,1856,1570,286,3,58,45
-1,1671,1832,-161,0,-239,168
1,1789,1469,320,3,61,41
-1,1951,2091,-140,0,-153,122
1,1665,1660,5,1,67,83
-1,1442,1642,-200,4,-260,122
1,1762,1602,160,1,33,49
-1,1566,1860,-294,0,-11,55
1,1632,1596,36,-1,7,59
1,1615,1831,-216,0,5,53
-1,1520,1416,104,0,-379,116
1,1864,1562,302,0,-66,69
1,1822,1553,269,4,98,57
-1,1785,1929,-144,-1,31,75
1,1588,1543,45,3,130,52
-1,1500,1685,-185,-8,-421,90
1,1523,1557,-34,-1,-129,85
-1,1558,1868,-310,2,43,72
1,1478,1343,135,1,31,119
-1,1741,2052,-311,-1,-54,90
-1,1435,1581,-146,-2,209,94
0,1534,1462,72,5,84,51
-1,1649,1677,-28,1,-79,116
1,1606,1601,5,-2,-14,99
1,1518,1489,29,2,173,87
1,1498,1573,-75,-2,-33,77
1,1707,1670,37,0,-21,65
1,1435,1573,-138,4,414,81
1,1739,1859,-120,1,130,109
-1,1866,2161,-295,-1,-82,90
0,1793,1848,-55,1,133,175
1,1872,1554,318,1,85,55
1,1571,1711,-140,2,186,77
-1,1608,1424,184,2,-107,72
1,1294,1086,208,5,378,93
-1,1841,1717,124,-6,-25,42
1,1611,1431,180,-1,-47,43
-1,2002,2150,-148,0,-171,108
1,2056,1698,358,3,92,63
1,1452,1557,-105,3,351,107
1,1757,1634,123,-1,346,91
1,1499,1371,128,-1,22,69
1,1950,1778,172,-1,45,73
-1,1826,1908,-82,-7,-507,140
-1,1467,1744,-277,-4,-334,85
-1,1373,1696,-323,3,73,72
-1,1707,1645,62,-1,169,158
-1,1425,1634,-209,0,49,60
1,1660,1717,-57,-2,-168,95
1,1463,1085,378,2,11,45
-1,1983,2188,-205,-1,-85,60
-1,1532,1464,68,-1,-345,76
1,1733,1358,375,10,271,55
-1,1500,1390,110,4,-47,76
-1,1512,1560,-48,-4,-145,60
1,1365,1237,128,14,179,47
1,1689,1639,50,0,213,137
-1,1551,1748,-197,-1,-94,50
1,1654,1509,145,3,187,69
1,1455,1577,-122,0,39,65
-1,1252,1604,-352,-12,-73,42
-1,1492,1599,-107,1,-29,106
1,1700,1699,1,0,96,101
1,1753,1544,209,1,100,67
1,1690,1910,-220,0,693,133
-1,1502,1687,-185,-11,-423,76
1,1862,1916,-54,0,102,71
-1,1485,1448,37,-3,-326,86
1,1502,1320,182,-1,-5,51
0,1505,1419,86,-1,-435,146
1,1458,1370,88,2,34,71
-1,1354,1736,-382,-5,-278,60
1,1626,942,684,-1,-11,45
0,1967,1943,24,1,51,79
1,1492,1549,-57,0,174,57
-1,1569,1708,-139,-2,-48,50
1,1996,1875,121,3,161,69
1,1518,1361,157,1,19,45
-1,1555,1646,-91,-2,-53,70
1,1479,1610,-131,-1,-57,61
1,1844,1753,91,9,448,95
-1,1431,1694,-263,-1,-40,56
-1,1699,1533,166,0,12,68
-1,1588,1723,-135,0,-307,121
1,1693,1560,133,-3,10,69
1,1513,1633,-120,4,-41,91
0,1617,1736,-119,0,31,125
-1,1655,1546,109,-11,-280,52
1,1512,1062,450,13,135,43
1,1526,1743,-217,0,7,57
1,1779,1191,588,0,24,63
1,1508,1314,194,-1,83,79
0,1904,1877,27,1,271,107
1,1715,1659,56,3,148,59
1,1699,1427,272,2,150,73
1,1618,1454,164,1,111,67
-1,1526,1562,-36,-1,-27,82
-1,1235,1363,-128,-2,-47,44
1,1705,1738,-33,1,204,77
-1,1640,1447,193,1,71,54
1,1438,1877,-439,0,29,63
-1,1351,1725,-374,-8,-337,62
1,1423,1704,-281,1,19,47
-1,1866,1892,-26,-8,221,94
1,1717,1508,209,4,435,121
-1,1523,1474,49,1,-237,128
-1,1682,1441,241,2,85,74
-1,1514,1466,48,1,32,52
1,1515,1645,-130,6,679,127
1,1947,1604,343,0,261,83
1,1847,1795,52,0,162,83
-1,1902,1710,192,0,-16,78
-1,1459,1661,-202,-8,40,62
1,1480,1622,-142,-1,30,49
1,1672,1535,137,2,29,57
-1,1525,1553,-28,-3,-11,46
-1,1585,1559,26,0,-481,98
-1,1055,1514,-459,0,-1,42
1,1681,1536,145,0,21,57
1,1371,1498,-127,0,12,61
1,1667,1454,213,3,284,79
-1,1500,1885,-385,-1,-162,68
1,1638,1607,31,12,403,49
1,1372,1229,143,7,170,53
-1,1468,1880,-412,-2,-43,72
1,1708,1479,229,5,270,93
-1,1596,1268,328,-3,-68,52
1,1748,1852,-104,2,161,115
-1,1730,1888,-158,-2,-47,50
1,1567,1746,-179,2,413,141
-1,1449,1673,-224,1,21,44
1,1716,1565,151,1,25,45
-1,1602,1725,-123,0,5,46
-1,1598,1699,-101,0,-477,116
1,1679,1444,235,-5,-114,73
-1,1373,1530,-157,-3,-86,68
1,1571,1572,-1,1,264,95
-1,1825,1855,-30,-11,-117,41
1,1894,1722,172,0,12,73
1,1745,1581,164,10,182,51
-1,1882,1464,418,-7,439,130
-1,1344,1730,-386,-5,-163,56
1,1557,1445,112,14,147,43
1,1866,1805,61,-1,-9,67
-1,1439,1684,-245,-4,-337,66
1,1700,1389,311,3,111,46
-1,1715,1901,-186,0,-20,70
-1,1620,1822,-202,0,1,62
-1,1221,1473,-252,-2,-12,48
-1,1690,1434,256,-5,-68,68
-1,1502,1301,201,-4,-65,64
1,1549,1453,96,-1,-88,63
-1,1503,1860,-357,-3,-101,62
1,1568,1674,-106,1,215,95
1,1446,1631,-185,3,155,65
-1,1708,1907,-199,-1,-35,114
-1,1453,1669,-216,-2,-17,60
-1,1366,1561,-195,-3,-105,55
1,1194,1275,-81,3,390,121
-1,1516,1637,-121,-4,-94,60
1,1490,1558,-68,1,12,55
1,1704,1732,-28,-4,-4,63
1,1624,1607,17,6,70,43
1,1514,1206,308,4,642,97
1,1385,1338,47,-6,-266,91
-1,1723,1548,175,1,52,50
1,1558,1583,-25,1,183,73
-1,1674,1447,227,-10,-335,58
-1,1702,1912,-210,-3,-306,116
1,1863,1498,365,1,99,93
-1,1327,1732,-405,-4,-315,88
-1,1615,1831,-216,0,-225,160
-1,1785,1499,286,-1,-477,104
-1,1918,1696,222,0,-242,94
1,1784,1502,282,0,84,97
-1,1595,1786,-191,0,-21,42
1,1543,1533,10,0,-21,85
0,1667,1648,19,0,-220,104
1,1570,1444,126,-2,-150,45
1,1587,1661,-74,-1,-161,79
1,1657,1597,60,0,-100,79
-1,1575,1503,72,-1,-37,72
-1,1760,1796,-36,-8,-127,60
1,1712,1016,696,9,694,69
-1,1567,1576,-9,-2,-26,42
-1,1493,1866,-373,-7,-255,94
1,1720,1614,106,1,45,63
1,1912,1964,-52,1,12,51
-1,1498,1286,212,1,78,68
1,1622,1598,24,0,0,45
1,1637,1962,-325,-1,-55,89
1,1674,1877,-203,-2,-17,151
-1,1949,1927,22,-1,-69,56
1,1722,1517,205,-2,-59,43
1,1462,1523,-61,-6,-62,81
1,1446,1494,-48,-5,2,70
-1,2114,2057,57,0,39,68
1,1545,1536,9,2,34,41
1,1940,1880,60,-1,16,71
1,1596,1686,-90,-5,-23,43
1,1727,1731,-4,0,-71,121
-1,1461,1756,-295,0,-253,118
1,1524,1556,-32,-1,0,41
1,1437,1331,106,-2,-15,51
-1,1317,1344,-27,-8,-119,52
1,1510,1475,35,-6,-158,93
1,1728,1497,231,-2,187,113
-1,1671,1610,61,0,-44,92
-1,1570,1597,-27,-3,-191,84
-1,1543,1537,6,-1,-7,48
1,1516,1512,4,0,50,71
1,1950,1799,151,0,20,95
-1,1152,1581,-429,-2,-285,84
1,2000,1676,324,-2,-67,65
-1,1742,1726,16,2,-117,102
-1,1186,1286,-100,3,145,58
-1,1480,1615,-135,-6,-523,158
1,1458,1455,3,-6,407,115
-1,1550,1744,-194,-5,-45,54
1,1549,1532,17,2,293,66
1,1381,1551,-170,1,339,93
-1,1461,1373,88,-9,-158,62
-1,1508,1477,31,-1,-445,98
-1,1586,1531,55,0,27,64
1,2072,1597,475,-5,213,129
1,1521,1560,-39,1,32,61
-1,1521,1409,112,1,34,48
-1,1819,1954,-135,-1,-9,44
1,1658,1586,72,-1,272,91
1,2004,2073,-69,0,143,125
1,1698,1276,422,0,31,77
-1,1460,1647,-187,-2,-108,58
-1,1737,1730,7,1,33,68
0,1489,1496,-7,-3,439,147
1,1961,1812,149,0,-27,53
-1,1547,1533,14,0,-14,70
-1,1321,1445,-124,-2,-69,62
1,1885,1897,-12,-1,26,65
1,1674,1658,16,2,242,125
1,1733,1418,315,-2,134,91
1,1784,1545,239,1,149,85
-1,1662,1768,-106,0,-94,92
1,1473,1500,-27,1,49,79
-1,1718,1655,63,1,46,70
-1,1367,1341,26,-6,-599,70
-1,1623,1658,-35,1,9,54
-1,1569,1527,42,-6,-73,44
-1,1608,1546,62,1,-1,56
1,1502,1251,251,-4,-91,53
-1,1354,1474,-120,1,2,61
-1,1122,1482,-360,-9,-152,40
1,1792,1576,216,-4,-19,51
1,1631,1732,-101,-1,26,81
-1,1805,1968,-163,0,98,78
1,1386,1434,-48,5,307,67
1,1561,1248,313,0,23,63
1,1565,1556,9,-3,40,59
-1,1742,1726,16,2,13,40
1,1545,1570,-25,0,-28,63
1,1578,1610,-32,4,99,85
-1,1689,2059,-370,-4,-166,64
1,1692,1484,208,5,108,43
-1,1760,1444,316,-1,9,80
-1,1464,1095,369,0,9,78
1,1443,1361,82,1,234,87
0,1481,1428,53,0,151,156
1,1347,1482,-135,-1,40,41
-1,1355,1242,113,-4,-272,102
-1,1668,1791,-123,-5,-514,104
-1,1517,1575,-58,0,-231,96
1,1557,1797,-240,-1,-60,79
1,1737,1834,-97,0,7,139
-1,1320,1513,-193,-2,71,74
-1,1928,1698,230,-2,-117,80
-1,1522,1485,37,-1,-23,58
1,1644,1470,174,2,81,53
1,1545,1595,-50,8,847,141
1,1609,1578,31,1,14,51
-1,1590,1716,-126,0,-143,132
-1,1556,2042,-486,-3,-21,48
-1,1421,1497,-76,6,100,46
-1,1453,1312,141,7,420,78
-1,1460,1507,-47,-8,-88,41
-1,1506,1551,-45,-2,-135,94
-1,1354,1468,-114,1,40,60
-1,1575,2043,-468,0,-114,68
1,1779,1654,125,0,287,143
1,1799,1661,138,5,62,49
-1,1287,1353,-66,-5,-329,90
1,1721,1410,311,9,151,53
1,1612,1603,9,-2,-17,55
-1,1540,1599,-59,3,21,90
-1,1822,1940,-118,1,5,46
1,1568,1619,-51,0,38,67
-1,2061,1959,102,-3,-211,97
1,1478,1496,-18,1,177,70
-1,1292,1579,-287,0,-304,88
1,1562,1558,4,3,147,81
-1,1565,1244,321,0,185,116
-1,1554,1658,-104,-4,-49,44
-1,1116,1583,-467,-7,-578,70
-1,1451,1665,-214,-8,-113,48
-1,1650,1793,-143,-2,-58,92
-1,1482,1648,-166,-1,-323,98
0,1415,1698,-283,0,2,132
-1,1917,1974,-57,-1,-65,76
1,1480,1567,-87,0,222,105
1,1666,1544,122,0,37,99
1,2074,1573,501,1,130,115
1,1800,1643,157,2,217,107
1,1709,1686,23,0,65,101
1,1716,1462,254,7,257,61
-1,1566,1584,-18,-2,-135,86
-1,1433,1550,-117,0,-899,168
1,1530,1346,184,-1,-18,47
1,1741,1539,202,1,125,67
1,1547,1589,-42,4,867,101
-1,1341,1126,215,-12,-349,54
-1,1446,1670,-224,1,-52,86
1,1554,1494,60,1,92,63
-1,1536,1565,-29,-10,-488,78
-1,1708,2075,-367,0,49,64
1,1465,1346,119,-1,-37,75
-1,1583,1735,-152,-1,-274,96
1,1459,1535,-76,0,12,77
-1,1519,1883,-364,-1,-303,126
-1,1387,1277,110,-4,-137,72
-1,1721,1667,54,1,-22,52
-1,1123,1443,-320,-20,-735,62
-1,1162,1498,-336,-13,-436,52
-1,1600,1491,109,-7,-701,88
-1,1525,1576,-51,-7,-119,82
-1,1566,1425,141,-2,-178,88
1,1662,1595,67,2,50,79
-1,1507,1653,-146,-4,-99,50
-1,1485,1395,90,2,-124,114
1,1200,1204,-4,15,1679,93
-1,1472,1519,-47,-5,-226,76
-1,1496,1240,256,0,-8,70
1,1821,1638,183,-1,6,57
-1,1554,1670,-116,9,18,108
-1,1561,1559,2,0,-319,88
1,1748,1586,162,-6,-131,51
1,1512,1290,222,2,83,59
-1,1606,1605,1,-1,20,40
1,1786,1948,-162,0,-31,45
-1,1579,1949,-370,0,-264,70
-1,1356,1572,-216,0,-261,164
1,1476,1528,-52,-3,-97,57
1,1737,1886,-149,0,158,123
1,1812,1534,278,4,216,73
-1,1754,1500,254,-9,-92,124
1,1747,1578,169,2,314,85
-1,1577,1742,-165,-1,-385,112
1,1591,1565,26,0,-1,41
1,1742,1267,475,-2,108,79
1,1476,1515,-39,-1,-35,121
1,1520,1470,50,-5,94,105
1,1646,1748,-102,-3,152,81
1,1653,1749,-96,-7,-189,49
1,1952,1848,104,0,267,111
-1,1607,1604,3,6,91,62
-1,1200,1206,-6,10,305,86
1,1521,1555,-34,4,331,107
-1,1821,1806,15,-4,-669,120
-1,1668,1734,-66,-3,-229,64
1,1517,1485,32,3,86,63
-1,1372,1602,-230,0,-35,72
-1,1594,1744,-150,-4,-157,86
1,1679,1661,18,2,47,41
1,1632,1279,353,22,814,59
-1,1753,1796,-43,0,36,96
1,1749,1653,96,2,182,59
1,1488,1724,-236,1,129,69
1,1663,1675,-12,6,244,73
1,1960,1580,380,3,62,47
-1,1793,1461,332,-2,-16,48
0,1931,1870,61,-2,-121,132
-1,1576,1840,-264,0,37,72
-1,1644,1509,135,-4,-8,56
-1,1772,1579,193,-4,-109,70
-1,1623,1743,-120,0,-4,40
-1,1519,1452,67,-10,-219,54
1,1499,1127,372,-1,20,59
1,1549,1530,19,1,422,77
1,1500,1984,-484,0,-37,75
1,1594,1760,-166,0,54,74
1,1641,1518,123,16,268,41
1,1575,1539,36,0,325,89
1,1274,1243,31,-5,-46,157
-1,1424,1421,3,2,54,52
1,1743,1596,147,-1,52,135
1,1660,1500,160,2,231,91
1,1506,1465,41,-2,251,89
1,1696,1236,460,-2,-84,59
0,1662,1510,152,0,398,118
1,1555,1558,-3,-7,-52,93
1,1547,1733,-186,-3,-136,61
0,1702,1704,-2,3,548,134
1,1810,1720,90,-1,-115,81
1,1172,1265,-93,6,466,75
1,1501,1597,-96,1,7,53
1,1327,1170,157,4,115,53
-1,1456,1516,-60,-3,-57,74
1,1474,1530,-56,0,26,58
1,2169,1613,556,0,84,109
0,1527,1475,52,3,90,69
-1,1930,1934,-4,-1,10,52
-1,1564,1715,-151,-1,-13,48
-1,1442,1824,-382,0,-70,78
1,1675,1730,-55,1,108,77
1,1631,1512,119,9,406,121
1,1457,1594,-137,-1,293,94
-1,1432,1525,-93,5,220,70
-1,1659,1729,-70,-2,-665,170
1,1413,1331,82,1,28,165
1,1589,1750,-161,-1,120,63
-1,1612,2170,-558,-1,-111,104
1,1568,1515,53,-4,68,139
-1,1566,1672,-106,-2,-330,114
1,1533,1423,110,1,-232,125
-1,1515,1540,-25,-3,-259,118
1,1646,1477,169,2,238,97
1,1487,1516,-29,0,14,71
0,1460,1538,-78,-2,-37,127
1,1717,1688,29,0,72,65
-1,1505,1540,-35,7,502,88
0,1529,1285,244,0,-28,100
-1,1734,1605,129,0,-473,124
-1,1818,1945,-127,2,48,84
-1,1136,1123,13,-3,-10,42
-1,1533,1440,93,3,83,58
1,1712,1560,152,-3,-38,97
0,1469,1473,-4,1,47,110
0,1546,1531,15,-8,781,196
1,1550,1320,230,-2,-18,45
1,1531,1705,-174,1,65,83
1,1565,1619,-54,-1,90,73
1,2171,1792,379,2,58,45
1,1764,1684,80,1,61,67
1,1495,1500,-5,0,167,77
1,1525,1477,48,-1,118,85
-1,1555,1446,109,2,-213,64
1,1285,1500,-215,0,-149,89
-1,1853,1935,-82,-1,-59,50
1,1520,1577,-57,0,15,55
-1,1727,1606,121,1,8,58
-1,1234,1698,-464,-11,-229,44
-1,1704,1804,-100,-2,-116,62
1,1784,1872,-88,0,86,137
1,1718,1720,-2,-1,-7,45
-1,1661,1691,-30,0,-89,118
-1,1503,1500,3,-8,26,108
-1,1499,1503,-4,1,-43,70
1,1598,1578,20,3,123,81
-1,1558,1550,8,2,77,54
1,1709,1730,-21,-8,360,93
-1,1463,1620,-157,-1,-451,132
1,1858,1970,-112,-2,-108,73
1,1504,1499,5,4,279,69
1,1360,1501,-141,-3,75,56
-1,1817,1762,55,-3,-142,74
1,1696,1680,16,0,-72,73
-1,1567,1615,-48,-5,-34,42
-1,1198,1064,134,2,-773,150
-1,1651,1563,88,-2,-43,54
-1,1712,1729,-17,-1,-42,72
-1,1549,1676,-127,-2,-227,78
-1,1720,1623,97,-6,-252,98
-1,1588,1504,84,-3,-216,104
-1,1718,1720,-2,0,-16,72
0,1873,2046,-173,-1,-130,147
1,1562,1547,15,4,94,55
-1,1446,1670,-224,0,42,106
-1,1532,1553,-21,-2,-947,130
-1,1488,1515,-27,0,-22,60
1,1488,1525,-37,6,156,53
-1,1805,1817,-12,-4,-22,44
0,1682,1572,110,-1,163,146
-1,1464,1630,-166,-10,-364,66
-1,1540,2101,-561,-2,-421,108
1,1376,1563,-187,3,73,57
-1,1334,1422,-88,0,-518,112
-1,1774,1612,162,-9,-133,52
-1,1639,1719,-80,2,-216,138
-1,1787,1828,-41,0,-195,58
-1,1569,1773,-204,0,18,46
-1,1624,1571,53,-5,-150,60
-1,1340,1647,-307,-3,-529,124
0,1531,1546,-15,0,-154,117
-1,1522,1671,-149,-1,-96,58
-1,1651,2074,-423,-7,-189,58
-1,1653,1476,177,-1,-20,42
1,1518,1307,211,7,85,43
1,1419,1273,146,3,96,51
1,1587,1637,-50,3,54,47
-1,1494,1852,-358,-12,-184,46
0,2076,1898,178,0,-13,102
-1,1766,1792,-26,0,-49,78
1,1650,1491,159,4,146,61
-1,1605,1348,257,-1,-124,90
-1,1317,1855,-538,-5,-218,100
1,1781,1211,570,1,-10,47
1,1641,1811,-170,-5,407,137
1,1805,1693,112,0,-24,69
-1,1521,1635,-114,-3,-335,86
1,1275,1260,15,0,186,127
1,1779,1151,628,4,453,95
1,1658,1611,47,2,235,89
1,1484,1626,-142,-1,-66,63
-1,1823,1710,113,0,36,110
1,2078,1897,181,0,131,83
-1,1301,1524,-223,-11,-1053,96
1,1402,1445,-43,2,239,63
-1,1695,1712,-17,2,28,44
1,1439,1400,39,-1,-21,65
-1,1610,1657,-47,-1,-305,146
1,2003,1944,59,1,128,159
1,1749,1505,244,0,50,102
-1,1771,1746,25,-4,-210,74
1,2086,2105,-19,0,-190,147
-1,1689,1635,54,-7,-40,44
1,1589,1478,111,-1,-7,41
1,1603,1718,-115,0,22,81
-1,1475,1545,-70,2,32,52
0,1933,1931,2,0,-29,130
1,1677,1505,172,2,485,111
1,1767,1545,222,-1,-54,61
-1,2093,2102,-9,0,-351,108
1,1336,1500,-164,0,-9,47
1,1657,1796,-139,-1,186,89
1,1536,1216,320,0,-204,73
1,1583,1495,88,0,54,137
1,1717,1601,116,-1,-36,53
-1,1367,1481,-114,-1,-319,146
1,1713,1659,54,3,268,89
1,1200,0,1200,3,94,51
1,1755,1410,345,-2,7,63
1,1581,1532,49,2,97,63
1,1389,1390,-1,-1,-11,59
1,1433,1414,19,1,610,133
-1,1794,2082,-288,-2,-74,52
1,1483,1352,131,4,223,73
-1,1611,1563,48,-4,-46,42
1,1522,1417,105,3,175,91
-1,1688,1698,-10,-4,-90,76
1,1496,1679,-183,1,13,53
-1,1724,1782,-58,-10,-608,86
1,1363,1456,-93,0,-6,55
-1,1782,1688,94,4,217,62
1,1554,1501,53,0,71,63
1,1539,1310,229,3,75,47
-1,1211,1579,-368,-1,-67,66
1,1466,1068,398,1,84,57
1,2102,2116,-14,1,9,61
1,1594,1657,-63,5,201,121
-1,1051,1149,-98,-18,-366,46
-1,1249,1540,-291,-1,-98,78
-1,1931,1933,-2,0,9,66
1,1500,1498,2,5,348,91
1,1778,1728,50,1,417,121
1,1534,1684,-150,1,27,50
1,1617,1586,31,-1,44,63
-1,1904,2101,-197,0,218,78
0,2004,1776,228,-1,1,121
-1,1399,1540,-141,-2,-173,120
1,1281,1207,74,-2,63,61
-1,1544,1585,-41,-8,-808,90
-1,1719,1787,-68,1,-775,110
1,1781,1312,469,-1,-2,43
0,1543,1232,311,3,437,169
0,2108,1899,209,-4,312,131
1,2014,1948,66,0,-1,83
-1,1796,1710,86,1,25,52
1,1765,1408,357,0,-39,49
-1,1534,1326,208,-4,-19,42
1,1590,1523,67,-5,-162,57
1,1615,1495,120,-1,0,69
1,1944,1920,24,0,1,75
1,1758,1714,44,2,83,61
-1,1492,1564,-72,0,-62,110
1,1783,1795,-12,2,215,99
-1,1794,1610,184,-1,-306,110
1,1939,1997,-58,-1,-94,133
-1,1713,1808,-95,-8,-70,40
1,1468,1750,-282,-1,-12,51
-1,1488,1608,-120,-3,-120,69
-1,1364,1319,45,-2,-25,42
-1,1404,1600,-196,-4,-92,50
0,1610,1418,192,0,99,118
1,2080,1651,429,-2,50,51
-1,0,1196,-1196,6,198,74
1,1765,1559,206,6,266,59
-1,1617,1576,41,-4,-679,162
1,1285,1199,86,7,139,45
1,1443,1344,99,-1,-85,63
-1,1676,1784,-108,-1,-104,72
1,1574,1657,-83,-1,-45,69
-1,1410,1519,-109,1,6,44
-1,1266,1536,-270,0,-355,144
-1,1649,2082,-433,-1,-29,60
1,1351,1300,51,2,51,73
-1,1406,1769,-363,-10,-261,52
1,1800,1519,281,7,422,71
1,1514,1509,5,-2,140,131
-1,1382,1588,-206,0,-10,65
1,1816,1702,114,-2,-87,71
-1,1286,1723,-437,10,406,70
1,1517,1474,43,2,304,75
1,2084,1771,313,3,468,87
-1,1828,1647,181,-3,-201,66
1,1627,1592,35,3,-40,43
-1,1499,1754,-255,-1,-9,55
1,1632,1530,102,-2,-97,67
-1,1767,2088,-321,-7,-111,54
1,1313,1152,161,9,119,49
1,1491,1502,-11,1,40,56
1,1810,1553,257,1,86,65
1,1598,1404,194,1,40,63
1,1779,1771,8,1,668,119
-1,1402,1379,23,-1,-33,70
-1,1665,1812,-147,-3,28,106
-1,1588,1528,60,-1,8,47
-1,1410,1491,-81,-3,-75,48
1,1599,1573,26,-3,-35,91
-1,1354,1556,-202,1,-493,106
1,2093,1819,274,2,397,151
-1,1487,1403,84,-4,-52,62
-1,1400,1561,-161,-8,-92,46
1,1540,1250,290,1,391,135
-1,1610,1362,248,-1,-49,64
1,1692,1824,-132,0,259,79
1,1724,1262,462,1,424,123
1,1537,1440,97,0,69,59
-1,1541,1534,7,3,425,78
-1,1815,1789,26,0,-14,56
0,1637,1906,-269,-4,-168,56
-1,1539,1575,-36,-1,-51,64
-1,1606,1465,141,1,-20,68
-1,1737,1547,190,3,156,54
-1,1561,1343,218,-3,493,114
-1,1486,1593,-107,0,-6,72
-1,1803,1800,3,1,16,54
-1,1236,1544,-308,-6,-300,86
1,1291,1248,43,5,210,63
1,1643,1857,-214,0,8,43
1,1571,1416,155,9,189,49
1,1524,1591,-67,-4,-2,51
1,1792,1361,431,4,149,63
1,1954,1649,305,0,-36,127
1,1769,1148,621,3,357,79
-1,1754,1702,52,0,-5,80
1,1744,1801,-57,1,407,151
1,1523,1532,-9,1,105,83
-1,1499,1401,98,-4,-448,94
1,1811,1856,-45,0,24,69
-1,1492,1422,70,-1,-265,162
-1,1339,1795,-456,4,200,72
-1,1468,1563,-95,-5,-302,80
1,1378,1544,-166,3,382,93
1,1608,1510,98,-1,359,117
-1,1701,1817,-116,-1,-134,80
1,1544,1548,-4,0,103,99
-1,1609,1717,-108,-2,-55,56
1,1503,1417,86,4,286,75
-1,1809,1872,-63,-1,-28,54
-1,1537,1475,62,0,-119,68
0,2086,1796,290,0,755,130
-1,1299,1484,-185,0,-12,48
-1,1360,1585,-225,-7,-210,58
-1,1598,1848,-250,0,-216,95
1,1473,1358,115,2,101,65
-1,1517,1390,127,-3,-109,64
-1,1374,1283,91,3,97,54
-1,1800,1837,-37,0,-51,56
-1,1843,1947,-104,0,23,100
1,1529,1409,120,-2,430,113
-1,1460,1571,-111,-1,-27,48
1,1741,1804,-63,2,165,109
-1,1534,1647,-113,1,-224,120
-1,1769,1715,54,-3,-91,92
1,1704,1456,248,1,831,109
-1,1804,2078,-274,0,14,52
1,1723,1478,245,5,146,53
1,1322,1391,-69,0,5,67
1,1882,1984,-102,-2,-252,103
-1,1374,1511,-137,0,-19,68
-1,1607,1605,2,0,-181,90
1,1488,1525,-37,9,341,57
1,1781,1224,557,12,384,54
-1,2082,1800,282,-2,-30,52
-1,1825,1691,134,0,-67,114
1,1395,1536,-141,2,150,113
-1,1355,1590,-235,-1,25,102
1,1589,1556,33,1,45,65
-1,1261,1502,-241,2,91,52
1,1409,1512,-103,-2,-105,59
-1,1607,1321,286,4,89,52
-1,1601,1636,-35,-15,-102,40
-1,1819,2063,-244,0,-39,68
1,1419,1384,35,5,489,77
-1,1577,1495,82,1,24,44
1,1314,1449,-135,12,140,41
-1,1754,1726,28,-2,-50,58
-1,1398,1527,-129,-4,-89,52
0,1986,1766,220,2,277,203
1,1709,1220,489,7,186,51
-1,1513,1500,13,0,-104,80
1,1710,1460,250,1,72,49
-1,1935,1955,-20,0,-639,166
1,1810,2072,-262,0,-38,73
-1,1243,1619,-376,1,-236,86
1,1789,1452,337,1,60,93
1,1930,1210,720,-1,-22,55
-1,1515,1665,-150,-4,-321,108
1,1728,1485,243,1,183,95
-1,1475,1313,162,0,-44,107
-1,1756,1728,28,0,-101,90
-1,1559,1422,137,-1,-26,71
-1,1497,1424,73,0,58,76
1,1450,1419,31,1,-30,83
1,1516,1660,-144,0,115,55
1,1821,1343,478,2,88,71
-1,1742,1759,-17,0,-269,82
1,2053,1973,80,1,62,105
1,1594,1481,113,0,54,69
1,1715,1715,0,0,8,99
1,1500,1482,18,2,80,55
-1,1511,1502,9,-2,-71,112
1,1852,1917,-65,0,99,81
-1,1595,1508,87,-3,-38,41
-1,1188,1420,-232,0,-20,108
-1,1429,1455,-26,-1,-18,53
1,1897,1605,292,3,59,59
1,1453,1333,120,7,534,93
-1,1964,2062,-98,0,-66,62
1,1966,1924,42,0,39,93
-1,1332,1572,-240,-1,-536,102
-1,1344,1390,-46,-5,-160,60
1,1442,1558,-116,1,9,47
-1,1743,1683,60,-4,-169,126
1,1474,1401,73,0,33,71
-1,1344,1625,-281,-5,-91,62
-1,1601,1770,-169,0,22,78
-1,1406,1601,-195,2,86,72
1,1732,1900,-168,4,101,57
1,1437,1484,-47,-5,-172,63
0,1326,1823,-497,3,157,89
-1,1829,1955,-126,-2,-551,126
-1,1466,1448,18,0,-5,98
1,1569,1561,8,1,62,67
1,1726,1818,-92,0,15,83
1,1147,1518,-371,-3,118,89
1,1176,1454,-278,-1,-60,89
-1,1748,1800,-52,-1,-465,102
-1,1592,1498,94,-8,-268,46
1,1467,1494,-27,5,501,67
1,1513,1500,13,-1,-19,77
-1,1796,1896,-100,-3,-74,108
0,1359,1312,47,0,1,79
1,1963,1821,142,9,153,45
1,1752,1522,230,0,273,103
1,1602,1639,-37,0,116,109
-1,1814,1970,-156,-1,-407,118
1,1336,1460,-124,-1,63,55
1,1592,1548,44,-1,-19,145
-1,1711,1776,-65,0,12,42
-1,1500,1549,-49,2,-75,90
1,1863,1544,319,1,36,43
1,1977,1807,170,-2,8,49
1,1738,1740,-2,1,469,117
-1,1409,1368,41,-3,-104,70
-1,1500,1876,-376,1,-189,152
1,2118,1801,317,3,96,53
1,1740,1618,122,0,-51,85
-1,1541,1580,-39,-6,-328,60
-1,1463,1512,-49,0,97,68
-1,1798,2122,-324,-6,-371,80
1,1455,1305,150,12,194,47
1,1577,1326,251,0,46,49
-1,1738,1806,-68,-2,-64,48
-1,1588,1602,-14,2,61,60
1,1728,1661,67,0,68,85
1,1903,1787,116,2,80,57
-1,1729,1696,33,0,-185,90
1,1271,1433,-162,3,94,52
-1,1609,1524,85,-1,-147,118
1,1507,1286,221,0,-86,95
-1,1916,1815,101,0,1,54
1,2126,1794,332,0,87,55
1,1751,1721,30,2,166,77
1,1556,1370,186,-5,100,71
0,1893,1777,116,0,-183,139
1,1504,1676,-172,1,151,73
1,1643,1616,27,-1,224,125
1,1767,1678,89,9,908,99
1,1671,1327,344,3,88,83
1,1592,1406,186,0,266,91
1,1861,1605,256,-1,-89,69
-1,1401,1388,13,-8,-438,128
1,1740,1816,-76,0,94,77
-1,1659,1521,138,-7,-106,54
1,1639,1414,225,0,-87,57
-1,1558,1798,-240,-3,-172,120
-1,1723,1823,-100,0,-13,62
0,1491,1529,-38,1,134,137
1,2148,1890,258,-1,-6,51
1,1670,1708,-38,7,620,101
1,1542,1627,-85,-1,-23,93
1,1406,1158,248,1,138,90
-1,1583,1705,-122,0,-233,74
1,1552,1610,-58,1,93,83
-1,1790,1656,134,0,-16,68
-1,1664,1795,-131,-5,-179,64
1,1617,1749,-132,-1,-3,65
1,1537,1643,-106,0,111,53
-1,1885,2153,-268,-2,-47,44
-1,1440,1681,-241,-4,-237,88
1,1628,1432,196,-3,-40,53
1,1802,1657,145,2,192,101
1,1583,1424,159,-3,-61,65
-1,1645,1454,191,-5,-38,48
0,1881,1827,54,-2,-438,123
1,1629,1552,77,12,191,47
1,1521,1365,156,6,292,65
1,1886,1663,223,-1,-64,66
1,1915,2044,-129,-1,-6,51
-1,1609,1652,-43,1,23,52
-1,1425,1634,-209,6,454,92
-1,1446,1435,11,-4,-80,50
1,1740,1550,190,1,20,41
-1,1287,1638,-351,-4,-218,60
1,1829,1880,-51,-2,486,109
-1,1640,1420,220,1,-26,88
1,1712,1576,136,1,94,99
1,1397,1295,102,13,571,63
-1,1650,1809,-159,-2,-83,68
-1,1688,1781,-93,0,-82,60
-1,1763,1730,33,-1,-145,66
-1,1306,1674,-368,-6,-160,54
1,1831,1715,116,-2,-115,77
-1,1867,1842,25,-8,-98,40
1,1641,1264,377,4,183,59
-1,1355,1351,4,-2,-82,70
-1,1715,1650,65,-3,-368,96
1,1854,1856,-2,1,501,117
-1,1600,1866,-266,-1,-5,42
-1,1361,1452,-91,-1,-63,90
1,1687,1435,252,0,12,77
-1,1642,1540,102,-3,-9,136
-1,1329,1351,-22,1,46,66
-1,1245,1643,-398,-8,-259,54
-1,1439,1679,-240,3,45,46
1,1815,1644,171,-1,100,95
1,1649,1669,-20,0,432,114
-1,1845,1865,-20,0,-55,90
-1,1611,1609,2,0,-21,72
-1,1549,1403,146,2,320,96
-1,1432,1500,-68,0,-23,52
1,1684,1434,250,0,8,51
-1,1364,1341,23,10,726,67
1,1834,1876,-42,-6,-92,67
1,1608,1492,116,4,72,53
-1,1365,1528,-163,1,-37,64
1,1638,1821,-183,1,293,95
1,1741,1645,96,-1,89,103
-1,2045,1814,231,0,-6,72
1,1646,1941,-295,6,149,49
1,1683,1678,5,-4,-55,63
1,1893,1665,228,1,76,55
1,1383,1646,-263,2,195,111
-1,1567,1326,241,0,-26,72
1,1803,1553,250,4,273,77
0,1746,1820,-74,0,-34,112
-1,1481,1544,-63,5,20,40
-1,1424,1599,-175,2,18,66
-1,1430,1693,-263,-1,-70,66
-1,1677,1742,-65,1,7,122
1,1424,1350,74,-1,-35,41
-1,1708,1838,-130,-2,-67,60
-1,1385,1416,-31,-1,-309,104
1,1629,1812,-183,0,-3,67
1,1754,1598,156,1,159,135
-1,1699,1719,-20,0,99,84
-1,1355,1340,15,-4,-546,76
1,1862,1679,183,-3,-20,43
0,1361,1390,-29,3,355,138
-1,1603,1579,24,1,17,92
-1,1805,1654,151,0,-122,89
-1,1767,1859,-92,2,93,98
1,1572,1463,109,-1,-29,69
-1,1588,1648,-60,0,7,60
1,1452,1604,-152,2,351,77
1,1672,1875,-203,-8,-591,91
1,2107,1424,683,8,221,49
-1,1752,1748,4,-3,-36,84
-1,1593,1418,175,0,-3,66
1,1588,1470,118,-2,-3,91
1,1839,1690,149,2,37,49
1,1420,1411,9,7,161,53
-1,1622,1434,188,-2,-360,70
-1,1892,1565,327,-3,14,50
1,1405,1269,136,3,32,45
-1,1365,2108,-743,-10,-149,44
1,1776,1701,75,-3,-96,59
1,1434,1270,164,6,314,73
1,1644,1704,-60,0,15,69
-1,1845,1701,144,0,-497,114
1,1500,1598,-98,0,31,47
-1,1669,1789,-120,0,-8,52
1,1699,1426,273,-3,-65,45
1,1675,1538,137,11,380,61
1,1590,1592,-2,6,1215,131
-1,1455,1583,-128,-3,-111,50
1,1596,1461,135,0,569,103
-1,1412,1358,54,-3,-136,58
1,2109,1365,744,1,-2,53
-1,1411,1146,265,0,-209,146
1,1408,1369,39,-2,8,73
-1,1653,1504,149,-1,-149,186
-1,1454,1603,-149,1,241,78
1,1797,1662,135,0,-159,65
-1,1551,1616,-65,4,144,54
1,1849,1760,89,1,436,147
-1,1422,1704,-282,0,-69,80
-1,1452,1496,-44,-4,-30,58
-1,1568,1500,68,-5,-415,78
1,1549,1668,-119,0,3,41
1,1610,1446,164,11,808,69
-1,1632,1634,-2,0,-37,109
-1,1534,1655,-121,0,22,54
1,1580,1602,-22,2,-127,115
1,1348,1314,34,10,258,43
-1,1637,1761,-124,-3,-347,84
1,1488,1418,70,-2,-65,89
1,1584,1338,246,1,525,105
-1,1439,1617,-178,-5,-190,52
-1,1741,1800,-59,-2,29,98
1,1686,1655,31,1,98,101
1,1623,1433,190,3,165,75
1,1416,1750,-334,-2,55,63
-1,1513,1500,13,-2,6,52
-1,1433,1626,-193,-1,20,70
1,1500,1500,0,0,136,123
1,1784,1518,266,3,149,77
-1,1564,1652,-88,-1,-64,78
-1,1716,1830,-114,0,7,54
1,1698,1623,75,0,23,55
-1,1507,1572,-65,-3,-30,46
1,1427,1629,-202,-6,373,99
1,1353,1555,-202,-1,13,55
-1,1358,1418,-60,-4,-368,92
1,1372,1088,284,16,775,67
1,1636,1465,171,7,101,45
1,1652,1533,119,5,849,129
-1,1606,1709,-103,-3,-57,74
1,1600,1714,-114,3,112,61
1,1527,1654,-127,0,-35,69
1,1611,1445,166,6,461,77
-1,1581,1601,-20,1,-122,62
1,1868,1401,467,6,200,55
0,1730,1680,50,6,358,85
1,1656,1262,394,0,186,65
-1,1614,1589,25,-2,-219,74
1,1400,1417,-17,3,1023,177
-1,1818,1803,15,0,112,80
0,1956,1815,141,0,72,118
-1,1438,1618,-180,0,-56,66
1,1705,1831,-126,-3,-26,93
-1,1472,1535,-63,-1,16,40
-1,1395,1853,-458,-5,-161,66
-1,1409,1376,33,-9,-229,56
-1,1370,1545,-175,-12,-493,62
-1,1543,1550,-7,0,15,52
1,1624,1432,192,-4,24,55
-1,1486,1545,-59,-5,-8,42
0,1626,1476,150,0,-50,90
0,1514,1721,-207,1,204,97
-1,1813,1903,-90,0,-34,54
-1,1556,1661,-105,0,-31,88
1,1534,1502,32,3,345,75
-1,1591,1593,-2,-1,-1,42
1,1426,1630,-204,-5,-314,61
-1,1896,1991,-95,-2,-348,100
-1,1397,1425,-28,-14,-393,48
1,1429,1408,21,3,610,111
-1,1394,1633,-239,-5,-109,58
1,1706,1365,341,0,147,70
-1,1594,1645,-51,2,72,54
-1,1500,1519,-19,-3,16,62
-1,1389,1397,-8,-7,-477,84
1,1718,1500,218,8,281,59
1,1575,1555,20,8,389,68
1,1612,1444,168,-2,-468,111
1,1529,1462,67,2,39,51
-1,1660,1479,181,-2,-147,118
1,1751,1796,-45,0,-42,83
1,1838,1784,54,-2,-4,75
-1,1347,1445,-98,-1,-157,104
1,1572,1658,-86,0,73,103
1,1999,1878,121,-2,7,53
-1,1364,1472,-108,-14,-480,50
-1,1692,1655,37,-2,-34,94
1,1638,1389,249,8,91,45
-1,1437,1619,-182,5,406,76
1,1346,1337,9,1,57,59
-1,1645,1810,-165,0,-86,90
-1,1480,1476,4,-8,-709,118
-1,1514,1789,-275,-6,-291,70
-1,1920,1805,115,-7,-520,98
1,1424,1337,87,0,62,101
-1,1384,1643,-259,-4,-48,50
1,1663,1768,-105,0,278,95
-1,1400,1525,-125,0,258,124
1,1836,1553,283,-16,-423,59
1,2045,1943,102,0,-33,69
-1,1500,1862,-362,-1,-655,138
1,1356,1320,36,9,439,67
-1,1682,1500,182,-1,-71,72
-1,1680,1715,-35,-1,-69,130
-1,1390,1396,-6,2,-1,108
-1,1625,1632,-7,0,50,60
1,1745,1548,197,0,625,137
1,1784,1755,29,0,-60,57
-1,1547,1478,69,-3,-81,60
-1,1610,1632,-22,1,-8,62
1,1550,1510,40,-1,-89,79
1,2110,1500,610,3,81,57
0,1814,1745,69,1,161,78
-1,1935,2054,-119,0,-14,60
-1,1670,1254,416,-2,25,58
-1,1442,1868,-426,0,3,42
1,1542,1751,-209,0,-249,125
-1,1625,1477,148,-5,-30,52
0,1639,1581,58,3,239,141
1,1855,1766,89,-3,-70,47
-1,1492,1609,-117,3,104,46
1,1160,1557,-397,6,95,51
-1,1453,1555,-102,-8,-406,76
0,2058,1817,241,-1,211,135
-1,1407,1447,-40,-4,-117,82
1,1671,1280,391,0,15,47
-1,1556,1545,11,0,-137,122
-1,1896,1585,311,-2,-32,40
-1,1177,1178,-1,-11,-150,80
-1,1569,1406,163,-3,-42,50
-1,1442,2039,-597,-3,-46,40
1,1379,1488,-109,-2,-5,45
1,1693,1496,197,-1,60,69
-1,1490,1530,-40,0,-68,76
-1,1823,1734,89,-2,-2,84
-1,1616,1500,116,-12,-240,56
-1,1604,1553,51,1,4,62
-1,1191,1480,-289,-1,-28,40
1,1442,1862,-420,-2,-69,55
1,1744,1794,-50,2,76,65
-1,1585,2112,-527,-3,-58,52
0,1812,1824,-12,1,54,114
-1,1549,1656,-107,-9,-148,74
1,1422,1554,-132,8,513,79
-1,1582,1601,-19,-3,-431,102
-1,1561,1821,-260,-9,-593,80
1,1515,1409,106,0,6,53
-1,1607,1503,104,-5,-460,78
1,1851,1659,192,0,51,87
-1,1500,1873,-373,-3,-54,116
1,1674,1709,-35,0,1,93
1,2114,1584,530,0,12,91
-1,1547,1648,-101,-5,-799,164
-1,1489,1747,-258,4,263,100
1,1809,1500,309,-12,-665,111
-1,1656,1519,137,0,-4,74
-1,1393,1659,-266,-2,-33,82
1,1277,1575,-298,-6,-98,53
-1,1670,1750,-80,-1,-138,82
0,1819,1892,-73,1,59,142
1,1830,1527,303,0,192,83
-1,1465,1592,-127,-2,-495,104
1,2158,1564,594,3,907,105
1,1288,1239,49,1,56,61
-1,1777,1783,-6,0,-620,142
-1,1264,1473,-209,-14,-184,40
1,1823,1812,11,-1,5,103
-1,1756,1744,12,-10,-90,76
-1,1376,1822,-446,-12,-438,66
1,1383,1560,-177,0,36,81
1,1741,1486,255,0,-22,63
1,1411,1463,-52,-6,-401,107
-1,1457,1537,-80,1,-14,96
1,1634,1578,56,0,34,75
1,1609,1393,216,1,30,84
-1,1858,2140,-282,0,21,88
1,1822,1794,28,-3,-111,63
0,1596,1587,9,-2,273,98
-1,1502,1836,-334,2,47,84
1,1748,1522,226,-15,-364,51
-1,1411,1616,-205,-2,-1105,138
1,1546,1620,-74,1,35,83
1,1447,1345,102,0,-345,101
-1,1639,1731,-92,0,5,52
-1,1563,1541,22,-10,-628,78
-1,1350,1261,89,-3,-54,48
1,1753,1813,-60,-7,-594,172
1,1631,1488,143,4,425,81
-1,1510,1559,-49,-4,-80,64
-1,1478,1242,236,-8,-332,54
1,1790,1439,351,4,578,101
-1,1400,1553,-153,10,152,44
-1,1628,1884,-256,-5,-68,118
1,1556,1452,104,1,122,79
1,1874,1572,302,2,24,63
-1,1611,1734,-123,2,71,66
-1,1430,1624,-194,-4,-42,44
1,1594,1800,-206,0,-524,175
1,1804,1663,141,-1,-10,77
0,1802,1834,-32,1,21,124
1,1934,1568,366,4,124,62
1,1406,1569,-163,-1,-67,41
1,1870,1684,186,4,320,65
0,1439,1298,141,0,77,155
1,1681,1558,123,-2,52,65
1,1877,1424,453,-3,95,97
1,2144,1853,291,-9,51,79
-1,1821,1861,-40,0,-49,68
1,1569,1469,100,3,88,41
-1,1464,1317,147,-2,-91,60
1,1687,1450,237,0,18,62
-1,1475,1663,-188,1,82,70
1,1425,1558,-133,0,557,99
-1,1366,1500,-134,-2,-284,106
1,1783,1553,230,1,4,47
-1,1270,1565,-295,-2,-85,54
-1,1368,1663,-295,0,3,48
-1,1416,1879,-463,-13,-357,56
1,1500,1544,-44,3,91,61
-1,1465,1746,-281,0,30,60
1,1552,1408,144,1,209,65
0,1940,1792,148,1,568,86
1,1881,1408,473,2,128,65
-1,1747,1811,-64,-1,-37,50
-1,1280,1543,-263,-1,-25,44
1,1553,1552,1,1,406,83
-1,1560,1392,168,1,2,62
-1,1646,1497,149,5,100,58
-1,1523,1879,-356,0,-12,52
1,1656,1842,-186,0,76,73
-1,1833,1803,30,0,-104,70
1,1797,2001,-204,0,94,105
-1,1287,1365,-78,-10,-956,90
-1,1547,1576,-29,-1,-271,70
-1,1882,1936,-54,-2,-417,86
-1,1799,1860,-61,0,-256,94
1,1661,1566,95,0,82,100
1,1429,1511,-82,-2,-1,85
1,1542,1537,5,-3,-22,44
1,1585,1666,-81,0,85,79
1,1461,1131,330,1,39,55
1,1206,1124,82,2,950,85
-1,1945,1872,73,-2,-22,62
-1,1406,1622,-216,2,5,54
-1,1460,1675,-215,-1,-5,42
1,1750,1447,303,-4,-155,85
-1,1518,1885,-367,-3,-2,88
1,1605,1286,319,4,201,63
1,1607,1525,82,0,124,53
-1,1886,1932,-46,0,-16,66
-1,1814,1821,-7,0,-16,66
1,1756,1653,103,0,10,77
1,1618,1516,102,7,651,81
-1,1128,1617,-489,0,9,44
1,1677,1221,456,1,20,43
1,1794,1533,261,6,194,41
-1,1942,1876,66,0,26,82
1,1563,1462,101,4,276,75
1,1666,1820,-154,1,14,47
-1,1595,1814,-219,1,103,76
-1,1662,1628,34,-5,-98,54
-1,1698,1616,82,0,-135,92
-1,1418,1498,-80,0,-11,54
-1,1659,1663,-4,-4,-279,84
-1,1797,1794,3,1,80,70
1,1587,1817,-230,0,57,89
1,1626,1355,271,2,94,51
-1,1890,1928,-38,0,-19,46
1,1627,1515,112,0,89,59
-1,1513,1805,-292,-1,-133,74
-1,1748,1838,-90,0,-128,134
-1,1764,1646,118,0,-20,98
1,1763,1671,92,0,-11,105
1,1609,1482,127,8,602,97
-1,1807,1741,66,0,-33,76
1,1717,1728,-11,-2,2,59
1,1636,1507,129,-1,107,147
-1,1489,1451,38,4,341,84
1,1712,1389,323,-7,68,95
1,1570,1533,37,-1,-8,43
-1,1877,1577,300,-1,-4,44
1,1890,1729,161,7,187,67
1,1893,1925,-32,-1,-37,77
-1,1671,1525,146,0,-46,58
1,1624,1754,-130,2,53,45
-1,1620,1448,172,-6,-235,70
1,1805,1819,-14,0,75,61
1,1507,1551,-44,2,89,65
1,1688,1682,6,2,91,69
-1,1723,1902,-179,-4,-55,48
1,1360,1409,-49,2,131,69
1,1732,1804,-72,-1,-34,89
1,1679,1785,-106,-1,118,82
1,1515,1554,-39,4,205,71
1,1913,1905,8,1,294,67
1,2044,1812,232,1,21,65
1,1913,1717,196,-3,-40,59
1,1807,1768,39,-3,-120,123
1,1630,1657,-27,-1,8,65
1,1934,1884,50,-2,16,57
-1,1638,1819,-181,2,70,64
-1,1524,1754,-230,-2,-530,130
-1,1723,1778,-55,0,-145,138
1,1500,1539,-39,0,55,87
-1,1669,1889,-220,-4,-91,86
-1,1645,1506,139,0,14,44
1,1817,1784,33,1,-10,71
-1,1874,1943,-69,-1,-353,122
-1,1516,1433,83,-1,-21,82
1,1695,1526,169,0,13,63
1,1594,1539,55,6,294,69
-1,1754,1788,-34,0,-22,70
-1,2049,1808,241,0,-107,72
1,1684,2006,-322,-3,-40,117
-1,1552,1766,-214,-2,-23,74
-1,1756,1827,-71,-8,-88,56
1,1595,1664,-69,1,3,63
1,1671,1699,-28,-1,1049,119
1,1585,1785,-200,-1,63,103
-1,1644,1643,1,-3,-223,108
1,1952,1866,86,0,26,59
-1,1793,2197,-404,0,1,64
-1,1792,1758,34,2,88,72
1,1732,1523,209,2,261,87
-1,1700,1807,-107,0,22,60
-1,1655,1445,210,1,-94,106
1,1511,1454,57,0,155,95
1,1836,1744,92,1,230,83
1,1758,1665,93,-1,29,75
0,1857,1961,-104,-6,-35,99
-1,1528,1434,94,1,51,58
1,1755,1695,60,0,31,58
-1,1663,1798,-135,-2,-8,48
-1,1630,1813,-183,-1,-386,92
1,1535,1417,118,1,100,69
-1,1846,1738,108,0,5,54
1,1790,1446,344,-1,-68,69
1,1590,1543,47,8,227,53
1,1540,1496,44,0,-27,75
1,1802,1744,58,0,43,85
1,1830,1752,78,3,62,43
1,1957,1860,97,1,51,61
-1,1485,1604,-119,0,11,68
1,1827,1702,125,-3,12,79
-1,1839,1741,98,-1,-170,54
1,1299,1674,-375,0,-66,65
1,1624,1441,183,-11,-238,75
1,1607,1460,147,-1,-121,75
-1,1663,1466,197,-3,-334,116
-1,1852,1965,-113,-2,-102,68
-1,1821,1869,-48,-2,-20,46
1,1857,1638,219,2,76,49
-1,1758,1825,-67,-7,-287,66
-1,1558,1500,58,0,-7,50
-1,1429,2202,-773,0,-76,84
1,1373,1418,-45,-1,148,125
1,1614,1347,267,2,147,77
-1,1412,1630,-218,3,153,70
-1,1759,1780,-21,-2,-108,98
1,1973,1845,128,0,75,75
-1,1683,1905,-222,-1,-70,58
1,1873,1466,407,3,768,95
-1,1616,1704,-88,-4,-487,122
1,1834,1747,87,10,296,53
1,1652,1692,-40,-1,-19,53
1,1586,1546,40,2,231,74
1,1652,1420,232,0,847,217
-1,1878,1811,67,-9,-148,56
0,1825,1656,169,0,36,152
-1,1640,1371,269,-3,-97,76
1,1566,1489,77,1,132,75
-1,1403,1706,-303,-11,-164,42
1,1785,1735,50,-7,-98,93
-1,1467,1482,-15,0,59,72
-1,1494,1462,32,-7,-398,72
0,1576,1607,-31,0,229,177
-1,1841,1800,41,0,8,80
-1,1525,1543,-18,-6,-271,62
1,1579,1586,-7,1,65,63
1,1797,1681,116,0,54,85
1,1493,1456,37,2,51,43
1,1603,1609,-6,1,65,93
-1,1437,1630,-193,-4,-254,72
1,1884,1772,112,0,107,79
-1,1575,1482,93,-1,-55,58
1,1798,1909,-111,0,99,123
-1,1906,1752,154,0,-21,62
-1,1900,1757,143,-1,-19,58
1,1684,1652,32,0,30,58
1,1773,1884,-111,-3,22,57
1,1435,1517,-82,-4,-23,45
-1,1558,1495,63,3,54,48
1,1468,1589,-121,-2,42,69
-1,1765,1893,-128,-1,-78,94
1,1598,1615,-17,-1,-6,63
1,1505,1532,-27,6,233,63
1,1505,1496,9,1,76,77
1,1869,1787,82,-1,44,95
1,1757,1628,129,4,196,81
-1,1461,1583,-122,0,-22,70
1,1519,1521,-2,4,138,61
1,1811,1703,108,-3,186,107
-1,1895,1888,7,-1,-18,70
-1,1308,1336,-28,-5,-453,74
-1,1401,1515,-114,0,-131,138
-1,1663,1540,123,-3,-422,70
1,1692,1819,-127,0,183,116
1,1412,1370,42,-1,-33,41
1,1661,1762,-101,8,201,60
-1,1779,1878,-99,1,99,106
-1,1603,1610,-7,3,83,48
1,1519,1751,-232,5,888,97
-1,1674,1586,88,-3,-229,69
1,1906,1675,231,2,36,51
1,1797,1485,312,2,233,61
-1,1826,1794,32,0,-64,82
1,1451,1629,-178,0,102,79
-1,1501,1678,-177,-2,-285,108
-1,1894,1844,50,-5,-44,101
-1,1400,1494,-94,1,55,62
-1,1620,1592,28,-3,-627,104
-1,1390,1422,-32,-1,5,64
1,1397,1357,40,-4,-422,107
-1,1482,1800,-318,-1,-373,82
1,1649,1600,49,-2,20,89
-1,1844,1912,-68,-1,-8,54
1,1467,1612,-145,0,22,69
1,1346,1298,48,-3,317,101
-1,1707,1804,-97,2,-79,108
1,1884,1812,72,0,44,75
1,1432,1392,40,-1,-42,43
1,1521,1669,-148,1,60,73
1,1607,1793,-186,0,14,53
0,1474,1539,-65,3,244,131
1,1625,1634,-9,2,35,95
0,1682,1748,-66,-2,-95,144
-1,1500,1478,22,-2,-9,66
1,1577,1403,174,3,123,52
1,1591,1593,-2,-1,-123,79
1,1599,1659,-60,2,112,61
-1,1770,1708,62,-1,-71,52
1,1666,1911,-245,-1,3,41
-1,1538,1820,-282,-3,-136,70
-1,1710,1938,-228,0,-134,104
0,1538,1620,-82,-1,-286,138
1,1495,1222,273,3,70,77
1,1727,1502,225,4,939,99
-1,1576,1500,76,-3,-23,46
-1,1487,1774,-287,-5,-840,108
1,1500,1687,-187,0,348,93
1,1717,1566,151,-2,114,85
1,1636,1495,141,0,61,57
1,1495,1245,250,-3,273,101
-1,1497,1665,-168,-8,-242,60
1,1585,1604,-19,-1,215,133
-1,1816,1784,32,1,16,68
-1,1559,1792,-233,-1,-485,124
-1,1662,1440,222,2,64,46
-1,1557,1506,51,-4,-195,74
1,1653,1537,116,1,67,55
-1,1571,1345,226,-3,-451,80
1,1627,1458,169,10,469,63
-1,1602,1896,-294,-1,-188,84
-1,1564,1582,-18,-4,-206,62
0,1356,1364,-8,3,1381,207
1,1722,1604,118,0,339,193
0,1486,1836,-350,0,16,65
-1,1385,1724,-339,4,121,76
1,1639,1451,188,2,71,53
1,1767,1495,272,4,499,85
1,1650,1445,205,-4,210,71
1,2068,1483,585,3,157,65
0,1726,1860,-134,0,188,138
1,1544,1542,2,0,157,89
1,1584,1066,518,3,235,69
1,1527,1772,-245,0,93,91
1,1345,1400,-55,3,175,55
0,1696,1491,205,1,-10,105
-1,1553,1500,53,-2,-84,62
1,1824,1644,180,0,207,90
-1,1556,1664,-108,0,-65,74
0,1719,1630,89,0,-55,105
1,1796,1804,-8,0,-23,85
-1,1541,1625,-84,-8,-121,46
1,2069,1482,587,0,51,61
-1,1732,1796,-64,-1,-262,88
1,1355,1317,38,6,209,55
-1,1500,1850,-350,0,21,60
-1,1571,1768,-197,-4,-117,52
1,1628,1344,284,3,30,40
1,1500,1355,145,3,153,91
1,1807,1642,165,1,25,45
1,1755,1550,205,2,383,79
1,1855,1730,125,0,-8,85
-1,1436,1867,-431,0,7,48
1,1880,1399,481,0,2,45
1,1573,1500,73,14,448,59
-1,1566,1922,-356,-1,-116,87
-1,1596,1729,-133,-1,-103,106
1,1793,1807,-14,2,150,85
-1,1440,1943,-503,-6,-79,48
-1,1683,1544,139,0,-404,112
1,2142,1370,772,0,6,45
1,1717,1633,84,4,226,73
-1,1532,1500,32,0,-7,57
1,1814,1381,433,0,158,89
1,1364,1343,21,8,327,49
-1,1784,1593,191,0,-403,120
-1,1723,1863,-140,0,16,118
-1,1240,1242,-2,0,-1,58
-1,1528,1365,163,0,8,44
1,1633,1613,20,-8,352,133
-1,1829,1747,82,-3,-129,86
-1,1288,1240,48,-7,-1069,124
-1,1532,1499,33,1,25,64
1,1305,1365,-60,-4,-27,67
1,1731,1500,231,7,125,53
0,1395,1393,2,1,-9,163
-1,1642,1705,-63,-2,-357,152
-1,1684,1638,46,-2,-39,58
-1,1542,2142,-600,0,6,70
1,1851,1729,122,3,231,93
-1,1563,1483,80,0,10,76
-1,1796,1804,-8,0,4,50
1,1767,1816,-49,2,-17,71
1,1837,1688,149,2,157,63
-1,1571,1417,154,-3,-117,54
-1,1320,1485,-165,0,-88,66
-1,1557,1338,219,-1,-29,56
1,1229,1254,-25,5,598,109
1,1647,1358,289,11,964,97
-1,1812,1925,-113,0,-125,142
-1,1633,1705,-72,-2,-311,154
1,1544,1442,102,-2,129,57
-1,1780,1497,283,1,-354,90
-1,1775,1825,-50,-3,-641,160
1,1669,1728,-59,0,195,145
-1,1816,1652,164,-7,-46,52
0,1545,1307,238,-2,-1031,144
-1,1496,1475,21,-11,-198,90
-1,1432,1555,-123,-3,21,44
1,1602,1643,-41,-2,-53,43
-1,1379,1703,-324,-5,-219,70
-1,1538,1665,-127,1,86,86
-1,1538,1394,144,-12,-502,82
-1,1761,1816,-55,3,-11,60
-1,1674,1798,-124,1,55,58
-1,1696,1560,136,-5,-856,142
-1,1663,1852,-189,0,-7,52
-1,1897,1645,252,1,26,54
-1,1543,1718,-175,-1,-200,74
1,1350,1064,286,-7,-38,65
0,1844,1681,163,0,-214,141
1,1376,1567,-191,0,-6,67
-1,1500,1603,-103,-3,122,66
-1,1563,1425,138,-3,-95,50
1,1834,1766,68,2,21,41
-1,1672,1547,125,-5,-34,50
-1,1538,1743,-205,-6,-567,88
0,1399,1500,-101,3,481,119
1,1806,1664,142,-7,33,77
1,1752,1578,174,0,5,103
0,1805,1677,128,-1,55,107
1,1682,1339,343,1,149,129
1,1484,1500,-16,4,238,73
-1,1758,1843,-85,0,1,57
1,1589,1562,27,0,34,83
-1,1394,1516,-122,-3,-211,66
1,1522,1302,220,0,-91,75
1,1552,1533,19,1,277,67
1,1611,1606,5,0,251,115
-1,1746,1761,-15,-1,-23,98
1,1615,1527,88,0,128,91
-1,1440,1548,-108,-5,-400,80
0,1279,1363,-84,0,445,121
-1,1758,1857,-99,1,-429,124
1,1395,1321,74,2,293,71
1,1609,1367,242,6,569,89
-1,1613,1622,-9,3,-7,84
1,1393,1634,-241,1,25,54
1,1386,1540,-154,1,35,61
-1,1495,2144,-649,-6,-504,84
1,1824,1657,167,0,109,75
-1,1725,1653,72,2,252,100
-1,1568,1803,-235,-1,-72,58
1,1351,1614,-263,-1,-6,85
-1,1539,1497,42,-1,-28,72
1,1633,1562,71,0,45,57
1,1859,1771,88,0,-10,79
-1,1804,2055,-251,-3,12,98
1,1495,1795,-300,-2,-50,43
-1,1320,1686,-366,-1,-567,122
1,1241,1058,183,3,132,117
-1,1750,1612,138,-5,-665,84
-1,1710,1524,186,3,373,118
-1,1180,1740,-560,0,-25,52
-1,1553,1612,-59,0,-95,126
-1,1657,1563,94,1,-47,64
1,1771,1362,409,-3,-64,47
-1,1765,1714,51,-2,-29,112
1,2092,1504,588,-3,-26,111
-1,1642,1651,-9,0,3,74
1,1520,1351,169,-5,-29,47
1,1763,1799,-36,0,-5,69
-1,1519,1857,-338,0,34,46
1,1780,1774,6,0,265,125
0,1735,1606,129,0,-160,133
1,1868,1806,62,0,-21,59
1,1760,1791,-31,1,101,65
0,1596,1411,185,0,-511,101
1,2093,1349,744,4,246,53
1,1825,1662,163,1,203,65
-1,1866,1851,15,0,5,48
-1,1609,1854,-245,-4,-34,56
1,1644,1454,190,1,577,115
-1,1779,1775,4,-8,-205,60
-1,1555,1595,-40,0,-9,62
0,1686,1839,-153,0,-65,122
1,1741,1179,562,15,261,43
-1,1425,1530,-105,-1,-41,66
-1,1594,1627,-33,-1,-435,140
1,1779,1647,132,-1,3,49
1,1572,1541,31,4,254,59
-1,1789,1768,21,0,-42,68
1,1689,1305,384,0,17,51
1,1757,1532,225,3,28,41
-1,1564,1857,-293,-1,-208,104
-1,1445,1523,-78,0,-27,72
1,1780,1775,5,1,40,63
-1,1814,1858,-44,0,-70,110
-1,1402,1442,-40,-5,-48,48
-1,1842,2060,-218,0,50,58
-1,1178,1743,-565,-5,-145,42
-1,1808,1527,281,-3,-90,88
1,1139,0,1139,0,184,83
0,1480,1514,-34,-3,-548,149
1,1762,1790,-28,2,413,135
-1,1279,1578,-299,-24,-1328,76
-1,1544,1621,-77,-1,-76,54
1,1649,1208,441,4,199,71
-1,1262,2094,-832,-5,-537,82
1,1642,1698,-56,1,108,62
1,1779,1776,3,-1,-97,61
1,1934,1860,74,0,5,93
1,1540,1418,122,2,25,45
-1,2062,2145,-83,0,-9,62
1,1691,1589,102,0,145,123
1,1395,1503,-108,0,270,119
-1,1577,1543,34,0,-211,164
1,1586,1531,55,0,293,83
1,1763,1789,-26,2,95,101
1,2052,1729,323,2,70,69
0,1727,1751,-24,0,-154,157
-1,1512,1501,11,-6,-129,50
-1,1605,1546,59,0,-111,108
1,1506,1357,149,6,189,51
-1,1868,1803,65,0,-48,74
1,1731,1582,149,-6,-319,99
-1,1546,1790,-244,-1,-293,112
1,1778,1777,1,0,71,63
1,1629,1582,47,1,-14,77
-1,1712,1851,-139,-1,-127,74
-1,1410,1550,-140,-1,-87,66
-1,1610,1662,-52,0,-33,72
1,1709,1476,233,0,15,67
0,1764,1789,-25,-1,-73,87
-1,1662,1763,-101,-1,-54,80
1,1283,1333,-50,-2,17,145
-1,1350,1513,-163,-7,-268,56
1,1788,1765,23,0,19,85
-1,1392,1513,-121,-3,-8,56
-1,1358,1522,-164,-2,25,44
-1,1583,1395,188,-2,-29,40
1,1398,1296,102,-1,-33,69
-1,1818,1855,-37,-6,-260,62
-1,1789,1576,213,-4,-451,102
-1,1385,2099,-714,-1,-125,58
1,1738,1575,163,0,-20,97
0,1560,1403,157,-1,55,83
-1,1787,1903,-116,0,61,76
-1,1528,1351,177,-2,-587,116
1,1529,1411,118,0,43,53
1,1786,1767,19,-9,235,87
-1,1572,1638,-66,-3,-277,81
-1,1500,1617,-117,-5,-330,110
1,2099,1382,717,1,4,52
1,1538,1540,-2,17,321,45
1,1807,1949,-142,0,23,77
-1,1874,1561,313,4,158,66
0,1794,1865,-71,-1,-57,104
-1,1384,1481,-97,2,-46,86
-1,1581,1700,-119,-1,-30,74
1,1834,1708,126,1,34,49
1,1467,1525,-58,-5,182,101
-1,1416,1552,-136,-11,-1229,136
1,1500,1796,-296,0,-45,71
1,1591,1641,-50,1,83,145
1,1651,1358,293,0,297,67
-1,1655,1499,156,2,-45,114
-1,1910,1786,124,-3,-82,56
-1,1536,1519,17,-4,-187,84
-1,1408,1554,-146,-1,-78,82
1,1482,1508,-26,11,803,77
1,1634,1220,414,12,65,40
1,1678,1762,-84,1,80,121
-1,1493,1495,-2,-10,-417,66
1,1525,1593,-68,15,758,79
-1,1744,1804,-60,0,-289,138
-1,1427,1471,-44,-2,-60,58
1,1519,1466,53,0,14,41
-1,1454,1529,-75,5,64,70
-1,1375,1624,-249,-2,-44,50
1,1817,1901,-84,0,237,131
-1,1354,1414,-60,-4,-246,64
1,1737,1531,206,0,7,63
1,1547,1434,113,5,194,59
1,1770,1757,13,2,114,55
-1,1842,1784,58,-1,-108,68
-1,1824,1933,-109,-2,-40,46
-1,1623,1728,-105,-1,-14,50
1,1709,1574,135,0,240,89
-1,1425,1555,-130,-1,-112,60
1,1657,1486,171,2,54,47
-1,1858,1944,-86,2,75,52
1,1547,1435,112,4,549,101
1,1526,1742,-216,-1,-20,119
1,1581,1538,43,0,235,67
1,1955,1850,105,1,29,57
1,1426,1555,-129,-2,-259,89
1,1664,1334,330,-2,14,53
-1,1582,1691,-109,-2,-52,56
1,1941,1815,126,0,-9,49
-1,1944,1650,294,-2,-84,62
-1,1735,1837,-102,-5,-44,78
-1,1371,1667,-296,-16,-294,54
1,1539,1443,96,5,119,49
1,1842,1964,-122,0,-12,55
-1,1733,1721,12,-1,-198,88
-1,1780,1943,-163,0,-169,88
1,1434,1548,-114,-1,-22,93
-1,1500,1409,91,-3,-170,70
-1,1361,1696,-335,-7,-55,41
-1,1833,1534,299,5,95,46
1,1867,1561,306,1,114,61
1,1573,1537,36,2,103,51
1,1795,1945,-150,-6,143,69
1,1946,1857,89,1,-17,53
-1,1528,1647,-119,0,-51,65
-1,1531,1570,-39,-2,-140,96
1,1533,1450,83,1,57,53
1,1570,1343,227,9,428,65
1,1736,1615,121,1,269,145
-1,1724,1544,180,1,9,86
-1,1440,1541,-101,-5,-760,96
1,1807,1336,471,3,119,65
1,1671,1693,-22,0,54,69
-1,1848,1956,-108,0,32,96
-1,1600,1974,-374,-7,-93,48
1,1796,1928,-132,-5,-4,63
-1,1529,1590,-61,-6,-52,96
1,1539,1500,39,-3,-69,85
0,1854,1793,61,0,145,157
1,1550,1432,118,2,24,47
1,1667,1699,-32,0,88,97
-1,1914,1857,57,0,-44,54
1,1965,1841,124,-9,-107,41
1,1535,1409,126,6,462,85
1,1832,1624,208,3,158,71
-1,1727,1794,-67,-6,-358,76
-1,1810,1913,-103,-1,-13,68
-1,1833,1974,-141,-3,-132,64
-1,1408,1572,-164,0,-6,42
-1,1367,1591,-224,-1,-34,46
-1,1749,1722,27,0,-50,60
-1,1578,1402,176,-3,-56,52
-1,1561,1708,-147,-3,-250,86
1,1681,1683,-2,2,6,49
-1,1343,1723,-380,0,20,68
-1,1419,1561,-142,-1,-13,42
1,1561,1419,142,-3,83,65
-1,1338,1575,-237,-6,-577,86
0,1809,1682,127,-8,-127,112
-1,1519,1921,-402,-1,-447,116
1,1500,1481,19,2,-207,85
-1,1803,1949,-146,-8,-370,70
-1,1362,1598,-236,-1,-58,62
-1,1398,1582,-184,-4,-117,54
1,1246,1401,-155,-1,-25,65
0,1671,1693,-22,-5,-585,113
1,1715,1554,161,1,107,95
-1,1687,1580,107,4,237,66
-1,1519,1509,10,-4,4,45
1,1570,1410,160,0,-12,71
1,1679,1357,322,2,277,81
1,1813,1722,91,2,297,123
1,1599,1519,80,2,107,43
-1,1248,1236,12,-11,-907,108
1,1923,1352,571,2,518,75
-1,1748,1794,-46,0,-4,74
-1,1413,1544,-131,-11,-139,43
-1,1583,1752,-169,-2,-299,136
1,1357,1500,-143,0,101,52
1,1552,1405,147,1,176,77
-1,1521,1502,19,0,31,74
-1,1657,1155,502,0,-3,78
1,1547,1721,-174,0,-6,63
1,1788,1563,225,4,84,45
-1,1718,1747,-29,-7,-232,68
-1,1398,1559,-161,-3,-130,100
-1,1982,1924,58,-4,-40,48
1,1686,1863,-177,-1,-84,71
1,1805,1652,153,0,-7,41
1,1559,1398,161,7,110,51
1,1635,1555,80,1,1,45
-1,1647,1412,235,-6,-32,40
-1,1391,1565,-174,-3,-104,62
1,1508,1210,298,8,292,53
-1,1445,1678,-233,3,58,122
-1,1513,1564,-51,-1,-208,90
-1,1354,1683,-329,-3,-120,52
-1,1479,1555,-76,-7,-440,64
-1,1762,1938,-176,0,21,78
1,1877,1773,104,-1,-83,89
1,1504,1671,-167,-4,-98,57
1,1797,1558,239,3,83,59
0,1518,1533,-15,-1,-43,100
1,1417,1561,-144,-6,-314,101
1,1686,1390,296,0,8,59
-1,1944,1756,188,0,13,104
1,1730,1036,694,3,347,81
-1,1501,1573,-72,3,-3,116
-1,1260,1354,-94,-3,-388,94
1,1563,1704,-141,2,17,53
1,1546,1594,-48,2,88,63
-1,1757,1880,-123,-6,-33,44
-1,1509,1547,-38,0,-41,62
1,1580,1333,247,-3,521,119
-1,1511,1502,9,-5,-107,74
-1,1243,1320,-77,5,124,54
1,1773,1927,-154,1,170,105
1,1495,1558,-63,2,70,51
1,1885,1821,64,0,-46,71
1,1708,1750,-42,0,-21,71
-1,1459,1557,-98,-4,-143,60
1,1686,1350,336,-1,82,93
1,1382,1356,26,-1,-39,41
1,1910,1789,121,-4,-192,63
1,1750,1513,237,2,61,57
-1,1760,1962,-202,1,3,52
1,1464,1470,-6,5,38,45
-1,1611,1484,127,-4,-32,60
-1,1811,2054,-243,-4,-116,62
1,1654,1535,119,8,437,77
1,1865,1565,300,0,17,45
-1,1853,1722,131,1,-54,90
-1,1782,1918,-136,0,-42,54
-1,1423,1498,-75,1,35,48
1,1730,1433,297,0,254,109
-1,1824,2038,-214,-2,-110,76
-1,1345,1605,-260,-5,-346,72
-1,1925,1774,151,-3,-52,66
-1,1418,1431,-13,-6,-208,60
-1,1720,1583,137,-10,-719,86
-1,1337,1550,-213,-9,-762,118
-1,1790,1909,-119,0,-181,80
-1,1895,1812,83,0,7,99
1,1644,1533,111,0,360,87
1,1393,1239,154,6,64,45
-1,1332,1689,-357,0,-207,108
1,1634,1537,97,-3,-121,57
-1,1510,1670,-160,-2,-45,60
-1,1571,1697,-126,-1,-134,60
-1,1289,1589,-300,-3,-119,70
-1,1459,1640,-181,0,-7,44
1,1734,1372,362,-1,9,75
1,1757,1310,447,6,323,61
-1,1492,1514,-22,1,159,68
0,1542,1524,18,-2,59,130
-1,1598,1598,0,-1,-16,48
-1,1689,1574,115,1,-5,138
1,1469,1843,-374,0,-55,95
1,1919,1527,392,1,41,53
-1,1680,1221,459,-6,-561,76
1,1881,1845,36,0,17,49
-1,1678,1498,180,-3,-238,100
1,1922,1642,280,4,332,95
-1,1618,1735,-117,0,28,70
1,1429,1302,127,-3,-111,67
1,1707,1534,173,0,7,49
1,1245,1387,-142,4,209,59
-1,1433,1555,-122,5,166,42
-1,1605,1561,44,0,60,74
-1,1579,1569,10,-8,-428,82
1,1352,1405,-53,0,49,49
1,1713,1639,74,3,101,57
1,1771,1276,495,11,683,77
-1,1556,1691,-135,-2,-70,60
-1,1560,1662,-102,0,-47,132
-1,1483,1410,73,-2,-44,56
1,1595,1386,209,2,36,45
1,1441,1500,-59,0,58,107
-1,1528,1573,-45,0,69,90
-1,1884,1949,-65,0,-226,86
1,1616,1430,186,0,191,107
1,1701,1319,382,1,241,111
1,1343,1497,-154,0,-80,87
1,1632,1548,84,-6,-91,61
0,1613,1521,92,2,218,95
-1,1600,1678,-78,2,35,54
1,1454,1657,-203,-3,-18,43
-1,1406,1765,-359,-6,-132,56
1,1518,1375,143,0,-12,89
1,1575,1549,26,1,107,65
1,1725,1698,27,1,701,153
1,1470,1329,141,0,-173,85
-1,1825,1784,41,-2,-34,52
1,1552,1602,-50,-2,-197,95
1,1663,1675,-12,-1,-25,79
1,1711,1589,122,2,166,75
-1,1519,1659,-140,-5,-28,83
1,1536,1542,-6,-4,-109,51
1,1574,1659,-85,0,-2,41
-1,1650,1701,-51,-5,-96,102
0,1959,1874,85,0,-46,79
-1,1335,1583,-248,-10,-484,86
1,1712,1672,40,1,47,69
-1,1582,1711,-129,1,-51,131
-1,1736,1742,-6,-8,-9,40
-1,1527,1719,-192,0,-323,92
1,1707,1600,107,-3,-92,57
-1,1261,1614,-353,-3,-108,54
-1,1522,1633,-111,1,240,78
1,1741,1824,-83,1,135,107
1,1395,1308,87,0,16,101
1,1812,1741,71,-2,16,61
-1,1392,1365,27,-1,-47,80
1,1525,1470,55,2,391,89
0,1830,1706,124,-4,-39,130
1,1592,1370,222,-3,17,53
1,1768,1373,395,0,22,71
-1,1785,1477,308,2,52,50
1,1453,1265,188,3,30,53
-1,1725,1522,203,2,78,56
1,1687,1795,-108,0,12,47
-1,1651,1915,-264,-5,-186,64
0,1462,1622,-160,1,-135,107
1,1393,1224,169,-3,-129,77
-1,1567,1631,-64,-4,-266,74
1,1484,1464,20,1,170,117
1,2138,1799,339,0,-3,48
-1,1538,1707,-169,0,7,78
1,1670,1552,118,-1,18,79
1,1500,1513,-13,1,123,85
-1,1518,1593,-75,0,222,92
-1,1404,1613,-209,-2,-60,50
-1,1594,1645,-51,0,-22,56
1,1593,1617,-24,4,363,75
-1,1688,1736,-48,1,-91,66
-1,1548,1713,-165,-2,-347,90
1,1532,1577,-45,0,76,105
1,1779,1701,78,0,143,75
1,1755,1785,-30,0,5,81
-1,1877,1928,-51,0,2,78
0,1754,1956,-202,0,-173,133
-1,1513,1617,-104,-6,-64,47
1,1822,1784,38,0,42,67
-1,1487,1626,-139,4,129,68
1,1585,1548,37,1,100,69
-1,1382,1611,-229,-3,-48,56
1,1576,1542,34,-4,-65,89
1,1492,1500,-8,7,131,41
1,1619,1368,251,0,28,67
1,1656,1079,577,-3,-10,47
1,1779,1753,26,-3,208,101
1,1588,1578,10,2,136,83
-1,1798,1523,275,-3,-63,52
1,1380,1161,219,-3,-118,45
-1,1459,1433,26,-5,-297,78
-1,1305,1500,-195,-4,-139,56
1,1591,1690,-99,1,631,235
0,1545,1678,-133,-2,-13,118
-1,1501,1783,-282,-1,-58,58
-1,1497,1532,-35,-10,-280,52
-1,1475,1637,-162,0,-59,62
1,1740,1709,31,0,-28,83
-1,1569,1575,-6,-2,217,86
-1,1789,1692,97,2,-78,88
-1,1799,1759,40,0,30,116
-1,1315,1500,-185,-2,-4,54
1,1587,1218,369,5,237,75
1,1616,1376,240,-2,83,79
-1,1549,1701,-152,0,-12,80
-1,1487,1542,-55,1,-23,58
1,1743,1790,-47,-1,58,79
1,1209,1584,-375,-2,1,49
1,1558,1770,-212,0,-9,51
1,1655,1489,166,1,132,75
0,1868,1839,29,2,113,130
-1,1757,1871,-114,-1,-78,68
1,1575,1587,-12,-4,-163,57
1,1748,1562,186,1,64,45
1,1605,1633,-28,0,-18,91
1,1746,1655,91,3,109,65
-1,1617,1544,73,-2,-121,58
-1,1822,1868,-46,-3,-273,103
1,1675,1500,175,3,282,85
1,1209,1298,-89,0,55,57
1,1734,1580,154,2,23,47
1,1506,1418,88,-1,-44,47
1,1571,1742,-171,1,33,53
-1,1755,1554,201,-7,-456,92
1,1447,1458,-11,-2,-219,67
-1,1591,1722,-131,-1,-403,78
-1,1787,1771,16,0,-52,76
-1,1334,1731,-397,-8,-196,45
1,1583,1580,3,3,292,81
-1,1521,1474,47,-2,-50,56
-1,1574,1739,-165,0,-123,93
1,1605,1509,96,6,471,76
-1,1554,1880,-326,0,-35,50
-1,1723,1586,137,-11,-192,48
1,1468,1556,-88,-4,134,103
-1,1305,1624,-319,-4,-533,104
1,1568,1594,-26,-1,-19,81
1,1514,1533,-19,-1,-104,69
-1,1568,1601,-33,2,50,54
-1,1747,1567,180,-3,-235,98
1,1557,1604,-47,0,60,69
1,1394,1680,-286,-2,162,113
-1,1285,1281,4,-2,-49,42
-1,1840,1867,-27,0,-49,92
-1,1582,1611,-29,-7,-201,58
-1,1338,1581,-243,-18,-149,40
-1,1640,1640,0,-1,-1,46
1,1674,1226,448,4,420,63
1,1648,1360,288,11,796,79
1,1727,1586,141,14,855,105
-1,1497,1711,-214,3,276,86
-1,1646,1754,-108,-1,26,56
-1,1572,1621,-49,-1,-14,48
1,1737,1884,-147,-1,96,127
-1,1215,1600,-385,3,44,48
1,1477,1697,-220,-1,50,71
1,1653,1580,73,2,78,83
-1,1385,1708,-323,0,-32,64
1,1825,1787,38,-4,-74,83
-1,1735,1558,177,-7,-55,40
-1,1482,1661,-179,-1,-39,48
-1,1646,1718,-72,-1,-13,42
1,1735,1578,157,-2,465,119
-1,1546,1648,-102,-5,-118,50
-1,1500,1605,-105,-1,-221,96
-1,1699,1827,-128,-1,-76,66
1,1500,1613,-113,-3,259,119
1,1538,1487,51,5,-2,47
1,1570,1743,-173,-7,-47,41
-1,1538,1656,-118,-2,-342,94
-1,1575,1467,108,-10,-234,48
-1,1570,1743,-173,-5,-645,92
-1,1489,1685,-196,-5,-192,52
-1,1706,1714,-8,0,35,64
-1,1390,1468,-78,0,-30,122
-1,1391,1558,-167,1,143,56
-1,1620,1625,-5,-4,-82,60
-1,1586,1515,71,1,5,42
1,1438,1394,44,2,170,70
-1,1563,1750,-187,-7,-523,82
1,1597,1635,-38,0,85,77
1,1703,1572,131,-2,-70,53
-1,1796,1708,88,0,-7,44
-1,1500,1179,321,-3,-189,102
-1,1384,1691,-307,-1,-47,48
-1,1680,2032,-352,2,69,70
-1,1508,1566,-58,-5,-265,68
1,1591,1569,22,-1,203,93
-1,1477,1410,67,-2,-51,54
1,1838,1467,371,4,503,101
-1,1409,1547,-138,-1,1,50
0,1676,1680,-4,-1,15,59
1,1950,1866,84,-1,-24,45
-1,1255,1772,-517,-10,-201,52
-1,1726,1695,31,-9,-381,64
1,1627,1500,127,9,377,65
-1,1709,1574,135,-1,-36,52
-1,1598,1586,12,1,-302,88
1,1573,1604,-31,-5,-29,61
1,1518,1477,41,2,291,89
-1,1481,1561,-80,-2,-23,60
1,1500,1556,-56,2,230,67
-1,1611,1590,21,7,229,86
1,1776,1831,-55,0,-2,57
-1,1612,1571,41,-4,-107,50
-1,1763,1803,-40,0,-88,122
1,1877,1829,48,-1,-11,61
1,2035,1678,357,2,238,117
-1,1665,1643,22,0,-82,104
0,1603,1599,4,-9,-63,120
1,1829,1509,320,-4,-42,63
1,1565,1252,313,-4,-415,123
1,1575,1499,76,1,46,43
-1,1629,1786,-157,1,16,64
1,1600,1603,-3,0,803,109
-1,1423,1464,-41,-5,-41,48
-1,1396,1307,89,-1,-22,62
-1,1818,1788,30,1,18,50
-1,1680,1676,4,1,-48,106
1,1609,1543,66,1,19,47
-1,1270,1509,-239,-3,-66,42
1,1707,1713,-6,1,89,49
-1,1573,1632,-59,-2,-129,84
-1,1519,1681,-162,2,69,44
0,1544,1521,23,-1,-307,96
-1,1849,1727,122,-2,-20,44
-1,1378,1634,-256,-7,-289,70
1,1729,1712,17,0,-150,93
1,1569,1472,97,1,73,86
-1,1709,1557,152,-4,-661,116
-1,1591,1611,-20,3,-181,122
1,1499,1514,-15,-2,-6,45
1,1405,1434,-29,0,391,115
0,1799,1806,-7,-3,-39,121
1,1700,1288,412,5,263,69
-1,1564,1740,-176,-2,-29,46
1,1476,1580,-104,-2,-83,55
-1,1305,1681,-376,-1,-460,86
1,1571,1718,-147,-2,-249,117
1,1593,1653,-60,1,334,103
1,1534,1382,152,5,173,57
1,1498,1510,-12,0,249,175
-1,1406,1443,-37,-1,572,114
-1,1819,1887,-68,-1,-116,106
-1,1618,1717,-99,-5,-118,80
-1,1573,1563,10,-6,-257,76
1,1752,1549,203,1,118,93
1,1746,1695,51,1,97,51
1,1480,1485,-5,3,236,73
-1,1415,1553,-138,-2,-299,122
-1,1464,1840,-376,-1,-13,48
1,1244,1171,73,-1,-19,79
-1,1602,1604,-2,-8,-165,56
-1,1533,1566,-33,-2,84,70
0,1594,1711,-117,0,208,146
-1,1239,1376,-137,-1,-1,94
-1,1502,1602,-100,7,25,104
-1,1685,1756,-71,-1,-53,56
-1,1541,1598,-57,1,13,46
1,1639,1324,315,4,110,63
0,1711,1748,-37,0,-530,110
1,1576,1522,54,-6,-114,57
-1,1458,1596,-138,-2,-197,72
-1,1618,1619,-1,-1,-19,60
-1,1468,1520,-52,1,60,48
1,1765,1676,89,0,261,95
-1,1341,1584,-243,-1,-172,57
1,1608,1532,76,0,224,71
1,1703,1746,-43,-6,99,77
1,1511,1585,-74,0,-18,57
-1,1500,1510,-10,-7,-617,98
1,1602,1453,149,1,69,58
-1,1968,1891,77,0,-268,100
-1,1774,1858,-84,-1,-579,106
1,1747,1712,35,1,21,63
-1,1572,1526,46,1,7,40
-1,1575,1561,14,0,-56,82
-1,1529,1457,72,-5,-165,82
1,1623,1793,-170,-2,112,67
1,1499,1514,-15,0,46,69
-1,1382,1478,-96,-1,-69,66
1,2057,1702,355,3,125,59
-1,1607,1534,73,1,-54,56
0,1862,1725,137,0,-226,140
-1,1290,1643,-353,-2,-72,78
-1,1559,1621,-62,5,46,84
-1,1544,1758,-214,0,-50,68
-1,1452,1375,77,2,40,48
-1,1598,1783,-185,-5,-380,140
-1,1581,1605,-24,-1,-57,48
1,1322,1785,-463,-4,170,73
1,1920,1700,220,-5,-168,63
0,1631,1550,81,6,403,128
-1,1524,1711,-187,0,-145,120
-1,1264,1617,-353,-1,-141,62
-1,1432,1643,-211,-6,-335,72
1,1573,1563,10,-1,23,53
-1,1628,1661,-33,-6,-157,74
1,1951,1694,257,-1,-167,95
1,1720,1703,17,5,158,47
-1,1498,1510,-12,-4,-471,100
1,1620,1586,34,1,63,49
-1,1487,1552,-65,-9,-257,48
1,1535,1373,162,1,409,85
-1,1624,1572,52,-3,-59,50
-1,1484,1491,-7,4,-50,104
-1,1770,1618,152,0,-43,76
-1,1562,1477,85,-8,-219,52
-1,1387,1622,-235,1,8,44
1,1594,1108,486,4,92,61
-1,1110,1270,-160,-3,-196,68
1,1472,1716,-244,1,112,81
1,1646,1265,381,4,179,55
1,1794,1126,668,0,22,83
-1,1768,1715,53,0,-13,70
1,1776,1639,137,-2,55,79
1,1788,1592,196,2,61,58
-1,1727,1959,-232,-6,-15,40
-1,1344,1274,70,-5,-222,54
1,1703,1272,431,5,362,81
1,1641,1323,318,2,283,67
-1,1806,1875,-69,0,-111,126
-1,1552,1692,-140,0,6,52
1,1564,1548,16,-4,37,71
-1,1639,1975,-336,0,-312,110
-1,1287,1377,-90,-22,-1316,84
1,1630,1500,130,1,48,43
-1,1904,1918,-14,-3,-73,68
-1,1334,1224,110,1,74,42
1,1480,1436,44,6,98,47
1,1763,1538,225,0,-30,91
1,1706,1663,43,14,581,67
-1,1500,1795,-295,0,-84,80
-1,1587,1794,-207,-3,12,62
1,1674,1179,495,3,129,51
1,1318,1379,-61,1,79,68
-1,1717,1513,204,1,-121,96
1,1771,1636,135,10,182,49
-1,1521,1545,-24,-5,-1007,106
1,1620,1471,149,8,868,103
-1,1618,1729,-111,0,63,98
-1,1585,1611,-26,-2,-283,134
-1,1497,1426,71,-1,-43,46
-1,1616,1532,84,-13,-416,60
-1,1330,1500,-170,-6,-104,52
1,1366,1542,-176,-1,-133,73
1,1583,1459,124,5,968,129
1,1587,1713,-126,1,40,47
-1,1378,1301,77,11,368,80
1,1722,1762,-40,1,62,99
1,1627,1382,245,-9,-465,91
-1,1513,1375,138,-1,-898,158
-1,1396,1245,151,0,47,60
-1,1754,1610,144,-8,-191,56
1,1544,1524,20,-14,-112,49
-1,1514,1809,-295,0,-191,102
-1,1636,1665,-29,0,-103,76
-1,1990,1628,362,-3,-693,106
-1,1177,1676,-499,-14,-93,42
-1,1698,1787,-89,-3,-92,53
1,1884,1797,87,2,133,91
1,1556,1640,-84,2,396,67
1,1629,1582,47,0,33,77
1,1649,1426,223,-6,28,61
1,1501,1617,-116,0,-129,89
1,1513,1720,-207,0,657,135
-1,1645,1633,12,0,0,82
1,1694,1679,15,0,253,137
1,1799,1319,480,0,-19,53
1,1364,1353,11,4,911,129
-1,1383,1522,-139,0,-349,98
1,1678,1175,503,5,521,83
-1,1624,1493,131,0,11,52
-1,1654,1625,29,-3,-128,66
-1,1639,1515,124,-7,-96,49
-1,1676,1893,-217,0,-9,76
-1,1098,1699,-601,-2,-126,74
1,1531,1540,-9,3,35,43
-1,1697,1646,51,0,-911,126
-1,1866,1783,83,0,-18,50
-1,1856,1704,152,0,85,78
1,1732,1601,131,3,97,85
1,1364,1633,-269,7,52,41
-1,1534,1768,-234,-4,-264,78
-1,1580,1469,111,0,-141,90
1,1703,1645,58,0,-258,130
1,1527,1544,-17,1,0,41
1,1555,1395,160,5,656,71
-1,1802,1637,165,-1,-160,96
1,1511,1235,276,3,167,57
1,1680,1642,38,-9,-102,47
-1,1797,1964,-167,2,37,45
0,1788,1893,-105,-1,-26,115
-1,1556,1474,82,1,39,60
-1,1916,1662,254,1,-80,63
-1,1383,1561,-178,-13,-747,86
1,1737,1730,7,0,48,59
1,1768,1617,151,0,12,61
1,1693,1632,61,-1,208,73
1,1611,1630,-19,0,10,42
-1,1566,1534,32,-4,7,128
1,1287,1217,70,-8,-118,46
-1,1721,1440,281,-1,7,74
-1,1783,1653,130,-2,-60,50
-1,1541,1797,-256,-3,-345,102
-1,1173,1680,-507,-1,-255,76
-1,1736,1643,93,-3,-54,70
-1,1705,1624,81,0,15,78
-1,1529,1601,-72,0,-65,60
-1,1781,1842,-61,0,472,82
-1,1385,1320,65,-10,-290,66
1,1372,1202,170,-2,-129,61
1,1839,1871,-32,-1,-34,43
-1,1545,1376,169,0,4,49
1,1711,1500,211,0,-52,73
-1,1765,1637,128,-5,-39,40
1,1717,1476,241,0,110,103
1,1542,1463,79,3,54,53
-1,1704,1618,86,0,-158,142
-1,1720,1749,-29,0,114,80
-1,1622,1813,-191,-1,-293,100
1,1375,1515,-140,4,98,47
1,1515,1197,318,1,94,81
0,1688,1591,97,-2,9,137
1,1719,1634,85,1,13,43
-1,1757,1876,-119,-1,-328,126
1,1550,1529,21,9,179,47
-1,1716,1669,47,-7,-310,74
-1,1757,1766,-9,0,33,80
-1,1604,1621,-17,0,-65,80
-1,1405,1399,6,5,251,68
1,1191,1258,-67,18,333,45
1,1890,1792,98,2,128,69
-1,1804,1970,-166,-1,-33,60
1,1558,1616,-58,-1,1,47
1,1500,1589,-89,0,-72,51
-1,1604,1609,-5,-2,-1,48
-1,1572,1604,-32,2,108,42
1,1858,1852,6,0,-12,45
1,1497,1603,-106,0,231,93
-1,1625,1728,-103,-2,-47,49
-1,1684,1613,71,0,-12,64
1,1712,1558,154,0,11,55
1,1777,1561,216,1,278,77
1,1901,1749,152,1,75,105
-1,1558,1615,-57,-1,2,48
-1,1414,1703,-289,-5,-610,96
1,1701,1459,242,0,160,83
-1,1421,1654,-233,1,33,184
-1,1632,1698,-66,-8,-281,53
1,1565,1635,-70,3,179,65
-1,1114,1682,-568,-17,-422,42
1,1773,1659,114,-1,-14,53
-1,1644,1668,-24,-1,-16,50
0,1209,1338,-129,-1,359,120
1,1838,1459,379,10,339,43
-1,1272,1411,-139,1,68,52
-1,1501,1430,71,-3,-284,60
1,1556,1782,-226,0,-158,131
-1,1193,1518,-325,-4,-89,50
1,1776,1491,285,1,118,139
-1,1381,1617,-236,-7,-40,42
1,1723,1622,101,-1,99,73
1,1441,1621,-180,-3,178,80
-1,1220,1683,-463,-1,-25,62
-1,1784,1898,-114,-1,-119,96
-1,1594,1750,-156,-2,-36,44
1,1680,1621,59,5,525,65
-1,1574,1237,337,-8,-484,81
-1,1741,1678,63,-3,-257,110
1,1854,1783,71,1,61,67
0,1922,1749,173,-4,-252,136
-1,1386,1612,-226,-3,-11,40
1,1764,1574,190,2,274,75
-1,1500,1760,-260,-1,-28,84
1,1795,1617,178,-1,21,53
-1,1685,1707,-22,0,72,98
1,1691,1552,139,0,29,87
1,1408,1216,192,-6,-149,45
1,1719,1632,87,-1,2,41
1,1521,1190,331,6,163,61
-1,1561,1589,-28,5,281,74
-1,1568,1770,-202,0,-27,62
-1,1622,1804,-182,-7,-61,64
1,1664,1484,180,5,489,77
1,1601,1507,94,0,8,47
-1,1632,1721,-89,1,16,94
1,1644,1623,21,0,74,79
1,1624,1512,112,0,236,101
-1,1245,1662,-417,-11,-545,98
-1,1456,1841,-385,-1,-218,74
-1,1474,1489,-15,-1,-16,46
0,1498,1610,-112,-1,-87,140
1,1774,1853,-79,4,88,53
1,1794,1543,251,0,-4,47
-1,1616,1810,-194,-8,-247,56
-1,1560,1600,-40,-5,-326,108
1,1976,1870,106,1,133,79
0,1907,1754,153,-2,-138,102
1,1727,1513,214,8,497,81
-1,1387,1706,-319,-2,-31,48
-1,1547,1624,-77,-4,-303,76
1,1294,1607,-313,1,17,47
1,1706,1553,153,1,62,95
-1,1201,1717,-516,3,136,64
1,1673,1417,256,-1,49,83
1,1657,1549,108,0,259,81
1,1816,1611,205,-1,408,123
1,1780,1526,254,-5,-127,83
-1,1574,1533,41,-3,-184,70
1,1612,1726,-114,0,27,51
1,1637,1117,520,-13,-581,65
-1,1617,1670,-53,0,-23,54
-1,1700,1535,165,3,243,90
1,2190,2077,113,0,19,63
1,1503,1118,385,8,328,63
1,1448,1521,-73,1,7,75
-1,1258,1550,-292,2,-67,70
-1,1579,1545,34,0,-32,60
1,1805,1840,-35,0,54,91
-1,1785,1746,39,-1,-32,74
1,1894,1758,136,-1,-299,117
-1,1678,1718,-40,-2,-141,130
-1,1533,1698,-165,-1,-47,54
-1,1644,1910,-266,0,68,72
-1,1839,1672,167,-5,-66,60
-1,1582,1606,-24,-1,-199,124
-1,1510,1766,-256,-1,-713,140
-1,1427,1287,140,-7,-32,50
-1,1548,1719,-171,1,-657,152
-1,1634,1541,93,-3,-296,86
1,1929,1785,144,0,5,87
1,1742,1727,15,0,10,81
-1,1700,1829,-129,-4,-139,56
1,1333,1445,-112,-4,-121,51
1,1623,1438,185,4,328,82
0,1671,1825,-154,-3,-279,141
-1,1671,1500,171,-2,-127,82
1,1700,1597,103,-3,6,103
-1,1693,1871,-178,-3,11,76
1,1587,1588,-1,6,176,57
1,1528,1200,328,0,208,69
1,1632,1669,-37,-2,-49,67
1,1590,1379,211,0,-6,56
-1,1337,1646,-309,-1,7,64
-1,1608,1639,-31,0,15,56
-1,1681,1620,61,0,-132,167
1,1851,1778,73,-1,-102,81
1,1197,1364,-167,3,260,71
1,1855,1395,460,5,267,71
1,1585,1641,-56,-3,-16,43
1,1302,1186,116,-5,-134,69
1,1488,1436,52,0,141,82
-1,1716,1768,-52,-1,-137,106
1,1500,1589,-89,0,41,75
-1,1612,1514,98,-11,-1315,100
1,1727,1436,291,0,4,41
-1,1265,1508,-243,0,-87,60
-1,1520,1377,143,3,-32,90
-1,1589,1621,-32,-1,-427,148
1,1688,1822,-134,8,175,49
1,1837,1638,199,3,186,71
1,1596,1204,392,2,-69,63
1,1709,1352,357,-4,-69,53
1,1622,1557,65,9,845,103
1,1351,1659,-308,-1,8,43
1,2072,1171,901,1,281,71
1,1656,1644,12,2,208,95
-1,1628,1598,30,-5,-611,138
-1,1457,1704,-247,-1,-82,62
-1,1631,1548,83,0,-56,58
-1,1529,1432,97,0,-179,80
1,1693,1522,171,8,202,49
-1,1367,1715,-348,-2,-261,104
1,1795,1690,105,1,144,83
1,1629,1390,239,0,55,81
1,1687,1391,296,0,35,53
-1,1520,1704,-184,-1,-116,62
1,1706,1572,134,0,141,85
-1,1618,1562,56,-2,-556,90
-1,1280,1566,-286,-5,-75,50
1,1769,1680,89,-5,86,62
1,1498,1533,-35,5,417,101
1,1771,1404,367,0,74,83
-1,1643,1964,-321,-1,-227,106
1,1445,1498,-53,6,198,57
1,1605,1575,30,3,115,53
-1,1630,1843,-213,-4,-76,54
1,1604,1358,246,-6,269,133
-1,1776,1657,119,0,-6,44
1,1709,1402,307,8,517,69
1,2077,1762,315,0,34,75
-1,1531,1632,-101,0,119,82
1,1654,1714,-60,1,33,85
1,2132,1936,196,-1,-8,43
-1,1275,1605,-330,-7,-137,56
1,1447,1648,-201,0,-8,43
-1,1611,1599,12,-5,-223,82
-1,1883,2082,-199,0,-143,74
-1,1515,1691,-176,-2,-139,136
-1,1671,1778,-107,-5,-248,114
1,1450,1482,-32,1,165,81
-1,1683,1828,-145,-1,-22,48
1,1306,1371,-65,-4,41,71
-1,1173,1995,-822,-2,-125,130
1,1463,1399,64,2,182,147
1,1501,1462,39,1,-58,57
-1,1696,1873,-177,8,-112,92
1,2088,1851,237,1,448,119
1,1821,1823,-2,3,57,44
-1,1730,1458,272,-1,-277,84
-1,1740,1790,-50,0,-107,74
1,1686,1792,-106,-2,-200,149
0,1599,1610,-11,-3,233,115
-1,1620,1930,-310,0,-10,56
1,1826,2094,-268,-1,-39,85
-1,1879,1675,204,-2,-31,52
-1,1345,1565,-220,-1,-144,78
-1,1511,1564,-53,4,104,76
1,1439,1893,-454,-1,-47,45
1,1504,1240,264,4,81,43
-1,1666,1700,-34,-4,-665,112
1,1404,1389,15,-3,509,117
1,1599,1609,-10,6,515,111
-1,2074,1915,159,0,-292,110
-1,1741,1853,-112,-3,-53,44
1,1996,1171,825,-2,652,127
-1,1681,1780,-99,0,21,60
-1,1550,1528,22,0,-19,76
1,1658,1488,170,0,25,53
-1,1493,1618,-125,-3,-135,79
1,1598,1574,24,10,675,77
-1,1769,2141,-372,1,-54,90
-1,1520,1510,10,-7,-376,90
1,1857,1393,464,3,222,63
1,1612,1849,-237,-2,-47,85
-1,1474,1345,129,0,-82,82
-1,1323,1264,59,0,-1,54
1,1983,2057,-74,0,21,59
-1,1668,1779,-111,-2,-38,44
-1,2042,2035,7,-4,-135,54
-1,1785,1663,122,0,-51,126
-1,1611,1922,-311,-5,-546,110
-1,1657,1808,-151,-1,-285,114
1,1812,1878,-66,1,151,53
1,1462,1470,-8,2,103,55
-1,1494,1573,-79,-13,-170,54
1,2074,2029,45,-6,-76,125
0,1863,1968,-105,-2,-188,95
1,2081,1723,358,0,50,43
-1,1510,1523,-13,-3,36,92
-1,1711,1530,181,-4,-33,43
1,1733,1810,-77,-2,-104,73
1,1704,1730,-26,-4,-109,57
-1,1607,1490,117,0,15,60
1,1661,1667,-6,-3,23,77
1,1608,1724,-116,0,138,97
-1,1965,1866,99,-1,215,94
-1,1675,1500,175,0,-221,92
-1,1506,1623,-117,-2,-56,46
-1,1856,1824,32,-1,-422,116
1,1622,1706,-84,0,101,77
-1,1563,2085,-522,-4,-98,62
-1,1634,1495,139,1,16,40
1,1694,1716,-22,9,146,43
-1,1642,1639,3,-2,-91,68
1,1601,1482,119,8,121,49
-1,1381,1620,-239,2,-30,52
-1,1219,1508,-289,-4,-69,57
-1,1673,1770,-97,-2,-120,78
1,1951,2018,-67,-1,6,87
-1,1635,1690,-55,-7,-552,76
-1,1538,1500,38,0,-60,68
1,1948,1812,136,0,21,65
-1,1651,1704,-53,-12,-691,86
1,1552,1544,8,7,314,71
1,2087,1562,525,0,105,67
-1,1485,1575,-90,0,-56,90
1,1213,1262,-49,3,-6,41
-1,1458,1490,-32,0,-97,74
1,1694,1647,47,1,105,103
1,1698,1340,358,4,402,71
1,1879,1894,-15,-1,1,43
-1,1461,2003,-542,0,-335,76
0,1782,1746,36,0,11,43
-1,1682,1841,-159,0,-3,44
1,1626,1640,-14,3,16,55
-1,1651,1711,-60,-1,-37,54
1,1718,1393,325,3,346,71
-1,1378,1415,-37,-1,-74,74
-1,1701,1714,-13,-1,-33,50
1,1666,1585,81,-2,-123,85
-1,1510,1618,-108,-1,-250,90
1,1724,1689,35,1,85,59
-1,1964,2072,-108,0,-8,60
-1,1500,1829,-329,0,-1,50
-1,1500,1493,7,0,-60,70
1,1806,1954,-148,-9,-163,87
-1,1627,1600,27,-3,-504,106
-1,1642,1614,28,-1,-282,124
-1,1637,1500,137,0,-41,86
1,1677,1734,-57,-2,157,109
0,1747,1780,-33,-2,-102,99
1,1737,1600,137,3,221,77
1,2082,1956,126,0,105,107
-1,1469,1474,-5,1,97,112
-1,1447,1512,-65,-4,-133,63
1,1315,1476,-161,-9,12,67
-1,1612,1637,-25,-6,-387,84
-1,1529,1500,29,-9,-185,44
1,1679,1610,69,-1,-40,61
-1,1806,1820,-14,-1,-56,70
1,1721,1692,29,-2,245,97
1,1873,2015,-142,-3,-321,105
1,1460,1496,-36,-3,177,99
1,1949,2091,-142,1,196,81
1,1568,1309,259,4,223,75
1,1583,1476,107,0,58,113
1,1940,1820,120,1,23,45
-1,1681,1732,-51,-15,-376,46
1,1601,1647,-46,1,281,105
-1,1594,1756,-162,-2,-40,46
1,1997,1889,108,7,308,61
-1,1500,1420,80,0,-210,86
-1,1471,1537,-66,-8,-51,122
1,1741,1670,71,-1,-10,61
-1,1813,1947,-134,0,-33,84
1,1230,1460,-230,-2,21,95
-1,1630,1778,-148,0,-350,84
1,2073,1614,459,1,78,65
-1,1271,1452,-181,-6,-183,50
1,2088,1704,384,5,153,57
0,1832,1772,60,0,194,124
1,1881,1635,246,1,71,129
-1,1305,1489,-184,-1,-31,58
1,1686,1364,322,-1,-10,63
1,1660,1750,-90,-3,-188,57
1,1836,1898,-62,-1,-2,49
-1,1964,1720,244,-2,-16,47
1,1672,1656,16,10,909,81
1,2074,2006,68,-2,-42,79
1,1458,1284,174,1,37,43
1,1736,1675,61,1,21,73
0,1631,1885,-254,0,306,130
1,1555,1486,69,1,175,64
-1,1742,1947,-205,0,-9,54
1,1619,1637,-18,-3,17,50
-1,1846,2092,-246,1,-188,84
1,1871,2027,-156,3,457,113
-1,1590,1633,-43,0,-41,56
-1,1598,1989,-391,-1,-347,98
-1,1542,1718,-176,-4,-58,44
1,1625,1572,53,5,490,93
-1,1666,1745,-79,5,350,52
-1,1512,1319,193,-8,-377,74
1,1878,1638,240,0,-38,127
-1,1952,1735,217,0,-20,64
-1,1805,1854,-49,-12,-92,40
1,1524,1500,24,1,122,59
1,1600,1550,50,5,225,60
1,1780,1511,269,0,4,45
-1,1800,1960,-160,3,225,94
1,1464,1404,60,-3,-146,75
-1,1624,1626,-2,-1,-239,160
1,2099,1841,258,0,49,171
1,1754,1656,98,2,96,49
1,1279,1281,-2,1,23,59
-1,1633,1883,-250,0,-312,106
-1,1473,1465,8,0,-42,80
-1,1756,1935,-179,-3,29,40
1,1648,1761,-113,5,-66,113
-1,1323,1439,-116,3,57,52
-1,1564,1536,28,-1,7,78
-1,1468,1591,-123,1,43,88
-1,1630,1776,-146,-4,-65,68
0,1941,1749,192,0,-7,133
-1,1945,1797,148,-7,-208,56
1,1327,1367,-40,0,37,51
1,1675,1734,-59,0,21,69
1,1437,1259,178,9,510,65
-1,1490,1515,-25,-2,-135,90
1,1996,1629,367,-3,-7,49
1,1747,1888,-141,-1,389,115
-1,1837,2105,-268,0,-57,62
1,1799,1626,173,0,691,115
1,1966,1794,172,0,-3,65
1,1643,1610,33,-6,-125,97
-1,1872,1762,110,-3,-283,74
-1,1501,1483,18,-10,-394,80
-1,1994,1949,45,0,9,68
-1,1587,1688,-101,-6,-391,84
-1,1600,1806,-206,-1,-59,70
1,1491,1328,163,0,102,121
-1,1502,1631,-129,1,275,138
1,1648,1582,66,-1,-35,73
1,1935,2105,-170,-5,-1,87
1,1340,1264,76,1,47,57
1,1985,1382,603,4,121,51
1,1473,1564,-91,-2,-18,51
1,1830,1972,-142,0,807,141
1,1682,1863,-181,3,458,73
-1,1461,1431,30,0,-210,98
1,1986,1951,35,-2,21,67
1,1767,1872,-105,-1,-1,49
-1,1601,1498,103,-3,-91,58
1,1846,1703,143,-2,-72,87
1,1958,1999,-41,0,122,95
1,1397,1212,185,4,104,51
-1,1288,1403,-115,-2,-175,80
-1,1487,1548,-61,-4,-172,106
1,1724,1524,200,-6,-75,79
1,1694,1853,-159,1,69,61
-1,1587,1517,70,0,13,40
1,1599,1653,-54,3,596,93
-1,1056,1481,-425,-3,-634,98
-1,1499,1489,10,-2,-68,68
-1,1500,1509,-9,-2,-66,49
-1,1446,1527,-81,-5,-373,78
-1,1824,1710,114,-3,-211,82
1,1573,1535,38,12,336,63
1,1797,2008,-211,0,58,103
-1,1535,1461,74,0,-216,106
1,1884,1967,-83,0,44,81
-1,1941,1998,-57,0,-23,72
1,1463,1410,53,-3,41,65
1,1474,1521,-47,-1,-138,85
1,2144,1482,662,4,108,43
1,1957,1844,113,-1,113,136
0,1897,1804,93,0,-6,95
-1,1610,1971,-361,-2,-65,62
-1,1365,1552,-187,-5,-129,60
1,1626,1506,120,0,107,115
-1,1794,1540,254,0,-182,70
-1,1857,1820,37,1,23,60
1,1201,1341,-140,4,90,45
-1,1583,1559,24,-3,-86,54
-1,1640,1613,27,0,-165,112
1,1516,1490,26,0,-4,61
-1,1472,1394,78,0,74,62
-1,1582,1560,22,3,107,64
1,1546,1305,241,7,280,59
-1,1966,1307,659,-6,-210,70
-1,1811,1806,5,0,-80,112
1,1337,1495,-158,-16,-265,47
-1,1808,1646,162,-3,-150,70
-1,1430,1601,-171,0,-173,84
-1,1271,1492,-221,7,235,54
1,1501,1483,18,5,171,61
1,1314,1352,-38,6,385,71
-1,1638,1495,143,6,-91,148
1,1505,1327,178,7,847,103
-1,1311,1562,-251,0,7,60
-1,1579,1637,-58,-7,-476,86
1,2056,1961,95,1,208,107
1,1558,1408,150,2,512,101
0,2064,1953,111,3,43,67
-1,1291,1304,-13,3,-141,112
1,1894,1810,84,0,-32,93
-1,1572,1571,1,2,-6,62
-1,1321,1419,-98,-6,-783,128
-1,1168,1497,-329,-2,-135,62
1,1487,1620,-133,-1,-4,65
-1,1588,1647,-59,2,240,140
1,1572,1325,247,2,116,43
-1,1840,1931,-91,-2,-507,86
1,1582,1497,85,0,103,83
1,1348,1426,-78,0,197,79
-1,1500,1500,0,-3,-101,88
-1,1572,1571,1,-2,-99,42
1,1327,1334,-7,-3,-159,65
1,2111,1827,284,0,-26,105
1,1458,1052,406,2,109,61
1,1939,1831,108,1,58,59
1,1629,1787,-158,1,224,87
-1,1940,1990,-50,0,-26,66
1,1540,1532,8,4,170,61
1,1488,1590,-102,-1,356,101
1,1312,1311,1,-2,-10,53
-1,1844,1722,122,-1,-83,88
-1,1989,1829,160,0,2,76
1,1546,1308,238,0,-14,72
1,1774,1947,-173,0,32,57
1,1801,1791,10,0,-58,63
1,1618,1422,196,0,-7,65
-1,1587,1705,-118,0,-161,88
-1,1519,1481,38,1,49,66
1,1949,1503,446,2,278,75
1,1844,1694,150,3,68,53
-1,1823,2116,-293,0,18,106
1,1576,1259,317,16,599,61
-1,1511,1622,-111,-1,82,92
1,1617,1638,-21,1,33,65
-1,1526,1514,12,-3,-420,86
-1,1814,1971,-157,0,106,70
-1,1573,1669,-96,-6,-172,54
1,1500,1505,-5,-2,-179,99
-1,1683,1937,-254,-7,-206,97
-1,1337,2085,-748,-4,-44,41
-1,1507,1230,277,2,326,100
-1,1695,1660,35,1,49,88
-1,1502,1952,-450,-5,-253,70
1,1880,1933,-53,2,64,69
-1,1414,1459,-45,-3,-81,46
0,1887,1861,26,-3,-75,64
-1,1731,1508,223,1,104,90
1,2085,1979,106,0,-19,69
1,2121,1819,302,0,7,103
-1,1561,1507,54,-6,-447,80
1,1478,1557,-79,1,156,67
-1,1921,1956,-35,0,-45,108
1,1562,1563,-1,-8,240,123
1,1634,1374,260,3,38,57
-1,1727,1877,-150,-2,-79,61
-1,1714,2095,-381,0,-396,130
-1,1411,1389,22,4,-131,90
1,1559,1577,-18,3,129,63
1,1549,1502,47,-3,403,117
1,1511,1306,205,6,81,46
-1,1677,1522,155,1,-419,110
1,2043,1970,73,0,-13,73
1,1579,1713,-134,6,230,55
-1,1703,1851,-148,-7,-120,46
1,1379,1595,-216,-3,-59,83
-1,1574,1552,22,2,76,78
-1,1837,1812,25,1,51,66
1,1630,1503,127,0,96,121
1,1565,1625,-60,-6,-20,93
1,1832,1684,148,2,98,53
1,1608,1507,101,-1,-32,55
-1,1498,1645,-147,-2,-66,84
-1,1526,1515,11,4,170,86
0,1579,1741,-162,-2,-318,165
1,1885,1800,85,-6,-128,57
-1,1746,1784,-38,0,-4,90
-1,1510,1735,-225,1,-16,62
-1,1638,1581,57,1,45,66
-1,1492,1538,-46,0,-121,112
1,2062,1975,87,0,109,153
1,1532,1569,-37,0,-5,49
1,1858,1696,162,8,379,73
-1,1678,1624,54,-3,-4,58
1,1584,1500,84,-1,369,75
1,1478,1483,-5,-5,-84,41
1,1593,1491,102,0,60,55
-1,1595,1590,5,-9,-91,52
-1,1501,1642,-141,1,118,84
-1,1450,1432,18,-9,-17,44
-1,1847,1555,292,-3,-110,70
0,1601,1482,119,4,-120,101
-1,1903,1911,-8,1,126,84
1,1631,1493,138,-9,-23,73
-1,1280,1321,-41,-1,-117,62
1,1651,1661,-10,0,24,71
1,1639,1461,178,0,12,63
-1,1818,1920,-102,-1,-49,50
1,1439,1281,158,-10,-9,55
1,1613,1543,70,0,37,107
1,1557,1574,-17,4,65,41
1,2058,1823,235,0,8,53
1,1623,1520,103,-2,25,55
-1,1579,1779,-200,1,91,100
1,1839,1771,68,-1,200,83
-1,1285,1865,-580,-4,-165,52
-1,1707,1740,-33,0,1,68
1,1472,1489,-17,3,299,99
1,1818,2063,-245,-1,-55,71
-1,1612,1779,-167,-3,-325,108
-1,1518,1557,-39,-3,-183,76
1,1351,1439,-88,3,78,47
-1,1574,1826,-252,0,-125,120
1,1928,1810,118,2,77,57
-1,1386,1445,-59,2,-282,98
1,1666,1586,80,9,423,71
-1,1714,1960,-246,0,-161,92
1,1571,1560,11,0,2,55
1,1837,1833,4,-1,-134,99
-1,1555,1236,319,-5,-22,46
1,1640,1536,104,1,240,107
1,1504,1459,45,0,1,51
1,1666,1497,169,0,177,146
1,1965,1710,255,0,41,61
1,1622,1699,-77,3,227,71
1,2132,1936,196,1,-30,77
1,1495,1637,-142,-1,-84,65
0,1866,1596,270,1,-23,97
1,1425,1139,286,-6,4,46
-1,1198,1444,-246,-10,-574,92
-1,1486,1566,-80,2,86,46
-1,1298,1511,-213,-4,-115,72
1,1905,1677,228,0,-4,99
1,1848,1706,142,0,-26,97
-1,1365,1545,-180,0,-2,42
1,1362,1450,-88,-6,-158,117
-1,1631,1526,105,0,15,82
1,1632,1750,-118,0,-23,71
-1,1526,1638,-112,1,-446,124
1,1402,1091,311,1,110,43
1,1559,1722,-163,1,-4,93
-1,1699,1856,-157,-1,129,90
1,1717,1685,32,-1,-49,59
1,1522,1415,107,12,309,53
1,1712,1574,138,1,66,70
-1,1826,1807,19,-4,-35,44
-1,1134,1428,-294,-1,-523,124
1,1862,1692,170,-3,-58,79
-1,1332,1500,-168,-1,-57,55
-1,1635,1650,-15,-1,-4,106
1,1622,1511,111,4,195,63
1,1594,1267,327,0,5,47
1,1406,1553,-147,-4,1483,153
-1,1650,1600,50,-3,-93,60
-1,1270,1488,-218,3,44,64
1,2076,1788,288,4,79,57
-1,1163,1831,-668,-9,-127,44
-1,1616,1784,-168,0,-3,42
-1,1482,1567,-85,0,-25,52
0,1795,1887,-92,-2,60,148
1,1484,1450,34,0,164,81
-1,1603,1858,-255,-1,-268,82
-1,1625,1406,219,-1,-217,114
-1,2045,1869,176,-1,1,40
-1,1735,1913,-178,0,174,96
1,1624,1672,-48,0,32,57
-1,1646,1564,82,1,-12,50
1,2077,1786,291,3,91,59
1,1634,1534,100,-8,-41,75
1,1707,1410,297,2,124,67
-1,1652,1491,161,-7,-418,92
-1,1577,1633,-56,-5,-241,56
1,1784,1811,-27,-1,-33,61
-1,1598,1535,63,-7,-358,80
1,1476,1774,-298,-3,-36,49
1,1497,1540,-43,1,205,75
1,1782,1605,177,4,89,65
1,1672,1477,195,0,61,77
-1,1473,1540,-67,-2,-108,76
-1,1249,1262,-13,2,13,48
1,1721,1767,-46,0,129,79
1,1618,1500,118,6,569,101
-1,1882,1866,16,0,-17,74
-1,1346,1103,243,-8,-171,60
1,1811,1667,144,3,338,79
1,1436,1322,114,3,209,97
-1,1286,1644,-358,-2,-130,54
-1,1765,1667,98,-3,-297,78
-1,1340,1640,-300,0,-115,86
1,1621,1627,-6,1,432,135
1,1369,1288,81,6,123,51
-1,1490,1741,-251,1,25,48
1,1504,1443,61,0,437,99
1,1661,1841,-180,10,392,69
1,1601,1557,44,-1,-24,47
-1,1890,1866,24,-4,-207,62
-1,2098,2113,-15,1,45,62
1,1780,1581,199,0,38,53
-1,1616,1632,-16,-7,-654,74
-1,1373,2076,-703,-3,-27,50
1,1701,1841,-140,3,-20,73
-1,1824,1677,147,-2,-187,64
-1,1259,1623,-364,-9,-193,102
-1,1755,1681,74,0,-36,80
1,1668,1448,220,-3,-136,61
-1,1403,1492,-89,0,-149,60
1,1607,1159,448,2,282,81
1,1747,1588,159,12,387,49
1,1939,2076,-137,0,40,121
1,1628,1358,270,-4,1197,133
1,1635,1564,71,2,106,89
-1,1378,1421,-43,-7,-807,106
1,1469,1335,134,10,514,65
1,1350,1390,-40,3,78,61
-1,1242,1669,-427,-11,-628,76
1,1816,1685,131,3,113,57
1,1746,1486,260,0,25,47
-1,1139,1140,-1,-10,-712,84
1,2060,2024,36,-1,-55,57
-1,1634,1747,-113,-1,-44,84
1,1488,1381,107,6,366,61
-1,1500,1395,105,-7,-178,80
-1,1877,1870,7,0,-95,82
1,1766,1678,88,-2,-30,43
-1,1785,1561,224,1,-105,102
-1,1495,1580,-85,-7,-254,64
-1,1500,1548,-48,0,-6,102
-1,1766,1851,-85,0,8,98
0,1757,1776,-19,-2,-51,76
1,1936,1828,108,-1,-51,67
-1,1669,1976,-307,0,-52,66
1,1728,1681,47,8,323,71
1,1583,1486,97,1,57,87
-1,1497,1605,-108,8,388,70
-1,1637,1500,137,-5,-35,88
1,1811,1879,-68,-3,31,109
1,1643,1336,307,-1,-19,65
1,1666,1991,-325,0,3,51
-1,1353,1309,44,-2,-7,46
1,1556,1644,-88,-1,131,79
-1,1582,1754,-172,0,-35,104
1,2085,1911,174,-3,381,163
-1,1716,1826,-110,-2,-589,140
1,1929,1679,250,0,59,53
-1,1368,1415,-47,-4,-204,63
1,1374,1269,105,-3,-67,57
1,1488,1485,3,-1,-20,65
1,1571,1842,-271,0,-5,75
1,1576,1534,42,0,-2,63
-1,1675,1945,-270,-1,-91,72
-1,1467,1550,-83,1,-27,66
-1,1520,1456,64,-7,-369,60
1,1322,1751,-429,5,33,81
-1,1339,1609,-270,0,-202,60
0,1675,1588,87,1,107,129
1,1528,1432,96,0,332,97
1,1866,1672,194,6,136,47
1,1579,1767,-188,-7,52,57
1,2091,1904,187,-5,383,111
-1,1991,1659,332,-1,-441,108
1,1630,1569,61,7,245,67
-1,1510,1627,-117,-3,-89,52
0,1236,1115,121,6,-79,190
-1,1800,1944,-144,-5,-71,80
-1,1679,1935,-256,1,-108,98
1,1500,1193,307,-5,-190,71
1,1666,1872,-206,-7,-28,43
-1,1479,1597,-118,-1,-146,82
1,1897,1587,310,7,149,49
-1,2087,2097,-10,0,-13,76
1,1708,1589,119,-1,-14,51
1,1626,1500,126,7,203,53
-1,1756,1555,201,-9,-197,64
1,1946,1675,271,0,29,69
-1,1901,1583,318,1,65,72
1,1504,1204,300,-8,-218,49
1,1855,1683,172,0,72,118
-1,1751,1794,-43,-1,-71,72
-1,1750,1694,56,-8,-470,102
1,1957,1670,287,0,26,55
1,2108,2076,32,-4,-33,75
1,1615,1153,462,8,293,53
1,1382,1342,40,-4,88,92
1,1669,1590,79,-4,-132,61
1,1560,1639,-79,-2,58,89
1,1256,1378,-122,2,59,43
1,1602,1499,103,0,29,61
1,1765,1606,159,-4,-90,53
-1,1523,1673,-150,-4,16,56
1,1598,1500,98,1,24,47
1,1975,1662,313,1,75,83
-1,1877,1746,131,-3,-302,108
-1,2065,2119,-54,0,7,69
1,1558,1458,100,4,650,89
-1,1659,1983,-324,-11,-91,40
-1,1715,1878,-163,-1,-495,138
1,1737,1582,155,-2,-17,47
1,1990,1655,335,3,104,59
-1,1666,1967,-301,0,59,63
1,1572,1566,6,1,193,97
-1,1591,1582,9,0,-216,94
-1,1612,1591,21,0,-121,107
1,1677,1861,-184,-3,-92,51
-1,1652,1997,-345,0,-122,144
-1,1772,1762,10,0,-120,104
1,1536,1554,-18,0,193,69
-1,1632,1683,-51,-2,-31,46
-1,1248,1525,-277,-8,-625,78
1,1732,1271,461,2,420,121
1,2162,1957,205,-1,-82,69
-1,1487,1869,-382,0,-43,101
-1,1648,2004,-356,0,-33,80
1,1392,1340,52,3,71,42
-1,1216,1744,-528,-2,-291,90
1,1190,1163,27,-5,-21,57
-1,1645,2009,-364,-3,-64,86
1,1680,1515,165,0,316,91
-1,1496,1877,-381,-3,-15,51
1,1760,1522,238,1,179,105
1,1775,2127,-352,-1,351,199
-1,1885,1604,281,1,-61,124
-1,1737,1845,-108,0,-29,64
-1,1642,2015,-373,-2,-102,78
-1,1217,1493,-276,-13,-460,50
-1,1833,1952,-119,0,-8,60
1,1658,1511,147,1,178,103
-1,1745,1529,216,2,18,94
1,2170,1693,477,6,200,61
1,1636,2025,-389,0,474,107
1,1373,1406,-33,7,370,73
1,1424,1416,8,0,28,69
-1,1368,1383,-15,-3,-495,92
-1,1692,2172,-480,-2,-9,46
1,1983,1660,323,0,-166,117
1,1409,1239,170,11,569,69
1,2020,1639,381,1,0,85
1,1746,1450,296,0,5,51
-1,1403,1347,56,-1,-21,48
-1,1647,1663,-16,-1,-107,96
1,1604,1648,-44,-4,-61,51
1,2175,1690,485,1,146,81
1,1555,1583,-28,1,593,125
1,1770,1550,220,0,-116,97
1,1989,1656,333,1,81,56
1,1617,1775,-158,2,95,67
-1,1598,2101,-503,-3,-395,118
-1,1639,1853,-214,-4,-237,68
1,1765,1556,209,1,331,87
1,1653,1996,-343,0,427,111
-1,1881,1774,107,-2,6,68
1,1754,1447,307,1,65,83
-1,1622,1527,95,0,-699,140
-1,1750,1843,-93,-2,-40,42
-1,1623,1865,-242,0,-34,86
1,1830,1860,-30,0,106,111
-1,1347,1385,-38,-8,-129,50
1,1957,1676,281,-1,41,53
-1,1879,1848,31,-3,-133,76
1,2103,1597,506,0,8,43
1,1483,1489,-6,5,43,41
0,1500,1232,268,-1,-123,126
-1,1689,1729,-40,-1,-24,82
-1,1357,1268,89,-7,-166,54
1,1964,1671,293,1,30,65
1,1623,1566,57,-1,-18,49
-1,1579,1613,-34,-6,-458,120
-1,1182,1438,-256,0,-132,67
1,1839,1513,326,-2,167,83
-1,1786,1826,-40,-5,-118,56
1,1851,1740,111,0,-23,71
1,1810,1490,320,0,35,79
1,1463,1485,-22,-2,-26,63
1,1234,1420,-186,1,-56,47
-1,1685,1686,-1,-5,-66,66
-1,1739,1678,61,0,-5,104
-1,1390,1373,17,0,62,90
-1,1545,2105,-560,0,2,70
1,1809,1652,157,0,181,113
0,1760,1785,-25,0,45,91
-1,1279,1360,-81,-11,-763,76
1,1836,1777,59,0,0,87
1,1177,1402,-225,-1,355,136
-1,1508,1576,-68,0,4,70
1,1697,1557,140,-1,-23,51
1,1829,1440,389,-3,-64,69
-1,1428,1858,-430,0,32,68
1,1478,1199,279,0,-21,61
-1,1825,1847,-22,0,-31,80
1,2106,1777,329,-1,4,65
1,1635,1499,136,0,-66,43
-1,1383,1550,-167,-1,-69,72
1,1861,1409,452,10,226,49
-1,1762,1808,-46,-1,-77,64
1,1428,1404,24,1,207,85
-1,1815,1959,-144,3,56,54
1,1758,1867,-109,0,79,81
-1,1495,1757,-262,-1,64,50
0,1393,1863,-470,0,134,111
-1,1571,1870,-299,-4,-417,116
-1,1692,1726,-34,0,-34,89
1,1227,1372,-145,7,190,59
-1,1230,1277,-47,-3,19,114
1,1752,1565,187,-2,62,71
1,1865,1949,-84,0,33,91
1,1556,1623,-67,6,596,85
-1,1607,1540,67,-1,-701,140
-1,1941,1986,-45,0,6,90
-1,1443,1799,-356,1,-336,100
1,2111,1328,783,0,41,73
1,1604,1583,21,-1,19,89
-1,1333,1194,139,-7,-1013,86
-1,1509,1884,-375,-3,-7,46
1,1388,1433,-45,2,39,47
1,1736,1682,54,-2,-66,118
-1,2047,2112,-65,-1,3,40
1,1880,1899,-19,0,-239,121
1,1607,1550,57,3,94,59
1,1772,1575,197,2,131,91
-1,1783,1684,99,-4,-291,74
-1,1394,1445,-51,-1,-51,78
0,1437,1612,-175,-3,-459,102
1,1418,1400,18,-8,46,89
1,1576,1500,76,3,310,103
1,1715,1441,274,1,-18,67
1,1373,1623,-250,-8,-142,57
-1,1327,1492,-165,-6,-568,100
1,1638,1436,202,-1,151,103
1,1758,1558,200,0,10,53
1,2051,2105,-54,0,104,111
-1,1247,1248,-1,-5,-277,66
1,1649,1485,164,1,19,55
1,1698,1768,-70,-9,163,111
1,1754,1711,43,-2,-158,91
1,1481,1343,138,6,277,89
1,1763,1489,274,1,-1,69
1,1506,1665,-159,1,27,67
1,1547,1500,47,4,140,57
1,1565,1367,198,1,574,101
1,1199,1103,96,2,557,99
1,1873,1565,308,3,79,55
1,1778,1768,10,3,461,123
1,1701,1764,-63,-1,47,91
-1,2124,2038,86,-2,-283,88
-1,1864,1843,21,-1,-207,94
-1,1692,1774,-82,2,184,70
0,1749,1719,30,1,55,133
1,1632,1676,-44,4,440,111
1,1951,1568,383,-2,432,91
-1,1808,1966,-158,0,-48,66
-1,2016,1931,85,0,-2,46
-1,1541,1852,-311,-1,-65,60
1,1460,1385,75,1,130,73
-1,2089,2064,25,-4,-300,80
-1,1614,1860,-246,-1,51,52
-1,1211,1317,-106,0,10,66
1,1555,1578,-23,3,54,47
1,1802,1858,-56,7,95,49
1,1610,1643,-33,11,1839,121
1,1973,1500,473,-1,412,85
-1,1574,1553,21,3,-361,110
-1,1430,1660,-230,0,-110,68
-1,1555,1346,209,-2,-652,108
-1,1435,1771,-336,-1,-82,68
1,1751,1714,37,-5,204,109
0,1802,1768,34,0,-94,117
-1,1562,1877,-315,-6,-213,64
1,1607,1443,164,5,153,51
1,1554,1327,227,4,94,73
-1,2076,2073,3,-3,-16,56
-1,1585,1367,218,0,-170,98
-1,1611,1641,-30,2,-352,80
-1,1704,1761,-57,-1,36,60
1,1269,1324,-55,1,2,47
1,1674,1646,28,-1,-168,79
0,1652,1602,50,14,1273,91
1,1881,1559,322,1,289,176
-1,1706,1760,-54,-4,-131,58
-1,2087,2065,22,0,-72,88
1,1770,1695,75,0,253,95
1,1189,1632,-443,1,459,117
0,1975,1463,512,-1,26,107
-1,1152,1229,-77,0,-18,70
1,1780,1590,190,0,21,63
1,1682,1718,-36,0,10,81
1,1678,1425,253,1,244,99
1,1370,1500,-130,3,238,71
0,1687,1779,-92,0,494,152
1,1545,1541,4,-4,87,125
-1,1336,1490,-154,-3,-725,124
-1,1650,1477,173,-8,-347,66
-1,2072,2073,-1,0,146,96
1,1767,1604,163,0,-4,42
0,1376,1474,-98,-3,-82,132
1,1725,1684,41,0,460,113
1,1600,1479,121,-5,-22,41
1,1596,1382,214,2,28,61
1,1645,1622,23,-3,-28,48
-1,1909,1825,84,-4,-530,90
-1,1776,1690,86,0,87,66
-1,1795,1853,-58,1,30,40
1,1649,1522,127,2,142,67
0,1634,1775,-141,1,131,138
1,1079,1225,-146,2,103,55
1,1546,1505,41,4,92,51
0,1237,1072,165,2,-51,100
1,1280,1306,-26,5,168,51
1,2086,2060,26,0,214,85
-1,1441,1575,-134,2,274,75
-1,1556,1884,-328,0,40,122
-1,1596,1572,24,4,92,58
0,1571,1364,207,-6,-641,123
1,1774,1607,167,0,-8,75
1,1894,1496,398,-6,-407,81
1,1766,1685,81,-2,-67,57
1,1703,1853,-150,0,81,69
1,1638,1500,138,3,324,69
-1,1420,1694,-274,-11,-518,84
1,1977,1495,482,2,47,51
1,1769,1684,85,3,31,75
-1,1683,1528,155,-1,-62,60
-1,1838,2099,-261,-1,-277,112
1,1622,1186,436,0,-24,53
-1,1531,1290,241,1,17,52
-1,1479,1897,-418,0,79,80
1,1325,1225,100,5,151,63
-1,1631,2049,-418,-7,-144,64
-1,1695,1866,-171,0,-5,58
1,1910,1612,298,-3,51,93
-1,1636,1774,-138,-3,-67,48
-1,1624,1825,-201,-17,-480,54
-1,1493,1512,-19,-4,-113,48
-1,1834,1980,-146,0,-96,90
-1,1899,1464,435,6,205,60
1,1192,1353,-161,1,-7,41
1,1887,1552,335,7,100,49
1,2104,1834,270,0,-1,45
1,1608,1472,136,5,185,65
1,1629,1780,-151,0,289,77
1,1734,1655,79,-2,-9,91
1,1751,1639,112,6,153,55
-1,1610,1879,-269,-1,-209,84
-1,1770,1697,73,-1,-88,66
1,1776,1575,201,1,81,75
1,1500,1409,91,0,-42,73
-1,1180,1466,-286,0,41,40
-1,1584,1526,58,-5,-43,56
-1,1586,1481,105,-6,-1183,178
1,1832,1448,384,5,157,45
-1,1688,1543,145,0,-7,60
-1,1629,1761,-132,-3,-78,50
-1,1735,1673,62,0,49,70
1,2051,1594,457,-8,111,81
1,1646,1764,-118,-1,-165,87
1,1763,1182,581,0,-9,103
-1,1744,1793,-49,0,24,100
-1,1394,1537,-143,1,24,84
1,1656,1593,63,1,25,57
-1,1676,2084,-408,0,-15,66
1,1547,1539,8,-2,-16,40
-1,1591,2052,-461,-9,-157,44
1,1894,1797,97,-2,236,73
1,1583,1340,243,0,25,55
1,1662,1749,-87,2,66,49
-1,1484,1543,-59,0,-21,46
1,1918,1855,63,1,100,63
-1,1598,1588,10,2,12,42
1,1680,1646,34,2,85,77
-1,1759,1572,187,3,50,42
1,1384,1434,-50,-5,-31,52
-1,1832,1814,18,-1,-49,60
1,2034,1847,187,1,199,101
-1,1674,1566,108,-1,-43,52
1,1903,1561,342,-3,40,59
1,1528,1423,105,0,47,75
1,1690,1789,-99,0,20,61
-1,1308,1558,-250,-1,-7,58
1,1587,1479,108,1,255,95
1,1805,1644,161,12,681,87
1,1906,1764,142,-2,125,151
1,1500,1330,170,-4,34,55
-1,1621,1750,-129,-2,-89,58
-1,1774,1733,41,0,-23,70
-1,1802,1741,61,3,-5,52
-1,1322,1992,-670,-1,-4,44
-1,1766,1735,31,-2,-377,94
1,1545,1273,272,12,463,55
-1,1598,1588,10,7,129,64
-1,1782,1824,-42,-1,-114,72
-1,1938,1840,98,1,17,94
1,1993,1320,673,-8,-29,41
1,2029,1673,356,1,52,65
1,2041,1840,201,0,0,73
-1,1538,1610,-72,2,-409,140
-1,1757,1914,-157,-1,-2,68
1,1603,1501,102,13,493,53
-1,1830,1774,56,1,-57,90
1,1687,1558,129,0,59,64
1,1630,1557,73,4,100,85
-1,1666,1618,48,-1,-265,124
1,1996,1316,680,2,55,45
1,1393,1441,-48,1,53,89
0,1555,1500,55,0,119,150
1,1833,1921,-88,0,46,55
1,1608,1587,21,-1,-184,83
-1,1671,2032,-361,0,-50,54
1,1614,1611,3,-5,997,175
1,1322,1553,-231,0,481,141
-1,1660,1580,80,2,94,84
1,1747,1745,2,1,327,85
1,1545,1639,-94,3,302,53
1,1591,1401,190,-3,-31,41
-1,1310,1511,-201,-1,-83,58
1,1739,1437,302,3,300,73
-1,1850,1906,-56,4,586,98
1,1675,1500,175,-7,-84,51
-1,1625,1564,61,-6,-51,42
-1,1555,1790,-235,-6,-95,60
1,1282,1324,-42,6,474,85
1,1599,1394,205,-3,-326,95
1,2035,1668,367,2,24,51
1,1839,1916,-77,0,75,73
1,1781,1854,-73,-2,-11,47
-1,1459,1507,-48,-2,-13,56
1,1600,1597,3,-6,-234,57
1,1576,1625,-49,8,411,77
1,1769,1587,182,6,109,51
1,1758,1727,31,-2,-47,41
-1,1317,1445,-128,0,-40,57
1,1612,1659,-47,5,209,63
1,1891,1833,58,0,71,113
1,1801,1746,55,1,11,65
-1,1449,1685,-236,-8,-441,78
-1,1902,1855,47,-1,-142,104
-1,1488,1615,-127,1,38,86
-1,1665,2038,-373,0,-53,72
-1,1611,1823,-212,-2,-455,94
-1,1387,1352,35,0,-22,62
1,1757,1761,-4,1,51,42
1,1422,1630,-208,-1,-40,67
-1,1605,1589,16,-2,-44,70
-1,0,1196,-1196,-15,-728,68
1,1888,1869,19,9,240,45
-1,1829,1605,224,0,201,92
1,1450,1563,-113,4,340,107
1,1469,1397,72,3,129,69
-1,1899,1767,132,-9,-353,52
-1,1584,1651,-67,-16,-442,54
-1,1667,1516,151,0,-41,68
1,1718,1710,8,0,3,51
1,1372,1333,39,-2,41,71
-1,1623,1811,-188,0,-120,64
-1,1771,1704,67,0,-126,128
1,1785,1883,-98,1,-1,55
1,1535,1340,195,-9,138,88
-1,1741,2041,-300,0,-1,70
1,1817,1617,200,1,760,111
1,1626,1333,293,12,223,45
1,1699,1631,68,-3,-137,69
-1,1403,1467,-64,-4,-80,54
-1,1394,1680,-286,-1,-18,44
-1,1712,1663,49,-3,-157,68
1,1359,1410,-51,0,27,61
1,1507,1639,-132,0,177,95
1,1358,1312,46,13,704,75
1,1868,1822,46,-1,-91,105
-1,1768,1516,252,-6,-427,88
-1,1568,1788,-220,-5,-176,52
-1,1478,1439,39,-10,-343,66
-1,1576,1606,-30,6,164,60
0,1388,1097,291,0,-39,107
-1,1695,1931,-236,-1,-103,67
-1,1319,1429,-110,0,-156,98
-1,1646,1624,22,2,31,66
-1,1570,1329,241,-3,-86,44
1,1616,1366,250,8,124,41
-1,1512,1572,-60,2,106,84
-1,1548,1335,213,-3,-131,68
1,1506,1353,153,3,324,81
1,1934,1646,288,4,128,63
-1,1791,2057,-266,-3,-89,54
1,1757,1541,216,3,110,51
-1,1750,1774,-24,4,117,66
-1,1360,1621,-261,4,113,50
-1,1379,1444,-65,1,16,66
1,1761,1435,326,3,427,91
1,1704,1750,-46,3,124,65
1,1644,1526,118,3,274,111
1,1586,1533,53,-2,-34,85
1,1803,1694,109,4,126,58
-1,1188,1625,-437,-7,-976,96
1,1626,1517,109,0,-44,65
-1,1425,1817,-392,-9,-117,50
1,1865,1786,79,-1,-93,67
1,1535,1448,87,1,65,63
-1,1454,1466,-12,0,-26,54
1,1812,1879,-67,0,-211,83
1,1824,1580,244,3,210,75
1,1464,1497,-33,9,701,95
1,1611,1439,172,2,37,59
-1,1716,1900,-184,-3,-325,134
1,1649,1466,183,0,8,45
1,1685,1668,17,6,215,57
-1,1688,1644,44,-5,-170,64
-1,1500,1348,152,2,126,69
1,1587,1556,31,-2,331,121
-1,1497,1466,31,1,70,64
1,1716,1529,187,0,122,79
1,1337,1379,-42,-1,-34,63
-1,1575,1626,-51,-3,-34,46
-1,1906,1709,197,-1,-32,48
1,1876,1497,379,1,74,57
1,1707,1583,124,1,46,49
-1,1518,1631,-113,0,-88,104
-1,1358,1527,-169,2,-19,50
1,1869,1489,380,-1,72,113
-1,1483,1545,-62,-3,-145,66
-1,1684,1588,96,2,17,74
1,1728,1889,-161,0,39,65
1,1494,1878,-384,-1,-48,57
-1,1394,1320,74,-3,-210,64
1,1580,1578,2,3,96,61
1,1483,1229,254,2,789,113
1,1653,1735,-82,0,-144,131
1,1856,1517,339,10,229,45
1,1619,1579,40,1,127,69
1,1540,1235,305,1,42,50
-1,1546,1598,-52,1,104,92
1,1566,1591,-25,9,673,95
1,1679,1351,328,2,98,71
-1,1488,1541,-53,3,262,82
-1,1484,1871,-387,-1,-110,64
-1,1513,1860,-347,0,40,60
1,1525,1666,-141,-4,48,61
1,1955,1799,156,-3,103,89
-1,1738,1876,-138,4,275,80
-1,1457,1584,-127,-7,-251,94
-1,1746,1872,-126,-5,-75,46
1,1637,1528,109,-4,-72,57
-1,1579,1578,1,0,29,100
-1,1492,1604,-112,-1,-86,100
-1,1788,1914,-126,0,-577,112
-1,1267,1539,-272,-10,-218,49
1,1863,1510,353,-3,14,59
1,1562,1633,-71,1,321,81
1,1880,1738,142,1,291,121
1,1722,1523,199,4,276,73
-1,1610,1840,-230,0,-243,93
1,1656,1675,-19,4,702,107
-1,1697,1492,205,4,201,92
1,1884,2060,-176,0,-52,101
1,1544,1606,-62,0,847,231
1,1590,1567,23,2,303,77
1,1615,1440,175,-4,-100,65
-1,1876,1846,30,1,-198,72
-1,1666,1319,347,-2,-11,40
-1,1487,1550,-63,-1,-62,50
1,1478,1313,165,-2,12,49
-1,1619,1579,40,-3,-289,64
-1,1730,1887,-157,1,-256,136
1,1793,1961,-168,2,-86,85
1,1265,1221,44,1,13,55
-1,1675,1522,153,0,-203,66
0,1710,1937,-227,-2,-643,195
1,1559,1600,-41,0,89,89
1,1594,1605,-11,7,411,67
1,1598,1731,-133,-6,-247,67
1,1894,1723,171,0,23,89
1,1651,1496,155,5,145,59
1,1510,1639,-129,-1,-178,83
-1,1144,1679,-535,-1,-491,138
1,1626,1500,126,0,24,75
1,1593,1608,-15,-1,2,71
1,1588,1571,17,13,795,83
1,1713,1557,156,0,91,55
-1,1716,1900,-184,-1,-46,50
-1,1561,1598,-37,-7,-795,104
-1,1503,1500,3,2,-440,114
-1,1543,1572,-29,2,-252,112
-1,1728,1594,134,-4,-106,52
1,1716,1902,-186,1,61,69
1,1646,1594,52,1,34,42
-1,1906,1710,196,0,-314,124
1,1920,1592,328,1,43,59
-1,1571,1667,-96,-1,-129,104
-1,1655,1583,72,2,-382,120
-1,1728,1889,-161,-5,-133,92
-1,1605,1848,-243,-1,-233,94
1,1606,1553,53,2,566,111
1,1557,1588,-31,0,8,125
-1,1562,1517,45,-2,-109,72
1,1658,1629,29,0,74,113
1,1166,1232,-66,-1,94,105
1,1895,1721,174,1,131,59
-1,1732,1632,100,0,14,62
-1,996,0,996,1,-659,116
-1,1573,1642,-69,-3,-214,70
1,1818,1192,626,-2,246,95
-1,1526,1560,-34,-1,-55,50
-1,1457,1929,-472,-4,-21,40
-1,1456,1126,330,-1,-74,70
1,1651,1562,89,1,75,69
1,1476,1626,-150,-1,-23,83
1,1660,1509,151,-10,175,95
-1,1862,1427,435,0,3,42
1,1907,1708,199,0,230,75
1,1646,1649,-3,1,-131,77
-1,1138,1680,-542,-1,-55,60
-1,1715,1902,-187,-4,-50,42
-1,1884,1631,253,-17,-687,62
1,1591,1503,88,0,137,75
1,1470,1611,-141,5,347,75
-1,1659,1857,-198,-9,-150,78
-1,1354,1607,-253,-9,-115,46
-1,1703,1913,-210,0,-276,124
-1,1600,1856,-256,-2,-68,62
1,1450,1411,39,-1,-35,51
-1,1391,1565,-174,-5,-63,44
-1,1340,1484,-144,-5,-367,86
1,1682,1518,164,-2,-60,79
-1,1714,2049,-335,0,-102,100
-1,1654,1480,174,-5,-192,66
1,1596,1374,222,9,616,61
1,1918,1697,221,1,233,83
1,1658,1756,-98,-3,-350,87
-1,1142,1589,-447,-1,-193,70
1,1576,1563,13,0,163,89
1,1951,1786,165,4,171,51
-1,1216,1538,-322,0,-22,54
1,1495,1600,-105,0,77,57
1,1515,1570,-55,6,136,53
-1,1369,1601,-232,3,-207,118
-1,1509,1638,-129,-2,-86,66
1,1611,1349,262,5,373,69
1,1676,1495,181,7,88,57
1,1605,1364,241,8,534,79
1,1831,1770,61,1,76,91
1,2053,1676,377,0,54,96
-1,1556,1672,-116,-2,-184,90
0,1240,1794,-554,-6,-4125,210
1,1645,1497,148,2,215,67
-1,1359,1610,-251,-1,-58,56
-1,1596,1615,-19,1,-275,113
-1,1680,1692,-12,0,7,126
1,1330,1435,-105,-10,-60,41
0,1780,1907,-127,0,0,113
-1,1347,1541,-194,1,-189,118
1,1614,1354,260,7,492,63
1,1511,1681,-170,2,76,47
1,1920,1779,141,0,7,91
1,1485,1652,-167,-1,-30,55
1,1675,1563,112,-1,-49,65
1,1924,1863,61,2,501,115
0,1526,1375,151,0,11,150
-1,1482,1547,-65,0,7,52
-1,1350,1619,-269,-2,-115,70
1,2056,1703,353,1,204,69
1,1669,1612,57,7,187,41
1,1792,1965,-173,0,198,123
1,1585,1437,148,-1,551,119
1,1647,1466,181,-4,-2,47
1,1484,1532,-48,-1,-83,85
-1,1683,1787,-104,-25,-299,44
1,1339,1421,-82,-6,-68,51
-1,1602,1679,-77,-2,-282,75
-1,1344,1615,-271,-4,-448,86
1,1555,1543,12,-4,-3,87
1,1853,1512,341,0,197,73
1,1509,1420,89,6,396,65
1,2059,1741,318,-7,0,49
1,1729,1387,342,2,396,91
-1,1320,1432,-112,3,98,84
-1,1585,1724,-139,-4,-41,118
1,1856,1507,349,1,120,55
1,1173,1228,-55,8,198,103
1,1790,1611,179,-9,-7,69
1,1607,1590,17,2,181,145
1,1414,1450,-36,1,44,85
1,1517,1500,17,0,-13,61
-1,1491,1592,-101,0,-219,118
-1,1503,1859,-356,-1,326,112
1,1378,1327,51,-1,132,81
-1,1472,1500,-28,-5,-10,40
1,1573,1553,20,-1,-24,49
1,1351,1226,125,1,174,60
1,1354,1135,219,-2,-26,48
1,1535,1342,193,8,119,45
-1,1411,1517,-106,-2,-11,54
1,1803,1557,246,-1,208,125
1,1687,1592,95,5,112,53
-1,1776,1911,-135,-1,-36,81
1,1428,1460,-32,0,-3,61
-1,1296,1522,-226,0,32,68
-1,1498,1862,-364,-6,-689,138
1,1866,1636,230,-3,-11,59
1,1945,1884,61,-2,93,59
0,1783,1332,451,6,294,76
-1,1631,1871,-240,0,41,64
-1,1696,2164,-468,0,-16,54
1,1484,1603,-119,-1,-17,49
-1,1914,1809,105,0,-155,150
-1,0,978,-978,-2,-425,74
-1,1791,1702,89,0,-65,56
-1,1540,1543,-3,0,51,88
-1,1943,1958,-15,-2,-38,50
0,1501,1588,-87,-2,1037,233
1,1525,1403,122,-3,-101,63
-1,1015,1358,-343,-15,-779,72
1,2063,2003,60,0,34,81
-1,1427,1485,-58,-4,-42,56
-1,1627,1759,-132,0,39,78
1,1694,1649,45,0,-3,93
-1,1335,1491,-156,-5,-267,80
-1,1494,1587,-93,-6,-479,96
1,1761,1557,204,1,25,41
1,2075,1654,421,-1,91,59
-1,1874,1955,-81,1,25,46
-1,1592,1607,-15,-3,9,116
1,1729,1311,418,-1,335,141
1,1766,1619,147,0,-30,63
-1,1733,1955,-222,0,14,62
1,1824,1500,324,5,94,45
0,1600,1714,-114,-1,-51,130
1,1578,1634,-56,0,28,53
1,1684,1606,78,-5,-265,69
1,1316,1263,53,6,529,59
1,1507,1352,155,2,67,53
-1,1612,1773,-161,-3,-414,90
-1,1504,1585,-81,2,74,42
-1,1481,1584,-103,-12,-1088,86
-1,1716,1843,-127,-1,48,104
0,1255,1527,-272,1,-27,103
1,1494,1594,-100,-2,-28,47
-1,1465,1473,-8,-1,-78,114
1,1766,1551,215,1,188,90
1,1344,1260,84,-1,-234,80
1,1379,1326,53,1,528,115
-1,1422,1636,-214,1,1,56
1,1644,1593,51,9,449,71
1,1655,1761,-106,1,-220,143
1,1510,1580,-70,-1,39,45
1,1850,1552,298,1,76,59
-1,1779,1606,173,0,-19,78
-1,1253,1504,-251,-14,-1161,88
-1,1396,1532,-136,-1,-34,54
1,1438,1426,12,0,4,40
-1,1736,1878,-142,0,-55,60
-1,1243,1250,-7,-10,-1883,186
-1,1514,1576,-62,5,148,50
1,1592,1469,123,-1,90,48
-1,1326,1499,-173,-5,-475,134
-1,1796,1663,133,-5,6,128
1,1504,1585,-81,-6,-87,41
0,1711,1581,130,-1,-26,67
-1,1641,1554,87,0,-46,46
-1,1098,1417,-319,-9,-59,44
1,1878,1903,-25,0,-18,65
1,1639,1538,101,0,481,87
-1,1458,1623,-165,0,20,128
-1,1529,1408,121,1,33,60
1,1532,1559,-27,5,749,123
-1,1611,1718,-107,0,-25,60
1,1497,1608,-111,2,78,71
-1,1356,1389,-33,-3,-179,61
1,1662,1441,221,10,374,61
1,1763,1547,216,3,31,45
1,1772,1558,214,0,178,105
-1,1828,1715,113,-3,-20,46
-1,1292,1501,-209,-2,-156,72
-1,1591,1500,91,0,132,94
1,1441,1635,-194,-8,152,83
1,1500,1302,198,1,110,71
-1,1454,1621,-167,0,-32,66
1,1548,1542,6,7,-28,45
1,2077,1768,309,1,173,137
1,1524,1185,339,4,161,57
1,1822,1091,731,0,28,41
1,1521,1388,133,4,317,79
-1,1892,1891,1,-1,46,86
-1,1218,1457,-239,-9,-298,52
1,1308,1449,-141,1,-8,57
-1,1515,1297,218,2,166,60
-1,1680,1924,-244,-1,-43,56
1,1918,1613,305,1,15,63
1,1560,1537,23,-1,36,77
1,1709,1699,10,-5,-17,195
-1,1669,1591,78,1,22,48
-1,1432,1622,-190,-2,-71,56
-1,1399,1506,-107,-7,-517,78
1,1765,1603,162,0,45,91
1,1420,1383,37,-6,-68,55
1,1527,1570,-43,1,642,121
1,1864,1823,41,0,22,65
1,1527,1780,-253,-2,426,97
-1,1462,1468,-6,1,18,54
1,1302,1309,-7,5,399,97
-1,1558,1539,19,-2,-407,82
1,1648,1548,100,0,278,103
-1,1854,1840,14,0,-12,140
1,1867,1315,552,3,48,67
-1,1881,1963,-82,0,9,52
1,1582,1623,-41,1,108,85
-1,1535,1561,-26,-4,-88,54
1,1250,1213,37,5,141,131
-1,1592,1535,57,0,-375,124
-1,1484,1336,148,5,76,54
1,1407,1814,-407,10,212,49
1,1675,1425,250,1,37,83
-1,1497,1370,127,0,-39,136
1,1306,1425,-119,5,98,47
-1,1230,1604,-374,0,6,44
1,1969,1610,359,-2,-53,55
-1,1620,1531,89,-8,-96,44
1,1533,1720,-187,1,60,79
-1,1219,1399,-180,-1,-18,56
1,1451,1598,-147,3,68,75
-1,1447,1617,-170,0,-26,66
1,0,1196,-1196,-2,18,51
1,1451,1289,162,6,224,57
1,1606,1545,61,0,-210,65
1,1654,1466,188,-1,35,43
-1,1500,1515,-15,3,96,82
1,1777,1698,79,-7,-207,103
-1,1927,1872,55,0,-12,54
1,1903,1938,-35,2,111,101
0,1623,1625,-2,9,795,103
-1,1364,1431,-67,-2,-52,56
1,1625,1761,-136,2,45,71
1,2166,2003,163,-1,155,95
-1,1474,1472,2,-3,-130,52
-1,1546,1645,-99,3,87,74
-1,1844,2015,-171,0,120,92
-1,1597,1799,-202,-2,-32,44
-1,1748,1540,208,-2,-330,126
1,1623,1625,-2,7,97,41
1,1811,1638,173,-1,-29,59
1,1709,1477,232,0,-39,51
-1,1603,1500,103,5,233,52
0,1812,1887,-75,-2,57,97
-1,1615,1614,1,-3,243,108
1,1600,1320,280,3,121,67
-1,1730,1819,-89,-1,-132,88
-1,1609,1607,2,-3,-137,94
1,1464,1714,-250,1,35,47
1,1744,1564,180,-3,-88,81
1,1724,1720,4,0,259,149
1,1522,1419,103,-2,450,85
1,1625,1604,21,2,96,85
-1,1606,1766,-160,-2,-177,72
1,1314,1875,-561,4,-21,43
1,1441,1628,-187,-1,-42,54
1,2120,1654,466,9,245,57
1,1696,1509,187,2,57,45
-1,1314,1514,-200,-2,-194,100
1,1680,1509,171,6,394,85
-1,1276,1539,-263,-11,-502,83
-1,1595,1764,-169,-3,-124,132
-1,1579,1775,-196,1,13,48
-1,1496,1702,-206,4,433,66
1,1402,1473,-71,-2,-74,67
1,1630,1651,-21,-1,-44,59
-1,1562,1590,-28,0,-143,66
1,1547,1419,128,0,240,67
-1,1581,1782,-201,-10,-113,46
1,1355,1354,1,0,36,69
1,1635,1553,82,2,80,65
-1,1636,1593,43,0,22,78
1,1689,1048,641,-5,75,81
1,1972,1885,87,-2,-143,105
-1,1789,1731,58,-1,-84,104
1,1704,1337,367,0,-6,55
0,1520,1652,-132,-3,-255,110
-1,1674,1707,-33,-10,-451,72
-1,1394,1530,-136,0,-214,98
1,1440,1600,-160,7,279,53
1,1818,1710,108,7,467,85
1,1606,1623,-17,1,-28,95
-1,1708,1483,225,0,83,68
-1,1773,1575,198,0,144,70
1,1522,1690,-168,6,237,65
-1,1935,1980,-45,3,120,44
1,1482,1412,70,1,133,90
-1,1271,1198,73,-1,-17,50
1,1483,1564,-81,1,95,85
1,1555,1445,110,2,95,59
1,1669,1856,-187,0,48,59
0,1778,1703,75,0,-14,184
-1,1477,1500,-23,-3,-38,52
1,1542,1594,-52,1,105,71
1,1673,1556,117,-1,332,81
-1,1709,1737,-28,-1,-71,62
1,1539,1552,-13,2,76,61
1,1815,1135,680,1,6,51
1,1413,1399,14,1,94,57
1,1544,1609,-65,0,88,75
-1,1747,1643,104,0,-17,74
1,1469,1807,-338,-2,-124,77
-1,1612,1692,-80,0,-17,46
1,1664,1302,362,0,-3,69
-1,1914,1808,106,-1,-68,50
1,1603,1474,129,3,115,54
1,1549,1524,25,1,79,75
1,1606,1623,-17,1,144,81
-1,1540,1681,-141,-1,-31,50
-1,1914,1670,244,-4,-68,48
1,1744,1699,45,-4,85,119
1,1611,1617,-6,-3,-429,85
1,1774,1317,457,-2,25,53
1,1785,1361,424,-4,-168,107
1,1537,1373,164,1,159,75
1,1660,1165,495,0,-251,196
-1,1688,1527,161,-3,-97,54
-1,1588,1623,-35,0,-91,90
-1,1452,1578,-126,0,61,50
-1,1134,1687,-553,-5,-188,72
1,1884,2165,-281,1,24,55
-1,1815,1598,217,0,18,50
1,1509,1218,291,0,83,67
1,1490,1592,-102,-1,132,77
1,1366,1212,154,3,77,79
1,1611,1618,-7,-3,55,77
1,1513,1720,-207,1,389,107
0,1608,1380,228,-2,27,131
-1,1697,1645,52,-4,-57,82
1,1840,1400,440,3,235,65
1,1480,1433,47,4,162,49
1,1395,1256,139,16,253,43
1,1688,1692,-4,-1,-4,49
1,1774,1729,45,2,41,45
1,1540,1619,-79,2,48,51
-1,1907,1990,-83,-2,-82,62
1,1607,1622,-15,-4,313,75
1,1452,1446,6,5,213,65
1,1678,1289,389,8,584,69
-1,1308,1721,-413,-4,-266,66
1,1582,1556,26,1,346,84
1,1578,1536,42,-9,0,51
-1,1334,1723,-389,0,-42,86
1,1574,1504,70,0,13,65
1,1749,1699,50,3,89,55
1,1911,1398,513,6,209,63
1,1506,1362,144,-8,-453,89
-1,1500,1434,66,-1,-156,128
-1,1491,1691,-200,-1,-5,50
1,1529,1558,-29,-5,322,111
1,1637,1796,-159,-1,-44,105
0,1588,1526,62,2,223,150
1,1512,1011,501,11,1124,97
-1,1303,1456,-153,-5,-92,48
1,1548,1554,-6,0,139,68
1,1628,1600,28,8,354,63
1,1354,1360,-6,-3,1,55
1,1598,1636,-38,2,46,51
1,1467,1610,-143,-2,134,61
-1,1513,1472,41,1,32,70
0,1644,1639,5,0,-8,96
1,1774,2148,-374,0,68,69
1,1839,1685,154,-1,41,69
-1,1829,1688,141,-2,-24,48
1,1601,1424,177,1,38,73
1,1672,1720,-48,0,-29,85
1,1586,1528,58,7,316,77
-1,1506,1650,-144,-6,-572,106
1,1495,1584,-89,-13,-192,43
-1,1457,1417,40,0,5,58
-1,1306,1703,-397,-2,-248,84
-1,1355,1543,-188,0,-17,44
-1,1611,1618,-7,-13,-470,56
0,1827,1611,216,2,227,75
1,1787,1273,514,5,133,49
1,1631,1638,-7,1,199,101
-1,1896,1998,-102,-1,-70,78
1,1595,1348,247,-4,-97,59
1,1485,1430,55,-1,3,43
-1,1707,1845,-138,0,3,100
-1,1500,1525,-25,-2,92,52
1,1727,1574,153,0,59,91
1,1707,1684,23,-2,189,111
-1,1404,1350,54,0,-8,58
-1,1543,1560,-17,0,25,82
-1,1763,1760,3,-2,-101,78
0,1629,1706,-77,-1,-293,123
1,1586,1420,166,1,141,57
-1,1489,1580,-91,0,12,62
-1,1668,1535,133,-13,-266,40
-1,1303,1376,-73,2,143,84
-1,1590,1847,-257,-3,-107,54
-1,1600,1547,53,1,12,52
1,1633,1545,88,1,158,67
1,1842,1575,267,12,229,45
1,1568,1509,59,-6,-178,55
1,1693,1631,62,2,52,85
1,1463,1545,-82,2,815,139
1,1789,1274,515,13,495,67
1,1480,1587,-107,-1,16,83
1,1698,1621,77,0,32,87
-1,1395,1913,-518,-1,-55,58
1,1704,1689,15,1,237,115
-1,1674,1718,-44,-1,-230,102
1,1970,1538,432,0,160,63
-1,1934,1786,148,0,-185,128
1,1775,1832,-57,1,247,93
-1,1608,1887,-279,1,-70,106
-1,1810,2098,-288,-10,-38,46
-1,1591,1480,111,5,73,56
-1,1758,1742,16,-4,-111,56
1,1824,1663,161,0,-3,41
1,1456,1406,50,0,32,53
1,1866,1781,85,-1,-250,87
-1,1454,1534,-80,7,227,54
1,1803,1919,-116,-2,37,73
1,1757,1468,289,-8,-135,67
-1,1671,1648,23,0,-5,44
-1,1988,2103,-115,0,-5,82
-1,1485,1536,-51,-1,-36,66
1,1908,1919,-11,1,58,133
-1,1738,1561,177,3,-45,90
-1,1398,1432,-34,-6,-16,120
1,1690,1622,68,-1,28,61
-1,1536,1979,-443,-4,-210,76
0,1973,1819,154,-1,-70,80
1,1977,1818,159,0,15,47
1,1469,1207,262,10,398,61
-1,1788,1712,76,3,167,90
0,1255,1318,-63,-10,-215,79
-1,1469,1759,-290,-3,-221,96
1,1833,1576,257,0,69,67
1,1607,1629,-22,-1,-29,45
1,1311,1222,89,6,201,49
1,1500,1500,0,10,216,45
1,1117,1500,-383,2,71,55
1,1675,1492,183,9,198,61
1,1598,1379,219,4,264,68
-1,1201,1486,-285,0,-3,56
0,1406,1176,230,3,628,103
-1,1543,1464,79,-3,-162,62
1,1597,1713,-116,3,145,65
1,1662,1897,-235,-11,-131,63
-1,1837,1650,187,0,16,74
1,1908,1918,-10,-1,-15,81
1,1395,1247,148,-1,336,117
-1,2030,1769,261,1,16,42
-1,1663,2127,-464,0,-51,68
1,1641,1657,-16,0,22,87
-1,1458,1767,-309,-2,-322,118
-1,1208,1350,-142,0,-277,122
1,1465,1469,-4,-3,37,63
1,1617,1656,-39,1,51,87
1,1543,1445,98,0,73,75
1,1478,1530,-52,5,33,49
1,1375,1226,149,0,86,59
-1,1358,1154,204,1,-74,64
1,1891,1820,71,0,123,97
-1,1661,2129,-468,-1,61,88
-1,1980,1883,97,0,-37,88
-1,1366,1674,-308,-11,-420,60
-1,1847,1679,168,1,-15,68
1,1915,1825,90,1,22,51
-1,1397,1500,-103,-1,-52,62
1,1733,1618,115,-3,-190,83
1,1400,1295,105,3,401,89
1,1919,1969,-50,0,0,43
1,1571,1528,43,1,194,123
-1,1908,1780,128,0,51,78
1,1690,1653,37,-3,6,57
-1,1115,1234,-119,-10,-925,126
1,1635,1704,-69,5,161,55
1,1517,1491,26,0,688,87
-1,1783,1765,18,-4,-717,86
-1,1410,1766,-356,-1,-150,132
-1,1533,1406,127,0,-1,58
0,1555,1659,-104,-3,-112,60
1,1877,1681,196,7,132,55
1,1464,1256,208,11,722,67
-1,1566,1388,178,-2,-30,46
-1,1897,2131,-234,5,192,66
-1,1686,1803,-117,8,312,58
-1,2137,1892,245,1,17,48
-1,1590,1660,-70,0,-87,152
1,1554,1466,88,1,138,80
-1,1910,2115,-205,-2,-118,82
0,1679,1825,-146,0,443,175
-1,1650,1480,170,0,14,114
-1,1047,1133,-86,2,-97,90
1,1265,1217,48,3,316,91
1,1811,1597,214,1,330,119
-1,1675,1883,-208,0,-156,74
-1,1357,1199,158,-1,50,96
1,1409,1286,123,0,22,43
1,1361,1344,17,7,194,57
1,1705,1748,-43,0,31,99
1,1683,1813,-130,6,425,77
1,2122,1962,160,1,230,73
-1,1059,1410,-351,0,-38,144
1,1541,1668,-127,-2,93,63
1,1470,1243,227,2,669,153
-1,1811,1900,-89,-7,-25,40
-1,1770,1455,315,-1,-102,66
1,1713,1827,-114,1,103,63
1,1697,1816,-119,3,209,77
1,1592,1515,77,-1,-57,69
-1,1480,1645,-165,-1,-25,47
1,1656,1558,98,1,81,54
1,1954,2129,-175,-2,-30,67
1,1342,1316,26,3,107,49
-1,1647,1844,-197,0,-121,124
-1,1630,1882,-252,0,-4,90
1,1677,1362,315,9,465,77
1,1613,1308,305,11,699,67
-1,1816,1924,-108,-1,-52,76
-1,1669,1738,-69,1,16,60
1,1511,1215,296,-3,-88,61
-1,1612,1620,-8,0,-82,90
1,2110,1974,136,0,15,73
-1,1747,1518,229,-8,-334,74
-1,1759,1660,99,-6,-369,76
1,2023,1935,88,1,162,81
1,1765,1088,677,-3,-1,47
-1,1304,1628,-324,-5,-105,74
-1,1674,1728,-54,-2,-119,90
-1,1713,1617,96,1,-247,100
-1,1636,1498,138,1,-37,110
-1,1459,1406,53,1,-84,64
1,1600,1442,158,-1,-59,61
-1,1747,1665,82,-2,-457,124
1,1792,1827,-35,2,81,77
-1,1966,2118,-152,-2,-140,60
1,1749,1792,-43,4,258,59
1,1396,1523,-127,-1,-143,81
1,1889,1921,-32,0,20,49
1,1490,1473,17,1,763,103
1,1390,1549,-159,0,43,75
1,1736,1766,-30,1,7,64
1,1641,1300,341,10,414,81
1,1557,1580,-23,-3,-80,59
1,1684,1648,36,-2,3,89
0,1341,1199,142,3,269,154
-1,1233,1475,-242,-7,-263,52
-1,1476,1457,19,-3,-239,142
1,1427,1276,151,6,87,45
-1,1919,2200,-281,0,-48,64
-1,1457,1720,-263,-2,-74,70
-1,1536,1539,-3,-3,-240,70
1,1958,2126,-168,0,10,43
-1,1436,1503,-67,-4,-113,62
1,1736,1550,186,2,82,63
1,2108,1828,280,0,1039,123
1,1279,1467,-188,-5,-190,85
-1,1607,1528,79,-11,-91,40
1,1680,1705,-25,1,46,65
1,2209,1915,294,0,12,55
1,1977,1853,124,-3,-75,83
-1,1730,1949,-219,0,83,96
-1,1824,2112,-288,-7,-827,110
1,1250,1500,-250,6,222,59
-1,1663,1293,370,4,311,68
-1,1484,1781,-297,-2,-301,116
-1,1542,1592,-50,-5,-448,124
1,1569,1552,17,3,157,121
1,1723,1570,153,1,168,117
1,1994,2073,-79,0,241,119
1,1774,1769,5,0,128,107
1,1351,1292,59,2,288,139
1,2116,1820,296,0,269,131
-1,1406,1729,-323,0,-209,76
-1,1462,1501,-39,1,5,56
-1,1728,1188,540,-15,-292,48
-1,1042,1568,-526,-1,-223,142
0,1625,1603,22,0,-87,123
-1,1318,1691,-373,-1,22,56
1,1434,1500,-66,-2,-15,59
1,1987,1228,759,4,127,57
-1,1762,1721,41,0,-35,66
-1,1382,1358,24,-8,-113,48
-1,1602,1532,70,0,-23,54
-1,1712,1696,16,-1,179,46
-1,1817,2120,-303,1,-12,64
-1,1142,1258,-116,-4,-349,68
1,2124,1813,311,2,138,59
-1,1474,1987,-513,-5,-305,64
-1,1545,1588,-43,-3,-216,60
1,1718,1701,17,1,30,57
-1,1401,1457,-56,1,50,54
1,1725,1815,-90,0,-42,107
1,1797,1581,216,-1,277,120
-1,1839,1845,-6,0,5,78
-1,1809,2128,-319,0,-122,70
-1,1343,1442,-99,1,53,70
1,1989,1472,517,3,92,55
1,1620,1674,-54,-1,-99,69
1,1422,1510,-88,4,344,124
1,1747,1900,-153,-1,-28,47
1,1690,1736,-46,6,678,89
0,1744,1779,-35,0,90,106
1,2132,1806,326,1,213,93
0,1598,1536,62,0,-63,120
-1,1490,1522,-32,-1,-120,92
1,1631,1601,30,0,17,49
-1,1338,1562,-224,0,-42,68
-1,1471,1508,-37,5,-8,40
1,1757,1500,257,4,467,127
1,1579,1481,98,0,-26,47
-1,1715,1676,39,3,133,88
-1,1236,1567,-331,-3,-97,68
1,1803,1659,144,-5,-556,95
1,1933,1604,329,1,13,57
1,1547,1365,182,2,214,61
1,1806,1699,107,-1,48,63
-1,1647,1093,554,-3,-87,84
1,1537,1596,-59,-1,147,125
1,1266,1132,134,4,489,83
1,1519,1462,57,5,546,89
0,1739,1802,-63,-2,-604,170
1,1793,1668,125,0,112,99
1,1627,1333,294,7,188,57
1,1804,1743,61,0,57,103
1,1467,1178,289,7,88,43
1,1749,1755,-6,0,451,167
1,1443,1457,-14,-1,-20,41
-1,1661,1801,-140,-5,-418,96
1,1419,1787,-368,0,17,53
0,1678,1591,87,0,-147,87
1,1927,1843,84,-2,-12,65
1,1597,1447,150,-11,-323,61
0,1583,1550,33,-2,-33,48
1,1505,1535,-30,5,609,123
1,1500,1528,-28,0,364,89
-1,1745,1828,-83,-1,-47,78
0,1399,1505,-106,-3,-85,97
-1,1491,1332,159,1,-206,82
1,1762,1179,583,3,136,49
1,1437,1604,-167,4,76,43
-1,1332,1466,-134,-12,-760,84
1,1672,1631,41,0,333,97
1,1461,1562,-101,0,15,101
-1,1604,1625,-21,0,-44,124
1,1594,1675,-81,0,-7,91
-1,1592,1541,51,-2,-236,106
1,1588,1461,127,1,19,57
1,1465,1563,-98,5,226,67
-1,1662,1500,162,0,14,58
1,1373,1520,-147,-1,-21,85
1,1811,1634,177,-1,96,89
-1,1402,1330,72,-6,-233,56
1,1741,1800,-59,0,59,71
1,1570,1730,-160,1,-1,51
-1,1358,1554,-196,-2,-378,88
1,1699,1591,108,4,20,43
-1,1567,1323,244,1,-102,106
1,1595,1443,152,0,-43,71
-1,1662,1608,54,0,128,96
1,1639,1514,125,-7,279,89
1,1423,1602,-179,-1,340,107
-1,1260,1454,-194,-2,-186,66
1,1554,1579,-25,1,-182,117
-1,1803,1523,280,-1,-260,74
-1,1530,1434,96,2,69,48
-1,1734,1837,-103,-1,-110,82
1,1402,1233,169,6,275,57
1,2223,1549,674,0,-30,57
-1,1704,1988,-284,-3,-133,114
1,1521,1500,21,1,-98,113
-1,1534,1649,-115,1,-52,54
1,1567,1565,2,-9,-38,65
-1,1226,1409,-183,-2,-42,42
-1,1721,1500,221,-3,-513,150
1,1664,2002,-338,5,77,47
-1,1549,2224,-675,0,-115,84
-1,1502,1402,100,1,-317,150
-1,1173,1471,-298,-12,-228,42
1,1455,1178,277,8,199,45
1,1676,1656,20,1,27,43
1,1628,1817,-189,4,54,49
1,1844,1726,118,4,145,55
-1,1591,1808,-217,-2,-599,110
1,1600,1472,128,2,231,97
1,1325,1473,-148,-4,-333,101
1,1401,1485,-84,4,209,91
1,1608,1500,108,4,292,113
-1,1560,1563,-3,-4,-169,48
1,1589,1545,44,-1,-78,61
-1,1573,1784,-211,0,-230,100
-1,1455,1379,76,-2,-72,58
-1,1739,1646,93,2,64,86
1,2225,1512,713,4,190,61
-1,1586,1814,-228,-1,-6,78
1,1376,1274,102,0,18,69
-1,1586,1713,-127,-5,-145,84
1,1800,1644,156,-1,359,81
1,1660,1535,125,0,166,87
-1,1479,1469,10,-3,-89,64
-1,1736,1824,-88,0,-34,70
0,1550,1757,-207,-4,-131,52
1,1781,1718,63,2,86,77
-1,1631,1725,-94,-9,-711,94
-1,1455,1592,-137,-1,-94,72
1,1665,1494,171,5,211,61
1,1581,1652,-71,2,50,61
-1,1556,1608,-52,-1,-96,68
-1,1441,1289,152,2,41,54
-1,1742,1426,316,3,84,80
-1,1597,1879,-282,0,-85,66
1,1912,1568,344,0,62,65
1,1623,1734,-111,-1,-13,53
1,1607,1726,-119,0,-23,85
-1,1460,1390,70,1,21,44
0,1728,1856,-128,-6,32,95
-1,1405,1592,-187,-1,-132,74
1,1789,1559,230,1,120,79
1,1754,1635,119,0,7,45
1,1638,1807,-169,1,18,45
1,1309,1456,-147,5,86,41
1,1474,1168,306,4,244,59
1,1581,1599,-18,4,183,105
1,1637,1719,-82,0,22,49
-1,1403,1547,-144,0,-25,58
-1,1485,1470,15,-5,-149,64
-1,1600,1448,152,-3,-48,54
-1,1536,1658,-122,-1,-18,68
-1,1579,1536,43,-1,-110,64
1,1733,1583,150,5,102,43
1,1705,1548,157,-3,29,55
-1,1790,1654,136,7,178,52
-1,1674,1521,153,2,276,146
-1,1884,1593,291,-1,-70,66
1,1458,1443,15,3,142,73
-1,1612,1861,-249,0,-27,58
0,1650,1712,-62,-2,-4,141
-1,1649,2136,-487,0,-1,54
1,1587,1593,-6,1,621,149
-1,1922,1852,70,-2,-270,98
-1,1522,1673,-151,1,-86,96
1,1917,1732,185,1,16,48
1,1678,1401,277,1,37,43
-1,1309,1186,123,-7,-193,74
-1,1470,1940,-470,-8,-472,72
1,1461,1581,-120,-8,-41,41
-1,1628,1762,-134,0,-5,52
1,1415,1380,35,1,-113,55
1,1565,1587,-22,-9,-388,105
1,1679,1516,163,3,238,95
1,1558,1666,-108,-5,100,103
1,1566,1476,90,-3,-242,73
-1,1414,1517,-103,0,-547,94
1,1794,1488,306,3,227,71
1,1909,1832,77,2,122,67
1,1682,1388,294,-2,2,58
-1,1652,1710,-58,-5,-107,48
-1,1163,1477,-314,0,0,42
-1,1560,1468,92,-2,-37,46
1,1598,1441,157,-2,-244,91
-1,1528,1761,-233,6,168,52
-1,1468,1575,-107,-8,-899,90
-1,1669,1775,-106,-3,-299,80
1,1763,1447,316,1,-46,41
1,1463,1512,-49,8,162,53
1,1577,1527,50,0,118,137
-1,1388,1333,55,-3,-211,58
1,1992,1252,740,-2,-18,45
1,1583,1460,123,18,398,47
-1,1450,1504,-54,2,126,62
1,1643,1692,-49,3,651,135
1,1900,1682,218,1,744,111
0,1652,1585,67,0,83,136
1,1866,2082,-216,0,53,77
1,1917,1826,91,-3,85,63
1,1587,1574,13,0,49,71
0,1726,1711,15,0,-27,113
1,1500,1451,49,1,46,47
1,1396,1353,43,0,49,83
1,1406,1226,180,2,67,53
1,1322,1746,-424,-1,106,81
-1,1500,1252,248,-7,-307,62
1,1513,1437,76,-2,-133,83
-1,1480,1500,-20,-3,-86,48
1,1942,1468,474,0,20,55
1,1476,1555,-79,-5,-111,55
-1,1546,1481,65,0,56,58
0,1719,1679,40,2,210,121
-1,1769,1667,102,1,81,80
1,1686,1731,-45,0,-35,59
-1,1817,1915,-98,-1,-79,53
1,1481,1158,323,-3,46,73
1,1425,1233,192,-4,-100,59
-1,1656,1767,-111,0,-114,81
1,2053,1887,166,4,217,69
-1,1547,1572,-25,0,-23,60
1,1235,1444,-209,-1,21,55
1,1942,2216,-274,-3,-81,67
1,1425,1522,-97,2,99,57
-1,1925,1923,2,-2,-92,84
1,1517,1524,-7,7,51,53
1,1603,1680,-77,5,127,59
1,1469,1417,52,-2,23,55
1,1511,1197,314,-3,-77,51
-1,1648,1785,-137,0,-388,142
1,1487,1708,-221,5,128,55
1,1522,1418,104,-1,-71,55
-1,1559,1667,-108,-5,-28,82
1,1879,1746,133,-2,80,79
1,1650,1583,67,1,129,103
1,1620,1477,143,0,1,43
-1,1536,1438,98,-2,-47,48
1,1508,1444,64,-1,21,63
1,1813,2003,-190,-1,64,89
-1,1565,1586,-21,3,-43,57
1,1357,1423,-66,0,128,143
-1,1419,1529,-110,1,153,124
-1,1474,1576,-102,1,-64,78
1,1723,1403,320,-3,123,75
1,1372,1429,-57,0,46,61
1,1597,1548,49,2,180,75
-1,1830,1981,-151,-1,-63,82
-1,1641,1801,-160,-6,-433,66
-1,1517,1675,-158,-1,-168,78
0,1544,1598,-54,0,18,149
1,1788,1725,63,-3,-41,87
-1,1192,1755,-563,-2,-40,54
1,1479,1464,15,0,-15,59
1,1809,1823,-14,4,301,99
1,1294,1210,84,0,118,87
-1,1593,1443,150,-11,-185,48
1,2137,1823,314,2,119,67
1,1555,1326,229,1,40,111
-1,1618,1635,-17,-1,-20,72
1,1430,1475,-45,-1,21,65
0,1681,1510,171,0,141,127
-1,1540,1620,-80,-4,-153,66
1,1888,1746,142,0,61,91
-1,1821,1335,486,0,-16,68
-1,1698,1540,158,-1,-36,48
-1,1552,1638,-86,1,33,64
1,1119,1105,14,1,588,93
1,1687,1536,151,0,-218,101
1,1690,1812,-122,2,304,95
-1,1543,1534,9,-10,-260,68
1,1568,1401,167,0,-15,51
-1,1690,1607,83,-4,-63,46
-1,1407,1584,-177,-3,-303,92
-1,1416,1513,-97,0,-15,70
-1,1453,1489,-36,10,418,70
1,1412,1480,-68,-1,-12,45
-1,1338,1520,-182,0,50,82
-1,1391,1727,-336,0,10,84
1,1881,1467,414,0,239,103
-1,1391,1489,-98,2,10,60
1,2059,1942,117,0,-4,45
1,1443,1477,-34,2,92,59
-1,1645,1660,-15,0,-479,128
-1,1549,1549,0,0,-38,72
-1,1638,1797,-159,-3,-455,64
1,1944,1494,450,0,231,127
-1,1821,2014,-193,-1,-43,60
-1,1527,1447,80,1,64,56
1,1739,1727,12,1,17,75
1,1531,1526,5,-2,-8,55
-1,1577,1500,77,0,-231,112
1,1734,1896,-162,0,411,133
-1,1547,1500,47,1,-154,77
1,1844,1478,366,2,74,72
1,1784,1756,28,-1,-38,49
0,1719,1716,3,0,-42,65
-1,1711,1702,9,8,46,94
-1,1708,1803,-95,-1,-18,53
1,1568,1515,53,-1,389,141
1,1542,1671,-129,0,78,99
1,1606,1479,127,0,75,53
-1,1154,1484,-330,-2,-85,46
1,1630,1800,-170,0,-3,57
-1,1460,1717,-257,-15,-468,52
-1,1576,1500,76,-1,-32,48
1,1489,1538,-49,3,625,145
1,1557,1683,-126,-2,-101,73
1,1769,1456,313,1,564,109
-1,1578,1697,-119,0,-81,92
-1,1380,1730,-350,3,53,48
1,1560,1654,-94,1,66,59
1,1610,1656,-46,-3,132,105
-1,1539,1692,-153,-5,-205,68
-1,1210,1411,-201,0,-273,81
1,1467,1165,302,0,200,119
0,1556,1452,104,1,395,87
1,1803,1820,-17,11,547,55
1,1538,1303,235,-1,53,65
1,1877,2020,-143,0,15,59
1,1596,1548,48,3,100,59
-1,1809,1894,-85,0,-202,128
-1,1699,1500,199,-5,-12,46
-1,1716,1395,321,1,55,98
1,1522,1607,-85,2,67,99
-1,1766,1613,153,0,-23,70
-1,1548,1804,-256,0,-5,76
-1,1378,1570,-192,-9,-292,70
1,1455,1553,-98,-1,143,123
-1,1539,1644,-105,-1,-26,72
1,1728,1713,15,-1,20,97
-1,1645,1973,-328,0,6,112
-1,2004,1895,109,0,-231,88
-1,1465,1420,45,1,-116,60
-1,1500,1625,-125,-15,-387,50
-1,1434,1631,-197,-8,-460,68
-1,1371,1298,73,-7,-59,42
1,1487,1150,337,0,71,57
-1,1711,1533,178,0,-222,156
-1,1543,1334,209,-5,-218,60
1,1801,1577,224,-6,-83,43
-1,1543,1486,57,0,-24,64
1,1743,1635,108,-4,-201,79
-1,1468,1659,-191,-3,-54,48
-1,1539,1470,69,1,-73,90
1,1703,1652,51,-2,-275,131
-1,1336,1948,-612,1,5,54
-1,1305,1480,-175,1,28,44
1,1639,1718,-79,-1,16,51
0,1754,1628,126,-5,-471,116
1,1572,1567,5,4,189,83
-1,1523,1464,59,-1,-52,66
1,1894,1368,526,0,24,73
1,1453,1335,118,9,121,41
-1,1508,1631,-123,-2,-177,78
-1,1912,1989,-77,-1,-330,92
1,1429,1465,-36,2,130,101
1,1671,1462,209,-5,-45,149
-1,1631,1749,-118,2,47,54
-1,979,1471,-492,1,77,56
1,1763,1785,-22,0,56,115
-1,1759,1624,135,-2,-703,152
-1,1651,1849,-198,-1,-645,122
-1,1668,1581,87,-2,-48,48
-1,1268,1359,-91,9,70,40
-1,1525,1265,260,-1,-358,120
1,1525,1500,25,0,151,107
-1,1638,1739,-101,1,-893,168
1,1550,1583,-33,-4,54,93
1,1503,1487,16,-1,43,61
-1,1413,1530,-117,-2,-55,52
1,1652,1679,-27,1,81,63
1,1191,1415,-224,2,121,99
1,1743,1662,81,0,45,95
1,1735,1594,141,0,74,145
1,1951,1680,271,1,143,83
1,1931,1846,85,-1,45,109
1,1501,1539,-38,2,52,52
1,1646,1622,24,-1,143,153
-1,1761,1627,134,0,-62,90
-1,1582,1647,-65,-7,-699,124
1,1291,1289,2,14,454,69
-1,1935,1778,157,-1,-337,140
-1,1294,1651,-357,0,-82,92
1,1717,1612,105,1,106,107
1,1923,1945,-22,0,17,69
1,1677,1396,281,1,143,77
1,1777,1587,190,-1,-76,125
-1,1795,1824,-29,0,-96,100
-1,1725,1669,56,1,11,48
-1,1566,1597,-31,-1,-20,50
-1,1715,1775,-60,0,4,46
-1,1377,1405,-28,1,-43,88
1,1742,1713,29,1,340,103
1,1630,1601,29,0,97,112
-1,1510,1514,-4,1,-68,82
1,1885,1737,148,-1,13,76
1,1751,1526,225,2,277,163
-1,1726,1625,101,0,-25,62
1,1463,1534,-71,3,403,75
-1,1709,1473,236,-1,-67,66
1,1656,1510,146,5,803,105
1,1719,1435,284,0,74,65
-1,1642,1746,-104,-2,-190,100
1,1691,1767,-76,-1,-20,57
-1,1517,1596,-79,-2,-101,64
1,1668,1511,157,2,155,79
0,1603,1661,-58,-2,40,80
-1,1570,1721,-151,-3,-83,54
-1,1105,1369,-264,0,17,48
-1,1417,1568,-151,3,-197,80
1,1619,1370,249,-1,-102,79
-1,1483,1604,-121,3,229,82
1,1547,1521,26,0,297,105
1,1663,1500,163,-1,9,81
-1,1697,1489,208,2,117,68
1,1731,1762,-31,-4,305,131
1,1346,1468,-122,-1,-173,69
0,1784,1876,-92,0,43,128
1,1701,1472,229,-5,204,97
-1,1589,1484,105,0,-64,170
-1,1754,1705,49,1,78,72
1,1944,1767,177,0,126,117
-1,1505,1575,-70,-6,-580,68
1,1744,1715,29,-5,-55,141
-1,1755,1716,39,-1,-352,114
-1,1751,1500,251,-2,-151,77
-1,1668,1665,3,-15,-305,56
1,1684,1500,184,1,66,65
1,1500,1461,39,-7,13,49
1,1754,1634,120,-3,-12,43
1,1729,1563,166,-1,13,63
-1,1239,1458,-219,-2,-90,112
-1,1756,1706,50,-1,-125,82
1,1282,1584,-302,1,21,75
-1,1399,1789,-390,0,-120,90
1,1604,1624,-20,-2,-87,67
-1,1520,1503,17,0,32,66
1,1588,1501,87,7,161,40
1,1518,1678,-160,-5,-48,71
1,1306,1113,193,8,662,73
-1,1640,1401,239,-2,-30,65
1,1612,1475,137,0,84,73
1,1445,1375,70,-2,31,66
1,1612,1618,-6,-1,170,81
-1,1626,1761,-135,2,71,68
1,1596,1566,30,-4,-83,95
-1,1437,1374,63,-2,-240,70
0,1714,1453,261,-1,-49,116
1,1661,1544,117,0,299,105
-1,1605,1624,-19,-25,-662,52
1,1743,1785,-42,-1,22,95
1,1439,1657,-218,8,385,75
1,1558,1390,168,1,119,75
1,1593,1635,-42,0,76,73
1,1573,1488,85,-2,-71,91
0,1783,1711,72,-1,93,108
1,1605,1657,-52,3,66,63
-1,1544,1749,-205,-2,32,71
-1,1622,1607,15,1,25,60
1,1378,1527,-149,-2,-4,51
-1,1619,1539,80,-11,-165,70
-1,1322,1747,-425,-6,-110,58
-1,1644,1873,-229,-3,-78,52
-1,1669,1704,-35,2,4,49
1,1549,1508,41,2,367,97
1,1473,1619,-146,3,398,75
-1,1236,1250,-14,-3,-40,44
-1,1919,1773,146,7,248,60
-1,1741,1691,50,-1,-533,218
1,1539,1557,-18,3,174,91
1,1501,1454,47,4,15,44
1,1782,1786,-4,-2,2,43
1,1371,1209,162,-2,95,61
-1,1768,1619,149,-1,-149,92
-1,1603,1547,56,-4,-556,98
1,1658,1794,-136,3,55,47
1,1715,1104,611,2,23,49
-1,1532,1669,-137,0,-89,126
-1,1402,1315,87,3,-108,122
1,1563,1734,-171,-6,-64,65
1,1512,1394,118,3,241,65
-1,1569,1618,-49,-2,-85,58
-1,1584,1589,-5,-7,-311,72
1,1627,1536,91,-2,-61,59
1,1788,1904,-116,1,10,59
-1,1664,1706,-42,-2,-190,73
1,1539,1498,41,0,0,55
1,1778,1674,104,0,39,51
-1,1144,1781,-637,0,-245,112
-1,1606,1736,-130,0,-63,70
1,1708,1749,-41,1,37,65
-1,1745,1933,-188,0,14,64
-1,1639,1898,-259,-1,-32,82
-1,1730,1554,176,0,30,110
1,1443,1681,-238,5,228,57
-1,1364,1271,93,1,-56,108
-1,1662,1705,-43,-8,-87,50
-1,1285,1636,-351,-4,-86,94
-1,1102,1716,-614,-2,-93,60
-1,1444,1329,115,-5,-12,61
1,1426,1601,-175,-3,-106,53
1,1689,1749,-60,4,547,115
1,1635,1753,-118,1,413,101
1,1478,1476,2,-6,-245,103
-1,1510,1787,-277,2,-599,106
-1,1666,1553,113,-1,-111,104
-1,1387,1519,-132,0,-206,78
1,1454,1479,-25,5,369,139
-1,1580,1499,81,5,94,60
-1,1583,1555,28,-11,-1276,88
1,1714,1651,63,9,218,53
-1,1545,1551,-6,-4,-90,50
1,1756,1521,235,-1,-66,149
1,1673,1297,376,2,315,95
1,1677,1467,210,1,70,95
1,1716,1101,615,-3,0,49
-1,1663,1632,31,1,-123,130
-1,1846,1785,61,-2,-26,68
1,1571,1514,57,10,335,63
1,1659,1614,45,11,299,49
-1,1545,1602,-57,0,-34,52
1,1476,1397,79,2,29,61
1,1782,1721,61,-2,20,77
-1,1557,1500,57,0,-23,84
1,1580,1505,75,-3,-285,93
1,1704,1561,143,7,315,75
1,1651,1564,87,-4,-78,55
0,1723,1788,-65,0,-160,188
1,1527,1379,148,3,379,71
-1,1570,1776,-206,-7,-428,85
-1,1469,1256,213,-1,343,66
1,1760,1516,244,-2,-13,79
1,1649,1611,38,4,303,105
-1,1566,1407,159,-1,-31,70
1,1640,1312,328,0,125,75
-1,1719,1710,9,-1,-355,122
-1,1496,1590,-94,-9,-444,58
1,1357,1815,-458,6,295,53
-1,1500,1621,-121,-5,-380,74
0,1577,1652,-75,0,-33,62
1,1233,1639,-406,0,428,99
1,1808,1760,48,0,8,66
1,1722,1698,24,-1,-24,43
1,1598,1360,238,0,149,73
1,1705,1460,245,1,103,71
1,1765,1511,254,0,-3,61
-1,1602,1646,-44,-1,-62,82
1,1680,1732,-52,-3,70,97
-1,1711,1792,-81,0,-42,64
-1,1342,1603,-261,0,-155,62
-1,1453,1845,-392,0,4,44
-1,1595,1421,174,-4,-254,66
1,1348,1355,-7,2,286,113
1,1654,1780,-126,-2,11,117
-1,1555,1659,-104,0,-147,112
1,1367,1465,-98,-2,-151,86
1,1798,1834,-36,-1,10,73
-1,1489,1509,-20,1,-12,76
1,1719,1701,18,-5,152,111
-1,1127,1712,-585,-3,-87,46
1,1730,1620,110,-1,-21,85
-1,1802,1817,-15,0,-83,119
-1,1550,1747,-197,3,72,52
-1,1451,1848,-397,-1,-82,48
-1,1367,1612,-245,-1,-28,74
-1,1684,1730,-46,0,6,52
1,1401,1542,-141,0,283,107
-1,1635,1654,-19,0,-116,84
-1,1669,1739,-70,2,-213,114
-1,1201,1276,-75,3,100,72
1,1656,1592,64,3,163,125
-1,1636,1458,178,0,-11,68
1,1514,1353,161,1,151,71
1,1717,1723,-6,-2,1,73
1,1544,1754,-210,2,13,65
-1,1563,1635,-72,1,-13,44
-1,1500,1682,-182,0,7,136
-1,1425,1506,-81,9,196,48
-1,1748,1655,93,0,113,94
-1,1702,1508,194,-1,-36,48
1,1121,1224,-103,1,46,62
-1,1377,1449,-72,-5,-441,80
-1,1490,1955,-465,0,-52,78
-1,1204,1390,-186,1,107,52
-1,1377,1624,-247,-4,-228,74
-1,1959,1704,255,-4,-13,42
1,1547,1713,-166,1,-59,99
-1,1617,1258,359,2,-15,54
0,1801,1551,250,-1,-207,95
1,1850,1449,401,0,129,79
-1,1751,1617,134,-1,-121,106
-1,1394,1486,-92,-1,-12,50
-1,1676,1734,-58,0,-216,88
0,1642,1515,127,-1,-97,186
-1,1536,1478,58,-7,-273,58
1,1730,1513,217,-1,-32,59
1,1683,1173,510,6,403,80
1,1743,1662,81,-2,143,55
1,1725,1716,9,0,-49,95
-1,1383,1287,96,1,594,120
-1,1445,1607,-162,0,-69,58
1,1706,1210,496,-3,73,102
1,1627,1708,-81,-5,-83,63
-1,1209,1360,-151,1,-277,100
-1,1650,1752,-102,6,-108,94
1,1920,1810,110,2,63,53
1,1685,1513,172,0,-6,53
0,1769,1452,317,-2,-383,106
-1,1579,1576,3,-3,-114,68
-1,1897,1700,197,-4,-345,102
1,1562,1525,37,0,74,89
-1,1525,1494,31,-2,-117,70
1,1616,1591,25,9,318,55
-1,1373,1439,-66,-6,-423,82
1,1630,1727,-97,15,213,43
-1,1447,1853,-406,1,82,86
1,1751,1645,106,0,93,75
-1,1638,1537,101,-4,-252,68
1,1694,1948,-254,1,112,61
1,1791,1743,48,0,232,165
-1,1283,1595,-312,-10,-482,84
-1,1076,1387,-311,-20,-214,42
1,1494,1274,220,4,187,57
1,1369,1390,-21,2,291,115
-1,1208,1734,-526,-6,-36,50
-1,1881,1894,-13,-3,-322,134
1,1822,1644,178,0,55,51
0,1368,1235,133,2,-242,155
-1,1270,1569,-299,0,-4,52
1,1713,1581,132,4,485,99
-1,1691,1571,120,0,-95,94
-1,1764,1670,94,1,14,44
-1,1513,1519,-6,-5,-171,56
1,1491,1505,-14,2,36,45
1,1939,1885,54,3,38,41
-1,1792,1828,-36,-1,-62,58
1,1760,1339,421,8,909,85
-1,1567,1597,-30,5,7,80
-1,1705,1736,-31,1,3,54
-1,1908,1873,35,1,14,62
-1,1083,1685,-602,-7,-94,46
-1,1707,1638,69,2,138,116
1,1373,1673,-300,5,128,43
-1,1445,1711,-266,1,-45,48
-1,1645,1825,-180,0,-36,72
-1,1377,1423,-46,-6,-99,44
-1,1570,1728,-158,-3,-170,74
1,1712,1883,-171,0,80,71
1,1568,1592,-24,-5,-43,47
1,1614,1695,-81,0,91,67
1,1686,1171,515,1,211,131
1,1839,1855,-16,4,231,85
1,1530,1223,307,4,86,50
1,1296,1207,89,3,113,59
-1,1528,1733,-205,-1,-113,82
1,1644,1627,17,0,-26,55
1,1479,1503,-24,-1,-89,57
-1,1104,1726,-622,-2,-258,66
0,1500,1500,0,2,83,88
1,1769,1503,266,-3,-61,73
-1,1624,1760,-136,-7,-371,66
1,1652,1694,-42,1,37,43
1,1365,1368,-3,-3,-165,79
1,1596,1441,155,4,305,81
1,1695,1504,191,4,96,41
1,1836,1953,-117,0,61,83
-1,1620,1535,85,-9,-283,70
1,1303,1541,-238,2,98,89
-1,1675,1778,-103,0,-24,62
1,1576,1266,310,2,107,75
1,1588,1433,155,0,2095,161
1,1610,1549,61,1,233,111
-1,1279,1680,-401,-7,-368,64
1,1446,1288,158,3,325,86
-1,1585,1541,44,2,7,44
-1,1614,1557,57,-4,7,48
1,1218,1410,-192,4,178,60
1,1621,1500,121,-1,126,145
1,1117,1500,-383,0,467,95
-1,1396,1787,-391,-3,-8,42
-1,1384,1297,87,-1,-241,68
-1,1219,1541,-322,-11,-252,67
-1,1727,1730,-3,-3,-62,86
-1,1773,1499,274,0,-478,98
-1,1839,1770,69,0,23,66
1,1598,1175,423,10,416,61
1,1627,1846,-219,-1,97,67
0,1638,1446,192,-2,-167,90
-1,1491,1504,-13,-2,-56,46
-1,1332,1369,-37,-2,-64,58
1,1585,1493,92,5,108,48
1,1957,1735,222,0,-81,87
-1,1366,1604,-238,1,-63,125
-1,1620,1695,-75,1,28,58
1,1602,1778,-176,4,182,67
1,1103,1324,-221,10,953,127
-1,1783,1818,-35,-2,-29,42
-1,1434,1736,-302,-10,-195,54
1,1791,1393,398,5,81,43
1,1563,1619,-56,2,53,63
-1,1382,1581,-199,-14,-353,50
-1,1556,1607,-51,-3,-258,78
-1,1816,1833,-17,0,-60,64
-1,1344,1285,59,-3,-48,58
1,1380,1308,72,-1,372,127
1,1531,1379,152,8,208,49
-1,1517,1565,-48,-1,-120,74
1,1497,1569,-72,4,73,61
-1,1162,1739,-577,0,-135,114
1,1522,1140,382,5,107,53
1,1590,1500,90,3,134,71
-1,1876,1781,95,1,-19,100
-1,1825,1796,29,-3,305,108
-1,1778,1963,-185,-2,-78,70
1,1491,1567,-76,-1,-3,43
1,1754,1549,205,6,745,93
1,1433,1337,96,12,107,41
-1,1535,1622,-87,-1,-457,120
1,1851,1665,186,-1,111,61
-1,1797,1741,56,-1,-146,64
1,1732,1583,149,0,2,65
1,1842,1734,108,1,223,113
-1,1772,1808,-36,-4,-32,68
-1,1173,1601,-428,-3,-81,58
0,1627,1525,102,0,33,144
-1,1136,1400,-264,0,-120,86
-1,1509,1566,-57,0,47,98
1,1802,1655,147,2,59,62
1,1369,1464,-95,1,32,43
1,1665,1443,222,10,571,69
1,1372,1288,84,4,135,49
-1,1355,1749,-394,-5,-216,65
-1,1375,1394,-19,1,12,84
-1,1774,1819,-45,0,-121,106
1,1754,1702,52,-3,-89,55
1,1659,1857,-198,0,-331,129
1,1386,1561,-175,-3,141,75
-1,1389,1375,14,-11,-153,50
-1,1627,1773,-146,0,-12,50
1,1576,1367,209,12,568,63
-1,1381,1476,-95,-3,-171,68
1,1590,1371,219,0,231,111
1,1594,1441,153,6,406,77
-1,1704,1762,-58,-3,-146,90
-1,1500,1794,-294,-7,-355,64
1,1703,1696,7,-1,-36,51
1,1760,1508,252,-1,-43,55
-1,1885,2027,-142,0,10,48
-1,1829,1764,65,0,32,134
0,1786,1577,209,2,121,120
-1,1570,1582,-12,-4,-440,90
1,1393,1377,16,4,282,67
-1,1493,1502,-9,-1,-196,74
1,1803,1705,98,2,9,47
-1,1500,1725,-225,1,4,48
1,1822,1697,125,7,295,53
1,1728,1173,555,9,81,41
1,1803,1617,186,1,-65,75
1,1631,1524,107,-1,-28,107
1,1718,1670,48,-1,105,91
1,1500,1500,0,1,73,59
0,1741,1129,612,-7,-125,111
-1,1149,1444,-295,-2,-205,74
0,1351,1450,-99,3,55,90
-1,1690,1899,-209,0,-306,92
-1,1771,2033,-262,0,-65,106
1,1605,1579,26,0,3,65
-1,1556,1792,-236,0,12,76
1,1809,1611,198,2,111,73
-1,1575,1508,67,-1,-16,50
1,1405,1310,95,3,477,125
1,1597,1610,-13,0,252,67
-1,1222,1411,-189,0,-57,48
-1,1503,1683,-180,-4,-94,47
-1,1491,1685,-194,1,24,50
-1,1661,1839,-178,-2,-46,68
-1,1513,1635,-122,-10,-432,88
1,1974,1558,416,-3,-273,93
-1,1606,1979,-373,0,2,84
-1,1651,1783,-132,0,-38,55
1,1815,1691,124,0,-45,73
1,1771,1812,-41,0,1,71
1,1780,1793,-13,4,134,53
1,1605,1583,22,1,6,41
0,1767,1484,283,0,-326,163
-1,1726,1851,-125,-1,-8,44
-1,1702,1573,129,-1,-1,52
1,1823,1683,140,-1,26,57
1,1165,1071,94,4,398,75
-1,1510,1727,-217,-6,-67,40
-1,1352,1723,-371,0,-111,86
1,1869,1740,129,-2,7,69
-1,1660,1807,-147,0,-3,52
-1,1302,1358,-56,-4,-242,92
1,1431,1445,-14,8,345,83
-1,1146,1624,-478,-5,-78,50
1,1830,1676,154,-2,-134,77
1,1639,1616,23,-1,-24,91
1,2043,1823,220,2,469,127
1,1522,1482,40,-1,5,41
1,1430,1590,-160,-2,-144,91
1,1166,1447,-281,1,133,109
-1,1828,2038,-210,-1,-103,74
1,1500,1648,-148,-2,113,55
1,1781,1791,-10,-4,97,107
1,1998,1493,505,6,126,51
0,1784,1517,267,-8,-336,80
-1,1982,2006,-24,-1,-27,56
1,1844,1664,180,1,14,45
1,1859,1718,141,0,203,129
1,1561,1300,261,1,477,81
1,1505,1696,-191,3,633,105
-1,1524,1817,-293,-1,-455,120
-1,1557,1614,-57,1,10,114
1,1445,1274,171,0,401,117
-1,1817,2048,-231,0,-160,94
-1,1615,1731,-116,0,-24,152
1,1242,1925,-683,1,26,76
1,1970,2017,-47,-1,-43,43
-1,1732,1876,-144,-1,-153,72
-1,1403,1603,-200,-4,-122,52
0,1749,1888,-139,2,166,72
-1,1840,2069,-229,0,80,70
-1,1693,1650,43,1,17,64
1,1655,1676,-21,0,372,121
1,1855,1636,219,2,390,87
-1,2008,2145,-137,-1,-134,88
-1,1598,1527,71,0,-354,120
1,1653,1599,54,0,77,81
-1,1620,1496,124,-7,-176,66
-1,1593,1608,-15,-1,-97,136
-1,1695,1984,-289,-5,-110,62
1,1602,1609,-7,-1,24,69
1,1741,1539,202,0,64,65
1,1859,1580,279,0,145,131
-1,1984,2039,-55,0,-136,110
-1,1638,1591,47,1,42,76
1,1988,2052,-64,-3,-122,69
1,1764,1539,225,1,555,143
1,1776,1883,-107,-3,77,69
0,1841,1570,271,3,282,83
0,1688,1537,151,1,72,90
1,1777,1494,283,2,1211,165
1,2002,1868,134,-5,-28,87
-1,1218,1755,-537,-2,-322,72
-1,1649,1524,125,0,88,98
1,1934,1453,481,-1,9,57
1,1523,1640,-117,3,570,104
1,2036,2004,32,-1,-47,83
-1,1608,1535,73,-2,-111,68
-1,1250,1663,-413,0,-134,122
-1,1264,1451,-187,-2,-15,43
1,1662,1337,325,10,1283,129
1,1522,1425,97,9,444,81
1,1576,1797,-221,1,519,133
0,1724,1797,-73,-1,88,109
1,1654,1392,262,2,66,65
1,1674,1663,11,10,117,41
1,1781,1642,139,0,287,103
1,1614,1212,402,6,32,41
1,1624,1539,85,-7,531,161
1,1569,1596,-27,6,272,69
-1,1994,2048,-54,-1,-40,66
-1,1791,1795,-4,3,-179,144
1,1433,1500,-67,7,656,83
-1,1668,1849,-181,-5,-173,94
1,1527,1500,27,1,186,97
1,1820,1806,14,-2,-66,63
1,1483,1510,-27,6,246,53
-1,1936,1445,491,-1,27,92
1,1603,1625,-22,3,19,41
1,1632,1276,356,8,137,43
-1,1861,1788,73,-2,-404,82
0,1792,1788,4,0,36,92
-1,1665,1667,-2,0,-97,79
-1,1358,1489,-131,-2,-375,100
1,1659,1430,229,-4,-155,79
1,1672,1387,285,7,415,75
-1,1750,2005,-255,-1,-93,72
-1,1163,1616,-453,-12,-268,44
1,1638,1362,276,-5,-195,75
0,1837,1884,-47,0,-82,127
1,1531,1825,-294,1,42,129
1,1801,1847,-46,2,174,117
1,1530,1633,-103,1,390,123
-1,1500,1230,270,-1,5,78
1,1564,1333,231,0,156,67
-1,1566,1746,-180,-1,-24,56
1,1613,1544,69,0,-11,153
-1,1581,1144,437,-3,-165,102
1,1833,1813,20,0,50,151
1,1371,1423,-52,2,55,73
-1,1696,2010,-314,-1,-14,54
-1,1665,1635,30,1,35,50
1,1780,1608,172,0,-169,93
-1,1661,1855,-194,-2,-93,56
-1,1613,1867,-254,-1,-32,69
1,1594,1809,-215,3,144,71
1,1759,1589,170,0,205,95
1,1530,1500,30,-6,-271,69
0,1617,1545,72,-9,-903,107
-1,1696,1741,-45,0,-28,66
-1,1706,1667,39,1,43,68
1,1794,1799,-5,0,44,51
-1,1707,1670,37,-7,-267,68
-1,1328,1543,-215,5,138,60
1,1878,1763,115,0,-21,88
-1,1456,1503,-47,-15,-846,76
1,1752,1281,471,0,15,69
1,1536,1572,-36,-1,107,131
1,1814,1827,-13,-2,-12,47
-1,1430,1628,-198,-1,-29,64
-1,1321,1548,-227,5,328,70
-1,1679,1957,-278,-3,-157,78
-1,1522,1761,-239,-2,-345,102
0,1550,1469,81,-4,-119,139
-1,1553,1315,238,-5,-171,54
1,1495,1485,10,-3,-104,135
1,1973,2040,-67,-1,1,63
1,1777,1702,75,0,-92,109
-1,1558,1519,39,0,-54,86
1,1275,978,297,-1,121,53
1,1961,1675,286,3,406,109
1,1857,1618,239,-2,216,105
-1,1119,1353,-234,-8,-812,102
-1,1766,1477,289,0,-27,124
-1,1618,1702,-84,-12,-182,85
-1,1441,1453,-12,-1,-31,49
1,1541,1535,6,9,952,97
1,1779,1578,201,1,228,87
-1,1694,1755,-61,2,-19,94
-1,1633,1676,-43,1,15,50
0,1872,1818,54,-2,100,119
-1,1377,1408,-31,2,40,84
1,1552,1524,28,0,659,91
1,1489,1438,51,5,181,47
1,1560,1548,12,0,63,109
-1,1750,1720,30,-1,-21,76
-1,1503,1500,3,-3,-186,74
-1,1634,1749,-115,-1,-123,122
1,1701,1674,27,-1,77,87
-1,1232,1624,-392,-1,-78,48
1,1653,1554,99,3,123,57
1,1514,1681,-167,0,187,115
1,1431,1711,-280,0,9,51
-1,1688,1928,-240,0,-57,58
-1,1611,1672,-61,1,20,44
-1,1346,1624,-278,-3,10,80
1,1473,1237,236,-2,-46,57
1,1693,1308,385,0,373,101
-1,1687,1500,187,1,44,62
1,1472,1501,-29,14,682,71
1,1392,1544,-152,0,134,89
1,1757,1582,175,0,-27,73
1,1523,1624,-101,-1,-17,119
1,1665,1580,85,1,30,73
-1,1419,1598,-179,-3,-198,86
-1,1786,1714,72,-3,-342,76
1,1628,1229,399,0,93,94
-1,1732,1739,-7,-1,-61,64
-1,1493,1484,9,-1,-11,54
0,2026,1827,199,0,-6,130
-1,1546,1763,-217,-1,-66,66
0,1673,1743,-70,-1,-219,84
1,2141,1965,176,0,12,75
1,1765,1500,265,3,117,105
1,1793,1675,118,1,47,87
-1,1538,1571,-33,-5,-112,52
-1,1741,1502,239,0,9,60
-1,1496,1458,38,0,286,92
-1,1959,1676,283,-1,-38,78
1,1500,1575,-75,1,497,101
1,1863,1829,34,14,285,48
1,1568,1232,336,2,32,45
1,2149,1938,211,0,28,61
1,1695,1305,390,-1,82,55
1,1422,1367,55,3,44,53
0,1933,2155,-222,-1,-574,127
-1,1492,1612,-120,-4,-17,56
-1,1819,1850,-31,0,-397,98
-1,1773,1870,-97,-10,-531,86
1,1534,1236,298,4,110,49
-1,1328,1589,-261,-7,-212,62
1,1505,1470,35,15,756,73
1,1630,1470,160,0,0,45
1,1450,1500,-50,1,270,59
-1,1668,1883,-215,0,10,48
1,1888,1768,120,-1,-85,91
1,2147,1769,378,0,2,77
-1,1483,1228,255,-9,-224,58
1,1512,1417,95,-4,-53,45
-1,1571,1488,83,-5,-153,80
1,1652,1495,157,-2,68,79
-1,1695,1939,-244,-1,-673,130
-1,1461,1515,-54,-9,-357,74
-1,1472,1322,150,-3,-55,44
1,1785,1338,447,6,146,57
1,1485,1535,-50,-1,-30,54
1,1505,1303,202,4,336,81
1,1955,1669,286,0,6,43
-1,1481,1486,-5,-8,-109,62
-1,1650,1727,-77,-1,-35,62
1,1677,1545,132,-1,114,63
1,1944,1690,254,1,-112,103
1,1829,1987,-158,1,263,105
1,1628,1773,-145,0,1,55
1,1295,1327,-32,20,615,55
1,1524,1451,73,1,97,87
-1,1458,1733,-275,-1,-488,104
1,1931,1662,269,0,37,77
1,1500,1766,-266,2,74,69
1,1434,1248,186,1,460,101
-1,1466,1637,-171,1,-17,64
1,2150,1813,337,0,12,53
-1,1685,1949,-264,-1,-277,78
-1,1528,1690,-162,-1,-218,88
1,1435,1445,-10,-1,-3,49
1,1538,1754,-216,1,-6,87
-1,1497,1612,-115,-2,-79,48
1,1526,1473,53,2,96,51
1,1443,1533,-90,16,863,71
-1,1810,2154,-344,-1,-79,84
1,1872,1567,305,2,353,89
1,1498,1500,-2,0,-33,73
1,1959,1791,168,0,-27,61
1,1954,1681,273,11,373,61
-1,1446,1700,-254,-7,-90,53
1,1734,1700,34,0,25,91
-1,1559,1895,-336,0,2,76
1,1556,1562,-6,-8,-377,107
-1,1677,1958,-281,-3,-228,88
1,1466,1528,-62,-3,85,41
1,1756,1547,209,1,5,57
-1,1314,1308,6,-3,-615,128
1,1837,1462,375,3,245,97
1,1541,1296,245,-3,68,63
0,1519,1456,63,3,377,116
1,1579,1471,108,0,140,75
1,1962,1673,289,6,554,69
-1,1527,1335,192,-2,-835,152
1,1741,1454,287,1,231,117
1,1912,1552,360,0,44,107
1,1787,1705,82,10,229,49
1,1533,1731,-198,3,244,93
-1,1354,1551,-197,0,-102,80
-1,1669,1966,-297,0,-222,76
-1,1252,1697,-445,-5,-53,70
1,1649,1489,160,-2,-24,51
-1,1365,1213,152,-10,-253,50
1,1552,1621,-69,2,102,67
1,1458,1517,-59,2,84,57
1,1970,1665,305,1,449,97
1,1500,1325,175,-1,8,41
-1,1301,1620,-319,-3,-148,64
1,1713,1546,167,1,38,87
1,1557,1348,209,3,130,65
1,1500,1927,-427,0,-248,159
1,1508,1341,167,2,106,53
-1,1662,1974,-312,-1,-99,94
1,1764,1542,222,0,126,67
-1,1505,1471,34,-1,-25,64
1,1734,1615,119,2,215,81
1,1402,1190,212,-2,-56,57
-1,1520,1720,-200,0,-48,100
1,1342,1562,-220,0,-172,79
1,1655,1652,3,3,253,73
-1,1790,1533,257,0,179,88
1,1504,1611,-107,3,192,95
1,1934,1698,236,1,75,71
1,1606,1528,78,5,778,101
1,1483,1493,-10,1,71,81
1,1945,1567,378,4,373,71
-1,1408,1459,-51,1,-192,96
1,1320,1365,-45,2,-129,75
1,1575,1679,-104,1,97,71
-1,1468,1866,-398,-5,-116,58
-1,1570,1770,-200,3,20,100
-1,1669,1725,-56,0,11,76
-1,1738,1554,184,-1,-86,82
1,1726,1495,231,2,136,95
0,1563,1762,-199,-1,-66,121
-1,1564,1990,-426,-6,-151,48
1,1648,1668,-20,0,12,61
1,1559,1776,-217,-2,-129,97
-1,1483,1494,-11,-6,-613,110
1,1796,1695,101,-1,-4,43
1,1859,1916,-57,-1,179,95
1,1715,1605,110,3,132,55
-1,1463,1632,-169,-1,-57,66
-1,1219,1342,-123,3,-7,54
0,1514,1521,-7,-2,-18,135
1,1474,1731,-257,1,258,121
1,1637,1667,-30,7,68,45
-1,1971,1953,18,-2,-136,96
-1,1340,1512,-172,-3,-295,94
-1,1758,1593,165,3,58,84
1,1569,1857,-288,-5,-116,73
-1,1703,1905,-202,0,1105,128
1,1859,1965,-106,0,12,67
-1,1504,1472,32,-8,-298,80
1,1414,1398,16,2,104,65
-1,1597,1722,-125,-4,-173,98
1,1955,1878,77,1,571,103
1,1361,1500,-139,3,572,77
1,1583,1658,-75,-2,296,91
-1,1634,1939,-305,-1,-62,92
1,1911,1697,214,0,43,77
1,1870,1665,205,3,124,61
1,1698,1392,306,2,125,47
1,1712,1978,-266,0,-22,75
0,1596,1609,-13,-6,-404,87
-1,1671,1553,118,-2,-667,124
-1,1875,1918,-43,1,16,62
-1,1359,1509,-150,-3,-19,43
1,1717,1335,382,2,44,45
-1,1333,1334,-1,-11,-758,82
-1,1965,1959,6,-4,-150,56
1,1643,1597,46,-3,-711,105
1,1443,1352,91,5,255,69
-1,1692,1916,-224,0,231,92
-1,1460,1467,-7,-5,-158,54
1,1666,1522,144,2,88,45
1,1458,1716,-258,-2,42,57
-1,1935,2157,-222,0,6,78
1,1643,1302,341,6,523,73
1,1682,1500,182,1,375,103
-1,1957,1822,135,0,-5,92
-1,1870,1964,-94,-1,-64,92
-1,1587,1654,-67,-6,-130,42
0,1840,1790,50,0,5,65
1,1947,1676,271,3,92,47
1,1921,1687,234,5,134,63
-1,1349,1207,142,0,3,52
-1,1481,1720,-239,-11,-103,58
1,1894,1903,-9,-1,204,99
0,1889,1733,156,1,-2,113
1,1489,1632,-143,2,28,53
-1,1682,1926,-244,0,36,112
1,1602,1629,-27,-10,-91,77
1,1720,1628,92,11,1084,85
-1,1655,1456,199,0,13,50
1,2170,1951,219,0,323,115
-1,1738,1885,-147,-1,-147,98
-1,1424,1599,-175,0,29,80
-1,1805,1694,111,0,13,76
1,1931,1677,254,-1,-142,77
1,1685,1342,343,6,1455,141
-1,2125,1970,155,1,12,70
-1,1945,2176,-231,-1,-15,50
0,1865,1942,-77,0,-2,143
1,1601,1485,116,5,50,41
1,1730,1891,-161,1,89,75
1,2181,1940,241,0,37,65
-1,1520,1505,15,2,25,58
1,1807,1672,135,0,101,77
-1,1343,1712,-369,2,-467,118
-1,1671,1954,-283,-2,-205,94
-1,1663,1935,-272,3,118,62
-1,1747,1660,87,-4,-134,58
1,1392,1350,42,0,151,59
-1,1475,1881,-406,-4,-180,68
1,1935,2187,-252,0,241,95
-1,1933,1872,61,-5,-43,76
1,1449,1500,-51,4,508,65
-1,1665,1815,-150,-4,-197,70
-1,1744,1742,2,0,-65,96
-1,1608,1469,139,-1,-85,72
1,1740,1123,617,12,142,43
-1,1478,1611,-133,0,-179,84
0,1564,1590,-26,2,355,165
-1,1693,1537,156,1,6,54
-1,1578,1664,-86,-7,-608,76
-1,1298,1646,-348,-3,-48,52
1,1973,1986,-13,5,115,63
1,2165,1955,210,2,23,41
1,1822,1658,164,3,104,55
0,1909,1888,21,-3,39,102
-1,1259,1399,-140,-3,-304,66
-1,1609,1205,404,1,-237,134
-1,1741,1673,68,0,-3,66
1,1569,1488,81,0,-60,91
1,1622,1609,13,2,383,109
-1,1651,1829,-178,-2,-193,68
-1,1535,1521,14,0,34,100
1,1605,1667,-62,6,36,47
1,1827,1581,246,-1,197,126
1,1339,1688,-349,0,31,97
-1,1748,1955,-207,1,-67,96
-1,1500,1669,-169,-2,-100,74
1,1418,1617,-199,4,340,75
1,1890,1908,-18,6,164,49
1,1578,1479,99,1,95,73
1,1961,1742,219,0,-3,103
1,1457,1659,-202,1,78,55
1,1645,1726,-81,-1,244,113
-1,1553,1676,-123,-1,-8,40
-1,1878,1925,-47,-8,-334,114
1,1722,1773,-51,-2,-150,85
1,1418,1505,-87,5,259,71
-1,1661,1210,451,-4,-63,44
-1,1516,1509,7,-1,-56,44
-1,1737,1967,-230,-3,-68,54
-1,1485,1592,-107,-1,-281,90
1,1649,1295,354,-4,577,133
1,1571,1578,-7,5,210,59
-1,1614,1883,-269,-10,-187,53
1,1584,1711,-127,-1,179,85
1,1972,1733,239,-3,-219,111
1,1684,1545,139,0,-33,93
1,1365,1716,-351,3,81,45
1,1392,1567,-175,13,1215,111
-1,1646,2175,-529,-4,-321,99
1,1500,1694,-194,-2,9,55
-1,1576,1832,-256,-2,-123,77
-1,1728,1566,162,0,-25,122
1,1652,1673,-21,-1,-46,55
1,1990,1802,188,-2,-27,41
-1,1728,1978,-250,0,9,60
-1,1472,1884,-412,0,-62,63
1,1554,1835,-281,1,-61,71
1,1586,1699,-113,4,323,77
-1,1898,1774,124,0,-22,74
1,1982,1723,259,-1,56,95
1,1660,1500,160,0,-14,51
-1,1523,1504,19,-3,-123,62
-1,1457,1597,-140,-9,-79,44
-1,1478,1791,-313,0,-401,96
-1,1599,1657,-58,1,0,76
-1,1437,1500,-63,-7,-211,52
-1,1573,1740,-167,0,3,94
-1,1601,1659,-58,-2,-686,94
1,1475,1596,-121,1,154,81
1,1644,1675,-31,3,149,73
1,2176,1683,493,0,26,109
1,1719,1987,-268,2,-77,109
1,1334,1215,119,-1,138,83
-1,1630,1683,-53,0,21,64
0,1601,1477,124,4,529,129
-1,1592,1792,-200,0,-179,66
1,1589,1567,22,0,56,85
1,1451,1330,121,0,288,84
-1,1736,1799,-63,-3,-228,70
-1,1572,1470,102,2,207,104
1,1967,1738,229,0,116,131
-1,1548,1512,36,-7,-541,76
1,1665,1589,76,1,141,89
-1,1681,1463,218,1,124,84
-1,1402,1671,-269,-3,-25,40
-1,1669,1830,-161,0,-74,52
-1,1646,1430,216,2,46,52
-1,1381,1628,-247,-2,-76,52
1,1386,1654,-268,2,20,45
1,2041,1347,694,1,3,43
-1,1360,1691,-331,-2,-467,110
1,1682,1558,124,-1,5,69
1,1586,1207,379,-2,-127,61
-1,1733,1972,-239,-3,-86,58
1,1658,1543,115,-4,163,129
1,1469,1441,28,4,670,109
-1,1481,1662,-181,-2,-292,104
1,1868,1662,206,0,59,61
1,1383,1597,-214,-6,-96,59
1,1292,1652,-360,-5,-37,51
1,1734,1551,183,4,684,99
0,1563,1635,-72,1,181,127
1,1977,1728,249,-1,-183,101
1,1800,1623,177,0,56,95
-1,1444,1443,1,0,-47,108
1,1655,1516,139,-1,112,81
-1,1529,1693,-164,-7,-140,54
1,1524,1544,-20,-1,219,117
-1,1662,1500,162,-3,-255,76
0,1669,1475,194,0,-55,121
-1,1595,1545,50,-3,80,82
1,1724,1982,-258,0,-22,43
-1,1770,2069,-299,-4,-45,56
1,1433,1346,87,-5,-256,73
1,1347,1574,-227,5,325,95
-1,1439,1715,-276,-6,-350,80
1,1754,1454,300,-1,88,77
1,1722,1558,164,1,19,45
1,2073,1750,323,3,50,51
-1,1962,1743,219,-8,-328,58
1,1676,1861,-185,2,13,41
1,1586,1558,28,1,12,43
1,1635,1406,229,1,137,89
-1,1442,1420,22,-2,-24,47
-1,1536,1666,-130,-2,-103,87
-1,1341,1455,-114,3,12,40
-1,1728,1700,28,0,-131,96
1,1582,1548,34,0,-29,79
0,1580,1674,-94,-1,-220,104
-1,1520,1298,222,2,74,72
-1,1761,1942,-181,0,107,88
1,1734,1663,71,0,52,79
-1,1795,1776,19,-1,-114,87
-1,1432,1486,-54,1,26,44
1,1888,1757,131,2,27,48
1,1606,1544,62,0,57,69
-1,1630,1315,315,0,-157,76
1,1662,1368,294,7,181,61
1,1666,1311,355,-4,-127,47
-1,1982,1924,58,0,-298,112
-1,1593,1535,58,-14,-611,78
1,1949,1754,195,-6,-113,57
-1,1623,1653,-30,0,-266,116
1,1617,1500,117,-1,183,81
1,1664,1656,8,3,96,59
-1,1474,1530,-56,0,-611,118
1,1774,1657,117,1,42,51
-1,1642,1731,-89,0,-169,128
-1,1693,1796,-103,0,41,216
-1,1749,1955,-206,-1,42,94
1,1712,1520,192,2,135,59
1,1410,1690,-280,1,85,73
-1,1610,1618,-8,-9,-399,74
-1,1376,1403,-27,-1,-128,106
1,1605,1664,-59,5,486,93
1,1647,1263,384,9,332,59
1,1529,1552,-23,0,-25,63
1,1579,1548,31,1,-109,117
-1,1358,1334,24,4,65,124
-1,1553,1607,-54,-4,-108,62
1,1805,1649,156,0,-21,51
-1,1627,1651,-24,0,-219,96
1,1736,1619,117,1,105,53
-1,1738,1967,-229,2,-235,116
-1,1638,1510,128,-1,-320,140
1,1715,1713,2,7,366,87
1,1669,1613,56,0,158,139
-1,1828,1642,186,0,24,68
-1,1493,1674,-181,-1,-255,116
-1,1610,1662,-52,-1,-4,42
1,1494,1442,52,-1,59,55
1,2037,1632,405,0,35,47
1,1937,1969,-32,0,148,107
-1,1397,1366,31,2,4,96
-1,1751,1898,-147,-2,-88,62
-1,1358,1430,-72,-4,-126,52
-1,1972,1733,239,0,0,68
1,1590,1672,-82,-1,-133,105
1,1499,1402,97,0,61,75
-1,1399,1418,-19,-4,-120,50
1,1773,1659,114,1,158,61
-1,1657,1789,-132,0,-27,70
1,1420,1188,232,4,544,73
-1,1671,1583,88,3,58,93
1,1751,1952,-201,-1,121,93
1,1289,1430,-141,2,867,85
-1,1540,1540,0,3,103,60
-1,1650,1500,150,1,-80,76
-1,1550,1582,-32,-3,-167,84
-1,1595,1664,-69,-3,-427,90
0,1599,1603,-4,11,287,70
-1,1797,1651,146,8,380,74
1,1432,1508,-76,1,91,67
-1,1585,1656,-71,-11,-1150,96
1,1450,1343,107,8,314,63
-1,1695,1619,76,0,31,60
-1,1657,2178,-521,-1,-17,46
-1,1665,2180,-515,-4,-256,62
0,1581,1537,44,1,-815,138
-1,1786,1916,-130,1,180,68
1,1562,1175,387,-2,-61,53
-1,1526,1623,-97,-1,-107,50
-1,1752,1666,86,-4,-107,66
-1,1995,2122,-127,-9,-4,88
-1,1529,1645,-116,-3,-62,46
1,2181,1663,518,-2,43,51
1,1623,1701,-78,-1,37,63
1,1924,1779,145,0,51,85
-1,1715,1680,35,-1,-37,70
1,1514,1593,-79,1,27,65
1,1551,1529,22,0,5,55
0,1367,1253,114,1,411,105
0,1539,1662,-123,-2,-499,92
1,1438,1263,175,2,361,83
-1,1638,1516,122,-4,-250,70
-1,1697,1791,-94,-2,-192,82
-1,1771,1931,-160,-2,-309,96
-1,1736,2183,-447,-1,0,94
1,1943,1733,210,5,72,49
1,1631,1334,297,4,153,57
-1,1366,1633,-267,-6,-448,84
-1,1711,1680,31,2,-22,84
-1,1425,1460,-35,1,14,72
-1,1815,1855,-40,0,78,120
1,1718,1324,394,4,101,69
1,1731,1539,192,-3,353,103
1,1938,1765,173,0,32,75
-1,1626,1782,-156,-1,7,48
-1,1609,1678,-69,-2,-86,60
-1,1789,1822,-33,-2,-100,66
1,1543,1579,-36,4,673,95
-1,1172,1578,-406,-7,-668,86
1,1518,1530,-12,-1,539,139
-1,1446,1673,-227,-1,39,60
1,2186,1726,460,1,32,51
1,1507,1539,-32,-1,-24,65
-1,1684,1693,-9,-1,-46,56
1,1489,1323,166,-2,-33,67
1,1597,1723,-126,-2,-79,125
1,1687,1636,51,0,-7,99
-1,1758,1945,-187,-3,-96,48
1,1635,1316,319,0,-206,69
-1,1632,1682,-50,-2,-441,94
-1,1437,1617,-180,-8,-257,54
1,1688,1374,314,-5,-53,43
-1,1957,1948,9,-2,-145,122
-1,1662,1637,25,-3,-266,74
1,1951,1752,199,1,107,113
-1,1717,1281,436,2,36,108
1,1672,1455,217,8,522,67
-1,1834,1778,56,0,-12,52
1,1617,1663,-46,3,278,81
1,1728,1725,3,1,103,57
-1,1195,1345,-150,-3,-125,54
1,1528,1361,167,0,51,69
1,1592,1169,423,1,78,65
1,1565,1470,95,1,265,81
-1,1746,1957,-211,-4,-296,100
-1,1724,1744,-20,3,-42,74
-1,1519,1530,-11,0,-59,105
-1,1517,1758,-241,-1,-100,72
-1,1791,2130,-339,0,-14,68
1,1589,1523,66,-1,210,108
1,1352,1465,-113,-1,216,73
1,1829,1901,-72,0,821,143
1,1737,1851,-114,0,419,121
1,1623,1438,185,2,398,93
0,1635,1781,-146,0,17,127
1,1785,2137,-352,-2,-240,79
-1,1655,1779,-124,0,-20,100
1,1425,1181,244,0,-38,121
1,1538,1604,-66,0,15,79
1,1463,1607,-144,7,803,163
-1,1512,1673,-161,-5,-292,100
-1,1521,1453,68,1,39,54
1,1693,1481,212,1,181,75
1,1368,1390,-22,0,113,123
1,2112,1806,306,-2,162,61
1,1667,1756,-89,0,61,58
-1,1741,1691,50,0,22,44
1,1412,1415,-3,0,-2,45
-1,1589,1748,-159,-1,-79,78
1,1532,1485,47,0,270,97
-1,1867,1752,115,-2,-175,100
1,1461,1562,-101,8,575,102
-1,1799,2120,-321,-1,-4,54
1,1507,1598,-91,-3,-26,60
1,1672,1721,-49,5,175,65
-1,1337,1363,-26,1,-72,80
1,1803,1704,99,-1,-122,79
0,1702,1404,298,3,217,138
-1,1321,1320,1,-7,-604,84
-1,1505,1466,39,-4,-472,84
0,1624,1679,-55,0,21,124
1,1752,1490,262,2,177,77
1,1537,1518,19,5,269,57
-1,1792,2128,-336,-2,-313,88
-1,1540,1466,74,2,-187,112
-1,1613,1634,-21,-8,-41,128
1,1915,1970,-55,0,-39,73
1,1446,1500,-54,4,221,63
-1,1588,1551,37,-3,102,62
1,1785,1768,17,0,2,53
-1,1787,1656,131,-11,-270,106
1,1769,1139,630,18,648,53
1,1357,1514,-157,21,972,59
-1,1814,1722,92,5,102,48
-1,1629,1728,-99,-3,-69,53
1,1851,1492,359,13,261,47
-1,1711,1769,-58,-1,-24,60
1,1678,1479,199,0,40,87
1,1517,1543,-26,1,-31,43
1,1801,1581,220,1,324,69
-1,1854,1626,228,0,-185,82
1,1886,1645,241,2,180,69
1,1585,1530,55,1,107,56
-1,1476,1655,-179,1,-3,70
-1,1514,1520,-6,-2,-168,62
1,1634,1361,273,-2,146,79
1,1450,1367,83,1,31,75
1,1385,1408,-23,1,56,61
1,1532,1503,29,3,537,111
1,1377,1500,-123,-3,-99,51
-1,1708,1684,24,-4,-250,69
-1,1574,1735,-161,-1,-41,56
-1,1751,1755,-4,0,-7,50
-1,1478,1447,31,-3,12,46
1,1424,1318,106,0,183,83
1,1698,1408,290,0,48,59
1,1736,1661,75,1,38,57
0,1493,1543,-50,0,21,103
1,1962,1963,-1,0,-25,41
1,1758,1444,314,0,3,91
-1,1598,1595,3,-2,-169,78
1,1726,1620,106,0,-2,51
-1,1742,1757,-15,-3,16,42
1,1470,1342,128,5,115,47
1,1516,1467,49,1,112,57
1,1454,1594,-140,-4,-98,73
-1,1388,1298,90,-5,-201,54
1,1441,1336,105,4,278,75
0,1768,1741,27,-1,-46,81
-1,1396,1424,-28,1,121,64
-1,1309,1527,-218,4,77,42
1,1651,1597,54,0,10,49
1,1500,1246,254,4,274,61
1,1400,1313,87,9,188,53
1,1983,1768,215,0,126,63
-1,1615,1639,-24,3,269,94
1,1481,1731,-250,-4,-345,95
1,1771,1539,232,0,10,55
-1,1754,1957,-203,0,-7,76
1,1785,1702,83,0,10,53
-1,1677,1714,-37,-3,193,98
-1,1621,1627,-6,0,11,76
1,1730,1657,73,-3,-118,59
-1,1458,1563,-105,-6,-368,70
-1,1561,1734,-173,-1,-12,40
1,1644,1500,144,2,153,97
-1,1644,1603,41,0,-14,102
-1,1696,1696,0,0,-206,116
1,1662,1778,-116,-1,30,91
1,1477,1294,183,-3,16,61
-1,1463,1506,-43,0,-11,66
1,1776,1910,-134,0,-4,57
1,1662,1513,149,4,177,49
1,1638,1708,-70,1,65,93
-1,1536,1468,68,0,-17,50
-1,1720,1695,25,-8,-245,48
-1,1644,1542,102,-4,-147,50
1,2084,1988,96,0,-265,119
-1,1022,1396,-374,-1,63,40
1,1419,1430,-11,-4,116,69
0,1762,1429,333,-1,-50,78
1,1597,1450,147,2,276,91
1,1741,1767,-26,0,36,83
1,1801,1503,298,-5,13,61
1,1299,1589,-290,-5,-181,99
1,1764,1678,86,0,16,55
1,1351,1400,-49,-1,147,67
-1,1500,1500,0,1,28,54
-1,1828,1998,-170,0,-14,50
-1,1564,1943,-379,-3,-82,56
1,1579,1053,526,-1,-31,41
1,1705,1587,118,21,293,45
-1,1287,1508,-221,8,184,58
-1,1746,1504,242,-5,-128,48
-1,1563,1613,-50,-1,-242,88
-1,1360,1313,47,-4,-506,97
1,1653,1407,246,1,93,69
-1,1574,1772,-198,0,-2,46
-1,1768,1688,80,-1,-61,62
1,1480,1505,-25,15,935,71
1,1483,1401,82,-3,-68,51
0,1443,1623,-180,5,233,110
1,1660,1630,30,4,272,89
1,1800,1649,151,7,388,87
-1,1452,1412,40,-3,-154,66
1,1753,1749,4,0,61,93
1,1540,1396,144,-2,-56,61
-1,1167,1673,-506,-1,120,74
1,1781,1487,294,7,98,49
1,1493,1569,-76,0,114,67
1,1707,1490,217,1,73,53
1,1337,1407,-70,7,210,44
1,1653,1677,-24,0,47,101
1,1490,1552,-62,2,122,81
1,1238,999,239,1,449,133
-1,1542,1725,-183,-3,-44,50
1,1769,1551,218,-3,-272,61
1,1402,1706,-304,3,261,89
1,1708,1896,-188,3,54,51
1,1408,1430,-22,0,84,104
-1,1580,1513,67,-4,-270,62
1,1335,1366,-31,0,22,65
1,1347,1385,-38,-2,-73,59
1,1520,1565,-45,0,3,47
1,1833,1774,59,0,19,67
1,1964,2006,-42,0,96,153
0,1729,1956,-227,1,107,129
-1,1499,1546,-47,-5,-172,50
1,1424,1439,-15,0,28,77
-1,1817,1753,64,0,-157,94
-1,1491,1301,190,-5,-112,64
-1,1763,1742,21,0,-7,58
1,2014,1712,302,-2,-14,45
1,1484,1338,146,1,148,55
1,1604,1448,156,1,169,79
1,1766,1803,-37,0,233,133
1,1773,1579,194,1,82,67
-1,1551,1644,-93,1,-180,92
-1,1766,1738,28,-5,-5,102
1,1567,1520,47,-2,-102,73
0,1491,1553,-62,0,-428,145
1,1635,1574,61,6,1055,111
0,1538,1527,11,10,989,107
1,1125,1313,-188,-1,-159,59
-1,1560,1678,-118,-3,-230,126
-1,1655,1526,129,-1,-4,50
-1,1574,1805,-231,-2,-523,94
-1,1226,1451,-225,-11,-236,62
-1,1516,1418,98,-7,-474,78
1,1610,1690,-80,3,196,95
1,1664,1664,0,0,10,61
-1,1607,1638,-31,-3,-65,72
1,1724,1764,-40,1,28,65
-1,1519,1738,-219,-2,-1,41
-1,1836,1880,-44,0,-364,84
1,1875,1829,46,6,429,81
1,1687,1556,131,2,124,53
-1,1475,1427,48,0,-16,60
1,1561,1945,-384,3,35,51
-1,1615,1459,156,-1,-52,62
1,1712,1649,63,-4,7,61
1,1712,1481,231,0,35,98
1,1575,1706,-131,7,556,91
1,1754,1752,2,1,16,49
1,1786,1549,237,-3,-5,83
1,1574,1569,5,0,179,133
-1,1811,1599,212,-1,-33,42
-1,1576,1458,118,-2,-151,56
1,1572,1243,329,-1,-21,47
1,1538,1161,377,3,35,41
-1,1604,1388,216,0,-43,82
-1,1541,1640,-99,-2,-36,46
-1,1577,1449,128,-3,-83,72
-1,1500,1308,192,0,29,54
1,1634,1691,-57,-3,-95,71
1,968,0,968,1,222,75
-1,1355,1380,-25,-1,-70,54
1,1796,1550,246,1,190,71
-1,1787,1870,-83,-3,-391,102
-1,1671,1848,-177,2,56,44
1,1569,1554,15,2,275,107
1,1826,1889,-63,0,-150,97
1,1603,1636,-33,5,887,123
1,1471,1499,-28,4,268,73
1,1752,1493,259,7,125,45
1,1824,1583,241,0,-3,59
-1,1586,1744,-158,-4,-81,50
1,1456,1392,64,-4,112,69
1,1541,1644,-103,2,24,41
1,1360,1311,49,3,218,77
-1,1534,1736,-202,1,-923,150
1,1557,1440,117,2,59,45
-1,1741,1708,33,-2,-51,70
-1,1785,1676,109,-6,-444,118
-1,1383,1493,-110,-2,-230,68
-1,1599,1596,3,0,-78,68
-1,1597,2079,-482,-5,-545,86
-1,1609,1616,-7,-4,-578,102
0,1742,1766,-24,-1,-37,139
1,1563,1629,-66,3,244,109
1,1666,1542,124,6,167,63
-1,1431,1757,-326,-3,-5,40
-1,1501,1742,-241,-7,-113,40
1,1877,1840,37,5,109,57
-1,1474,1475,-1,1,8,44
-1,1432,1565,-133,-2,-114,56
1,1875,1909,-34,-2,56,103
-1,1374,1524,-150,-3,-170,102
-1,1647,1678,-31,0,-29,70
-1,1247,1212,35,-1,-16,76
-1,1432,1604,-172,-2,-24,46
1,1747,1263,484,-1,-8,77
1,1879,1778,101,0,50,95
1,1508,1626,-118,2,739,147
1,1752,1554,198,2,8,53
1,1626,1586,40,6,217,59
-1,1830,1886,-56,0,-135,70
1,1761,1298,463,5,251,67
1,1501,1375,126,1,244,107
-1,1572,1644,-72,-5,-346,94
-1,1567,1636,-69,-2,-180,60
1,1463,1227,236,6,829,99
-1,1472,1563,-91,0,-61,74
-1,1259,1749,-490,-2,-58,50
-1,1648,1676,-28,-6,-500,132
-1,1785,1644,141,-5,-67,44
-1,1566,1625,-59,0,-98,130
1,1245,1444,-199,14,601,69
1,1425,1174,251,-4,-95,64
0,1863,1990,-127,0,-111,167
-1,1392,1428,-36,-9,-405,68
-1,968,0,968,-4,-35,46
1,1980,1765,215,-4,0,45
-1,1883,1946,-63,0,-103,94
-1,1895,1820,75,-4,-152,74
1,1639,1636,3,0,25,69
-1,1447,1804,-357,0,-47,63
-1,1576,1751,-175,-6,-106,46
-1,1215,1622,-407,-7,-239,79
-1,1692,1768,-76,-1,-134,78
1,1382,1533,-151,2,438,71
1,1563,1548,15,-1,-80,105
1,1759,1985,-226,-1,-117,83
-1,1439,1490,-51,-3,51,64
-1,1515,1380,135,-1,-204,72
1,1792,1682,110,0,87,67
1,1500,1519,-19,0,373,95
1,1500,1502,-2,-1,-48,71
-1,1670,1727,-57,-8,-224,54
1,1717,1594,123,-1,-7,89
-1,1767,1887,-120,-1,-55,48
1,1420,1334,86,0,18,45
1,1725,1836,-111,-3,-383,128
-1,1784,1634,150,-2,-259,66
-1,1368,1373,-5,0,-44,60
-1,1605,1910,-305,0,-197,132
0,1307,1552,-245,-1,695,195
1,1834,1883,-49,0,34,125
-1,1671,1967,-296,-2,-218,88
-1,1461,1435,26,-2,-259,102
-1,1438,1557,-119,-1,-9,48
-1,1417,1602,-185,-7,-849,142
-1,1367,1763,-396,0,-301,104
1,1791,1802,-11,0,142,101
-1,1738,1758,-20,0,3,58
0,1386,1498,-112,-11,-415,148
-1,1635,1557,78,1,-83,66
-1,1574,1750,-176,-7,-1241,166
-1,1740,1820,-80,-1,-509,100
1,1625,1782,-157,3,146,85
-1,1464,1682,-218,-1,-5,44
-1,1574,1538,36,-2,-222,92
1,1758,1500,258,2,53,49
-1,1894,1897,-3,0,-19,58
-1,1666,1971,-305,-3,-194,80
1,1765,1742,23,0,20,53
1,1468,1406,62,1,-3,47
1,1834,1770,64,0,-56,55
-1,1584,1516,68,-4,-109,60
-1,1776,1702,74,0,7,78
1,1829,1731,98,1,104,81
-1,1570,1621,-51,0,60,122
1,1725,1661,64,0,138,87
1,1430,1399,31,1,358,109
1,1807,1530,277,10,399,67
0,1795,1500,295,1,-147,92
1,1737,1685,52,4,95,53
-1,1579,1500,79,-6,-387,90
1,1398,1499,-101,-7,-33,125
-1,1496,1723,-227,-1,23,66
1,1838,1747,91,0,75,67
-1,1678,1550,128,0,-13,52
1,1456,1705,-249,-6,-28,64
1,1722,1790,-68,0,100,63
-1,1397,1562,-165,-14,-660,108
-1,1720,1835,-115,-4,-165,56
1,1566,1486,80,0,34,63
1,1870,1846,24,5,170,65
-1,1451,1494,-43,2,60,51
1,1607,1380,227,-3,244,87
1,1650,1759,-109,2,101,61
-1,1736,1649,87,-1,-48,54
1,1348,1395,-47,1,380,103
-1,1508,1787,-279,-4,-667,108
1,1587,1724,-137,-2,91,109
-1,1616,1325,291,2,21,92
1,1836,1880,-44,0,-77,87
-1,1735,1728,7,0,-4,74
1,1381,1318,63,0,53,97
1,2181,2066,115,0,-7,65
-1,1574,1513,61,0,5,104
1,1540,1550,-10,-2,56,74
-1,1524,1811,-287,0,-120,88
-1,1475,1765,-290,0,-49,84
-1,1564,1739,-175,-1,35,82
-1,1763,1883,-120,0,-27,48
-1,1724,1974,-250,-2,-33,48
-1,1783,1855,-72,1,-38,80
1,1671,1650,21,-2,253,107
-1,1715,1763,-48,0,-43,66
-1,1518,1572,-54,2,59,64
-1,1484,1412,72,0,-2,54
-1,1729,1800,-71,1,21,96
-1,1638,1401,237,0,-25,58
0,1448,1161,287,16,1015,79
1,1550,1534,16,1,24,49
1,1461,1429,32,0,150,85
-1,1380,1479,-99,0,-188,72
1,1745,1558,187,0,54,99
-1,1581,1508,73,5,178,54
1,1541,1504,37,1,460,99
1,1483,1345,138,3,297,93
1,1858,1500,358,5,321,79
-1,1732,1914,-182,0,-13,66
-1,1524,1624,-100,0,-11,54
-1,1345,1138,207,5,236,66
1,1891,1754,137,0,-162,77
1,1522,1568,-46,-3,447,95
-1,1549,1676,-127,-1,-157,66
-1,1552,1914,-362,0,5,44
1,1713,1762,-49,0,137,133
-1,1812,1719,93,-1,-44,54
1,1612,1678,-66,-3,7,61
1,1868,1849,19,0,225,73
1,1607,1411,196,-8,235,151
1,1452,1464,-12,1,156,61
1,1717,1418,299,-1,-17,49
-1,1564,1663,-99,-1,-133,103
1,1815,1598,217,1,35,47
-1,1082,1308,-226,0,-74,70
-1,1523,1560,-37,-1,-109,104
-1,1555,1535,20,2,37,54
1,1432,1503,-71,0,-3,47
-1,1482,1388,94,0,-3,46
1,1838,1878,-40,-3,-105,159
1,1788,1552,236,1,9,53
1,1726,1734,-8,-3,143,121
1,1949,1645,304,0,317,79
1,1541,1683,-142,0,296,89
-1,1864,1774,90,0,23,58
1,1770,1325,445,-3,116,86
-1,1547,1544,3,0,-22,54
1,1668,1522,146,6,343,75
1,1599,1568,31,3,110,71
-1,1746,1898,-152,-1,0,103
1,1471,1535,-64,3,512,79
-1,1555,1535,20,4,67,48
-1,1686,1581,105,1,0,46
-1,1276,1493,-217,10,272,76
1,1771,1623,148,5,267,71
-1,1356,1572,-216,-4,-86,48
-1,1471,1490,-19,3,145,106
1,1797,1542,255,3,176,55
-1,1748,1882,-134,-2,4,48
-1,1153,1204,-51,8,225,48
1,1721,1773,-52,-2,-213,119
1,1776,1922,-146,2,162,63
1,1979,1766,213,0,-15,69
-1,1533,1558,-25,-1,-140,76
-1,1725,1216,509,1,73,50
0,1867,1850,17,-3,-33,125
1,1568,1638,-70,0,-168,117
-1,1645,1722,-77,-4,-86,50
-1,1438,1465,-27,2,42,70
-1,1337,1554,-217,-14,-540,54
-1,1569,1523,46,-4,-49,82
-1,1459,1670,-211,0,-130,88
-1,1537,1802,-265,0,-71,70
-1,1606,1313,293,-1,-193,74
0,1737,1595,142,0,86,115
1,1577,1350,227,6,352,85
-1,1564,1534,30,-2,-71,64
1,1500,1459,41,1,468,97
1,1904,1738,166,2,108,73
1,1401,1435,-34,-2,-148,59
-1,1535,1556,-21,9,454,80
1,1796,1953,-157,0,184,91
-1,1329,1431,-102,-1,1,52
1,1772,1364,408,1,312,95
1,1602,1512,90,4,132,67
1,1806,1533,273,4,289,69
1,1498,1332,166,1,29,83
1,1793,1984,-191,-4,-150,105
-1,1771,1640,131,1,39,64
1,1731,1814,-83,4,64,43
-1,1645,1709,-64,0,-43,74
-1,1567,1525,42,0,-8,67
-1,1671,1556,115,0,8,48
1,1598,1500,98,-3,110,71
-1,1731,1911,-180,-2,-120,92
-1,1734,1746,-12,1,-257,118
1,1595,1660,-65,0,-49,105
-1,1502,1540,-38,-1,-51,48
-1,1654,1811,-157,0,3,42
-1,1383,1360,23,0,-2,72
-1,1529,1810,-281,-3,-146,60
0,1357,1300,57,0,186,132
-1,1451,1870,-419,-4,-33,40
0,1582,1626,-44,-1,-319,114
1,1546,1515,31,-2,17,73
-1,1274,1500,-226,2,-133,150
-1,1713,1818,-105,-3,-90,70
-1,2039,1894,145,0,-213,102
0,1505,1480,25,-10,-916,103
1,1535,1870,-335,6,691,111
-1,1361,1774,-413,0,-563,114
-1,1758,1720,38,-1,-14,42
1,1500,1798,-298,0,-15,57
-1,1902,1912,-10,-4,-107,58
1,1525,1196,329,3,206,61
-1,1826,1967,-141,-1,-541,136
-1,1433,1415,18,-1,-7,52
-1,1734,1745,-11,-4,-62,40
1,1618,1672,-54,0,38,91
-1,1454,1611,-157,0,-19,64
-1,1343,1477,-134,-1,-311,126
-1,1917,1766,151,-2,-130,84
1,1740,1552,188,2,22,45
-1,1598,1435,163,-3,-42,50
-1,1756,1974,-218,0,65,60
1,1922,1891,31,2,106,65
-1,1528,1447,81,-1,-78,122
-1,1541,1593,-52,-1,-25,58
-1,1234,1776,-542,0,-37,80
1,1872,1449,423,6,695,95
1,1747,1528,219,3,146,57
-1,1763,1818,-55,0,-69,82
1,1546,1504,42,2,1023,105
-1,1504,1556,-52,-2,-42,40
-1,1584,1760,-176,-1,-100,76
-1,1979,1751,228,1,27,114
1,1681,1332,349,-1,132,99
-1,1577,1699,-122,0,-83,54
-1,1734,1768,-34,-2,-85,66
-1,1439,1415,24,-1,-104,84
-1,1828,1925,-97,-1,228,114
1,1777,1358,419,1,55,59
-1,1778,1223,555,-3,-46,46
1,1526,1385,141,4,487,93
-1,1494,1484,10,-1,-15,40
1,1673,1570,103,-2,21,89
-1,1475,1378,97,-3,-366,106
1,1565,1419,146,5,979,123
1,1917,1616,301,1,51,83
1,1933,1820,113,-3,436,119
1,1855,1403,452,-2,34,49
-1,1426,1293,133,5,109,106
1,1523,1451,72,7,252,59
-1,1446,1504,-58,3,-5,68
1,1956,1530,426,0,29,89
-1,1812,1899,-87,-2,-116,59
0,1452,1650,-198,2,8,43
-1,1327,1461,-134,-7,-299,100
1,1812,1775,37,-1,-17,107
-1,1738,1842,-104,0,-2,62
-1,1838,1980,-142,-2,-113,68
-1,1428,2203,-775,-3,-169,78
1,1571,1502,69,-1,-312,91
1,1735,1815,-80,0,14,55
-1,1462,1887,-425,0,-38,50
1,1442,1622,-180,8,661,69
1,1850,1729,121,-2,-24,50
1,1770,1694,76,-1,-38,63
1,1613,1453,160,4,290,81
1,1633,1619,14,2,92,83
-1,1605,1662,-57,0,73,94
-1,1605,1500,105,-1,-58,54
-1,1848,1717,131,2,-197,132
0,1657,1655,2,-1,-282,112
-1,1259,1261,-2,-13,-325,56
1,2204,1426,778,0,44,97
1,1745,1865,-120,0,-2,85
1,1547,1591,-44,-4,1151,141
-1,1488,1779,-291,0,-811,112
-1,1589,1783,-194,-6,-63,44
-1,1537,1596,-59,6,239,102
0,1657,1766,-109,-1,-146,134
-1,1384,1376,8,-8,-114,54
-1,1413,1654,-241,0,-9,58
-1,1500,1563,-63,-3,-203,54
1,1459,1443,16,2,573,103
1,2159,1838,321,0,240,103
-1,1509,1650,-141,0,-3,46
-1,1271,1248,23,-4,-85,48
-1,1538,1401,137,3,-65,68
-1,1578,1584,-6,-2,-75,50
1,1627,1611,16,1,37,61
1,1798,1482,316,3,24,41
1,1627,1551,76,-1,6,45
-1,1363,1726,-363,-1,-255,68
-1,1424,2205,-781,-1,-44,72
-1,1619,1534,85,2,22,54
1,1506,1500,6,-4,-121,87
-1,1650,1894,-244,-3,-213,130
1,1547,1641,-94,7,464,81
1,1657,1655,2,0,66,67
1,1370,1591,-221,5,227,75
1,1259,1260,-1,22,533,55
-1,1604,1562,42,-8,-120,46
-1,1814,1811,3,-1,-416,110
-1,1620,1697,-77,-1,-128,78
-1,1177,1365,-188,-6,-431,74
-1,1790,1835,-45,-1,-150,92
-1,1549,1531,18,0,21,46
-1,1637,1685,-48,-1,-122,104
-1,1525,1737,-212,0,-119,88
-1,1111,1503,-392,-16,-306,44
-1,1667,1637,30,0,-153,132
1,1280,1240,40,2,-1,41
-1,1500,1408,92,0,-16,50
1,1643,1568,75,5,38,42
-1,1401,1605,-204,-2,-199,70
-1,1571,1586,-15,0,24,62
-1,1636,1531,105,0,-16,90
-1,1231,1289,-58,-5,-111,40
1,1781,1308,473,0,-56,81
0,1395,1453,-58,-11,-283,54
-1,1660,1904,-244,-2,-39,44
-1,1452,1524,-72,0,-114,66
-1,1431,1492,-61,0,-38,64
1,1256,1436,-180,2,33,49
1,1648,1659,-11,1,203,81
1,1612,1746,-134,6,140,53
0,1462,1416,46,1,351,98
-1,1560,1606,-46,-3,-56,50
0,1661,1807,-146,0,59,124
1,1568,1348,220,8,165,47
-1,1923,1686,237,-2,-689,144
1,1695,1628,67,6,256,67
1,1472,1729,-257,-6,-7,57
-1,1443,1623,-180,-7,-169,51
1,1579,1563,16,1,445,101
-1,1451,1397,54,4,85,54
-1,1292,1783,-491,0,-5,84
1,1713,1672,41,7,777,139
-1,1540,1650,-110,1,-269,94
-1,1235,1285,-50,-5,-103,48
1,1503,1352,151,-1,67,71
1,1488,1549,-61,2,12,41
1,1817,1817,0,1,52,75
1,1621,1653,-32,1,146,95
-1,1781,1892,-111,2,134,82
1,1642,1699,-57,0,-6,97
-1,1403,1214,189,-9,-45,46
1,1648,1544,104,5,185,52
1,1863,1887,-24,-5,67,111
-1,1294,1226,68,-3,-218,68
0,1656,1606,50,0,164,184
1,1626,1384,242,1,175,90
-1,1336,1531,-195,-2,-61,54
1,1422,1382,40,1,-163,65
1,1785,1279,506,5,318,79
1,1650,1335,315,15,351,45
1,2107,1870,237,0,39,59
-1,1238,1281,-43,2,73,58
-1,1875,2100,-225,-5,-90,56
1,1519,1422,97,1,127,97
-1,1642,1633,9,-5,-244,68
1,1691,1716,-25,0,8,47
-1,1563,1856,-293,0,1,44
1,1606,1266,340,8,151,43
-1,1865,2115,-250,-1,-81,60
-1,1656,1631,25,2,-451,174
1,1409,1371,38,1,102,85
-1,1750,1787,-37,2,92,106
-1,1386,1434,-48,-2,-159,50
1,1912,1656,256,0,67,69
-1,1694,2116,-422,0,-75,72
1,1373,1108,265,5,886,117
1,1694,1326,368,5,352,69
1,1682,1579,103,2,36,41
1,1241,1278,-37,-9,-214,55
1,1488,1523,-35,3,350,71
1,1368,1533,-165,-6,-107,75
-1,1630,1500,130,-1,-1,44
1,1644,1631,13,2,243,85
1,1782,1838,-56,-1,-71,65
-1,1905,1774,131,0,-415,152
-1,1442,1643,-201,1,25,98
0,1793,1665,128,1,90,94
-1,1623,1899,-276,0,-75,91
0,1593,1705,-112,3,248,127
1,2121,1861,260,-2,378,95
-1,1692,1857,-165,-1,-7,56
1,1656,1556,100,7,88,43
1,1537,1551,-14,2,111,63
-1,1267,1253,14,1,21,44
-1,1607,1654,-47,0,-208,95
-1,1466,1590,-124,-1,2,58
1,1705,1389,316,3,165,57
1,1377,929,448,0,-207,187
-1,1863,2274,-411,-3,-661,134
-1,1621,1621,0,0,7,86
-1,1510,1523,-13,-5,-179,54
-1,1497,1390,107,-4,-237,62
-1,1501,1658,-157,2,-34,122
-1,1892,1798,94,-3,91,66
1,2276,1861,415,0,26,49
-1,1679,1788,-109,-1,-34,46
1,1645,1677,-32,0,424,99
1,1771,1385,386,-9,151,101
1,1803,1018,785,12,155,47
1,1711,1541,170,-4,-31,111
1,1664,1219,445,6,161,51
1,1796,1797,-1,-1,13,55
1,1320,1431,-111,9,440,87
-1,1714,1880,-166,0,4,96
1,1788,1752,36,4,46,41
-1,1635,1696,-61,0,-3,50
0,1343,1336,7,-3,-75,107
-1,1796,1722,74,0,-99,162
-1,1398,1534,-136,-8,-140,50
1,1633,1523,110,1,163,57
1,1016,1243,-227,2,136,69
1,1642,1631,11,1,66,93
1,2279,1983,296,-1,-53,59
-1,1804,1795,9,-2,-268,82
1,1806,1792,14,6,246,71
1,1418,1460,-42,2,97,57
-1,1424,1242,182,-8,-280,78
1,1793,1880,-87,0,153,113
1,1419,1445,-26,0,10,63
-1,1473,1575,-102,-6,-298,74
1,1668,1782,-114,0,-7,45
1,1553,1313,240,1,161,65
-1,1553,1574,-21,0,-56,96
1,1878,1515,363,-1,146,114
-1,1903,1846,57,0,-81,66
1,1694,1654,40,-2,328,87
-1,1890,1999,-109,-1,-18,112
1,2283,1980,303,0,0,79
-1,1704,1782,-78,-6,-105,52
1,1763,1551,212,3,104,73
1,1785,1866,-81,4,117,47
-1,1890,1865,25,-4,-129,96
-1,1491,1807,-316,-3,-41,48
1,1537,1606,-69,5,272,89
-1,1538,1547,-9,0,10,64
-1,1339,1149,190,3,74,70
1,1550,1509,41,5,140,55
1,1410,1482,-72,2,404,105
1,1245,1500,-255,1,11,41
1,1782,1816,-34,0,-100,129
-1,1320,1441,-121,6,128,58
1,1609,1209,400,0,10,47
1,1666,1685,-19,0,-16,53
1,1622,1421,201,3,60,43
1,1785,1218,567,6,603,95
-1,1569,1534,35,2,-4,68
-1,1543,1585,-42,-5,-303,80
-1,1258,1500,-242,-1,-1,52
1,1631,1723,-92,-7,-5,41
1,1656,1600,56,-2,-33,45
1,1878,1877,1,0,29,75
1,1434,1306,128,4,251,55
-1,1483,1650,-167,-2,-67,54
1,1500,1454,46,4,245,81
-1,1446,1484,-38,-7,-128,54
-1,1458,1588,-130,0,-21,70
1,1976,2287,-311,0,-1,65
1,1611,1194,417,-2,-105,63
-1,1366,1378,-12,-1,-11,58
1,1521,1691,-170,-2,-216,81
-1,1859,2164,-305,0,-112,80
-1,1167,1322,-155,-4,-392,80
-1,1673,1765,-92,0,23,56
-1,1685,1500,185,0,103,94
-1,1851,1805,46,-13,-236,118
-1,1083,1408,-325,-8,-1091,134
-1,1560,1662,-102,0,-34,80
1,1514,1641,-127,1,301,93
-1,1794,2008,-214,0,-116,80
1,1061,1322,-261,-4,-166,69
-1,1868,1785,83,-1,-51,80
1,2168,1855,313,3,60,48
-1,1448,1525,-77,-3,-157,102
-1,1685,1509,176,1,168,92
1,1441,1413,28,0,17,139
-1,1852,2172,-320,-8,-105,52
1,1665,1632,33,-1,139,101
-1,1334,1355,-21,2,-316,104
1,2176,1849,327,2,160,69
-1,1545,1878,-333,0,-231,116
1,1467,1428,39,4,122,87
1,1889,1793,96,0,31,101
-1,1494,1434,60,0,2,57
-1,1570,1611,-41,0,-174,86
1,1730,1619,111,5,128,55
1,1533,1179,354,0,10,52
0,1806,1845,-39,0,276,121
-1,1250,1409,-159,-4,-157,58
-1,1486,1481,5,0,-2,78
1,1301,1102,199,0,198,81
1,1696,1619,77,3,170,79
0,1785,1665,120,0,18,100
-1,1789,1774,15,-6,-312,60
-1,1614,1590,24,-2,-9,44
1,1844,1808,36,-8,23,89
-1,1476,1741,-265,2,-87,58
-1,1584,1444,140,-4,-204,59
1,1671,1754,-83,-2,-71,57
-1,1527,1726,-199,-6,-361,62
-1,1787,1777,10,0,-22,98
1,1534,1627,-93,2,30,61
1,1650,1624,26,2,27,53
1,1674,1622,52,0,28,73
1,1265,1308,-43,2,41,49
-1,1481,1450,31,-6,-146,52
1,1811,1483,328,0,25,79
1,1624,1820,-196,6,609,104
1,1816,1860,-44,0,0,105
-1,1797,1755,42,0,-82,144
1,1665,1589,76,3,84,52
1,1186,1243,-57,7,291,75
1,1536,1279,257,3,457,85
1,1621,1560,61,0,21,67
1,1263,1398,-135,0,-48,81
-1,1633,1273,360,0,338,102
1,1351,1446,-95,9,360,51
-1,1252,1107,145,-1,88,44
1,1402,1435,-33,2,1007,127
-1,1825,1696,129,1,-175,78
-1,1436,1532,-96,-1,-271,134
-1,1634,1147,487,0,4,64
0,1788,1774,14,0,-63,143
1,1337,1167,170,2,149,71
1,1500,1247,253,0,435,125
-1,1826,1825,1,-3,10,136
1,1976,1871,105,-1,271,107
-1,1228,1261,-33,5,127,66
-1,1669,1777,-108,0,-8,58
1,1329,1071,258,8,225,57
1,1500,1457,43,5,95,49
1,1738,1664,74,-1,75,81
-1,1862,1984,-122,-4,-159,54
1,1299,1202,97,1,199,83
-1,1540,1464,76,-3,-470,78
1,1800,1640,160,-2,-119,71
1,1775,1788,-13,1,81,57
-1,2157,2073,84,0,10,58
-1,1991,1854,137,1,137,86
-1,1556,1451,105,0,-76,84
-1,1885,1902,-17,0,-14,68
1,1484,1585,-101,3,266,133
-1,1137,1426,-289,3,-221,74
1,1746,1472,274,-5,-63,53
-1,1217,1549,-332,0,-31,62
-1,1558,1711,-153,-3,-150,64
1,1809,1629,180,0,7,55
1,1601,1415,186,2,94,55
-1,1870,1976,-106,-3,-12,46
1,1387,1162,225,4,150,57
1,1777,1787,-10,1,41,63
-1,1763,1940,-177,-4,-103,74
-1,1984,1862,122,1,217,118
1,1541,1474,67,3,62,43
1,1336,1413,-77,6,767,87
1,1626,1531,95,6,233,67
1,1399,1542,-143,0,7,49
-1,1556,1508,48,2,-203,60
-1,1967,1949,18,-2,-223,80
1,1340,1292,48,-3,-33,50
1,1572,1602,-30,0,199,127
1,1764,1609,155,0,78,125
-1,2070,2240,-170,-1,-98,54
-1,1926,1901,25,0,11,92
1,1754,1837,-83,0,-30,81
-1,2017,1926,91,-3,-683,120
1,1521,1662,-141,3,116,53
1,1869,1818,51,3,118,51
1,1461,1672,-211,-2,-84,61
-1,1814,1682,132,-1,1,72
-1,1318,1636,-318,-5,-217,64
1,1466,1622,-156,0,117,113
-1,1687,1737,-50,0,-74,108
1,2002,1941,61,6,667,107
-1,1372,1349,23,2,59,52
-1,1503,1553,-50,-5,-178,72
-1,1415,1518,-103,0,172,62
1,1521,1543,-22,2,450,91
-1,1518,1566,-48,1,-21,62
0,1587,1590,-3,-1,9,127
-1,1704,1669,35,0,32,90
1,1603,1771,-168,-2,-14,65
0,1931,2012,-81,0,46,126
1,1514,1423,91,0,98,117
1,1455,1638,-183,3,245,95
1,1481,1531,-50,-1,120,87
-1,1328,1584,-256,1,20,56
-1,1500,1812,-312,-1,-244,84
-1,1587,1942,-355,-5,-313,70
-1,1500,1411,89,-15,-357,58
-1,1615,1511,104,-1,-45,44
1,1891,1863,28,1,-103,111
-1,1090,1703,-613,0,-61,60
1,1639,1588,51,0,81,87
-1,1500,1436,64,-1,-24,44
1,1348,1479,-131,-6,-35,55
1,1934,2009,-75,0,35,93
1,1201,1233,-32,-1,9,43
1,1362,1251,111,12,473,61
1,1759,1881,-122,0,10,49
1,1920,1886,34,-2,-32,97
-1,1488,1822,-334,0,-17,54
-1,1995,1924,71,0,-66,76
1,1873,1856,17,0,55,71
-1,1876,1930,-54,-2,62,64
-1,1697,1798,-101,-1,42,46
-1,1407,1716,-309,0,-7,66
-1,1655,1478,177,-1,-126,104
1,1459,1619,-160,-3,-78,63
1,1530,1533,-3,-2,-210,79
0,1734,1644,90,1,34,51
1,1463,1409,54,10,293,59
1,1746,1663,83,3,243,106
-1,1481,1758,-277,0,2,42
1,1968,1619,349,0,23,58
1,1866,1939,-73,3,18,53
1,1879,1691,188,1,100,87
-1,1992,1928,64,3,-279,124
-1,1938,1982,-44,-3,-247,82
1,1826,1484,342,-1,39,57
-1,1611,1453,158,-1,-501,162
1,1947,1880,67,-3,-49,67
1,1577,1508,69,0,447,129
-1,1901,2137,-236,0,-16,64
-1,1754,1704,50,0,-91,64
1,1569,1521,48,-5,-64,103
0,1942,1978,-36,-5,579,165
1,1804,1657,147,0,8,51
-1,1616,1991,-375,-1,-26,52
1,1461,1250,211,18,380,43
1,2005,1639,366,-1,-27,43
1,1870,1956,-86,7,254,49
1,1505,1550,-45,-4,-390,107
-1,1403,1498,-95,-7,-93,46
0,1521,1704,-183,-4,62,114
1,1525,1525,0,7,276,63
-1,1977,1943,34,0,-116,98
1,1719,1682,37,-2,-40,95
-1,1943,1884,59,1,-31,88
1,1883,2010,-127,0,39,89
1,1515,1734,-219,1,-64,61
1,1477,1590,-113,0,266,87
-1,1302,1521,-219,-6,-379,76
-1,1642,1755,-113,-2,-200,92
1,1590,1587,3,2,529,80
1,1691,1829,-138,2,411,125
-1,1522,1506,16,0,-65,104
1,1537,1403,134,1,40,44
1,2010,1960,50,-2,68,75
1,1775,1410,365,1,255,93
1,1307,1399,-92,6,105,43
1,1589,1323,266,-1,16,51
-1,1955,1965,-10,-2,95,72
1,1898,1930,-32,0,63,71
1,1647,1495,152,0,32,82
1,1897,1722,175,3,107,81
-1,1976,1944,32,0,58,100
1,1494,1787,-293,10,135,47
-1,1370,1625,-255,0,4,40
-1,1343,1762,-419,0,25,60
-1,1921,1908,13,0,-20,58
-1,1957,1963,-6,-3,-541,158
1,1500,1530,-30,0,-93,79
1,2144,1951,193,0,-213,107
1,1605,1406,199,5,215,89
1,1919,1910,9,0,-31,59
1,1731,1777,-46,-2,-31,121
-1,1327,1812,-485,-7,-101,48
-1,1267,1253,14,-5,-113,58
1,1595,1411,184,-1,-118,67
-1,1974,1946,28,10,118,74
-1,1249,1534,-285,-4,-396,88
-1,1538,1597,-59,-1,94,144
-1,1511,1535,-24,4,228,84
-1,1769,1613,156,-1,125,128
1,1800,1469,331,2,160,77
1,1899,1929,-30,1,68,69
1,1530,1508,22,-1,-37,47
1,1958,1962,-4,4,1167,195
1,1396,1244,152,2,997,107
1,1691,1470,221,0,50,71
1,1596,1516,80,6,165,61
-1,1271,1181,90,2,65,46
-1,1918,1911,7,-3,-14,74
1,1781,1641,140,1,244,73
-1,1886,1817,69,0,-33,62
1,1946,2152,-206,0,15,57
-1,1395,1532,-137,-3,-20,50
1,1763,1577,186,0,123,75
1,1540,1501,39,-5,168,133
-1,1543,1633,-90,-3,-108,58
0,1951,1969,-18,0,-101,139
0,1649,1630,19,-1,-11,59
1,1922,1907,15,1,419,81
1,1477,1282,195,5,293,67
1,2128,1962,166,0,24,95
-1,1248,1489,-241,3,66,50
1,1806,1663,143,0,3,45
1,1816,1500,316,3,116,63
-1,1968,1952,16,0,56,102
1,1778,1519,259,0,94,53
-1,1866,1698,168,0,-55,124
-1,1540,1442,98,0,-199,110
1,1511,1511,0,-3,-87,49
-1,1576,1528,48,-2,-144,95
0,1963,1957,6,0,35,124
0,1605,1522,83,0,12,84
1,1679,1787,-108,0,-7,51
-1,1500,1465,35,-4,-159,122
1,2063,1914,149,0,112,85
1,1227,1256,-29,-1,-25,49
-1,1957,1963,-6,0,-361,130
1,1977,1636,341,-6,132,113
-1,1243,1194,49,-2,-136,58
1,1616,1002,614,3,693,107
1,1432,1821,-389,-4,-119,87
-1,1243,1049,194,-13,-421,60
1,1974,1946,28,0,108,75
1,1526,1530,-4,-4,-40,43
-1,1624,1547,77,-6,-159,60
-1,1328,1571,-243,-7,-215,68
-1,1319,1593,-274,-1,-96,74
-1,1493,1271,222,-2,-69,64
1,1414,1500,-86,8,202,46
-1,2071,2137,-66,0,-22,124
-1,1627,1813,-186,1,89,106
-1,1575,1769,-194,0,-111,67
1,1473,1374,99,8,162,47
1,1271,1308,-37,7,346,69
1,1936,1984,-48,-1,-90,76
1,1870,1483,387,5,25,41
-1,1515,1748,-233,0,-153,84
-1,1387,1573,-186,-3,-3,46
1,1784,1516,268,4,175,53
1,1706,1500,206,1,38,69
0,1971,1949,22,-2,-55,104
1,1547,1518,29,-2,42,121
0,1413,1409,4,-1,97,109
1,1832,1507,325,3,135,71
1,1692,1655,37,2,181,111
1,1648,1541,107,2,39,61
1,1630,1676,-46,3,77,69
1,1233,1249,-16,3,197,79
1,1778,1731,47,1,16,44
1,1903,1956,-53,0,146,91
0,1981,1939,42,0,-609,159
1,1473,1334,139,0,14,63
-1,1500,1697,-197,2,74,56
-1,1343,1342,1,-1,-72,76
-1,1636,1629,7,1,-5,92
1,1600,1791,-191,6,255,55
1,1940,1980,-40,0,127,119
1,1352,1579,-227,0,-2,53
-1,1510,1525,-15,-5,-252,122
1,1454,1303,151,7,224,53
1,1551,1564,-13,3,240,151
-1,1543,1417,126,0,-4,50
-1,1517,1574,-57,1,21,44
-1,1381,1476,-95,-2,-36,52
1,1630,1218,412,0,46,83
1,1754,1829,-75,-1,-68,109
1,1968,1952,16,1,175,77
-1,1492,1527,-35,0,-88,73
1,1774,1579,195,6,518,77
1,1130,1390,-260,0,-14,77
-1,1655,1811,-156,-4,-293,92
1,1526,1440,86,0,363,111
-1,1753,1470,283,-13,-463,56
-1,1609,1510,99,-4,-238,84
-1,1646,1702,-56,0,-109,64
1,1942,1978,-36,-1,-11,61
-1,1515,1788,-273,-6,-576,76
1,1641,1625,16,-2,-224,119
-1,1663,1643,20,0,-192,126
-1,1372,1557,-185,0,7,52
1,1966,1954,12,2,471,149
-1,1913,1830,83,1,-47,86
-1,1365,1400,-35,-8,-401,52
-1,1277,1524,-247,1,-20,62
1,1944,1976,-32,0,421,165
1,1275,1703,-428,8,86,49
-1,1916,1836,80,-5,-5,40
1,1499,1734,-235,-1,93,109
1,1656,1702,-46,1,197,97
-1,1600,1555,45,2,208,124
0,1415,1500,-85,4,219,118
-1,1366,1562,-196,-1,-27,80
-1,1902,1944,-42,-1,-32,48
-1,1614,1652,-38,-1,-14,66
-1,1717,2149,-432,-2,-255,108
1,2152,1715,437,0,81,68
-1,1573,1780,-207,-2,-80,84
1,1521,1467,54,3,92,51
1,1897,1933,-36,0,7,47
-1,1910,1953,-43,0,-17,54
-1,1412,1406,6,6,-118,72
1,1517,1542,-25,9,554,76
-1,1873,1685,188,-1,-31,58
1,1821,1598,223,-2,44,65
1,1662,1604,58,5,115,93
-1,1448,1481,-33,0,-330,130
-1,1644,2156,-512,-4,-150,70
1,1430,1575,-145,0,-7,45
1,1892,1792,100,0,44,55
1,1888,1503,385,0,-3,53
1,1584,1537,47,5,258,73
-1,1587,1563,24,-1,-20,54
1,1963,1901,62,0,48,85
-1,1172,1547,-375,-2,-331,108
-1,1921,1909,12,-5,-364,82
-1,1919,1909,10,0,-36,64
1,1626,1500,126,6,602,113
-1,1563,1711,-148,-3,-4,78
1,1646,1524,122,1,472,105
-1,1416,1397,19,0,-24,55
-1,1614,2158,-544,-8,-274,80
-1,1490,1628,-138,-1,-22,82
-1,1571,1497,74,-11,-158,50
-1,1360,1686,-326,5,94,44
1,1652,1777,-125,-1,-58,75
-1,1500,1906,-406,-3,15,84
1,1921,1909,12,-2,4,41
-1,1595,1672,-77,1,26,120
-1,1462,1825,-363,-5,-179,48
1,1900,1877,23,0,-248,115
1,1655,1424,231,4,247,69
-1,1899,1931,-32,-7,-73,80
1,1898,1500,398,13,217,43
1,2159,1613,546,-10,-100,67
1,1652,1710,-58,-2,-446,133
-1,1543,1922,-379,-1,-48,54
0,1892,1972,-80,-1,-297,137
-1,1562,1829,-267,-8,-48,42
-1,1676,1507,169,3,129,42
-1,1941,1889,52,1,84,76
1,1535,1549,-14,1,302,111
1,1712,1667,45,2,60,59
1,1802,1731,71,1,-145,117
-1,1357,1689,-332,-4,-66,48
1,2100,1498,602,1,71,77
1,1482,1009,473,-4,-138,75
-1,1657,1749,-92,0,-6,60
-1,1901,1929,-28,-5,-40,70
-1,1576,1562,14,-2,4,40
1,1854,1500,354,7,570,89
-1,1739,1938,-199,1,92,94
1,1510,1548,-38,5,248,57
1,1533,1528,5,1,387,85
1,1778,1648,130,-2,-64,65
1,1541,1511,30,1,160,84
1,1497,2101,-604,2,284,71
1,1938,1892,46,0,-192,95
0,1403,1362,41,-2,-124,74
-1,1625,1483,142,-3,-163,54
0,1716,1500,216,0,51,194
-1,1828,1706,122,-2,-486,148
-1,1622,1819,-197,1,34,54
-1,1350,1611,-261,-11,-490,66
1,1529,1431,98,-2,152,127
1,1487,1560,-73,9,39,41
0,1122,1454,-332,2,349,132
1,1432,1130,302,2,417,116
-1,1637,1424,213,-8,-1297,132
1,1642,1568,74,5,563,97
-1,1376,1558,-182,-6,-330,66
-1,1500,1641,-141,-1,-29,48
-1,1562,1576,-14,-3,-68,60
-1,1520,1707,-187,-2,-195,89
-1,1649,1723,-74,-6,-116,46
-1,1511,1864,-353,0,-91,82
1,1500,1429,71,0,-147,75
1,1549,1540,9,-2,14,61
-1,1661,1712,-51,-3,21,60
1,1753,1497,256,5,511,125
1,1763,1865,-102,-2,9,41
1,1551,1500,51,7,168,50
1,1644,1296,348,7,293,59
-1,1444,1386,58,-9,-223,46
1,1377,1256,121,7,621,83
-1,1389,1533,-144,-4,-461,67
-1,1674,1538,136,8,245,44
-1,1799,1796,3,-1,-24,102
-1,1649,1751,-102,-1,-325,120
1,1863,2061,-198,0,11,55
1,1583,1382,201,-1,0,62
1,1932,1825,107,-1,-78,63
-1,1564,1565,-1,-10,-143,44
1,1946,1606,340,5,49,51
1,1596,1684,-88,3,325,75
0,1599,1514,85,-1,-6,51
1,1606,1592,14,-1,-35,79
1,1807,1788,19,1,138,92
1,1639,1802,-163,-6,-7,87
0,1626,1486,140,-4,85,132
1,1126,1435,-309,-7,-61,67
-1,1908,1923,-15,-1,-95,60
1,1454,1500,-46,5,398,67
1,1514,1693,-179,-1,-38,117
1,1523,1514,9,1,139,86
0,1560,1651,-91,-1,-247,88
-1,1388,1671,-283,0,-42,76
1,1514,1358,156,1,777,147
-1,1646,1697,-51,-7,-178,56
-1,1940,1885,55,1,351,110
1,1229,1277,-48,3,79,54
0,1815,1938,-123,0,126,117
-1,1685,1549,136,-3,-345,162
0,1608,1661,-53,-6,-223,123
1,1564,1293,271,20,536,45
-1,1511,1493,18,-4,-141,70
1,1555,1304,251,4,133,51
1,1878,1563,315,-2,290,77
0,1942,1882,60,1,100,118
1,1927,1898,29,4,251,57
1,1785,1654,131,-1,113,121
-1,1648,1500,148,3,142,90
-1,1888,1937,-49,-1,-469,102
1,1514,1497,17,0,-18,69
-1,1224,1405,-181,-12,-1195,86
-1,1515,1503,12,-1,-12,68
1,1864,1798,66,0,78,85
1,1777,1817,-40,-2,151,97
1,1741,1707,34,-3,-117,79
1,1603,1950,-347,-2,-24,47
1,1586,1500,86,-1,-120,55
1,1620,1494,126,0,-41,87
1,1672,1667,5,0,-45,135
1,1623,1086,537,1,207,73
-1,1627,1530,97,-1,-237,100
1,1668,1262,406,3,109,53
1,1423,1462,-39,3,387,105
1,1463,1301,162,4,534,109
1,1805,1790,15,0,5,41
1,1628,1714,-86,2,27,45
-1,1268,1568,-300,-1,38,72
1,1518,1571,-53,3,95,53
-1,1564,1670,-106,-2,-3,43
-1,1562,1764,-202,0,-82,84
1,1650,1435,215,9,480,69
-1,1535,1592,-57,1,22,68
1,1946,1878,68,6,385,61
1,1955,2028,-73,-1,8,73
-1,1601,1636,-35,0,-61,88
1,1583,1549,34,-3,225,47
-1,1507,1535,-28,-1,-811,120
1,1479,1500,-21,4,172,63
1,1636,1484,152,1,203,83
1,1757,1492,265,1,148,103
1,1529,1259,270,7,247,63
-1,1490,1621,-131,1,10,58
-1,1823,1724,99,-3,80,116
1,1621,1637,-16,0,196,69
1,1678,1556,122,-3,55,95
-1,1266,1605,-339,-9,-99,42
-1,1602,1748,-146,5,69,62
1,1767,1601,166,0,-20,57
1,1381,1649,-268,0,548,113
-1,1779,1815,-36,-1,-49,74
-1,1500,1899,-399,0,-26,60
-1,1869,1969,-100,0,-174,94
-1,1712,1659,53,0,148,72
1,1789,1925,-136,-6,-39,47
0,1613,1545,68,0,-43,134
1,1825,1769,56,0,-14,75
1,1811,1768,43,-1,1,99
1,1533,1477,56,0,99,67
-1,1477,1539,-62,-3,-88,54
1,1736,1738,-2,-2,70,59
1,1977,1861,116,0,316,87
-1,1450,1390,60,-9,-91,48
-1,1932,1890,42,-4,-672,144
-1,1260,1348,-88,-8,-177,46
-1,1743,1685,58,-9,-239,56
-1,1487,1595,-108,-6,-182,82
-1,1467,1548,-81,0,-105,54
1,1647,1792,-145,1,7,57
1,1400,1282,118,6,699,97
-1,1299,1485,-186,-2,-216,66
-1,1887,1665,222,-1,-423,138
1,1237,1148,89,0,59,81
0,1839,1998,-159,-1,-461,153
1,1616,1397,219,4,279,69
1,1585,1771,-186,0,67,113
-1,1838,1803,35,-7,-306,84
1,1821,1678,143,2,102,89
-1,1834,1773,61,-1,5,84
1,1657,1422,235,12,769,75
-1,1713,1811,-98,0,-72,62
1,1377,1557,-180,-3,-178,79
-1,1505,1500,5,3,-66,90
1,1632,1709,-77,1,285,127
1,1358,1500,-142,9,165,43
-1,1248,1463,-215,-12,-210,46
-1,1394,1541,-147,2,152,78
-1,1844,1993,-149,-1,-81,98
1,1670,1828,-158,0,59,91
1,1837,1654,183,10,636,68
1,1755,1454,301,3,112,53
-1,1630,1884,-254,-3,-93,56
1,1740,1688,52,1,-25,73
1,2000,1837,163,0,3,49
1,1369,1288,81,10,418,51
0,1831,2006,-175,0,-375,127
1,1776,1663,113,-1,131,101
1,1469,1239,230,10,380,51
-1,1636,1809,-173,3,70,58
1,1387,1547,-160,3,335,63
1,1646,1591,55,6,228,47
1,1552,1417,135,0,146,67
1,1488,1762,-274,4,225,63
1,1450,1435,15,-1,-40,75
-1,1787,1821,-34,-1,-110,78
1,1812,1688,124,0,-248,121
1,1634,1523,111,7,365,78
-1,1479,1498,-19,-2,-67,62
1,1481,1371,110,-4,-43,61
-1,1836,2001,-165,-4,-465,100
1,1403,1532,-129,-5,4,77
1,1629,1543,86,1,651,191
1,1600,1657,-57,1,145,93
1,1380,1563,-183,-1,91,57
1,1601,1548,53,0,251,69
-1,1547,1462,85,1,80,48
-1,1632,1509,123,1,31,60
-1,1903,1913,-10,-2,-58,64
0,1835,1704,131,0,24,87
-1,2008,1830,178,0,143,112
-1,1643,1380,263,-4,-265,64
-1,1707,1747,-40,-2,12,60
-1,1408,1484,-76,-5,-28,40
1,1663,1303,360,18,471,49
1,1749,1819,-70,1,20,57
1,1515,1351,164,2,165,77
1,1679,1820,-141,4,286,75
-1,1549,1677,-128,-2,-40,46
-1,1370,1451,-81,1,21,50
-1,1969,1831,138,0,1,106
-1,1846,1991,-145,0,-323,70
0,1655,1784,-129,0,-45,93
1,1815,1779,36,-1,104,81
1,1804,1696,108,-6,85,109
1,1888,1282,606,11,470,59
-1,1582,1579,3,-1,-44,80
1,1776,1768,8,0,-18,123
1,1998,1839,159,0,38,57
1,1666,1597,69,0,26,63
0,1605,1566,39,-2,-85,69
-1,1403,1488,-85,-6,-158,66
1,1833,2005,-172,-1,-31,89
-1,1807,1763,44,1,5,56
1,1708,1812,-104,3,108,55
-1,1500,1664,-164,-3,-160,64
1,1869,1692,177,0,35,43
-1,1493,1399,94,-3,23,62
-1,1376,1754,-378,-3,-1195,104
-1,1419,1492,-73,1,57,44
1,1269,1202,67,-6,-33,86
1,1988,1849,139,5,200,53
1,1758,1688,70,1,126,83
-1,1846,1954,-108,0,-54,70
-1,1316,1361,-45,3,153,108
1,1498,1228,270,0,37,89
0,1842,1995,-153,-1,-507,121
-1,1468,1398,70,0,29,176
1,1629,1663,-34,-2,149,71
-1,1757,1897,-140,0,-587,164
1,1775,1795,-20,0,-25,55
1,1845,1850,-5,-1,6,49
-1,1741,1508,233,-6,-138,54
-1,1557,1661,-104,0,-11,112
1,1962,1838,124,4,101,45
1,1991,1847,144,3,501,143
0,1591,1571,20,0,-3,69
1,1690,1320,370,0,193,54
-1,1511,1494,17,-6,-119,42
-1,1483,1475,8,-6,-136,68
-1,1230,1503,-273,-2,-21,44
-1,1831,1969,-138,0,-191,82
-1,1423,1520,-97,-1,-8,40
-1,1840,1998,-158,-2,-663,110
1,1631,1400,231,0,26,75
-1,1321,1636,-315,0,-38,40
-1,1767,1936,-169,-1,-1,54
-1,1730,1820,-90,-1,-23,66
1,1918,1750,168,0,-209,147
1,1787,1627,160,-3,-16,105
1,2004,1833,171,12,166,47
-1,1677,1638,39,-1,-111,94
1,1503,1500,3,-6,-126,49
-1,1854,1875,-21,-3,77,78
1,1608,1784,-176,1,64,63
1,1833,2004,-171,-2,-184,75
1,1756,1372,384,1,531,149
1,1919,1740,179,2,230,97
-1,1954,2098,-144,0,-32,80
-1,1339,1283,56,1,353,90
1,1571,1590,-19,2,38,53
1,1976,1824,152,2,306,81
-1,1988,1827,161,3,238,98
1,1375,975,400,4,181,61
1,1528,1414,114,1,20,55
-1,1549,1533,16,0,90,102
1,1736,1825,-89,0,128,81
1,1638,1602,36,-3,0,89
-1,1645,1645,0,-7,-110,62
1,1289,1478,-189,2,413,141
0,1843,1972,-129,-1,-695,129
1,1858,2039,-181,-1,-3,43
1,1744,1935,-191,0,3,119
-1,1390,1603,-213,3,179,54
0,1793,1999,-206,-1,-387,145
1,1981,1561,420,0,29,47
1,1818,1982,-164,0,-138,119
1,1391,1622,-231,0,36,47
1,1336,1459,-123,-5,-170,49
1,1578,1583,-5,1,93,77
-1,1469,1536,-67,-3,-152,76
1,1317,1391,-74,0,-81,69
1,1610,1747,-137,-1,-50,67
1,1642,1685,-43,0,629,141
1,1968,1723,245,-3,-82,73
-1,1317,1663,-346,1,61,90
-1,1892,1760,132,-1,-78,60
-1,1682,1746,-64,0,-97,74
-1,1455,1847,-392,0,19,64
1,1530,1408,122,-3,-49,47
1,1397,1535,-138,5,181,47
1,2106,1387,719,4,70,46
-1,1733,1926,-193,0,-31,68
-1,1316,1156,160,1,32,58
-1,1718,1973,-255,-4,-164,54
1,1967,1833,134,0,124,92
-1,1500,1559,-59,5,78,42
-1,1462,1538,-76,0,-709,156
0,1670,1778,-108,-1,26,98
1,1772,1722,50,-4,-29,57
0,1882,1849,33,0,179,119
-1,1830,1399,431,-2,-65,62
1,1810,1812,-2,-2,-18,65
1,1511,1527,-16,2,517,97
1,1412,1551,-139,-1,-22,55
-1,1811,1789,22,0,-36,76
-1,1793,1999,-206,0,-22,102
-1,1329,1717,-388,-16,-142,40
1,1460,1546,-86,-2,-11,45
1,1977,1713,264,3,50,53
-1,1733,1424,309,-1,-84,92
-1,1850,1880,-30,-7,-228,56
-1,1282,1333,-51,-8,-311,56
-1,1437,1631,-194,-4,-274,86
-1,1611,1592,19,3,84,82
-1,1709,1981,-272,-3,-58,48
-1,2053,2014,39,-1,-30,60
0,1462,1309,153,7,472,67
-1,2080,1775,305,0,15,68
-1,1534,1607,-73,-2,-194,70
-1,1250,1301,-51,2,20,44
-1,1321,1531,-210,1,38,94
-1,1351,1446,-95,0,-150,96
-1,1578,1705,-127,-4,-185,64
1,1985,1816,169,0,7,41
0,1818,1712,106,0,-11,82
1,1617,1448,169,-1,94,55
1,1560,1451,109,9,73,42
1,1604,1633,-29,0,13,49
0,1186,1524,-338,-7,441,97
1,1516,1481,35,0,132,75
1,1460,1390,70,-2,119,103
1,1729,1623,106,1,27,67
1,1281,1402,-121,1,5,49
-1,1539,1835,-296,1,47,82
1,1632,1538,94,0,13,65
-1,1681,1722,-41,-1,-21,50
-1,1758,1772,-14,1,34,64
-1,1567,1452,115,5,124,54
-1,1457,1157,300,-5,-52,72
1,1691,1606,85,8,263,45
1,1382,1371,11,5,109,51
1,1680,1668,12,-6,-178,61
-1,1291,1509,-218,-6,-415,59
1,1258,1373,-115,-6,-368,71
-1,1478,1670,-192,-2,-309,72
-1,1597,1750,-153,-4,-104,50
-1,1114,1639,-525,9,182,48
-1,1783,1913,-130,-1,0,40
1,1500,1442,58,2,349,121
1,1755,1311,444,0,-1,55
-1,1534,1704,-170,0,-70,74
1,1372,1334,38,1,28,53
-1,1434,1566,-132,-2,-206,80
-1,1591,1758,-167,0,-1,86
-1,1539,1709,-170,-3,-49,44
1,1615,1471,144,3,390,61
1,1243,1443,-200,6,217,53
1,1664,1627,37,-1,232,87
1,1930,1776,154,2,145,69
-1,1658,1691,-33,3,175,84
-1,1621,1661,-40,0,-17,56
1,1844,1774,70,3,186,65
1,1831,1737,94,-1,114,101
1,1284,1415,-131,-1,259,87
1,2069,2199,-130,-1,-123,91
0,1579,1628,-49,-5,-162,50
-1,1402,1765,-363,-4,-284,74
-1,1544,1870,-326,1,9,104
1,1661,1605,56,1,-22,43
1,1583,1704,-121,-3,-274,71
-1,1507,1461,46,0,10,66
-1,1409,1541,-132,0,-29,50
1,1575,1573,2,6,200,51
-1,1608,1768,-160,-5,-432,124
-1,1613,1689,-76,-1,-101,98
1,1760,1700,60,5,135,57
1,1717,1557,160,0,9,61
1,1612,1621,-9,-1,73,81
1,1321,1220,101,0,-7,47
-1,1596,1757,-161,0,-61,114
-1,1638,1729,-91,-7,-136,52
1,1423,1659,-236,1,-1,63
-1,1704,1783,-79,-1,-808,130
-1,1587,1568,19,4,168,54
1,1963,1940,23,8,167,57
1,1438,1305,133,-9,-457,77
0,1700,1648,52,0,-5,99
1,1675,1472,203,1,46,57
1,1775,1575,200,6,195,67
-1,1350,1290,60,-1,-46,60
-1,1579,1989,-410,-1,-155,58
-1,1311,1204,107,0,-214,80
-1,1737,1782,-45,-6,-397,78
1,1863,1812,51,0,106,81
1,1516,1655,-139,-2,166,82
1,1649,1309,340,7,195,53
1,1873,1848,25,1,207,71
1,1710,1440,270,-1,453,121
-1,1551,1579,-28,-10,2,40
1,1202,1332,-130,11,735,67
1,1724,1487,237,1,89,97
1,1261,1382,-121,0,0,47
1,1992,1557,435,3,63,52
1,1649,1699,-50,5,80,41
-1,1110,1641,-531,2,107,72
1,1695,1792,-97,0,93,81
-1,1864,1535,329,0,-698,112
1,1765,1631,134,-3,-163,83
-1,1675,1707,-32,0,-24,62
-1,1637,1763,-126,0,82,108
1,1590,1687,-97,2,773,189
-1,1464,1689,-225,0,-35,62
1,1471,1306,165,7,401,75
1,1687,1662,25,0,-9,75
1,1617,1500,117,7,410,105
-1,1298,1315,-17,1,40,72
-1,1801,1994,-193,1,35,40
-1,1254,1267,-13,-7,-242,58
-1,1500,1465,35,-2,-56,52
1,1828,1885,-57,0,27,95
1,1590,1541,49,2,34,71
-1,1604,1659,-55,-9,-255,74
0,1682,1862,-180,0,239,118
1,1466,1681,-215,0,121,121
-1,1474,1459,15,-9,-319,56
1,1693,1576,117,0,39,57
-1,1310,1523,-213,0,-6,60
-1,1860,1627,233,-1,-34,47
-1,1528,1971,-443,-1,-119,114
1,1709,1622,87,3,31,87
-1,1481,1435,46,-4,-217,76
1,1778,1661,117,4,144,63
1,1642,1108,534,4,153,55
1,1652,1696,-44,0,95,93
1,2061,1727,334,2,52,91
-1,1477,1623,-146,-1,-35,68
1,1601,1628,-27,0,-3,57
-1,1771,1551,220,1,41,116
1,1312,1315,-3,-4,-69,61
-1,1836,2045,-209,0,-16,58
1,1741,1699,42,0,5,79
-1,1481,1592,-111,-4,-578,78
-1,1724,2065,-341,0,50,112
-1,1471,1462,9,-3,-416,78
0,1384,1550,-166,1,65,107
0,1533,1436,97,0,-15,144
1,1700,1500,200,0,103,101
-1,1368,1330,38,1,4,46
-1,1654,1785,-131,-1,-12,62
-1,1312,1335,-23,-9,-1,84
1,1558,1353,205,8,733,95
1,1079,1514,-435,-2,-24,73
-1,1685,1664,21,-7,-115,44
-1,1374,1623,-249,-10,-53,43
1,1599,1531,68,-4,-150,59
1,1831,1798,33,-3,-133,41
-1,1487,1613,-126,-3,-139,76
-1,1299,1612,-313,-5,-287,103
-1,1465,1455,10,-1,-60,64
-1,1613,1717,-104,-1,99,98
-1,1340,1564,-224,6,570,96
1,1841,1721,120,0,11,63
-1,1106,1644,-538,1,32,50
-1,1871,1852,19,1,37,80
-1,1470,1427,43,1,35,54
1,1675,1674,1,-3,78,121
-1,1538,1730,-192,-1,-19,40
1,1366,1368,-2,9,284,55
1,1848,1713,135,4,384,75
1,2084,2181,-97,-1,-48,79
-1,1624,1533,91,-4,-65,84
0,1328,1569,-241,-15,-1179,76
0,1469,1467,2,-1,-226,111
1,1327,1303,24,-3,-191,59
-1,1687,1822,-135,0,58,80
-1,1668,1630,38,0,-184,92
-1,1575,1500,75,-3,-230,56
1,1705,1539,166,0,151,83
1,1707,1603,104,1,405,103
-1,1539,1640,-101,0,-20,83
-1,1585,1611,-26,0,-129,140
0,1505,1284,221,-5,-162,133
1,1616,1238,378,13,685,71
-1,1706,1855,-149,1,-286,104
-1,1627,1319,308,0,-429,180
1,1531,1453,78,-3,165,99
1,1847,1802,45,-3,53,65
-1,1409,1748,-339,-4,-316,68
-1,1502,1647,-145,-2,-192,70
0,1473,1407,66,0,-26,167
1,1756,1295,461,3,128,78
-1,1617,1689,-72,-4,-22,110
-1,1726,1535,191,0,-173,68
1,1654,1595,59,-3,129,105
1,1605,1639,-34,-1,-28,47
-1,1663,1686,-23,-9,-697,92
-1,1466,1454,12,-4,-29,48
-1,1533,1736,-203,-1,-92,76
-1,1566,1567,-1,-8,-439,62
-1,1379,1505,-126,1,-95,88
-1,1608,1604,4,0,120,156
-1,1400,1555,-155,-13,-332,52
1,1618,1234,384,3,220,59
1,1606,1637,-31,7,252,55
1,1357,1378,-21,1,52,63
1,1974,1526,448,5,273,87
1,1439,1528,-89,1,41,85
1,1653,1551,102,-8,-96,83
0,1842,1834,8,-3,-59,130
-1,1531,1459,72,0,115,78
-1,1579,1659,-80,2,269,60
1,1540,1597,-57,1,223,81
-1,1103,0,1103,-3,-233,72
1,1625,1652,-27,0,59,71
-1,1699,1769,-70,-8,-456,82
1,1684,1695,-11,0,29,59
1,1469,1566,-97,1,158,63
-1,1625,1619,6,-3,-178,94
-1,1696,1715,-19,0,-77,86
1,1667,1570,97,7,450,67
1,1412,1471,-59,9,422,64
-1,1112,1506,-394,-5,-184,62
1,1778,1690,88,0,13,51
-1,1921,2098,-177,0,180,128
-1,1396,1181,215,-6,-292,70
-1,1236,1500,-264,-2,-229,74
1,1686,1487,199,3,366,97
-1,1445,1540,-95,0,199,118
1,1381,1354,27,1,411,145
1,1560,1426,134,3,127,69
1,2000,1791,209,-4,-82,53
1,1561,1675,-114,1,11,63
1,1284,1416,-132,7,40,41
1,1787,1628,159,1,67,53
-1,1782,1436,346,0,-15,44
-1,1660,1663,-3,0,-111,66
1,1709,1741,-32,1,46,71
0,1398,1284,114,-1,45,166
1,1267,1108,159,3,113,61
1,1769,1791,-22,1,132,101
1,1313,1483,-170,8,134,47
1,1375,1390,-15,13,708,59
-1,1543,1661,-118,0,-59,58
-1,1255,1578,-323,-1,-46,56
-1,1482,1670,-188,2,-42,81
1,1469,1523,-54,9,303,57
-1,1204,1623,-419,-1,-9,42
1,1586,1780,-194,-3,55,75
1,1518,1293,225,5,276,55
1,1686,1793,-107,-1,-13,59
1,1725,1570,155,0,-16,99
-1,1640,1649,-9,1,-10,74
1,1506,1453,53,1,50,67
1,1799,1613,186,3,189,63
-1,1467,1353,114,0,3,42
-1,1372,1388,-16,21,466,48
1,1517,1612,-95,-3,49,75
1,1400,1473,-73,0,23,53
1,1804,1733,71,2,178,79
-1,1679,1555,124,0,56,50
-1,1300,1525,-225,-1,-27,54
1,1626,1191,435,4,328,81
1,1388,1452,-64,-5,-60,45
1,1725,1728,-3,-1,-138,97
-1,1731,1858,-127,1,-304,66
-1,1778,1699,79,-8,-398,86
1,1908,1805,103,-1,68,101
-1,1511,1481,30,-3,-44,40
1,1725,1098,627,-2,-77,57
-1,1500,1656,-156,0,2,42
0,1799,1668,131,-1,-1,118
-1,1439,1517,-78,-8,-868,98
1,1436,1389,47,-1,39,85
1,1532,1277,255,1,101,67
1,1524,1545,-21,3,249,73
-1,1469,1392,77,-5,-132,54
-1,1798,1978,-180,0,-467,104
-1,1642,1617,25,-4,1,56
1,2099,2005,94,-2,-112,47
-1,1580,1529,51,-2,-39,46
1,1552,1430,122,0,11,91
-1,1295,1490,-195,-5,-241,70
1,1241,1568,-327,-1,276,143
0,1493,1499,-6,0,11,89
1,1512,1589,-77,-6,-27,95
1,1835,1929,-94,0,89,69
1,1724,1536,188,0,168,101
-1,1712,1764,-52,-1,-181,82
-1,2021,1439,582,1,18,88
1,1526,1495,31,4,90,55
-1,1591,1588,3,0,-45,77
1,1775,1607,168,1,8,49
1,1571,1647,-76,1,30,45
1,1725,1681,44,10,802,93
1,1550,1331,219,-2,-9,43
-1,1781,1601,180,2,25,42
-1,1446,1466,-20,2,-129,74
-1,1602,1774,-172,0,-71,116
-1,1672,1795,-123,0,-157,94
1,1357,1500,-143,-2,87,51
-1,1392,1550,-158,-9,-785,130
1,1673,1524,149,0,40,79
-1,1713,1573,140,-3,1,58
1,1538,1424,114,-1,-38,59
1,1661,1537,124,4,212,69
-1,1671,1736,-65,-7,-738,74
-1,1689,1617,72,-3,48,90
0,1694,1695,-1,0,0,138
1,1774,1703,71,3,429,103
-1,1673,1630,43,0,-8,64
1,1581,1606,-25,7,229,55
1,1718,1730,-12,-1,431,129
-1,1390,1368,22,3,155,66
1,1548,1373,175,3,809,139
-1,1630,1842,-212,-8,-37,50
-1,1666,1893,-227,-7,-56,84
1,1659,1642,17,7,803,87
1,1771,1662,109,2,273,81
-1,1436,1469,-33,0,-105,70
-1,1606,1750,-144,2,109,82
1,1556,1717,-161,3,212,77
0,1570,1761,-191,-4,-91,118
-1,1768,1656,112,0,-8,58
0,1537,1629,-92,6,538,109
1,1671,1632,39,-2,30,51
1,1593,1674,-81,0,19,99
-1,1417,1920,-503,-17,-869,64
-1,1405,1432,-27,-2,-174,58
-1,1394,1536,-142,3,-58,86
-1,1682,1622,60,2,-57,66
1,1962,1908,54,0,13,111
1,1615,1289,326,13,388,49
1,1704,1643,61,1,-65,161
-1,1174,1706,-532,-13,-208,60
-1,1627,1716,-89,-6,-57,54
-1,1292,1403,-111,-5,-580,102
-1,1432,1764,-332,0,-10,64
1,1874,1982,-108,-1,-324,95
1,1584,1352,232,-1,27,75
-1,1618,1707,-89,-1,-37,56
1,1410,1765,-355,1,228,82
1,1639,1296,343,0,-44,73
-1,1382,1762,-380,-8,-192,58
1,1716,1610,106,5,653,127
1,1302,1312,-10,-6,-173,71
1,1544,1439,105,1,0,65
-1,1919,1768,151,0,-110,122
-1,1865,1744,121,-6,-15,40
-1,1411,1633,-222,0,7,74
-1,1759,1997,-238,-3,-31,42
-1,1240,1611,-371,-7,-72,42
1,1356,1042,314,18,396,47
-1,1476,1620,-144,-9,-676,84
-1,1439,1844,-405,0,-289,156
-1,1531,1642,-111,1,-30,90
1,1347,1528,-181,-2,-21,69
-1,1868,1643,225,-7,-649,132
-1,1601,1179,422,1,1,42
1,1500,1725,-225,-2,-46,49
-1,1484,1754,-270,1,213,72
-1,1453,1480,-27,2,243,76
-1,1849,1785,64,0,3,60
1,1581,1251,330,1,274,79
-1,1343,1286,57,-5,-167,66
1,1967,1894,73,5,257,77
-1,1417,1901,-484,-3,-149,64
1,1713,1823,-110,-1,195,61
1,1890,1822,68,1,-16,59
1,1659,1228,431,0,67,71
0,1613,1527,86,-1,-6,60
1,1794,1509,285,0,-33,75
-1,1683,1688,-5,0,-13,76
1,1470,1624,-154,2,424,111
1,1274,1620,-346,1,35,43
1,1783,1740,43,0,-9,91
1,2005,1885,120,1,503,95
1,1647,1725,-78,4,393,91
1,1623,1565,58,3,168,63
1,1644,1572,72,-3,261,110
-1,1319,1584,-265,2,43,46
1,1758,1479,279,-1,41,75
-1,1623,1557,66,-2,-205,90
-1,1142,1368,-226,-5,-182,76
1,1431,1552,-121,-1,43,51
1,1737,1597,140,2,91,75
-1,1500,1546,-46,-4,-10,42
-1,1689,1814,-125,1,-111,166
-1,1878,2019,-141,-1,-189,70
-1,1638,1192,446,0,-51,70
1,1313,1390,-77,3,442,85
-1,1537,1612,-75,1,44,76
-1,1476,1363,113,-1,-198,70
-1,1437,1455,-18,-3,-265,80
-1,1589,1745,-156,-1,-138,70
1,1630,1435,195,0,320,101
1,2029,2081,-52,0,-17,105
1,1711,1643,68,0,-1,83
-1,1650,1954,-304,-1,-35,56
1,1765,1845,-80,0,31,79
0,1537,1447,90,-1,-214,158
-1,1477,1391,86,-2,-473,86
1,1809,1969,-160,1,17,63
1,1480,1625,-145,-1,-12,47
-1,1433,1080,353,-2,14,40
-1,1636,1603,33,3,95,84
-1,1941,1906,35,-2,-125,64
-1,1534,1606,-72,0,41,66
-1,1398,1857,-459,-2,-63,71
1,1567,1764,-197,-7,-154,41
1,1806,1990,-184,0,31,85
0,1443,1301,142,-2,-489,162
-1,1832,1779,53,1,-215,110
1,1418,1500,-82,2,149,91
1,1746,1586,160,-1,30,53
1,1570,1713,-143,-2,-37,41
0,1616,1499,117,0,27,127
-1,1579,1753,-174,-3,-108,60
-1,1505,1814,-309,1,23,66
1,1733,1345,388,3,175,55
-1,1871,1767,104,0,-127,64
-1,1767,1566,201,-1,-29,64
1,1525,1615,-90,1,398,93
1,1529,1646,-117,0,9,59
1,1180,1326,-146,10,261,47
1,1976,1625,351,1,172,97
1,1828,1563,265,-2,-57,51
1,1653,1847,-194,-3,194,89
-1,1565,1766,-201,-1,-15,44
-1,1588,1603,-15,-11,-289,64
1,1783,1856,-73,2,120,55
1,1477,1762,-285,2,23,83
1,1248,1380,-132,5,297,83
-1,1108,1354,-246,-3,-105,52
1,1869,1355,514,3,44,43
-1,1371,1657,-286,0,-30,86
-1,1853,1720,133,0,-107,86
1,1843,1797,46,1,28,61
-1,1660,1839,-179,0,9,50
1,2032,2079,-47,0,37,71
1,1871,1354,517,-4,-102,53
-1,1407,1577,-170,-7,-514,76
-1,1622,1979,-357,-1,-68,74
1,1506,1743,-237,2,224,89
-1,1579,1753,-174,-4,-201,56
0,1475,1573,-98,0,789,144
-1,1405,1463,-58,3,30,70
1,1534,1257,277,0,9,57
1,1396,1353,43,-2,-153,85
-1,1411,1422,-11,4,38,44
-1,1638,1610,28,-4,-25,82
-1,1872,1789,83,-1,6,64
1,1760,1572,188,0,-10,63
1,1620,1533,87,1,86,81
-1,1654,1873,-219,-3,-17,46
-1,1806,2062,-256,-1,-12,45
-1,1460,1570,-110,3,119,108
-1,1720,1986,-266,-1,-25,46
-1,1525,1613,-88,-1,-25,43
-1,1541,1310,231,-3,-101,60
1,1408,1341,67,-1,-56,51
1,2066,1801,265,-6,-101,63
1,2066,2044,22,-2,-28,55
1,1550,1538,12,4,25,47
1,1852,1583,269,6,217,61
1,1936,1928,8,1,74,59
1,1569,1478,91,5,217,83
-1,1520,1628,-108,-2,-160,72
-1,1496,1529,-33,0,-32,48
1,1536,1475,61,-1,525,95
-1,1615,1564,51,-5,-156,63
-1,1559,1465,94,-1,-329,78
1,1330,1418,-88,2,65,83
-1,1889,1881,8,-3,-517,118
1,1579,1613,-34,-8,346,107
1,1468,1551,-83,8,126,43
1,1818,1856,-38,-12,-316,115
1,1400,1107,293,8,368,67
1,1481,1715,-234,0,-61,75
-1,1687,1614,73,-1,-26,60
-1,1343,1457,-114,-3,33,48
-1,2008,1816,192,0,-123,98
1,1730,1849,-119,-2,127,99
-1,1472,1621,-149,-5,-270,74
1,1509,1575,-66,-1,-13,101
-1,1469,1581,-112,-2,-127,72
-1,1537,1636,-99,1,191,118
1,1527,1561,-34,4,230,73
1,1621,1500,121,3,88,49
-1,1691,1649,42,1,-34,62
-1,1590,1500,90,-5,-243,66
-1,1732,1620,112,-2,-32,52
1,1720,1432,288,-2,26,65
-1,1697,1808,-111,1,-41,97
-1,1844,1830,14,0,-73,68
1,1712,1628,84,0,38,89
1,1402,1346,56,0,243,119
-1,1591,1604,-13,-7,-803,104
-1,1263,1276,-13,2,31,80
-1,1325,1368,-43,-8,-374,82
-1,1581,1725,-144,-3,-341,76
-1,1539,1621,-82,0,-44,140
-1,1304,1601,-297,-1,-49,54
-1,1533,1598,-65,-3,-356,100
1,1841,1832,9,7,254,63
-1,1417,1422,-5,-2,53,76
-1,1286,1253,33,1,-84,40
1,1591,1460,131,-6,-306,71
1,1819,1944,-125,4,64,41
1,1545,1335,210,2,69,55
1,1822,1851,-29,1,161,109
-1,1580,1575,5,-11,-1025,132
1,1491,1295,196,-1,-35,53
1,1265,1274,-9,-4,-82,53
1,1776,1480,296,1,96,91
-1,1370,1323,47,3,67,56
1,1716,1485,231,0,66,71
1,1989,1558,431,9,274,45
1,1549,1540,9,7,534,83
-1,1644,1764,-120,0,-58,66
1,1724,1430,294,-3,-50,45
-1,1765,1889,-124,-2,-14,42
-1,1467,1879,-412,-1,-159,92
-1,1263,1275,-12,1,38,48
-1,2001,2071,-70,-2,-55,48
-1,1840,1833,7,1,-43,40
1,1632,1321,311,0,15,57
1,1627,1428,199,8,124,47
1,1642,1500,142,1,57,45
-1,1503,1821,-318,-1,135,94
-1,1358,1642,-284,-3,7,68
1,2081,1953,128,1,533,105
1,1845,1829,16,-2,-158,65
1,1285,1253,32,8,138,59
-1,1932,1561,371,1,9,44
-1,1917,1948,-31,-1,-77,94
-1,1625,1570,55,-2,-183,54
1,1754,1420,334,8,257,51
-1,1772,1939,-167,2,48,48
1,1577,1520,57,0,116,81
-1,1413,1359,54,0,-35,80
1,1758,1975,-217,1,-3,45
1,1833,1843,-10,0,-5,47
0,2089,2077,12,0,23,118
-1,1244,1295,-51,-5,-203,80
1,1633,1682,-49,3,88,87
-1,1500,1727,-227,-2,-57,62
-1,1919,1713,206,-10,-416,124
1,1886,1774,112,-2,136,77
1,1586,1766,-180,-1,-15,45
-1,1529,1560,-31,4,-139,90
1,1861,1832,29,-3,-43,97
1,1672,1503,169,1,182,99
-1,1407,1677,-270,-2,1,66
-1,1102,1456,-354,-4,-317,76
-1,1304,1235,69,-2,-100,58
-1,1524,1848,-324,-9,-425,134
-1,1921,1766,155,0,16,60
1,1994,1855,139,-1,-27,59
-1,2077,2088,-11,-1,3,76
-1,1515,1847,-332,1,18,80
-1,1637,1766,-129,-1,-124,90
1,1247,1291,-44,-2,-33,61
1,1848,2001,-153,0,22,81
-1,1722,1884,-162,-5,-322,84
-1,1432,1664,-232,-2,-92,108
1,1551,1511,40,-1,-24,73
1,1487,1531,-44,3,127,73
1,1781,1698,83,-2,-38,49
-1,1630,1436,194,0,-63,72
1,1287,1636,-349,1,19,79
1,1524,1357,167,2,64,69
-1,1613,1607,6,-7,-139,48
-1,1350,1413,-63,-6,-125,46
1,1859,1715,144,1,242,97
1,1280,1259,21,3,149,75
1,1487,1431,56,2,56,61
-1,1459,1888,-429,-1,-63,56
0,1552,1397,155,-3,151,134
1,1586,1430,156,0,90,57
-1,2100,2066,34,5,-192,78
1,1774,1629,145,2,32,43
1,1645,1670,-25,1,-227,79
1,1671,1906,-235,0,-18,47
1,1748,1864,-116,4,234,103
1,1724,1654,70,0,-6,81
-1,1826,1720,106,0,-324,158
-1,1623,1512,111,10,194,80
-1,1884,1527,357,3,118,66
-1,922,1378,-456,1,-253,112
-1,1570,1519,51,0,34,72
1,1618,1399,219,0,23,83
-1,1822,1872,-50,-3,-66,48
1,1780,1619,161,-2,-71,71
1,1793,1497,296,2,114,73
1,1613,1631,-18,3,65,45
1,1759,1708,51,-6,-98,55
-1,1259,1497,-238,0,35,44
0,1764,1868,-104,0,-17,115
1,2078,2087,-9,0,241,129
1,1819,1849,-30,0,265,171
-1,1780,1751,29,-1,-619,160
1,1890,1457,433,-5,254,85
1,1450,1302,148,3,76,51
1,1603,1582,21,-4,-65,75
1,1825,1700,125,1,13,59
1,1570,1494,76,1,76,71
-1,1195,1662,-467,-6,-75,47
1,1796,1441,355,-1,92,91
1,1846,1344,502,-6,165,83
-1,1528,1608,-80,1,-173,76
-1,1554,1816,-262,-1,-203,90
-1,1859,1767,92,1,12,47
1,1825,1500,325,2,43,47
-1,1746,1712,34,-3,-693,158
1,1500,1476,24,0,77,77
-1,1837,1830,7,-4,-29,76
1,1451,1583,-132,6,503,77
-1,1781,1823,-42,-5,-168,52
1,1427,1351,76,-1,-25,85
-1,1698,1691,7,0,8,50
1,1584,1601,-17,-5,-28,69
1,1679,1813,-134,0,85,71
-1,1771,1847,-76,0,16,48
1,2074,2090,-16,0,-5,93
1,1657,1493,164,1,-49,95
1,1668,1625,43,-4,-97,55
1,1332,1530,-198,-1,552,105
1,1377,1428,-51,0,25,47
1,1370,1378,-8,-4,-51,49
0,1589,1595,-6,0,253,103
0,1303,1402,-99,-3,-61,141
1,1830,1548,282,4,104,49
1,1826,1762,64,-2,-49,61
-1,1467,1193,274,-6,-95,64
1,1495,1418,77,5,258,59
0,1622,1737,-115,2,757,166
-1,1591,1560,31,-2,51,64
1,1048,1361,-313,0,-5,55
1,1886,1607,279,0,14,79
-1,1263,1436,-173,-3,-157,65
1,1459,1601,-142,2,69,57
-1,1571,1656,-85,3,-77,76
-1,1345,1594,-249,0,-50,48
1,1517,941,576,13,253,47
1,1578,1600,-22,0,637,117
1,1851,1700,151,-2,-57,57
1,1722,1625,97,0,145,111
-1,1664,1997,-333,-1,-41,70
-1,1579,1572,7,7,532,82
-1,1613,1838,-225,-4,-90,44
1,1495,1331,164,-2,-107,69
1,1847,1679,168,2,50,142
1,1571,1593,-22,-1,177,59
1,1759,1702,57,0,106,95
-1,1639,1644,-5,-6,-181,58
-1,1675,1583,92,-2,-10,54
1,1536,1820,-284,0,15,99
-1,1661,1744,-83,-4,-144,66
-1,1504,1454,50,0,-40,64
-1,1514,1706,-192,-2,-59,152
-1,1777,1611,166,0,-8,52
-1,1494,1469,25,-7,-216,66
1,1711,1796,-85,0,147,117
-1,1429,1575,-146,1,-23,132
-1,1269,1790,-521,-2,-217,66
-1,1198,1529,-331,0,-53,116
1,1519,1409,110,6,288,65
1,1704,1891,-187,-9,66,103
-1,1716,1715,1,0,6,84
-1,1773,1916,-143,-1,-61,68
-1,1252,1330,-78,-6,-413,71
-1,1972,1671,301,2,-7,128
-1,1626,1726,-100,0,-24,80
-1,1377,1605,-228,2,16,46
1,2004,1753,251,1,107,105
1,1679,1901,-222,-3,-220,79
-1,1493,1750,-257,-1,-65,72
-1,1498,1469,29,2,169,102
-1,1820,1622,198,-2,-50,58
-1,1508,1884,-376,0,-8,64
1,2081,1532,549,1,49,73
-1,1618,1610,8,0,191,58
-1,1257,1390,-133,-19,-1038,77
-1,1590,1500,90,-2,-67,90
1,1614,1645,-31,1,78,57
-1,1686,1657,29,-4,-35,40
-1,1402,1485,-83,-8,-39,40
-1,1762,1716,46,-7,-585,78
-1,1492,1524,-32,-2,-12,48
0,1805,1852,-47,0,59,102
-1,1622,1729,-107,-3,7,68
1,1573,1769,-196,-1,274,147
1,1654,1642,12,1,82,65
-1,1499,1871,-372,0,-169,103
-1,1580,1583,-3,-1,-979,142
1,2160,1500,660,3,70,53
-1,1539,1483,56,0,-233,74
1,1493,1393,100,4,108,43
-1,1562,1527,35,-3,-192,84
1,1715,1654,61,2,107,63
-1,1693,1828,-135,0,11,76
1,1661,1621,40,3,599,93
1,1520,1614,-94,3,917,97
1,1649,1596,53,0,0,45
-1,1388,1514,-126,-3,-142,66
-1,1607,1748,-141,0,-16,74
-1,1804,1797,7,1,24,70
1,1792,1265,527,9,354,61
-1,1536,1541,-5,0,-144,102
-1,1532,1665,-133,-5,-152,64
-1,1567,1753,-186,-6,-221,64
-1,1696,1883,-187,-3,-78,74
1,1535,1553,-18,0,-51,141
-1,1561,1583,-22,-17,-576,60
-1,1662,1645,17,1,-4,56
1,1872,1611,261,1,199,75
1,1626,1605,21,10,227,58
-1,1422,2175,-753,0,3,64
1,1677,1607,70,6,433,71
1,1551,1534,17,5,109,49
-1,1748,1877,-129,0,2,44
1,1334,1435,-101,0,-30,79
1,1508,1572,-64,7,107,47
1,1885,1741,144,-9,-23,41
1,1851,1807,44,-3,151,81
-1,1672,1635,37,0,-141,92
1,1474,1359,115,0,-29,59
1,1734,1893,-159,-5,-32,63
1,1764,1600,164,1,377,85
1,1791,1588,203,-3,49,91
-1,1471,1549,-78,1,-132,92
1,1816,1656,160,0,32,53
-1,1614,1590,24,-1,1,66
-1,1875,1750,125,0,-267,112
-1,1608,1713,-105,-3,-205,90
-1,1594,1778,-184,-4,49,94
1,1802,1572,230,-1,69,55
-1,1423,1743,-320,-4,-72,58
1,1977,1439,538,0,233,87
-1,1561,1760,-199,-4,-145,60
-1,1765,1859,-94,7,31,40
1,1602,1601,1,1,127,61
1,2137,2009,128,0,-62,115
-1,1525,1609,-84,0,-200,78
-1,1650,1822,-172,0,-51,82
1,1594,1521,73,-1,-46,87
1,1810,1793,17,0,55,113
1,1690,1787,-97,1,32,55
-1,1637,1523,114,-2,-316,138
1,1868,1613,255,2,64,73
-1,1753,1719,34,-4,-58,47
-1,1675,1678,-3,0,-117,71
-1,1562,1591,-29,1,42,54
0,1611,1532,79,3,218,132
1,1568,1371,197,1,585,103
-1,1799,1599,200,-1,-301,120
-1,1609,1872,-263,0,-1,68
1,1665,1500,165,3,86,51
1,1347,1455,-108,4,94,53
1,1811,1567,244,2,111,63
-1,1750,1553,197,-1,21,58
1,1504,1513,-9,0,543,143
-1,1828,1644,184,0,-75,92
0,1355,1573,-218,1,368,113
0,1797,1860,-63,0,32,130
-1,1495,1527,-32,-12,-132,40
1,1877,1605,272,-3,-279,83
-1,1497,1482,15,2,280,96
0,1555,1546,9,-1,-67,106
-1,1772,1704,68,-1,-59,96
1,1436,1364,72,-1,-22,59
-1,1568,1372,196,0,-943,96
-1,1614,1569,45,-5,-267,68
1,1820,1552,268,-1,-9,49
1,1583,1601,-18,-3,-50,53
1,1574,1520,54,-2,206,109
-1,1601,1881,-280,0,-83,72
1,1548,1500,48,-4,-59,53
-1,1500,2031,-531,0,-5,56
-1,1819,1891,-72,1,-775,118
1,1573,1403,170,1,447,99
1,1594,1589,5,0,-1,59
-1,1470,1833,-363,-6,-473,76
1,1419,1774,-355,0,122,87
-1,1552,1555,-3,1,71,76
1,1537,1485,52,10,135,45
-1,1660,1812,-152,-7,-153,50
1,1885,1597,288,-5,-136,51
1,1767,1673,94,1,-32,67
1,1828,1473,355,6,422,71
1,1662,1691,-29,0,-82,107
-1,1294,1231,63,-13,-655,76
1,1500,1605,-105,0,39,99
1,1353,1447,-94,-1,-44,43
0,1865,1550,315,-3,-101,90
1,1590,1560,30,3,256,141
1,1742,1653,89,-2,-36,61
1,1250,1361,-111,-1,103,45
-1,1807,1858,-51,0,-135,154
1,1551,1555,-4,2,62,57
-1,1593,1890,-297,1,41,58
1,1720,1287,433,6,67,43
-1,1566,1837,-271,-8,-363,84
1,1452,1541,-89,-1,-170,67
-1,1535,1603,-68,1,277,234
1,1429,1370,59,-1,-42,59
1,2093,1673,420,1,25,45
-1,1735,1596,139,-3,-598,72
-1,1893,1589,304,-2,-91,54
-1,1421,1558,-137,0,-28,66
1,1546,1555,-9,-3,36,65
1,1562,1593,-31,-6,-72,57
-1,1928,1654,274,2,120,82
-1,1611,1673,-62,-4,-37,50
-1,1605,1596,9,0,44,78
1,1854,1462,392,1,180,109
0,1609,1872,-263,0,-97,124
1,1457,1536,-79,-9,-143,71
-1,1671,2096,-425,1,54,90
-1,1431,1773,-342,-3,-157,66
1,1901,1385,516,0,63,61
-1,1359,1441,-82,4,208,86
-1,1459,1476,-17,-4,-334,68
-1,1472,1811,-339,-3,-38,76
-1,1599,2032,-433,-3,-278,110
1,1782,1822,-40,1,48,51
-1,1726,1717,9,0,-2,66
-1,1608,1593,15,0,11,108
1,1544,1562,-18,9,564,89
1,1522,1470,52,8,230,75
1,1869,1654,215,0,128,71
-1,1864,1617,247,-3,-138,56
1,1858,1799,59,-3,25,81
1,1655,1592,63,-3,-119,49
0,1657,1673,-16,-1,-228,128
1,1636,1844,-208,0,74,67
1,1605,1596,9,5,434,95
-1,1461,1532,-71,-2,-13,60
1,1452,1349,103,-3,-97,55
1,1671,1494,177,1,-6,54
1,1717,1584,133,-2,80,79
-1,1779,1750,29,-1,-74,86
0,1843,1926,-83,-5,-17,92
-1,1485,1541,-56,0,7,48
-1,1538,1622,-84,0,-12,68
-1,1995,1927,68,3,122,58
1,1543,1558,-15,5,116,45
-1,1830,1808,22,-1,-116,74
1,1776,1428,348,0,117,65
1,1541,1452,89,0,109,67
-1,1585,1617,-32,-2,-417,94
-1,1825,1992,-167,0,-9,52
1,1718,1568,150,5,238,59
-1,1395,1577,-182,1,26,46
1,1524,1604,-80,2,6,89
-1,1500,1422,78,-7,-357,78
1,1902,1591,311,7,591,89
-1,1340,1462,-122,5,205,64
1,1999,1818,181,4,250,69
-1,1690,1805,-115,0,4,48
1,1728,1671,57,1,41,43
-1,1443,1549,-106,-3,-203,98
1,2034,1814,220,0,13,61
-1,1416,1382,34,-3,-107,56
-1,1672,1658,14,-1,19,90
1,1867,1794,73,0,11,61
1,1631,1780,-149,-3,72,115
1,1750,1654,96,0,91,79
1,1787,1654,133,-2,-53,61
-1,1720,1418,302,-2,-78,70
1,1519,1653,-134,1,615,171
1,2005,1812,193,1,37,47
1,1557,1435,122,12,367,89
-1,1694,1593,101,-3,-128,64
-1,1471,1332,139,2,-86,102
0,1661,1737,-76,-1,-71,79
1,1550,1555,-5,0,74,75
1,1846,1718,128,1,565,105
-1,1805,2011,-206,1,-216,64
-1,1397,1204,193,0,14,40
-1,1601,1647,-46,-5,-133,62
1,1942,1969,-27,0,3,63
1,1819,1321,498,0,-9,41
1,1680,1608,72,10,343,67
-1,1546,1721,-175,-2,-254,102
-1,1564,1245,319,-1,44,40
1,1604,1609,-5,-1,-307,121
-1,1579,2040,-461,-6,-509,102
1,1791,1758,33,2,137,89
-1,1809,1906,-97,1,39,102
-1,1590,1590,0,1,-210,82
1,2016,1799,217,-1,101,77
1,1627,1428,199,0,10,67
-1,1648,1896,-248,0,2,42
-1,1772,1825,-53,-6,-118,63
1,1669,1602,67,0,-2,51
-1,1825,1600,225,-1,-170,118
-1,1349,1452,-103,-4,-179,76
1,1676,1565,111,7,411,71
1,1689,1605,84,1,32,123
-1,1735,1664,71,-8,-311,66
1,1432,1316,116,-1,-40,61
-1,1422,1633,-211,-1,-12,60
-1,1657,1590,67,-3,-64,60
-1,1794,2021,-227,-1,-42,52
-1,1601,1731,-130,-1,-57,52
1,1786,1153,633,4,400,113
1,1574,1436,138,3,329,83
1,1500,1213,287,0,350,71
-1,1756,1545,211,-3,-977,122
1,1604,1643,-39,0,-44,61
-1,2026,1789,237,1,67,82
1,1638,1417,221,1,51,79
1,2098,1595,503,-1,-9,69
-1,1593,1667,-74,3,149,54
-1,1677,1601,76,-1,-38,50
-1,1579,1723,-144,-2,-52,54
1,1630,1463,167,0,68,141
1,1748,1800,-52,-1,-36,63
1,1887,1879,8,0,58,73
-1,1505,1487,18,-2,-23,58
-1,1506,1549,-43,-2,-74,60
1,1656,1500,156,-3,-19,63
1,1677,1682,-5,3,-3,41
1,1677,1722,-45,0,72,69
1,1744,1596,148,9,865,129
-1,1412,1644,-232,1,4,56
-1,1630,1617,13,0,-12,56
1,1614,1664,-50,-1,283,151
1,1353,1411,-58,-2,89,63
1,1452,1569,-117,-3,-160,85
1,1870,1728,142,0,96,107
1,1672,1798,-126,3,206,93
-1,1561,1725,-164,-4,-250,68
1,1827,1619,208,0,65,57
1,1649,1407,242,1,-30,75
-1,1372,1270,102,-4,-324,92
1,1537,1536,1,-7,247,111
1,1599,1795,-196,0,23,47
-1,1803,1844,-41,0,-216,90
1,1608,1612,-4,-6,-228,101
0,1675,1425,250,3,162,128
1,1693,1752,-59,4,65,61
-1,1678,1653,25,-4,-40,62
1,1685,1526,159,0,217,93
-1,1708,1644,64,-1,-178,84
-1,1635,1683,-48,0,-272,108
-1,1548,1615,-67,-6,-274,70
-1,1315,1542,-227,-4,-219,60
1,1854,1793,61,-1,-78,115
1,1694,1652,42,2,55,63
-1,1416,1738,-322,0,-31,52
0,1382,1382,0,1,-55,127
1,900,1171,-271,-3,-36,47
1,1788,1791,-3,0,10,103
1,1625,1538,87,0,-203,85
-1,1585,1466,119,0,20,46
-1,1547,1889,-342,-4,-277,82
1,1564,1590,-26,0,-7,83
1,1883,1839,44,-1,-21,49
-1,1781,1401,380,0,-43,68
1,1907,1253,654,1,114,67
1,1500,1269,231,17,507,51
-1,1773,1504,269,-10,-220,48
1,1656,1692,-36,-1,23,63
1,1736,1658,78,1,48,55
-1,1529,1634,-105,-1,41,66
-1,1706,1603,103,-9,-119,68
1,1523,1276,247,-1,-5,41
1,1652,1508,144,1,318,117
1,1358,1469,-111,19,1090,81
-1,1642,1521,121,0,-64,52
-1,1405,1495,-90,-1,-355,128
-1,1533,2015,-482,-2,-12,42
1,1742,1669,73,1,60,50
-1,1536,1626,-90,6,248,98
-1,1566,1765,-199,1,-333,106
-1,1815,1868,-53,0,12,45
1,1573,1500,73,0,-29,99
0,1523,1510,13,-1,17,148
-1,1621,1569,52,1,-55,64
1,1620,1666,-46,0,-10,81
1,1590,1273,317,3,603,85
1,1547,1473,74,-1,211,67
-1,1425,1545,-120,-4,-280,72
-1,1278,1143,135,0,-753,152
1,1635,1527,108,16,783,81
-1,1306,1252,54,-2,-147,110
1,1578,1576,2,3,587,153
1,1611,1688,-77,0,110,71
-1,1393,1319,74,0,-292,108
-1,1692,1597,95,1,132,116
1,1878,1685,193,-3,-154,79
-1,1242,1528,-286,-6,-64,48
-1,1333,1582,-249,1,-30,52
1,1800,1573,227,1,71,63
-1,1660,1750,-90,-4,-69,106
1,1456,1298,158,7,9,41
1,989,0,989,-14,-202,41
1,1643,1535,108,0,19,69
-1,1455,1696,-241,0,-7,48
1,1975,2165,-190,-1,-63,65
-1,1358,1808,-450,-1,-251,132
1,1659,1552,107,-4,-143,55
1,1296,1469,-173,3,59,55
1,1432,1451,-19,17,1042,79
-1,1277,1463,-186,-8,-469,64
-1,1293,1647,-354,-11,-114,44
-1,1310,1373,-63,-3,-77,46
-1,1537,1552,-15,-6,-433,94
-1,1720,1779,-59,0,-123,82
1,1565,1589,-24,0,23,55
-1,1417,1457,-40,-5,-249,92
-1,1701,1450,251,-1,-261,132
1,1746,1384,362,1,38,63
-1,1226,1782,-556,0,-27,68
1,1500,1614,-114,2,96,73
-1,1681,1556,125,-1,47,84
1,1570,1752,-182,1,35,49
-1,1264,1520,-256,-6,-55,42
-1,1544,1666,-122,1,-4,64
1,1654,1527,127,0,96,78
1,1492,1465,27,-3,174,91
1,1791,1577,214,0,187,122
1,1651,1250,401,0,72,63
1,1753,1533,220,0,182,79
1,1468,1260,208,3,127,51
1,2147,1991,156,2,79,53
-1,1584,1716,-132,-18,-270,56
-1,1256,943,313,3,97,48
1,1566,1589,-23,0,7,71
-1,2017,1984,33,-2,-83,64
1,1586,1604,-18,2,201,113
1,1349,1324,25,2,38,49
-1,1463,1609,-146,-9,-79,110
1,1667,1829,-162,3,379,117
-1,1567,1730,-163,-16,-1028,82
-1,1262,1638,-376,-5,-212,58
-1,1665,1500,165,0,-7,56
1,1771,1547,224,3,89,59
-1,1510,1690,-180,1,-42,52
-1,1592,1327,265,-1,0,78
1,1633,1474,159,1,124,103
1,1650,1500,150,0,10,59
-1,1581,1711,-130,-5,-320,100
1,0,1107,-1107,2,427,119
-1,1545,1735,-190,1,8,54
1,1577,1578,-1,-1,138,123
1,1737,1560,177,3,76,47
-1,1985,2154,-169,0,-9,48
-1,1558,1613,-55,-3,-171,76
1,1653,1466,187,0,149,87
1,1293,1444,-151,4,139,49
-1,1229,1166,63,-6,-200,78
-1,1389,1574,-185,-6,-245,82
-1,1674,1601,73,-4,-193,64
1,1619,1547,72,5,273,58
1,1439,1505,-66,0,-84,114
1,1493,1673,-180,1,110,61
-1,1519,1661,-142,-2,-24,44
1,1754,1784,-30,2,110,83
1,2161,1979,182,1,27,65
-1,1384,1197,187,-10,-1030,108
-1,1652,1617,35,-5,-108,59
0,1683,1580,103,13,855,83
-1,1662,1500,162,1,-269,86
1,1391,1361,30,-2,-151,89
-1,1530,1776,-246,-1,-202,108
-1,1618,1461,157,0,-6,56
-1,1568,1488,80,6,142,74
1,1312,1359,-47,2,523,103
0,2153,1997,156,0,-395,90
1,1504,1684,-180,-7,-124,43
1,1832,1616,216,0,-258,117
-1,1522,1770,-248,3,156,60
1,1814,1660,154,2,180,98
1,1567,1588,-21,1,139,119
-1,1252,1369,-117,1,-41,78
-1,1583,1654,-71,-10,-699,78
-1,1500,1525,-25,-3,-139,56
1,1629,1651,-22,0,25,51
-1,1455,1640,-185,-1,122,72
-1,1559,1595,-36,-1,270,80
-1,2001,2147,-146,-4,-88,86
0,1179,1225,-46,0,408,198
-1,1572,1513,59,-1,-291,122
-1,1668,1834,-166,-3,-109,68
-1,1588,1637,-49,2,-92,76
-1,1973,2167,-194,0,-56,62
-1,1497,1614,-117,-1,-70,102
1,1491,1456,35,0,-14,59
-1,974,1660,-686,-4,-31,52
0,1209,1622,-413,-3,-139,57
-1,1512,1779,-267,-6,-600,84
-1,1584,1870,-286,-4,-517,96
1,1576,1578,-2,0,24,103
-1,1396,1481,-85,0,4,40
-1,1451,1542,-91,0,-28,68
-1,1639,1781,-142,0,-145,94
1,1697,1656,41,0,33,59
-1,1432,1476,-44,0,89,118
1,1456,1667,-211,-6,-109,91
1,1439,1391,48,1,75,63
1,1670,1554,116,5,88,51
-1,1640,1601,39,-5,-29,94
1,1647,1578,69,16,1264,81
-1,1641,1625,16,0,-112,62
1,1628,1711,-83,4,322,89
-1,1502,1375,127,-1,-34,44
-1,1750,1698,52,-1,-421,144
-1,1808,1413,395,6,88,44
-1,1658,1529,129,-1,-32,84
-1,1688,1544,144,0,109,98
-1,1507,1569,-62,-3,-677,104
-1,2105,1907,198,-3,-141,58
-1,1255,1402,-147,-1,-293,216
1,1424,1488,-64,-2,108,75
1,1567,1587,-20,1,209,91
-1,1539,1726,-187,0,15,60
1,1578,1497,81,9,446,55
1,1702,1500,202,0,-7,57
1,1696,1788,-92,1,173,97
1,1692,1502,190,0,183,105
-1,1178,1757,-579,-6,-43,50
1,1384,1442,-58,0,502,101
1,2059,1988,71,-1,21,81
-1,2028,1679,349,-1,-295,122
1,1649,1820,-171,1,168,119
1,1439,1621,-182,0,73,75
-1,1487,1587,-100,-5,-87,44
-1,1651,1533,118,1,161,110
1,1796,1721,75,9,330,61
-1,1576,1579,-3,0,15,78
1,1674,1635,39,3,61,41
1,1662,1597,65,1,131,77
1,1595,1478,117,22,952,73
-1,1632,1360,272,-2,-170,81
1,2012,1663,349,-2,-211,85
1,1474,1005,469,-8,-6,75
1,1678,1559,119,3,100,55
-1,1535,1948,-413,-6,-119,49
1,1794,1500,294,-1,209,89
-1,1469,1603,-134,2,2,92
1,1625,1685,-60,1,893,225
1,1604,1167,437,4,304,71
1,1672,1732,-60,2,134,75
1,1882,2029,-147,0,272,77
-1,1533,1387,146,0,-13,62
-1,1552,1705,-153,-3,-116,100
1,1609,1286,323,15,313,55
-1,1814,1565,249,-2,-84,48
1,1614,1532,82,0,461,141
0,1613,1423,190,-1,-192,106
-1,1498,1629,-131,0,-45,84
1,1617,1454,163,19,436,47
1,1596,1406,190,2,296,89
-1,1810,1915,-105,-2,21,40
1,1497,1500,-3,5,262,77
-1,973,1403,-430,-5,-316,86
-1,1588,1671,-83,2,-184,96
-1,1447,1623,-176,-6,-100,42
-1,1666,1805,-139,-4,-128,66
-1,1492,1535,-43,2,84,84
1,1944,1390,554,0,4,49
1,1667,1621,46,1,42,63
-1,1398,1633,-235,0,-42,88
1,1712,1738,-26,1,223,85
-1,1860,1967,-107,0,-48,110
1,1423,1409,14,0,38,49
1,1629,1440,189,9,860,83
1,1409,1371,38,-3,121,97
-1,1500,1582,-82,0,-5,44
1,1956,1741,215,-1,-37,55
1,1676,1611,65,-3,-97,43
1,1636,1656,-20,0,18,51
-1,1513,1971,-458,0,0,58
0,1779,1714,65,-1,-293,128
1,1701,1523,178,-1,39,77
1,1686,1602,84,-5,-239,67
-1,1321,1303,18,-4,-302,84
1,1422,1646,-224,-17,-731,63
-1,1427,1799,-372,-5,-354,74
-1,1559,1759,-200,0,13,50
-1,1684,1776,-92,-1,-165,123
1,1598,1500,98,2,-16,41
1,1606,1698,-92,1,-13,101
1,1760,1593,167,1,202,61
1,1310,1508,-198,0,88,71
-1,1319,1604,-285,-1,-29,66
1,1670,1659,11,3,201,73
-1,1511,1980,-469,-1,56,64
-1,1810,1711,99,-1,141,96
-1,1543,2071,-528,0,-2,42
1,1608,1429,179,0,45,59
-1,1372,1359,13,8,111,52
-1,1547,1481,66,-7,-232,52
-1,1694,1587,107,-4,-387,68
1,1628,1441,187,1,19,63
-1,1644,1648,-4,-3,-3,54
-1,1404,1560,-156,1,14,48
1,1711,1989,-278,0,8,71
-1,1514,1382,132,-1,-31,50
1,1680,1601,79,6,546,133
1,1766,1980,-214,5,142,63
-1,1435,1634,-199,-3,65,84
-1,1605,1420,185,2,129,88
1,1766,1517,249,3,104,71
1,1810,1550,260,0,681,147
1,1685,1262,423,-3,-318,116
1,1712,1687,25,2,41,84
-1,1257,1359,-102,-1,-3,40
-1,1623,1554,69,-4,-524,86
-1,1406,1500,-94,-5,-86,44
1,1680,1579,101,2,143,69
-1,1494,1529,-35,-1,-74,57
1,1584,1816,-232,-3,-162,59
-1,1264,1338,-74,-3,-80,44
1,1450,1477,-27,1,96,85
1,1407,1427,-20,9,156,41
-1,1728,1633,95,-3,-3,98
-1,1423,1645,-222,-5,68,78
1,1500,1500,0,-7,-31,67
-1,1357,1627,-270,-11,-3,40
1,1755,1407,348,2,530,87
1,1688,1598,90,-10,-234,47
-1,1680,1614,66,-1,-6,62
-1,1749,1826,-77,2,-109,76
1,1682,1252,430,3,106,57
-1,1369,1248,121,-3,-713,92
-1,2003,1909,94,1,45,82
-1,1489,1516,-27,0,-7,66
-1,1662,1925,-263,0,78,86
-1,1400,1476,-76,1,61,84
1,1697,1589,108,-6,-132,59
-1,1975,2089,-114,-3,5,44
1,1726,1724,2,0,7,85
1,1551,1730,-179,-2,-208,101
-1,1567,1609,-42,0,283,94
1,1229,1106,123,1,46,49
1,1600,1465,135,1,65,67
1,1902,1998,-96,-1,116,117
-1,1605,1783,-178,-4,-45,50
-1,1712,1642,70,0,-4,48
1,1749,1631,118,-3,-138,47
-1,1462,1672,-210,-6,-249,84
1,1639,1472,167,3,198,61
-1,1604,1632,-28,-1,-94,58
1,1336,1532,-196,0,101,63
-1,1623,1759,-136,2,209,54
1,1882,1746,136,-1,-134,93
-1,1477,1439,38,-3,-27,66
1,1640,1304,336,0,17,45
1,1359,1896,-537,6,85,67
1,1768,1617,151,-3,-73,59
1,1513,1519,-6,6,705,149
-1,1594,1571,23,2,32,94
-1,1610,1776,-166,1,147,82
1,1511,1271,240,1,655,109
1,1867,1726,141,-2,27,79
1,1452,1459,-7,0,1,63
1,1751,1553,198,0,107,89
-1,1571,1568,3,6,466,104
-1,1784,1604,180,-3,-187,134
-1,1918,1983,-65,0,-238,152
-1,1519,1421,98,-2,-71,58
-1,1627,1664,-37,0,-7,76
1,1631,1654,-23,0,6,63
-1,1595,1654,-59,-3,-233,72
1,1519,1466,53,0,30,61
-1,1596,1583,13,4,103,68
1,1710,1505,205,0,37,69
-1,1704,1749,-45,-1,-229,104
1,1648,1652,-4,-3,77,59
-1,1544,1663,-119,0,4,44
-1,1323,1505,-182,0,14,44
-1,1490,1415,75,0,-14,62
0,1772,1613,159,0,236,209
-1,1739,1811,-72,-2,-27,80
-1,1637,1772,-135,-4,-359,102
-1,1650,1970,-320,-7,-594,110
1,1578,1365,213,3,28,45
1,1476,1496,-20,-1,63,89
1,1583,1511,72,12,201,41
1,1993,1908,85,-1,133,99
1,1645,1758,-113,0,-5,75
-1,1328,1627,-299,-10,-419,66
1,1449,1405,44,-3,-46,53
1,1593,1538,55,1,500,129
-1,1376,1465,-89,-1,8,46
-1,1502,1593,-91,-3,-89,94
1,1987,1643,344,0,19,69
1,1774,1611,163,0,116,87
1,1275,1030,245,8,182,53
-1,1699,1653,46,1,258,242
-1,1536,1447,89,-3,-14,40
1,1508,1286,222,8,247,61
-1,1525,1560,-35,-5,-349,112
-1,1768,1875,-107,1,20,54
-1,1480,1515,-35,-7,-335,62
1,1647,1524,123,1,140,117
1,1755,1693,62,0,94,84
1,1494,1601,-107,10,321,69
-1,1640,1560,80,-1,-30,130
1,1681,1744,-63,0,40,119
1,1763,1621,142,-2,-66,41
0,1410,1300,110,-3,-90,97
-1,1500,1629,-129,6,144,60
1,1717,1832,-115,-8,-284,59
1,1614,1771,-157,7,637,92
-1,1265,1316,-51,-9,-494,66
1,1746,1538,208,0,-121,115
1,1670,1577,93,0,31,67
-1,1508,1522,-14,4,34,43
-1,1529,1643,-114,0,-659,166
1,1619,1383,236,0,138,108
-1,1522,2001,-479,-1,-235,92
1,1615,1716,-101,1,72,69
1,1753,1630,123,4,151,45
1,1684,1664,20,1,72,83
0,1564,1492,72,-1,-25,107
1,1473,1367,106,1,44,67
0,1736,1618,118,-1,-141,85
1,1525,1469,56,3,327,115
-1,1622,1761,-139,-6,-71,48
1,1882,1898,-16,1,182,143
1,1874,2001,-127,-1,-32,53
1,1575,1594,-19,2,459,101
1,1533,1498,35,-1,-40,57
1,1818,1735,83,1,310,103
-1,1520,1626,-106,-2,-134,66
1,1570,1515,55,6,496,79
-1,1665,1630,35,1,33,122
-1,1732,1857,-125,0,0,42
-1,2007,1769,238,8,407,98
-1,1532,1517,15,-1,-242,74
1,1410,1436,-26,2,138,73
1,1850,1639,211,0,40,51
-1,1555,1572,-17,-3,-121,64
-1,1590,1638,-48,-1,-52,100
-1,1511,1634,-123,0,-115,66
1,1930,1349,581,0,143,51
1,1583,1587,-4,2,180,75
1,1865,1724,141,0,-13,57
-1,1358,1481,-123,1,53,74
1,1688,1885,-197,0,-15,68
0,1593,1787,-194,-4,490,125
1,1500,1194,306,-2,-151,53
-1,1506,1579,-73,-2,-595,140
-1,1774,1344,430,4,450,132
0,1395,1486,-91,-4,-206,75
1,1629,1678,-49,0,5,79
1,1641,1503,138,2,293,99
1,1520,1416,104,2,69,50
1,1732,1669,63,3,64,48
-1,1575,1594,-19,3,53,64
1,1599,1781,-182,-2,27,87
1,1819,1757,62,1,212,83
0,1354,1464,-110,11,386,140
-1,1653,1695,-42,-3,-753,148
1,1459,1534,-75,-8,-580,81
-1,1504,1226,278,-7,-28,41
1,1763,1616,147,-4,-46,61
1,1725,1769,-44,-2,91,61
-1,1736,1855,-119,-1,-46,80
1,1648,1456,192,-3,-31,55
0,1817,1761,56,0,16,109
1,1593,1482,111,3,342,71
1,1711,1654,57,0,77,85
-1,1609,1770,-161,4,337,76
1,1301,1487,-186,0,39,59
1,1874,1812,62,0,1,45
-1,1521,1553,-32,-4,-125,52
-1,1621,1528,93,-1,-132,112
-1,1423,1421,2,-4,-19,40
1,1263,1187,76,0,-36,79
-1,1478,1718,-240,0,-583,116
1,1543,1187,356,1,233,117
1,1324,1462,-138,-1,-5,65
1,1654,1520,134,-1,97,79
-1,1604,1786,-182,-4,-511,90
1,1777,1602,175,6,695,101
1,1471,1363,108,1,43,53
1,1507,1357,150,4,292,85
1,1889,1828,61,0,158,71
1,1740,1826,-86,0,26,81
1,1497,1483,14,0,138,155
-1,1331,1604,-273,-3,-155,98
-1,2089,1500,589,-1,35,80
-1,1743,1598,145,1,-107,60
-1,1529,1594,-65,-4,99,76
1,1596,1784,-188,4,74,41
0,1562,1654,-92,0,-106,151
-1,1324,1662,-338,-1,-250,132
1,1432,1411,21,1,148,65
1,1574,1479,95,-1,107,88
-1,1468,1410,58,-1,-14,44
-1,1475,1603,-128,-4,-221,112
-1,1527,1598,-71,6,253,62
1,1754,1884,-130,2,-476,89
-1,1588,1860,-272,-7,-302,76
1,1442,1636,-194,1,555,109
-1,1471,1458,13,-1,-41,62
-1,1599,1476,123,-1,-143,58
1,1716,1635,81,0,463,103
1,1607,1512,95,0,-10,63
-1,2015,1777,238,-6,-532,124
-1,1413,1571,-158,-1,-103,64
1,1643,1676,-33,0,494,175
1,1601,1437,164,0,4,41
1,1413,1562,-149,3,56,49
-1,1588,1742,-154,0,-252,120
-1,1350,1513,-163,2,7,40
1,1819,1898,-79,3,47,47
-1,1170,1274,-104,-1,-34,66
1,1397,1627,-230,-1,23,47
1,1868,1769,99,1,216,117
1,1798,1634,164,4,96,47
1,1339,1742,-403,0,-20,45
1,1507,1520,-13,0,59,69
1,2053,1473,580,8,294,61
1,1518,1600,-82,3,92,93
1,1990,1460,530,-2,-11,63
-1,1627,1804,-177,0,-107,164
-1,1340,1301,39,-2,-29,42
-1,1616,1557,59,-9,-243,60
-1,1590,1538,52,0,-178,134
-1,1414,1371,43,-1,-103,78
1,1360,1400,-40,-4,189,79
1,1606,1413,193,2,61,47
-1,1406,1577,-171,-8,-118,64
1,1395,1418,-23,5,134,61
-1,1818,1851,-33,-3,-140,82
1,1725,1613,112,1,136,75
1,1885,1832,53,1,28,55
-1,1615,1459,156,2,-129,90
1,1491,1416,75,-1,-6,53
-1,1585,1584,1,-5,-96,56
-1,1761,1877,-116,1,-231,102
1,1665,1321,344,0,73,125
-1,1725,1749,-24,2,-7,62
1,1739,1582,157,1,-39,63
-1,1612,1506,106,-9,-893,110
-1,1728,1676,52,-2,-164,93
1,1620,1713,-93,3,1051,137
-1,1475,1599,-124,-3,-150,76
-1,1329,1568,-239,6,170,50
-1,1794,1948,-154,-3,216,106
1,1810,1621,189,0,81,61
1,1597,1520,77,6,419,77
-1,1429,1269,160,-5,-401,78
-1,1708,1786,-78,1,-61,64
1,1753,1676,77,0,-70,105
1,2005,1719,286,0,23,43
1,1507,1520,-13,-1,66,79
1,1595,1574,21,1,564,115
1,1606,1318,288,6,152,41
-1,1607,1468,139,-2,-391,84
-1,1615,1816,-201,-3,-10,54
-1,1372,1299,73,2,90,54
1,1546,1419,127,5,279,81
-1,1578,1397,181,0,-68,68
-1,1796,1700,96,-9,-345,82
1,1714,1616,98,-1,-26,61
1,1823,1894,-71,-1,0,43
-1,1885,1861,24,0,-35,90
-1,1570,1596,-26,-1,-28,88
-1,1568,1500,68,0,-195,102
-1,1541,1643,-102,0,-19,62
-1,1762,1754,8,-3,15,40
1,1592,1483,109,2,99,71
-1,1714,1781,-67,0,9,62
1,1501,1495,6,-2,8,51
1,1775,1742,33,0,16,59
1,1610,1503,107,1,346,103
-1,1005,1500,-495,1,111,60
-1,1064,1399,-335,-7,-731,136
-1,1767,1751,16,1,135,96
-1,1589,1517,72,3,52,50
-1,1350,1430,-80,-4,-44,50
-1,1821,1761,60,-1,-684,108
1,1475,1599,-124,7,316,57
-1,1383,1500,-117,0,2,40
-1,1518,1593,-75,-3,-62,74
-1,1504,1771,-267,0,8,72
1,1647,1561,86,0,111,72
0,1494,1494,0,-5,-83,122
1,1722,1525,197,0,13,58
1,1695,1495,200,-1,-29,55
-1,1618,1319,299,1,26,42
1,1881,1836,45,0,31,65
-1,1556,1559,-3,-1,-528,94
-1,1712,1552,160,-2,-27,44
-1,1804,1490,314,0,14,54
1,1754,1530,224,4,259,53
-1,1986,1787,199,0,127,100
-1,1762,1608,154,-1,-69,62
1,1484,1617,-133,0,38,75
-1,1513,1380,133,-1,-8,56
1,1784,1773,11,-1,-64,91
-1,1489,1728,-239,-2,-24,54
1,1635,1510,125,-1,21,65
-1,1602,1690,-88,3,-233,102
-1,1529,1510,19,-12,-484,56
-1,1328,1359,-31,-2,-562,110
-1,1873,1705,168,0,-67,70
1,1618,1520,98,1,117,89
1,1574,1472,102,0,356,93
-1,1747,1623,124,-10,-282,60
-1,1426,1597,-171,-6,-216,56
-1,1570,1542,28,0,18,50
1,1532,1683,-151,0,0,59
-1,1626,1621,5,0,-63,136
-1,1805,1969,-164,0,-54,82
1,1595,1707,-112,0,-8,45
-1,1525,1759,-234,-2,-180,78
1,1522,1688,-166,0,385,127
1,1721,1856,-135,0,36,48
-1,1634,1731,-97,0,-104,86
-1,1504,1666,-162,-1,-152,70
1,1733,1732,1,0,-56,57
-1,1372,1680,-308,-5,-55,46
-1,1638,1754,-116,0,-66,94
1,1839,1735,104,0,-6,83
1,1717,1629,88,1,71,59
-1,1975,1798,177,-10,-208,98
1,1602,1488,114,4,317,101
1,1419,1478,-59,0,-13,49
-1,1582,1585,-3,-3,-115,108
1,1627,1464,163,-2,-91,103
1,1664,1368,296,-5,32,88
1,1233,1371,-138,2,61,67
1,1603,1419,184,-1,60,67
1,1538,1500,38,-1,-45,51
-1,1597,1612,-15,1,8,52
-1,1500,1530,-30,-15,-266,44
1,1762,1631,131,0,7,91
1,1741,1626,115,1,26,48
-1,1482,1489,-7,3,-2,76
1,1545,1601,-56,4,164,99
1,1546,1532,14,3,85,47
-1,1449,1651,-202,0,-59,82
-1,1219,1571,-352,0,-51,60
-1,1356,1779,-423,4,-161,154
-1,1418,1557,-139,0,25,70
1,2130,1331,799,6,199,53
1,1625,1162,463,9,196,55
-1,1494,1647,-153,-1,-21,44
-1,1764,1822,-58,1,12,54
-1,1755,1961,-206,0,-50,78
-1,1723,1850,-127,2,5,88
1,1724,1416,308,1,12,63
1,1909,1803,106,1,131,83
1,1612,1920,-308,0,4,43
1,1832,1754,78,0,-339,147
1,1458,1392,66,11,29,40
-1,1920,1717,203,-4,-162,110
1,1696,1395,301,8,201,47
-1,1312,1521,-209,3,187,70
0,1744,1841,-97,1,45,118
1,1467,1284,183,0,19,49
-1,1603,1532,71,-1,-25,66
1,1433,1531,-98,2,248,83
-1,1795,1918,-123,-10,-109,94
-1,2094,2136,-42,-4,-76,67
-1,1526,1296,230,0,-293,76
1,1760,1622,138,-1,75,45
-1,1742,1752,-10,-1,-10,46
1,1838,1857,-19,5,125,75
1,1763,1431,332,0,45,51
-1,1660,1977,-317,-1,-43,58
1,1410,1727,-317,-1,2,59
1,1569,1678,-109,8,241,57
-1,1515,1583,-68,2,38,52
1,1458,1572,-114,0,-2,41
-1,1505,1212,293,-3,-267,84
-1,1790,1927,-137,0,46,64
1,1782,1353,429,0,219,127
1,1626,1429,197,-3,-174,97
-1,1677,1743,-66,0,-5,94
-1,1346,1509,-163,-1,3,106
-1,1850,1764,86,0,-357,90
1,1651,1551,100,1,22,41
1,1474,1318,156,4,232,77
-1,1926,1788,138,0,-107,118
0,2147,1780,367,-1,-326,121
1,1780,1836,-56,1,39,57
1,1446,1514,-68,1,21,49
-1,1515,1329,186,-1,-14,54
-1,1705,1436,269,-3,112,92
1,1823,1794,29,1,42,97
1,1533,1524,9,0,8,51
1,1734,1573,161,6,762,111
0,1483,1682,-199,0,17,117
1,1707,1446,261,0,371,127
1,1518,1460,58,-4,-273,69
0,1485,1488,-3,7,551,129
1,1584,1472,112,-1,-13,63
1,1851,1619,232,0,18,61
-1,1790,2137,-347,1,236,112
-1,1351,1784,-433,-2,-458,122
-1,1660,1468,192,-4,-582,100
1,1484,1406,78,3,225,85
-1,1327,1491,-164,-1,-34,58
1,2083,1909,174,1,163,127
-1,1485,1764,-279,-4,-409,70
1,1371,1499,-128,3,148,69
1,1545,1589,-44,2,68,53
1,1856,1614,242,0,378,91
-1,1521,1219,302,-5,-73,40
-1,1767,1995,-228,-1,-87,78
1,1367,1543,-176,7,128,45
1,1752,1666,86,6,66,43
1,1581,1500,81,8,151,41
1,1934,2000,-66,-5,2,87
-1,1473,1494,-21,-10,-184,54
1,1783,1761,22,0,-5,49
1,2141,1787,354,0,52,65
-1,1480,1405,75,-3,-11,40
1,1766,1709,57,0,6,45
1,1387,1493,-106,4,448,101
1,1704,1467,237,1,243,75
1,1607,1536,71,-3,79,67
0,1438,1712,-274,-10,-6,94
1,1745,1369,376,-2,-126,63
-1,1610,1707,-97,-3,-58,52
-1,1860,1914,-54,0,-90,68
1,1504,1643,-139,0,-189,97
-1,1536,1482,54,-4,-239,74
1,1421,1368,53,1,-84,59
1,1792,1803,-11,1,55,67
1,1741,1808,-67,0,63,117
1,1581,1602,-21,-1,31,44
1,1683,1553,130,1,487,101
1,1786,1348,438,1,140,73
1,1500,1461,39,10,427,59
-1,1527,1616,-89,-1,-75,62
-1,1443,1527,-84,-14,-415,72
1,1590,1501,89,0,-31,45
-1,1528,1959,-431,-2,-112,64
-1,1902,2090,-188,0,-72,78
-1,1320,1277,43,1,-20,48
-1,1549,1491,58,-3,-87,54
1,1513,1160,353,5,446,73
-1,1079,1436,-357,-7,-330,66
1,1517,1223,294,-4,240,63
0,1794,1754,40,0,-24,115
-1,1987,1947,40,1,36,94
-1,1505,1727,-222,-1,-34,72
1,1851,1613,238,1,37,61
-1,1462,1504,-42,2,84,60
1,1656,1760,-104,8,240,55
1,1551,1298,253,0,8,65
-1,1711,1784,-73,-1,-47,73
-1,1803,1746,57,-2,-409,90
-1,1582,1800,-218,-3,-131,84
1,1448,1408,40,2,253,113
1,1704,1451,253,0,2,83
1,1598,1694,-96,0,5,49
1,1758,1790,-32,1,264,131
0,1494,1574,-80,0,308,107
-1,1479,1545,-66,0,-263,84
-1,1556,1290,266,-3,-94,60
-1,1855,1724,131,-1,-46,190
-1,1618,1608,10,-5,-409,154
1,1836,1845,-9,2,232,65
1,1755,1597,158,3,166,70
-1,1452,1514,-62,4,116,46
1,1429,1498,-69,2,146,63
1,1616,1479,137,2,9,49
1,1886,1740,146,4,144,57
1,1613,1344,269,6,438,81
-1,1748,1792,-44,-2,-30,50
-1,1627,1519,108,1,76,106
1,1959,1974,-15,1,16,89
-1,1789,1602,187,0,41,94
-1,1308,1235,73,-4,-69,86
-1,1331,1470,-139,1,29,62
-1,1552,1471,81,-10,-50,60
1,1746,1673,73,-4,-12,69
1,1702,1577,125,1,128,97
1,1466,1349,117,0,3,55
1,1415,1543,-128,0,847,107
-1,1591,1494,97,-3,-323,84
1,1841,1815,26,0,3,65
-1,1762,1896,-134,1,-62,86
-1,1630,1479,151,0,-7,62
1,1443,1444,-1,-1,-19,59
1,1709,1428,281,8,261,59
-1,1450,1510,-60,1,-167,116
1,1500,1667,-167,-1,201,119
-1,1737,1802,-65,-11,-30,40
-1,1619,1443,176,1,27,70
1,1477,1322,155,-2,-278,69
1,1709,1485,224,3,149,57
-1,1441,1926,-485,-5,-464,78
-1,1472,1623,-151,-4,-163,52
-1,1590,1500,90,-1,146,80
-1,1851,2096,-245,-3,-10,40
1,1963,1970,-7,0,-83,69
-1,1599,1612,-13,0,57,122
-1,1320,1587,-267,-4,-205,70
-1,1260,1479,-219,-4,-250,72
-1,1090,1336,-246,-2,-45,48
1,2101,1847,254,2,463,109
-1,1314,1484,-170,2,26,44
-1,1391,1534,-143,-7,-168,44
-1,1554,1500,54,-4,-152,50
1,1306,1770,-464,0,-5,45
1,1493,1592,-99,0,219,99
1,1767,1618,149,0,163,105
1,1497,1615,-118,-6,-187,61
1,1253,1481,-228,6,114,53
1,1745,1759,-14,1,-9,141
1,1578,1439,139,-2,46,85
1,1490,1306,184,-2,-176,75
-1,1321,1357,-36,-3,-173,70
-1,1400,1732,-332,-2,3,68
-1,1295,1422,-127,1,30,62
1,1578,1570,8,-3,418,85
-1,1714,1512,202,0,57,74
-1,1390,1341,49,5,197,72
1,1535,1464,71,9,334,67
1,1904,1480,424,0,63,65
0,1360,1460,-100,0,400,129
-1,1509,1707,-198,-1,-220,150
1,1474,1333,141,0,51,57
1,1575,1540,35,1,35,57
1,1522,1400,122,5,39,41
1,1630,1466,164,4,77,53
-1,1601,1513,88,4,-27,108
-1,1959,1974,-15,-2,-37,66
0,1298,1496,-198,0,489,94
1,1200,0,1200,-1,-96,57
-1,1611,1709,-98,-1,-33,54
1,1452,1458,-6,3,40,55
-1,1478,1906,-428,-1,-25,46
1,1497,1062,435,0,-16,75
1,1663,1755,-92,3,125,105
1,1571,1618,-47,-3,-59,59
1,1345,1600,-255,-2,37,87
1,1812,1866,-54,0,-66,71
-1,1570,1572,-2,-12,-479,146
1,1487,1439,48,5,111,51
1,1315,1404,-89,2,109,59
-1,1427,1585,-158,-9,-125,64
1,1432,1418,14,1,42,73
-1,1354,1515,-161,-1,-27,52
-1,1136,1173,-37,3,94,46
-1,1704,1622,82,-2,-26,44
1,1507,1522,-15,-1,181,75
1,1570,1328,242,3,107,69
1,1469,1265,204,-1,201,133
1,1760,1563,197,6,129,49
1,1564,1416,148,0,89,63
1,1447,1403,44,2,94,57
1,1368,1373,-5,-3,-115,99
-1,1284,1447,-163,1,45,50
1,1777,1520,257,8,186,53
-1,1348,1476,-128,-9,-563,100
1,1723,1503,220,2,96,91
-1,1520,1440,80,0,-242,90
1,1481,1326,155,-1,48,71
1,1785,1834,-49,0,7,59
1,1910,1577,333,-1,26,105
0,1500,1434,66,1,39,116
1,1464,1517,-53,-1,-1,59
-1,1801,1949,-148,-2,-170,92
-1,1641,1900,-259,-8,-406,70
1,1596,1518,78,3,40,43
-1,1537,1503,34,4,157,62
-1,1313,1410,-97,0,-123,64
0,1799,1441,358,2,123,140
1,1568,1384,184,2,139,101
-1,1499,1609,-110,0,-44,70
-1,1051,1312,-261,-1,-214,100
1,1744,1457,287,-4,-182,69
-1,1580,1455,125,0,-11,58
1,1538,1346,192,2,181,69
1,1500,1122,378,5,437,67
0,1967,1840,127,0,7,111
1,1405,1570,-165,1,67,49
1,1500,1490,10,0,546,143
-1,1508,1605,-97,1,40,58
-1,1707,1510,197,-2,-507,132
1,1712,1679,33,-1,66,101
-1,1955,1794,161,7,239,56
1,2154,1927,227,0,39,91
-1,1427,1516,-89,0,20,54
1,1853,1722,131,4,143,69
-1,1340,1483,-143,-7,-189,54
-1,1824,1811,13,-4,-132,76
-1,1543,1824,-281,-13,-185,48
-1,1874,1482,392,2,109,62
-1,1457,1409,48,-13,-115,40
1,1512,1588,-76,-2,305,115
1,1913,1552,361,-2,26,67
-1,1555,1430,125,0,-13,58
-1,1583,1557,26,-3,-326,66
-1,1453,1747,-294,0,-6,44
1,1746,1802,-56,0,-13,79
-1,1460,1585,-125,3,92,56
1,968,0,968,7,775,83
-1,1525,1816,-291,-1,-22,54
1,1455,1310,145,2,255,101
-1,1488,1379,109,-1,-10,42
0,1724,1418,306,-1,-125,162
1,1341,1434,-93,1,521,99
1,1751,1656,95,2,43,47
-1,1613,1500,113,-2,-203,86
-1,1540,1633,-93,-9,-138,50
-1,1769,1829,-60,-4,-46,70
-1,1521,1826,-305,0,-427,80
1,1715,1640,75,-3,55,63
0,1474,1345,129,-1,-299,148
1,1703,1778,-75,-2,56,75
1,1496,1500,-4,1,1381,229
-1,1737,1690,47,-3,-251,108
-1,1608,1538,70,-4,-22,44
-1,1491,1561,-70,-4,-93,46
1,1518,1380,138,5,181,71
1,1764,1718,46,3,581,89
-1,1375,1434,-59,-1,-353,100
1,1759,1748,11,-1,-98,89
1,1708,1774,-66,0,337,137
0,1439,1453,-14,1,-184,123
-1,1514,1885,-371,1,-16,56
-1,1516,1583,-67,-2,-64,50
-1,1682,1587,95,0,-26,98
-1,1393,1556,-163,1,-92,62
-1,1985,1822,163,1,-79,68
-1,1503,1482,21,-2,10,46
1,1642,1508,134,2,89,56
1,1760,1722,38,1,264,77
1,1888,1468,420,1,80,85
1,1694,1587,107,2,1087,157
1,1698,1741,-43,5,355,78
-1,1508,1851,-343,0,-67,96
1,1422,1445,-23,1,196,105
-1,1770,1993,-223,0,2,66
-1,1548,1447,101,1,9,56
-1,1410,1448,-38,-2,21,62
1,1711,1771,-60,-3,413,109
-1,1413,1669,-256,-1,-35,48
0,1593,1452,141,1,-74,118
1,1727,1598,129,1,-24,59
1,1858,1765,93,2,99,69
1,1678,1441,237,4,45,59
-1,1638,1562,76,-3,296,82
-1,1190,1268,-78,-7,-549,90
-1,1435,1692,-257,1,30,66
-1,1500,1440,60,-3,-405,132
-1,1963,1741,222,-2,-146,74
1,1580,1613,-33,0,58,97
-1,1435,1660,-225,0,-90,104
-1,1402,1471,-69,2,48,58
-1,1759,1944,-185,0,-77,58
1,1407,1306,101,8,154,45
-1,1622,1665,-43,1,66,84
-1,1687,1804,-117,0,7,88
0,1704,1673,31,0,28,83
-1,1166,1604,-438,-5,-262,68
-1,1231,1352,-121,0,-11,48
-1,1591,1514,77,-1,-187,88
1,1950,1753,197,-3,24,83
-1,1436,1683,-247,5,113,62
-1,1599,1646,-47,1,-186,76
-1,1632,1565,67,0,-41,58
1,1798,1599,199,0,94,105
-1,1621,1450,171,-3,-37,47
-1,1747,1956,-209,-5,-149,74
1,1674,1703,-29,-1,107,79
-1,1688,1369,319,-7,-286,68
-1,1692,1623,69,0,-58,102
1,1535,1742,-207,2,95,69
1,1361,1414,-53,3,164,59
1,1631,1527,104,-2,-117,65
1,1962,1742,220,1,163,153
1,1795,1708,87,-1,-12,45
1,1865,1714,151,1,189,135
-1,1729,1754,-25,-3,-119,90
1,1520,1259,261,7,210,59
1,1791,1429,362,0,141,87
1,1617,1691,-74,-11,-348,119
1,1489,1700,-211,1,183,109
1,1799,1256,543,29,536,40
1,1566,1612,-46,1,49,44
-1,1677,1813,-136,-4,-244,82
-1,1736,1967,-231,1,192,92
-1,1638,1383,255,-3,-103,66
-1,2128,1677,451,0,-53,62
1,1542,1627,-85,5,190,53
1,1782,1326,456,0,8,55
-1,1659,1811,-152,0,-9,76
-1,1412,1650,-238,-5,-364,70
1,1455,1576,-121,2,252,63
-1,1431,1721,-290,-3,-247,92
1,1972,1731,241,-1,-152,105
1,1520,1499,21,5,1137,99
-1,1531,1506,25,0,-62,110
-1,1578,1618,-40,-3,-209,116
1,1698,1560,138,-1,327,91
1,1375,1216,159,4,344,79
-1,1589,1710,-121,0,10,78
-1,1705,1553,152,-9,-200,56
1,1600,1514,86,-1,14,46
-1,1676,1607,69,0,-393,108
-1,1641,1653,-12,1,-903,192
-1,1569,1689,-120,9,290,40
-1,1431,1204,227,-10,-473,62
-1,1601,1657,-56,0,30,64
-1,1512,1609,-97,-8,-330,66
-1,1614,1696,-82,-2,-182,92
-1,1639,1697,-58,0,-221,150
-1,1594,1803,-209,-4,-31,42
1,1427,1314,113,11,426,55
-1,1562,1484,78,1,52,62
1,1650,1201,449,3,236,93
1,1276,1133,143,-2,9,67
1,1524,1407,117,2,167,101
-1,1603,1424,179,-3,-159,62
-1,1566,1571,-5,-1,-256,128
-1,1660,1869,-209,0,-15,60
1,1401,1426,-25,-3,28,59
-1,1497,1548,-51,-11,-745,76
-1,1706,2103,-397,-1,-29,62
1,1697,1500,197,5,341,61
-1,1568,1850,-282,0,-229,98
-1,1582,1655,-73,-1,-231,94
1,1530,1508,22,-6,-275,63
1,1799,1697,102,9,24,41
1,1636,1679,-43,-1,356,123
-1,1800,1433,367,7,159,44
-1,1430,1358,72,0,18,56
1,1646,1500,146,-3,457,109
-1,1620,1727,-107,-6,-20,42
1,1586,1597,-11,0,-90,83
-1,1519,1318,201,-1,-21,66
0,1499,1667,-168,0,84,144
-1,1479,1567,-88,3,143,74
1,1500,1579,-79,1,48,69
-1,1836,1907,-71,-1,-121,60
-1,1112,1403,-291,7,159,40
1,1886,1467,419,0,91,91
1,1579,1350,229,-3,-51,41
-1,1688,1807,-119,0,-45,86
-1,1644,1690,-46,-9,-741,110
1,1852,1652,200,-3,-117,97
1,1564,1500,64,1,97,101
1,1605,1566,39,-2,33,48
1,1575,1471,104,-4,-47,79
1,1669,1819,-150,-10,48,67
1,1839,1717,122,5,284,85
-1,1296,1242,54,-1,-136,108
-1,1632,1700,-68,-7,-332,69
1,1622,1569,53,4,197,69
-1,1109,1291,-182,0,-143,76
1,1655,1774,-119,0,11,57
-1,1452,1777,-325,0,-85,68
1,1725,1385,340,-1,182,105
-1,1464,1583,-119,-1,-162,120
1,1605,1400,205,6,149,49
1,1277,1305,-28,-2,4,51
-1,1751,1709,42,-1,-483,116
-1,1793,1961,-168,-4,-238,84
-1,1708,1846,-138,0,-220,92
1,1579,1559,20,1,145,91
1,1591,1457,134,9,702,101
1,1280,1256,24,5,295,63
1,1662,1521,141,1,145,85
1,1722,1738,-16,0,16,79
1,1853,1700,153,4,117,51
-1,1579,1366,213,-3,-59,46
1,1450,1598,-148,-3,-105,81
1,1744,1293,451,2,117,53
-1,1814,1680,134,-1,-252,92
1,1726,1734,-8,-2,513,85
-1,1519,1458,61,-1,6,68
-1,1610,1825,-215,0,-58,70
1,1582,1465,117,0,184,103
-1,1696,1799,-103,0,-134,128
1,1541,1151,390,18,268,41
-1,1384,1562,-178,3,172,54
0,1556,1663,-107,-7,-141,131
-1,1487,1484,3,0,-107,116
0,1417,1487,-70,1,91,134
-1,1185,1428,-243,-2,-9,60
-1,1764,1716,48,-2,-54,68
1,1860,1722,138,0,79,57
1,1788,1769,19,-2,358,75
-1,1381,1728,-347,-9,-445,128
1,1290,1717,-427,-2,85,77
-1,1630,1500,130,-16,-346,54
1,1289,1393,-104,-4,-229,101
-1,1715,1867,-152,0,4,86
0,1359,1276,83,9,733,137
1,1568,1780,-212,4,285,89
-1,1290,1632,-342,-1,-373,108
1,1414,1600,-186,-1,-25,69
-1,1573,1664,-91,0,-215,82
-1,1713,1179,534,-1,-127,72
-1,1637,1465,172,1,-3,46
1,1601,1500,101,-1,-27,41
-1,1644,1614,30,-3,-24,72
1,1602,1489,113,-1,-8,55
1,1525,1294,231,0,-5,47
-1,1751,1709,42,-3,-995,110
1,1837,1669,168,2,172,95
1,1667,1649,18,5,355,95
-1,1862,1873,-11,0,-14,82
1,1432,1256,176,4,229,72
-1,1830,1604,226,0,-4,62
-1,1136,1205,-69,-7,-445,74
-1,1718,1613,105,0,-73,64
1,1761,1586,175,3,128,61
1,1475,1843,-368,1,248,65
-1,1381,1632,-251,-9,-564,98
1,1884,1812,72,-1,40,73
1,1688,1702,-14,1,431,105
-1,1706,1734,-28,-1,-71,112
1,1380,1429,-49,2,20,40
-1,1634,1524,110,6,176,58
1,1368,1607,-239,6,93,43
1,1618,1363,255,4,371,117
-1,1943,1734,209,1,19,40
-1,1803,1892,-89,-4,380,92
1,1804,1643,161,0,67,79
-1,1760,1658,102,1,54,66
-1,1807,1720,87,1,2,76
1,1618,1496,122,-2,-63,69
1,1520,1358,162,-1,9,48
1,1802,1697,105,0,16,89
1,1901,1781,120,-1,-41,93
-1,1753,1926,-173,2,173,70
-1,1579,1768,-189,-1,-22,51
-1,1740,1937,-197,2,185,102
-1,1660,1559,101,-6,-99,100
1,1732,1378,354,0,385,115
1,1901,1794,107,0,-37,75
-1,1689,1847,-158,-1,-69,70
-1,1506,1590,-84,-5,-124,78
-1,1518,1623,-105,-3,-79,52
1,1635,1287,348,2,159,61
1,1740,1473,267,5,72,48
-1,1660,1393,267,-3,-190,82
0,1746,1908,-162,2,-486,100
1,1683,1201,482,1,54,61
-1,1811,1700,111,3,460,112
1,1519,1621,-102,0,43,43
1,1627,1577,50,6,55,43
-1,1377,1407,-30,-3,-75,72
1,1908,1863,45,0,-30,73
-1,1631,1818,-187,0,-21,70
-1,1904,1751,153,-4,-181,64
-1,1086,1215,-129,-5,-227,111
1,1872,1845,27,4,308,79
-1,1745,1623,122,2,51,56
1,1732,1752,-20,4,124,81
1,1537,1519,18,-3,51,71
-1,1500,1417,83,0,-24,72
1,1882,1848,34,7,868,135
-1,1602,1564,38,-6,-376,114
-1,1769,1888,-119,-3,-57,54
1,1530,1691,-161,-1,156,97
1,1568,1780,-212,-3,-37,41
-1,1562,1693,-131,5,42,40
1,1357,1286,71,6,53,41
1,1636,1559,77,0,12,83
1,1378,1561,-183,-1,-44,45
0,1352,1358,-6,5,267,114
-1,1896,1760,136,0,-243,96
1,1700,1483,217,0,83,63
1,1838,1925,-87,-6,-290,89
1,1932,2172,-240,0,253,121
-1,1414,1641,-227,1,34,64
-1,1497,1270,227,-3,-101,58
-1,1271,1888,-617,1,-155,110
-1,1557,1522,35,-8,-151,58
-1,1577,1671,-94,-10,-416,72
-1,1665,1824,-159,0,-8,110
-1,1374,1735,-361,0,-404,106
1,1872,1881,-9,0,1,129
-1,1250,1560,-310,-5,-284,72
1,1643,1488,155,9,377,57
-1,2151,1949,202,0,75,116
-1,1798,1772,26,-1,19,102
-1,1468,1745,-277,-2,-510,104
1,1552,1456,96,-4,318,85
-1,1679,1836,-157,0,47,68
-1,1312,1416,-104,-3,-97,66
-1,1854,1725,129,-4,-45,44
-1,1650,1680,-30,-2,118,114
0,1551,1645,-94,0,45,123
1,1493,1425,68,2,-13,73
1,1716,1694,22,0,-79,81
-1,1673,1500,173,-3,-390,88
-1,1400,1573,-173,-11,-374,70
-1,1752,1746,6,-2,-321,108
1,1453,1318,135,-2,179,89
-1,1638,1690,-52,-5,-276,70
1,1352,1236,116,2,117,85
-1,1572,1673,-101,-1,-174,64
1,2131,1911,220,-1,305,143
1,1484,1500,-16,3,153,53
1,1646,1632,14,3,150,73
-1,1784,1786,-2,-1,-31,50
-1,1700,1622,78,-1,-52,56
1,1532,1448,84,-8,-181,83
1,1500,1589,-89,-7,415,85
1,1627,1568,59,-1,880,105
1,1839,1830,9,0,65,77
1,1304,1331,-27,1,39,41
1,1797,1773,24,1,110,115
1,1895,2137,-242,0,-11,99
-1,1590,1686,-96,-10,-701,106
1,1684,1727,-43,0,22,63
-1,1834,1882,-48,-5,-110,50
1,1738,1371,367,2,531,115
1,1509,1619,-110,1,169,87
1,1247,1529,-282,1,-1,73
1,2117,1694,423,1,45,55
-1,1429,1566,-137,9,927,92
1,1599,1519,80,7,131,45
-1,1622,1617,5,0,-542,138
-1,1551,1677,-126,0,21,94
1,1699,1497,202,-4,-33,89
-1,1797,1842,-45,-2,-74,56
-1,1471,1582,-111,3,92,74
1,1949,1693,256,4,252,93
1,1492,1539,-47,0,3,75
1,1838,1555,283,-1,50,109
-1,1401,1178,223,0,69,55
1,1692,1538,154,-5,-3,79
-1,1360,1298,62,-8,-144,46
0,1639,1606,33,-3,173,117
1,1277,1761,-484,0,40,72
-1,1481,1337,144,-3,24,76
1,1621,1757,-136,0,37,87
-1,1781,1807,-26,-2,-36,74
-1,1639,1843,-204,1,-12,70
-1,1575,1434,141,1,-44,59
-1,1527,1699,-172,-3,-22,42
1,1461,1375,86,0,-201,107
-1,1657,1696,-39,1,-20,84
1,1500,1548,-48,-5,50,61
1,1327,1562,-235,4,85,69
1,1585,1358,227,-1,198,65
1,1883,1948,-65,-2,-46,63
1,1675,1680,-5,0,26,125
1,1502,1562,-60,-3,131,61
-1,1641,1732,-91,0,-68,65
-1,1805,1816,-11,0,-63,80
1,1824,2067,-243,2,745,141
1,2005,1521,484,-1,106,71
1,1835,1595,240,0,-6,47
1,1508,1326,182,-9,-475,81
1,1901,1642,259,7,107,49
-1,1321,1665,-344,0,1,45
1,1756,1504,252,2,135,87
-1,1886,1945,-59,0,231,90
-1,1125,1287,-162,-4,-513,88
1,1935,1895,40,1,25,65
1,1615,1651,-36,5,310,73
-1,1665,1721,-56,-1,-16,48
-1,1632,1520,112,-7,-243,58
1,1535,1733,-198,-4,-206,77
1,2038,1842,196,0,8,71
1,1975,1500,475,-5,-103,69
1,1841,1528,313,-4,48,91
1,1551,1488,63,3,114,43
0,1953,1877,76,-1,443,103
1,1655,1760,-105,-1,29,45
1,1755,1690,65,0,113,85
-1,1523,1630,-107,-6,-174,56
1,1766,1770,-4,0,24,61
-1,1546,1363,183,0,-19,70
-1,1590,1842,-252,-3,-64,50
0,1745,1670,75,2,-101,152
1,1617,1536,81,-3,-86,63
1,1401,1204,197,10,158,40
-1,1527,1545,-18,1,-3,80
-1,1718,1631,87,-7,-99,52
-1,1409,1346,63,-9,-224,70
1,1932,1546,386,0,2,61
1,1562,1451,111,-5,-16,61
1,1648,1680,-32,3,105,43
-1,1517,1671,-154,-1,-273,114
1,1698,1629,69,0,90,97
1,1499,1467,32,4,146,49
-1,1654,1680,-26,1,62,82
1,1538,1331,207,5,286,65
-1,1526,1626,-100,1,62,68
-1,1241,1500,-259,-2,-13,40
-1,1419,1487,-68,2,-84,82
1,1382,1499,-117,1,19,75
1,1519,1370,149,-3,-51,57
-1,1801,1581,220,-1,38,80
-1,1551,1713,-162,0,-126,116
1,1849,1190,659,-6,-26,57
-1,1404,1407,-3,1,32,44
-1,1571,1871,-300,0,30,58
-1,1706,1671,35,-4,-168,102
-1,1642,1959,-317,-1,-76,112
1,1634,1517,117,-3,-280,83
1,1661,1724,-63,-3,-43,53
1,1672,1579,93,-4,-22,73
-1,1668,1450,218,-5,-370,82
-1,1811,1641,170,-1,-412,106
1,1651,1515,136,3,158,59
-1,1672,1725,-53,-3,-157,71
1,1804,1897,-93,0,-21,79
-1,1347,1584,-237,-16,-259,58
-1,1922,1874,48,0,-13,68
1,1620,1737,-117,0,17,59
1,1535,1543,-8,2,48,65
1,2012,1510,502,-1,-141,107
-1,1348,1509,-161,-3,-20,46
1,1545,1434,111,0,-3,109
1,1680,1569,111,-1,-29,59
1,1360,1301,59,0,187,89
-1,1619,1642,-23,1,-111,74
-1,1371,1544,-173,1,-9,60
-1,1320,1669,-349,-1,-95,58
1,1438,1295,143,-1,-44,55
1,1544,1723,-179,1,334,91
1,1667,1033,634,4,102,51
-1,1716,1683,33,5,244,84
1,1581,1711,-130,0,149,56
-1,1596,1653,-57,0,-117,82
-1,1186,1850,-664,0,-260,92
1,1598,1573,25,2,262,77
1,1354,1461,-107,0,-12,75
1,1657,1575,82,1,200,79
-1,1688,1751,-63,2,-689,176
1,1712,1324,388,2,199,63
1,1672,1668,4,-1,-324,127
1,1297,1084,213,10,235,51
-1,1646,1637,9,-5,-35,50
-1,1516,1533,-17,3,64,88
-1,1423,1537,-114,-9,-172,50
-1,1523,1556,-33,2,-21,40
1,1418,1459,-41,6,212,47
-1,1501,1405,96,0,-17,112
-1,1690,1890,-200,-5,-238,84
1,1696,1596,100,0,268,107
1,1433,1311,122,-1,29,115
1,1499,1688,-189,4,224,53
-1,1555,1681,-126,-2,-34,42
-1,1680,1634,46,0,-211,110
1,1765,1905,-140,0,38,69
-1,1662,1781,-119,-4,-163,118
1,1741,1746,-5,0,-65,79
-1,1321,1534,-213,-3,-42,62
0,1590,1547,43,1,-238,183
-1,1776,1788,-12,0,-21,82
1,1647,1637,10,6,275,54
1,1707,1665,42,0,-43,65
-1,1978,1955,23,-1,-79,86
-1,1676,1994,-318,-1,-181,74
-1,1297,1527,-230,-1,-75,57
-1,1673,1635,38,0,23,60
-1,1609,1658,-49,0,33,84
1,1647,1615,32,2,121,71
1,1354,1372,-18,2,52,71
-1,1542,1555,-13,-23,-888,57
-1,1637,1663,-26,-10,-148,46
0,1543,1716,-173,-9,-21,88
1,1467,1532,-65,2,169,67
1,2071,1966,105,0,349,113
-1,1679,1901,-222,-3,-45,58
-1,1827,1922,-95,-3,-112,74
-1,1507,1563,-56,-2,-321,118
1,1799,1672,127,0,208,85
1,1539,1316,223,0,265,63
-1,1565,2094,-529,0,1,60
-1,1654,1774,-120,-2,-489,130
1,1684,1692,-8,-2,71,91
1,1560,1349,211,11,158,45
-1,1785,1665,120,-4,-36,48
1,1517,1639,-122,6,273,59
-1,1604,1657,-53,0,-31,51
-1,1719,1880,-161,0,-117,76
-1,1719,1669,50,2,1,64
-1,1404,1418,-14,0,0,52
1,1806,1665,141,1,172,75
1,1668,1585,83,-3,-15,45
-1,1296,1400,-104,3,71,54
1,1454,1123,331,8,330,65
1,1498,1566,-68,7,-17,41
1,1580,1623,-43,6,70,41
1,1910,1719,191,1,4,65
1,1727,1818,-91,8,278,61
1,1667,1594,73,0,-37,101
-1,1511,1361,150,2,158,76
1,1844,1959,-115,0,-23,97
1,1447,1519,-72,8,114,49
-1,1813,1657,156,-5,-208,78
-1,1531,1500,31,-6,-262,54
1,1615,1553,62,4,194,67
-1,1370,1199,171,-5,-699,86
1,1310,1564,-254,2,367,71
-1,1674,1836,-162,-5,-325,82
0,1657,1583,74,-7,-391,153
0,1669,1911,-242,0,284,190
-1,1772,1581,191,0,19,100
1,2047,2052,-5,1,61,73
1,1585,1675,-90,0,108,99
-1,1543,1566,-23,-2,-320,114
-1,1436,1456,-20,-2,-1,40
1,1394,1288,106,1,51,47
1,1711,1548,163,-1,163,111
-1,1916,1865,51,-1,-4,42
-1,1945,1872,73,0,-13,116
-1,1222,1507,-285,-2,-99,54
-1,1534,1798,-264,-1,-85,56
-1,1679,1667,12,1,45,84
1,1608,1656,-48,-3,-147,57
0,1580,1806,-226,2,183,144
1,1457,1704,-247,0,-49,85
1,1802,1530,272,-6,-76,83
-1,1662,1600,62,-3,-44,58
1,1588,1565,23,3,321,83
1,1931,1818,113,2,63,40
1,1296,1376,-80,1,20,55
1,1545,1330,215,0,157,127
1,1565,1320,245,3,57,47
1,1686,1676,10,2,111,65
1,1942,1879,63,1,57,105
1,1613,1649,-36,3,222,77
-1,1897,1932,-35,0,-84,62
1,2154,1521,633,2,145,119
-1,1311,1604,-293,4,86,58
0,1832,1963,-131,-3,-71,159
1,1408,1287,121,0,15,79
1,1540,1309,231,5,93,45
-1,1415,1411,4,-9,-128,42
0,1924,1977,-53,0,3,81
-1,1648,1500,148,-1,-230,86
-1,1428,1487,-59,-3,-635,134
1,1482,1416,66,-9,-245,49
-1,1301,1687,-386,15,339,44
-1,1810,1940,-130,1,2,44
-1,1679,1638,41,0,-100,68
-1,1520,2155,-635,-6,-107,46
1,1815,1567,248,0,211,91
1,1852,1631,221,1,83,53
1,1656,2064,-408,-3,507,111
-1,1315,1597,-282,-4,23,56
1,1357,1075,282,1,56,43
1,1537,1550,-13,-1,91,93
-1,1665,1697,-32,-4,-50,64
-1,1694,1914,-220,0,18,62
-1,1408,1427,-19,-4,-125,48
0,1518,1533,-15,-10,-357,133
1,1967,1819,148,2,224,91
-1,1650,1666,-16,-6,-41,56
1,1652,1550,102,-2,95,85
-1,1433,1529,-96,-1,-50,76
-1,1250,1452,-202,-1,-120,50
1,2033,1782,251,0,22,57
-1,1324,1517,-193,-7,-196,66
1,1730,1519,211,1,85,74
1,1864,1951,-87,0,-7,111
1,1551,1545,6,-4,277,163
1,1640,1620,20,0,24,65
-1,1677,1639,38,2,-21,104
-1,1302,1412,-110,2,-89,66
-1,1232,1434,-202,-2,-158,56
-1,1837,1868,-31,1,1,48
1,1362,1537,-175,0,-4,43
1,1919,1689,230,-5,-172,69
1,1540,1242,298,-9,-153,55
-1,1807,2040,-233,-1,-291,130
-1,1757,1696,61,-4,-253,98
1,1572,2028,-456,1,29,55
-1,1802,1772,30,0,-9,60
1,1500,1500,0,2,214,77
-1,1652,1665,-13,8,234,56
1,2156,1268,888,2,327,71
-1,1598,1521,77,-3,-256,74
-1,1937,1886,51,-3,-36,64
-1,1514,1735,-221,-2,-81,56
-1,1379,1377,2,0,-29,60
-1,1676,1641,35,-5,-133,62
1,1691,1522,169,3,-23,41
1,1840,1727,113,-2,236,141
-1,1851,1500,351,-1,-42,50
1,1811,1716,95,0,-4,77
-1,1511,1404,107,-3,-77,66
-1,1608,1597,11,1,52,58
-1,1191,1532,-341,-3,-153,58
-1,1993,2047,-54,1,-68,60
-1,1245,1271,-26,-9,-364,56
1,1237,1367,-130,-17,-777,67
-1,1655,1640,15,2,16,82
1,1321,1501,-180,1,161,73
-1,1741,1508,233,0,-38,74
1,1907,1925,-18,0,-2,59
1,1924,1832,92,0,60,71
-1,1704,1887,-183,1,-192,104
-1,1337,1662,-325,0,-38,74
1,1533,1534,-1,4,280,87
1,1829,1590,239,-1,162,77
-1,1532,1623,-91,-4,-325,93
-1,1783,1898,-115,0,6,68
-1,1596,1684,-88,1,5,56
1,1535,1585,-50,3,30,49
1,1586,1500,86,0,529,155
-1,1258,1347,-89,2,136,50
1,1902,1697,205,1,714,131
1,1724,1544,180,1,123,89
1,1675,1679,-4,-1,-68,109
0,1717,1856,-139,-1,-197,144
-1,1549,1513,36,-4,-5,64
1,1484,1468,16,0,5,71
1,1529,1352,177,5,198,55
-1,1358,1246,112,-12,-301,52
1,1407,1516,-109,1,79,79
1,1362,1592,-230,5,1035,123
-1,1796,1519,277,-3,-317,146
1,1512,1307,205,12,251,45
1,1919,1924,-5,0,165,85
1,1914,1925,-11,1,117,71
-1,1588,1708,-120,0,-649,112
1,1692,1527,165,4,93,47
1,1826,1504,322,0,22,93
1,1545,1537,8,0,2,67
-1,1664,1904,-240,0,-177,92
1,1518,1597,-79,-3,31,49
-1,1686,1914,-228,1,26,138
1,1605,1438,167,0,-87,113
-1,1535,1279,256,-4,-863,118
-1,1572,1548,24,-4,-106,54
-1,1754,1670,84,1,67,74
-1,1925,1681,244,-2,-72,68
1,1610,1500,110,-6,-177,63
-1,1338,1474,-136,-5,-92,44
-1,1726,1521,205,0,15,60
1,1489,1601,-112,11,374,55
-1,1266,1339,-73,-7,-238,70
1,1544,1317,227,8,241,55
1,1722,1440,282,0,191,95
1,1533,1301,232,0,86,69
1,1562,1620,-58,5,180,73
1,1371,1617,-246,2,166,65
-1,1295,1538,-243,-4,-153,54
-1,1538,1774,-236,-3,-445,128
1,1518,1495,23,0,4,50
1,1684,1624,60,0,239,141
-1,1386,1381,5,1,68,58
-1,1543,1452,91,8,178,100
0,1310,1354,-44,-1,-55,88
-1,1848,1896,-48,0,-48,64
1,1516,1659,-143,-1,513,167
-1,1276,1528,-252,-11,-632,68
1,1803,1722,81,3,133,65
-1,1346,1394,-48,-1,-21,44
-1,1556,1564,-8,-1,-319,124
1,1707,1699,8,1,101,67
1,1569,1192,377,3,49,51
1,2037,1802,235,4,593,105
1,1363,1500,-137,1,9,47
-1,1389,1492,-103,-2,-829,120
-1,1687,1909,-222,-6,-138,56
1,1543,1289,254,5,153,41
1,1244,1375,-131,2,76,47
-1,1919,1682,237,0,21,72
-1,1524,1849,-325,0,-18,46
1,1329,1546,-217,3,30,49
1,1481,1501,-20,-3,-33,73
-1,1175,1575,-400,1,7,42
1,1271,1312,-41,-12,-145,79
1,1768,1501,267,5,571,117
-1,1307,1431,-124,-5,-112,52
-1,1600,1650,-50,1,47,82
-1,1254,1811,-557,-2,-138,72
-1,1829,1948,-119,-6,-175,52
-1,1378,1437,-59,5,118,48
-1,1700,1885,-185,0,-80,106
0,1797,1530,267,-1,-237,86
-1,1586,1507,79,-1,-252,108
-1,1575,1561,14,0,-137,88
-1,1741,2156,-415,1,32,58
-1,1398,1596,-198,1,6,66
1,1598,1280,318,1,50,53
1,1348,1819,-471,-9,-103,40
-1,1361,1417,-56,-7,-242,58
1,1926,1712,214,0,24,51
1,1808,1531,277,4,25,43
-1,1843,1795,48,0,-90,70
-1,1376,1267,109,2,-130,86
-1,1719,1688,31,0,7,74
-1,1580,1366,214,10,606,76
1,1898,1693,205,2,147,65
1,1549,1487,62,-4,29,47
1,1566,1812,-246,-1,-871,107
1,1630,1602,28,-1,-10,47
1,1316,1151,165,6,380,57
-1,1495,1593,-98,-1,-49,52
1,1498,1350,148,0,161,85
1,1528,1484,44,2,24,63
-1,1219,1529,-310,-2,-187,50
1,1833,1821,12,5,91,48
-1,1523,1812,-289,-1,-202,112
0,1449,1547,-98,-1,6,56
1,1830,1706,124,1,73,69
-1,1905,1931,-26,-1,-9,70
-1,1608,1611,-3,-8,-601,92
-1,1270,1436,-166,-8,-101,48
-1,1736,2162,-426,0,15,42
-1,1925,1966,-41,0,44,104
-1,1822,1797,25,-1,-9,44
-1,1593,1594,-1,-2,-131,84
-1,1531,1264,267,-2,-212,58
-1,1298,1298,0,4,14,46
-1,1592,1651,-59,-2,-70,50
-1,1538,1607,-69,-2,-11,52
-1,1334,1500,-166,0,-158,76
1,1343,983,360,7,318,54
1,1609,1329,280,2,85,87
1,1789,1694,95,7,472,93
1,1844,1909,-65,1,11,53
-1,1542,1531,11,-1,-63,82
1,1568,1412,156,1,49,49
-1,1706,1742,-36,0,-17,72
1,1660,1572,88,0,-6,61
1,1798,1685,113,1,108,91
1,1817,1816,1,0,91,69
-1,1715,1508,207,0,-12,118
-1,1324,1506,-182,-3,82,54
-1,1480,1381,99,-3,-145,58
1,1630,1674,-44,7,149,59
-1,1515,1804,-289,-2,-511,116
-1,1522,1500,22,0,-314,131
1,1604,857,747,4,58,47
-1,1354,1346,8,-14,-156,40
-1,1500,1694,-194,-4,-111,60
1,1685,1533,152,4,77,50
1,1426,1316,110,1,-48,55
1,1512,1318,194,3,239,63
-1,1467,1530,-63,-3,-191,72
1,1544,1564,-20,0,-152,65
0,1678,1771,-93,-6,-117,147
1,1818,1895,-77,1,63,49
-1,1806,1783,23,0,-571,114
-1,1367,1358,9,-3,-31,42
0,1826,1697,129,2,44,63
1,1676,1686,-10,0,23,57
-1,1588,1633,-45,-1,-16,58
1,2061,1668,393,0,2,61
1,1804,1829,-25,-1,30,75
1,1344,1248,96,1,527,97
-1,1500,1668,-168,-5,-575,94
-1,1294,1263,31,-3,-342,81
1,1795,1794,1,1,74,75
-1,1493,1514,-21,3,130,71
1,1525,1517,8,4,399,141
-1,1491,1426,65,1,79,74
1,1680,1960,-280,0,-179,79
-1,1604,1686,-82,0,23,84
1,1553,1565,-12,0,18,43
-1,1321,1611,-290,-6,-809,104
1,1620,1768,-148,1,587,103
-1,1259,1285,-26,0,54,47
1,1611,1416,195,6,273,58
1,1505,1311,194,5,83,45
-1,1519,1768,-249,0,-59,126
1,1355,1626,-271,-2,-58,81
1,1974,1916,58,-1,-113,61
-1,1538,1516,22,-5,-247,66
1,1488,1473,15,-1,-17,62
-1,1593,1702,-109,-2,23,42
-1,1580,1642,-62,-1,-535,122
-1,1942,1700,242,-1,-96,122
-1,1325,1659,-334,-1,-19,48
-1,1699,1075,624,-1,31,50
-1,1500,1489,11,-1,-1059,202
1,1859,1563,296,-1,-45,81
-1,1642,1578,64,-2,-223,160
1,1671,1619,52,-10,-66,69
1,1307,1434,-127,-2,-136,109
-1,1526,1692,-166,0,-173,110
1,1816,1817,-1,-2,73,82
-1,1814,1666,148,0,-8,78
1,1539,1457,82,1,82,51
-1,1481,1485,-4,-1,-166,84
1,1276,1282,-6,-2,-58,57
1,1570,1539,31,-2,101,89
-1,1718,1925,-207,-10,-151,50
-1,1496,1370,126,0,-47,54
-1,1405,1554,-149,-2,-36,55
-1,1582,1775,-193,0,-47,66
-1,1249,1562,-313,0,53,84
1,1342,1500,-158,-4,-108,49
1,1930,1712,218,5,180,63
1,1908,1907,1,4,164,61
-1,1314,1390,-76,7,383,86
-1,1797,1869,-72,1,27,98
1,1675,1297,378,-2,-440,111
1,2061,1789,272,-1,109,91
-1,1426,1629,-203,1,-62,100
1,2165,1580,585,3,151,59
-1,1600,1716,-116,-2,-31,62
1,1374,1500,-126,-2,271,139
-1,1707,1935,-228,-1,-237,120
-1,1895,1742,153,1,-32,104
-1,1403,1858,-455,-3,-133,100
-1,1363,1387,-24,1,6,46
1,1705,1617,88,4,407,91
1,1863,1559,304,0,25,75
1,1499,1478,21,-1,-30,63
1,1803,1480,323,2,47,57
-1,1506,1470,36,-5,-13,40
-1,1897,1924,-27,-4,-351,96
-1,1623,1721,-98,-1,-189,66
-1,1515,1625,-110,-5,9,52
1,1338,1288,50,0,-5,47
1,1507,1679,-172,1,107,75
-1,1349,1381,-32,1,-33,42
1,1682,1792,-110,0,36,61
1,2066,1982,84,0,16,51
1,1219,1252,-33,4,392,89
1,1625,1653,-28,0,-294,105
1,1940,1702,238,-1,41,79
1,1698,1519,179,4,144,45
1,1908,1729,179,-2,-379,77
-1,2166,1500,666,-9,-149,56
1,1591,1629,-38,3,71,67
1,2114,2144,-30,-2,-70,73
1,1609,1603,6,-1,17,85
-1,1649,1526,123,2,56,60
1,1651,1566,85,-2,60,69
1,1401,1297,104,0,39,75
1,1415,1108,307,4,945,123
1,1916,1724,192,-3,-99,97
-1,1635,1828,-193,-4,61,70
-1,1464,1493,-29,-1,-152,66
-1,1239,1261,-22,-3,-84,52
1,1697,1944,-247,2,150,73
1,1491,1514,-23,4,267,81
-1,1301,1482,-181,-11,-128,42
-1,1586,1672,-86,-1,19,42
-1,1591,1627,-36,-6,-1033,132
-1,1692,1403,289,-2,-99,74
-1,1561,1398,163,0,-113,103
-1,1923,1718,205,0,-277,102
-1,1592,2131,-539,-5,-152,54
1,1843,1681,162,2,87,71
-1,1521,1509,12,-3,-94,52
1,1565,1469,96,0,147,105
1,1805,1723,82,0,14,85
-1,1409,1288,121,-6,-532,90
1,1513,1704,-191,4,162,65
1,1384,1556,-172,-1,7,71
-1,1521,1433,88,-5,-55,58
-1,1431,1445,-14,-6,-70,60
1,2088,2143,-55,0,-37,85
1,1683,1409,274,1,219,83
-1,1418,1384,34,-1,-17,64
-1,1607,1541,66,-1,-75,66
-1,1877,1969,-92,-3,-434,100
-1,1505,1660,-155,-3,-81,90
1,1881,1500,381,0,85,80
1,1469,1399,70,-4,-51,85
1,1775,1788,-13,0,200,109
1,1055,1333,-278,6,1265,169
-1,1480,1526,-46,0,0,70
1,1939,1996,-57,-1,-58,107
1,1419,1456,-37,-1,-6,43
-1,1400,1350,50,-10,-419,62
-1,1861,1985,-124,-2,-425,124
-1,2130,2101,29,-4,-5,42
1,1349,1282,67,-1,-43,61
-1,1599,1828,-229,-1,-2,50
-1,1208,1521,-313,1,147,72
1,1562,1732,-170,1,-12,47
1,1301,1405,-104,-2,316,79
-1,1951,1982,-31,-2,-40,59
1,1992,1853,139,3,210,76
1,1484,1724,-240,-4,-65,49
-1,1715,1579,136,0,0,52
1,1764,1677,87,-1,18,59
-1,1500,1640,-140,-7,-245,52
1,1836,1815,21,1,90,91
1,1387,1328,59,-1,-269,79
-1,1445,1275,170,-3,-117,68
-1,1777,1787,-10,0,-332,130
1,1502,1287,215,5,112,45
-1,1993,1942,51,-1,75,72
-1,1846,1999,-153,-1,-116,82
-1,1747,1797,-50,1,-320,118
-1,1319,1194,125,1,-36,40
-1,1437,2180,-743,-2,-181,90
1,1473,1523,-50,2,60,60
1,2006,1840,166,5,390,81
0,2114,2117,-3,0,13,87
0,1589,1438,151,0,-63,107
-1,1398,1405,-7,-1,-111,88
-1,1601,1500,101,1,17,51
1,1412,1380,32,-1,51,117
1,1897,1832,65,2,163,71
-1,1610,1679,-69,0,-90,112
-1,1468,1682,-214,-3,-228,58
1,1696,1502,194,0,12,45
-1,1154,1815,-661,-3,-218,82
-1,1655,1550,105,-8,-218,68
1,1954,2181,-227,6,595,91
1,1832,1629,203,1,30,47
-1,1833,2012,-179,-2,-29,50
1,1647,1382,265,1,231,65
1,1464,1500,-36,5,184,48
1,2117,2114,3,1,86,53
-1,1403,1477,-74,2,-167,74
-1,1858,1980,-122,0,-461,138
1,2018,1827,191,1,353,117
1,1597,1634,-37,0,56,87
1,1732,1589,143,0,25,69
-1,1536,1360,176,0,11,48
-1,1766,2067,-301,0,-186,84
1,1789,1646,143,5,35,41
1,1687,1459,228,-1,-79,51
-1,1454,1405,49,0,-288,116
-1,1288,1424,-136,-4,-43,40
1,1821,2023,-202,0,7,41
-1,1844,1823,21,1,-121,88
1,1906,1828,78,0,-5,101
1,1412,1500,-88,2,634,115
1,1526,1497,29,5,438,95
1,1988,1851,137,0,91,55
1,2007,1839,168,0,-9,63
1,1873,1705,168,1,30,53
1,1506,1244,262,0,-10,57
-1,1450,1692,-242,-2,-9,70
-1,1759,1867,-108,-2,-43,54
1,1970,1671,299,0,475,159
-1,1844,1995,-151,-1,-32,68
-1,1499,1425,74,-2,-92,74
1,1580,1810,-230,-1,755,149
1,1875,1640,235,-3,169,79
1,1729,1488,241,0,25,59
-1,1267,2158,-891,0,-8,78
-1,1476,1594,-118,-2,-7,46
-1,2013,2119,-106,1,40,100
1,1667,1540,127,7,100,41
1,1431,1246,185,1,113,75
-1,1763,1816,-53,0,4,72
-1,1441,1508,-67,-1,-43,48
-1,1805,1846,-41,0,-2,54
1,1524,1500,24,0,89,65
-1,1324,1315,9,1,-14,110
-1,1576,1443,133,-3,-22,40
-1,1661,1490,171,-8,-290,102
1,1845,1851,-6,7,265,75
1,1915,1807,108,6,199,53
1,1887,1631,256,-5,215,133
-1,1882,2158,-276,-1,-46,96
1,1835,1833,2,0,-66,99
-1,1786,1540,246,-1,-55,56
1,1679,1089,590,12,156,41
-1,1266,2005,-739,-1,-21,62
1,1820,1710,110,0,-140,121
-1,1757,1771,-14,1,52,103
-1,1600,1541,59,-7,-116,60
-1,1840,1856,-16,-2,-178,84
1,1826,1754,72,0,87,73
-1,1866,1846,20,-2,34,40
1,1695,1881,-186,0,-202,97
-1,1507,1337,170,0,9,72
1,1697,1443,254,3,161,65
1,1336,1496,-160,-3,-98,77
1,1877,2163,-286,7,128,51
1,1634,1532,102,2,483,111
-1,1367,1422,-55,5,37,80
1,1520,1377,143,0,493,79
0,1867,1830,37,1,1,104
-1,1597,1622,-25,1,22,60
-1,1627,1892,-265,-5,-111,54
0,1437,1318,119,-4,-218,70
1,1824,1709,115,-2,-138,83
1,2133,2002,131,0,96,93
1,1624,1641,-17,-2,-39,51
-1,1672,1565,107,0,-191,104
0,1745,1835,-90,0,-21,129
1,2006,1262,744,0,5,45
-1,1558,1767,-209,0,-179,80
-1,1831,1865,-34,-5,63,88
1,1546,1693,-147,1,53,69
-1,1855,1796,59,1,164,92
1,1574,1557,17,-2,-27,47
-1,1437,1610,-173,-3,-107,76
-1,1603,1853,-250,0,-75,84
-1,1837,2006,-169,-2,-182,76
1,1838,1737,101,6,404,89
-1,1906,1623,283,-5,-136,50
1,1570,1108,462,5,61,47
1,1576,1442,134,0,11,47
1,1926,1722,204,0,-87,63
1,1602,1281,321,3,29,45
0,1322,1433,-111,3,108,94
1,1822,1846,-24,1,72,55
-1,1429,1748,-319,-6,-361,72
1,2013,1831,182,2,139,55
-1,1832,1748,84,0,8,122
1,1888,1637,251,0,-46,63
1,1528,1523,5,4,272,71
1,1875,1932,-57,0,147,151
-1,1201,1486,-285,-3,150,74
1,1364,1391,-27,-3,-54,47
-1,1311,1435,-124,-6,-463,90
-1,1483,1734,-251,-2,-33,54
1,1825,2019,-194,5,284,101
-1,1869,1703,166,0,-49,76
-1,1827,1832,-5,-2,-189,116
-1,1088,1471,-383,-4,-969,124
-1,1645,1599,46,1,23,48
-1,1437,1820,-383,0,7,56
-1,1893,1974,-81,-1,-118,64
0,1858,1598,260,-5,-112,180
1,1917,1888,29,0,-10,105
-1,1834,1833,1,-2,-501,178
1,1632,1823,-191,-11,-552,125
-1,1397,1204,193,1,44,42
-1,1651,1539,112,0,-198,108
-1,1125,1287,-162,-9,-367,78
1,1883,1842,41,0,-26,81
-1,1615,1707,-92,-7,-131,60
1,1512,1621,-109,0,234,97
-1,1097,1572,-475,1,58,60
-1,1546,1579,-33,3,0,52
-1,1761,1818,-57,0,-182,116
1,1425,1330,95,1,329,81
1,1601,1459,142,-5,-135,59
1,2001,2128,-127,0,163,145
0,1786,1390,396,0,-291,152
1,1895,1832,63,-4,-48,65
0,1665,1779,-114,-1,-77,52
1,1627,1633,-6,-1,49,107
1,1802,1717,85,-1,-307,119
-1,1607,1599,8,-2,-33,96
1,2144,1529,615,1,131,81
0,1845,1817,28,-1,-11,93
-1,1752,1715,37,-1,-509,122
-1,1514,1526,-12,3,105,46
-1,1580,1828,-248,0,-14,72
1,1774,1669,105,2,31,49
-1,1719,1790,-71,0,-8,96
1,1430,1445,-15,-1,-49,55
-1,1605,1635,-30,-6,-101,66
1,1994,1891,103,0,7,49
1,2001,1788,213,1,25,57
0,1536,1425,111,9,615,99
1,1485,1422,63,4,277,89
1,1574,1088,486,-1,-19,90
-1,1381,1490,-109,1,16,48
1,1784,1528,256,1,61,85
0,1883,2002,-119,-5,-188,99
-1,1433,1513,-80,-6,-141,54
-1,1782,2007,-225,0,17,44
1,1438,1585,-147,2,37,51
-1,1120,1241,-121,-6,-359,64
-1,1449,1519,-70,0,-57,80
-1,1740,1832,-92,1,-11,51
-1,1999,1887,112,1,-146,58
-1,1500,1555,-55,-3,-62,47
1,1571,1455,116,0,9,55
-1,1818,1844,-26,0,-107,82
-1,1533,1851,-318,0,-45,46
1,1523,1790,-267,1,15,55
1,1982,1784,198,1,18,49
-1,1487,1595,-108,-2,-68,58
-1,1595,1709,-114,4,149,82
1,1303,1449,-146,2,152,87
1,1696,1616,80,2,181,63
1,1988,1901,87,0,35,67
-1,1530,1556,-26,0,9,52
0,1743,1854,-111,-1,-41,155
-1,1752,1824,-72,0,194,134
-1,1447,1469,-22,-3,-85,54
-1,1452,1582,-130,-9,-116,48
1,1365,1258,107,11,259,53
-1,1718,1711,7,-2,-101,82
-1,1574,1459,115,-7,-497,80
-1,1622,1651,-29,-3,-142,70
1,1498,1308,190,7,250,46
-1,1490,1864,-374,-2,-202,72
-1,1893,1996,-103,0,-525,110
1,1696,1708,-12,-1,-25,75
1,1562,1535,27,-1,-4,53
-1,1333,1400,-67,0,-23,56
-1,1778,1929,-151,2,17,60
1,1424,1576,-152,-3,-107,67
1,1856,1808,48,0,-128,79
1,2004,1885,119,-4,28,45
-1,1694,1708,-14,-3,-126,64
-1,1984,2012,-28,-1,-155,108
1,1526,1480,46,-5,-61,107
0,1500,1500,0,0,847,125
-1,1678,1629,49,1,-195,96
1,1922,1801,121,-1,-38,47
0,1815,1710,105,0,-211,112
-1,1877,2011,-134,-5,-333,124
1,1706,1483,223,4,515,105
1,1512,1465,47,-1,34,55
-1,1757,1851,-94,0,-131,184
1,1472,1687,-215,-1,179,79
-1,1499,1719,-220,-2,-80,74
-1,1365,1603,-238,-3,-24,66
-1,1320,1079,241,-6,-538,70
-1,1572,1654,-82,-1,-173,112
1,1411,1495,-84,4,183,97
1,2018,1870,148,7,219,59
1,1445,1643,-198,8,590,83
-1,1388,1521,-133,-17,-244,92
-1,1441,1282,159,-2,-73,56
1,1220,0,1220,13,752,79
-1,1716,1678,38,-3,-148,64
-1,1864,2024,-160,-1,-48,66
-1,1671,1589,82,0,-17,56
-1,1612,1500,112,-2,-70,66
1,1729,1600,129,-1,105,63
1,1845,1789,56,-4,-102,91
1,1536,1469,67,-1,52,73
1,2031,1858,173,-4,106,67
1,1401,1647,-246,0,14,47
1,1799,1866,-67,1,108,75
1,1743,1798,-55,0,164,61
1,1509,1560,-51,1,80,81
-1,1851,2037,-186,-2,-396,90
1,1507,1355,152,0,-1,51
-1,1558,1440,118,0,25,52
-1,1353,1427,-74,2,62,40
1,1859,1725,134,2,53,41
1,1302,1347,-45,9,1101,95
-1,1783,1756,27,-3,-32,44
-1,1800,1723,77,2,129,88
1,1515,1426,89,4,63,57
1,1545,1434,111,1,0,83
-1,1394,1509,-115,-10,-513,70
-1,1852,1812,40,0,-50,54
1,1587,1700,-113,-2,73,65
-1,1846,1974,-128,-4,-722,94
-1,1867,1844,23,3,93,54
-1,1184,1646,-462,-6,-139,44
-1,1766,1611,155,0,88,80
-1,1500,1500,0,-17,-512,57
1,1823,1578,245,1,150,83
-1,1459,1571,-112,-3,-189,92
1,1981,1839,142,-3,-8,51
-1,1520,1895,-375,-4,-138,52
-1,1823,1838,-15,-2,-24,50
1,1674,1454,220,0,160,75
1,1912,1553,359,5,60,41
0,1832,1988,-156,0,-105,107
1,1563,1459,104,-3,-52,99
-1,1519,2024,-505,-9,-3,50
1,2028,1867,161,0,-19,149
1,1725,1493,232,0,15,85
-1,1737,1946,-209,-1,-64,64
-1,1932,1859,73,-13,-979,84
-1,1449,1549,-100,-2,-184,74
1,1630,1304,326,2,263,91
1,1464,1069,395,4,128,55
-1,1220,0,1220,-1,3,50
1,1596,1820,-224,0,-194,87
1,1983,1836,147,3,87,57
1,1518,1550,-32,0,143,107
-1,1665,1837,-172,-3,-68,90
-1,1580,1450,130,-9,-266,54
1,1759,1854,-95,-5,-1,80
-1,1455,1542,-87,1,81,58
-1,1601,1578,23,-10,-36,40
-1,1871,1607,264,0,39,84
-1,1891,1518,373,-8,-22,44
-1,1337,1374,-37,-4,-138,46
-1,1830,1990,-160,-5,-229,84
0,1930,1833,97,0,148,190
1,1850,1813,37,0,-27,95
-1,1479,1668,-189,1,29,50
1,1996,1823,173,2,109,59
1,1589,1591,-2,0,123,95
-1,1540,1838,-298,-4,-30,46
-1,1431,1431,0,-3,-67,48
1,1387,1304,83,0,31,41
-1,1527,1508,19,-5,-100,46
1,1605,1467,138,-3,-2,41
0,2003,2025,-22,1,-13,97
1,1944,1715,229,2,-11,71
-1,1324,1549,-225,-3,-140,64
-1,1531,1536,-5,-1,-155,94
1,1786,1731,55,4,195,73
1,1847,1536,311,5,69,47
1,1466,1589,-123,1,199,73
-1,1611,1704,-93,0,218,178
1,2024,2003,21,2,229,83
-1,1635,1557,78,-2,8,80
1,1519,1515,4,5,272,75
1,1856,1587,269,1,136,85
-1,1532,1855,-323,0,-1,46
-1,1446,1427,19,0,-37,62
-1,1804,1860,-56,0,138,102
1,1837,2113,-276,0,-167,75
1,1993,2036,-43,0,-44,57
-1,1627,1737,-110,0,17,58
-1,1784,1823,-39,0,-110,70
-1,1601,1592,9,0,-96,78
-1,1451,1556,-105,-1,-22,62
0,1807,1813,-6,0,2,86
-1,1390,1549,-159,1,-376,112
-1,1332,1439,-107,1,34,54
-1,1394,1649,-255,-4,-161,70
-1,1487,1730,-243,-5,-295,68
1,2022,2005,17,0,66,91
1,1870,1590,280,0,49,111
-1,1566,1860,-294,-3,-50,56
-1,1529,1474,55,-4,-23,46
1,1553,1536,17,1,46,64
1,1697,1480,217,5,100,55
1,2095,1860,235,1,61,65
-1,1995,2034,-39,-3,-26,62
-1,1748,1690,58,-1,-20,72
-1,1585,1879,-294,-1,-45,64
1,1590,1181,409,-1,52,57
1,1870,1795,75,0,65,75
1,1589,1504,85,0,195,89
1,1549,1449,100,1,26,41
-1,1425,1359,66,1,11,56
-1,1551,1306,245,0,-97,86
1,1619,1745,-126,0,-21,99
1,1887,1581,306,1,135,73
1,1864,1549,315,1,31,40
-1,1712,1545,167,0,32,100
-1,1612,1604,8,2,34,60
1,1530,1385,145,1,317,95
-1,1563,1401,162,-2,-161,70
1,1473,1626,-153,7,247,61
1,1434,1500,-66,1,7,43
1,1854,2100,-246,0,88,113
1,1570,1170,400,8,255,58
1,1779,1547,232,3,179,80
-1,1192,1309,-117,6,173,44
1,2023,1689,334,2,61,53
-1,1359,1554,-195,-2,-55,44
1,1884,1093,791,3,209,69
-1,1488,1516,-28,-3,-42,46
-1,1598,1408,190,-2,-37,52
-1,1703,1736,-33,-3,-182,64
-1,1305,1433,-128,-10,-43,40
-1,1468,1709,-241,-5,-35,50
1,1659,1289,370,2,53,61
1,1443,1388,55,0,-6,57
1,1572,1159,413,1,189,75
-1,1338,1571,-233,0,22,74
1,1735,1482,253,5,68,49
1,1524,1606,-82,-1,425,115
1,1817,1559,258,0,23,55
-1,1556,1650,-94,-15,-406,42
-1,1807,1500,307,2,63,96
1,1746,1693,53,-1,1,87
-1,1561,1697,-136,-3,-62,58
0,1812,1867,-55,-2,118,117
-1,1581,1359,222,-6,-191,52
-1,1602,1727,-125,-1,-117,98
1,1898,1821,77,-1,-24,57
0,1653,1436,217,3,169,119
1,1742,1564,178,0,-23,77
0,1559,1372,187,-4,-691,212
-1,1706,1537,169,-3,-1,68
-1,1699,1662,37,0,-12,50
1,1716,1813,-97,-4,-364,77
1,1548,1430,118,-15,-169,41
-1,1602,1536,66,1,43,62
-1,1308,1507,-199,0,-81,80
-1,1565,1718,-153,-3,-9,56
1,1806,1587,219,0,3,43
1,1574,1149,425,-2,-209,119
-1,1426,1704,-278,-9,-585,89
-1,1700,1799,-99,-1,-35,74
-1,1585,1489,96,-2,-50,100
0,1787,1730,57,7,341,64
-1,1714,1459,255,-4,-40,74
-1,1537,1865,-328,-1,-68,70
0,1552,1689,-137,1,82,109
1,1452,1500,-48,19,505,45
1,1558,1748,-190,0,38,79
1,1807,1692,115,1,147,65
-1,1590,1500,90,-8,-722,84
1,1898,1507,391,3,206,57
1,1588,1741,-153,0,35,107
-1,1438,1302,136,-4,-271,84
-1,1477,1740,-263,-3,-80,62
-1,1558,1631,-73,-1,-53,52
-1,1684,1814,-130,3,-132,112
-1,1512,1299,213,-1,-40,70
1,1522,1571,-49,-1,7,47
-1,1559,1675,-116,0,-353,144
-1,1177,1592,-415,-8,-286,72
-1,1098,1556,-458,-9,-331,55
1,1707,1422,285,4,64,47
1,1821,1677,144,1,57,79
-1,1556,1323,233,0,18,72
1,1885,1495,390,-5,398,91
-1,1624,1921,-297,0,-5,58
-1,1461,1433,28,-6,-271,142
-1,1410,1343,67,-5,-206,54
1,1549,1604,-55,0,6,69
-1,1670,1828,-158,-9,-246,60
1,1921,1732,189,6,129,45
1,1950,1620,330,0,-48,55
-1,1418,1711,-293,-6,-212,78
-1,1431,1765,-334,-1,-164,86
-1,1646,1757,-111,-1,-68,88
1,1607,1140,467,0,-10,63
-1,1835,1663,172,0,34,68
1,1972,1617,355,1,51,65
-1,1500,2145,-645,2,-33,70
-1,1558,1535,23,2,-318,94
1,1730,1500,230,-2,-190,75
1,1761,1775,-14,0,90,89
1,1776,1628,148,0,8,51
-1,1396,1495,-99,0,-19,48
-1,1093,1595,-502,-6,-519,72
-1,1120,1719,-599,-5,-286,76
-1,1526,1814,-288,0,30,86
-1,1680,1819,-139,1,25,66
1,1813,1741,72,-2,-98,71
1,1442,1439,3,0,10,61
1,1726,1927,-201,-2,-69,107
-1,1604,1534,70,1,62,60
-1,1562,1238,324,-11,-115,40
-1,1621,1720,-99,-2,-8,40
1,2147,1483,664,0,326,113
1,1826,1673,153,-1,-58,65
1,1608,1510,98,-1,-148,119
1,1377,1353,24,8,470,77
-1,1388,1503,-115,-1,-98,56
1,1715,1414,301,1,120,58
1,1729,1612,117,0,-4,47
-1,1391,1486,-95,3,232,90
1,1469,1389,80,-2,365,101
-1,1520,1473,47,-2,7,122
1,1838,1660,178,1,377,87
-1,1733,1822,-89,0,-161,92
-1,1635,1444,191,-6,-190,56
-1,1548,1613,-65,-1,-217,100
1,1503,1550,-47,0,-141,105
-1,1360,1598,-238,-1,-15,52
1,1428,1517,-89,6,164,58
-1,1591,1839,-248,0,-583,184
-1,1783,1654,129,2,51,40
1,1494,1500,-6,1,367,71
1,1544,1430,114,3,122,63
1,1844,1739,105,7,481,87
-1,1666,1832,-166,-2,-17,42
1,1539,1446,93,1,420,121
-1,1410,1718,-308,0,-4,94
-1,1446,1499,-53,3,31,54
1,1529,1278,251,0,-63,85
0,1735,1648,87,0,-109,129
1,1682,1602,80,0,301,133
-1,1558,1533,25,-5,-62,70
-1,1292,1350,-58,11,124,48
-1,1731,1852,-121,-1,-655,148
1,1888,1592,296,4,553,155
1,1639,1346,293,9,236,53
1,1133,1373,-240,5,38,43
-1,1830,1724,106,0,-74,71
-1,1380,1447,-67,-3,-19,58
-1,1502,1428,74,-1,-81,100
-1,1667,1669,-2,4,80,58
1,1859,1723,136,5,352,103
-1,1493,1545,-52,0,-1,40
1,1638,1534,104,-1,-1,63
1,1252,1337,-85,3,245,69
1,1536,1500,36,0,-16,61
-1,1680,1654,26,0,-44,74
1,1721,1407,314,2,207,141
1,1653,1490,163,-3,136,66
1,1985,1821,164,0,-2,53
-1,1634,1818,-184,-2,-131,82
1,1494,1382,112,1,58,85
1,1545,1547,-2,3,183,70
1,1679,1415,264,1,120,73
-1,1715,1866,-151,0,-86,102
-1,1643,1539,104,1,10,104
-1,1738,1816,-78,-1,-177,84
-1,1502,1554,-52,-2,-37,66
1,1668,1668,0,4,182,59
-1,1447,1564,-117,-6,-559,82
-1,1551,1454,97,-4,-64,72
-1,1815,1991,-176,2,78,60
-1,1599,1832,-233,0,-152,104
1,1873,1708,165,-3,-219,133
-1,1534,1639,-105,-6,-136,50
-1,1997,1809,188,0,21,48
-1,1208,1683,-475,0,-79,89
1,1657,1681,-24,3,48,45
1,1576,1623,-47,0,23,59
1,1655,1796,-141,0,173,145
1,1487,1508,-21,-1,64,75
-1,1825,1981,-156,-2,-113,62
1,1664,1545,119,-2,633,135
-1,1230,1290,-60,1,84,122
1,1699,1388,311,2,61,56
1,1865,1692,173,0,4,101
-1,1520,1665,-145,-6,-354,72
-1,1719,1803,-84,-1,-355,132
-1,1668,1635,33,1,-119,82
-1,1592,1654,-62,1,143,116
-1,1614,1680,-66,-1,-26,48
1,1630,1584,46,1,247,99
1,1488,1504,-16,0,630,95
-1,1422,1559,-137,0,-2,84
0,1607,1767,-160,-2,-307,99
-1,1405,1520,-115,-2,-77,56
0,1765,1658,107,0,-3,95
1,1695,1783,-88,1,-60,111
-1,1496,1563,-67,-3,-394,96
1,1654,1646,8,5,128,49
-1,1346,1548,-202,-5,-304,104
-1,1689,1604,85,-1,-17,68
1,1387,1425,-38,3,33,113
-1,1762,1612,150,0,-89,72
1,1672,1580,92,-2,-143,75
1,1762,1662,100,0,-14,43
1,1578,1527,51,0,2,49
-1,1305,1340,-35,-14,-483,64
1,1653,1647,6,6,269,51
-1,1664,1581,83,0,-9,78
1,1554,1286,268,-4,-35,47
1,1517,1609,-92,-2,33,61
1,1665,1637,28,0,10,55
-1,1454,1645,-191,3,-397,102
-1,1579,1635,-56,0,4,54
1,1711,1523,188,-4,-103,73
-1,1225,1367,-142,-4,38,40
-1,1878,1799,79,1,-250,104
-1,1763,1606,157,-2,-33,72
1,1746,1652,94,0,46,97
1,1285,1136,149,-9,-421,89
1,1755,1575,180,5,382,81
1,1925,1931,-6,0,136,64
1,1573,1513,60,10,450,69
-1,1650,1611,39,-3,43,56
1,1415,1415,0,2,55,69
-1,1852,1787,65,-1,-79,58
1,1424,1093,331,0,14,49
1,1644,1569,75,2,114,69
1,1659,1627,32,-1,-18,49
-1,1476,1593,-117,-9,-26,40
-1,1500,1562,-62,-5,-47,50
-1,2012,1871,141,-1,-55,94
-1,1626,1690,-64,2,-203,120
1,1671,1538,133,2,92,57
-1,1493,1499,-6,-5,-98,108
-1,1366,1626,-260,-5,-84,50
-1,1754,1778,-24,-7,-127,55
1,1628,1310,318,2,84,49
-1,1336,1705,-369,-14,-368,62
-1,1621,1642,-21,0,-40,78
-1,1269,1558,-289,-19,-602,66
-1,1813,1857,-44,0,9,62
1,1539,1395,144,0,118,69
-1,1639,1716,-77,-3,-5,40
-1,1570,1517,53,6,18,79
1,1568,1566,2,3,201,85
1,1350,1354,-4,7,550,95
-1,1371,1500,-129,-16,-252,52
-1,1561,1653,-92,0,-267,78
-1,1500,1631,-131,1,12,56
-1,1472,1601,-129,-1,10,54
1,1744,1610,134,-1,398,109
1,1789,1654,135,0,-13,57
-1,1560,1571,-11,-7,-534,100
-1,1540,1409,131,6,59,40
-1,1886,1997,-111,0,-3,72
1,1621,1363,258,10,527,61
1,1872,1803,69,0,39,89
1,1916,1939,-23,0,-4,113
1,1550,1622,-72,2,254,99
1,1476,1413,63,1,14,83
-1,1678,1648,30,2,69,56
1,1687,1563,124,1,91,111
-1,1656,1634,22,-5,288,110
-1,1569,1761,-192,-5,-343,80
1,1357,1675,-318,-5,-182,59
-1,1300,1678,-378,-10,-601,72
-1,1300,1446,-146,-6,-116,70
-1,1391,1199,192,8,225,88
1,1556,1520,36,0,98,69
1,1526,1445,81,-5,-105,53
-1,1599,1679,-80,-7,-141,88
1,1299,1363,-64,9,304,49
-1,1794,1885,-91,0,-37,66
1,1627,1707,-80,0,231,85
-1,1796,1862,-66,-1,78,76
1,1515,1636,-121,-3,74,121
-1,1603,1617,-14,-1,-45,66
1,1397,1217,180,0,127,103
-1,1646,1640,6,-1,-111,86
-1,1543,1533,10,2,7,62
-1,1714,1878,-164,0,-9,48
-1,1725,1827,-102,0,5,42
1,1305,1374,-69,-1,-4,63
-1,1594,1639,-45,1,17,157
1,1697,1543,154,1,-31,125
-1,1314,1637,-323,-6,-209,56
1,1387,1288,99,1,671,81
1,1896,1785,111,1,46,75
1,1391,1294,97,0,32,66
-1,1752,1500,252,-1,-13,76
-1,1592,1621,-29,0,-58,62
-1,1614,1414,200,1,38,48
1,1500,1666,-166,-4,-264,77
1,1629,1582,47,0,-41,69
1,1404,1489,-85,-1,-18,58
-1,1536,1704,-168,0,197,136
1,1599,1500,99,0,30,47
1,1744,1635,109,0,6,109
0,1717,1660,57,1,-357,124
-1,1127,1296,-169,1,66,48
1,1526,1258,268,0,2,49
1,1555,1578,-23,4,239,69
-1,1361,1376,-15,-12,-405,62
-1,1777,1907,-130,0,-319,130
-1,1884,1729,155,0,-59,116
1,1547,1502,45,0,-29,51
-1,1385,1636,-251,0,-72,86
1,1668,1483,185,-3,-158,81
-1,1521,1640,-119,0,56,102
1,1770,1456,314,0,63,55
1,1531,1599,-68,9,193,49
-1,1330,1479,-149,0,-45,60
0,1347,1448,-101,-2,-57,111
1,1710,1291,419,4,102,55
-1,1673,1636,37,-4,-61,52
-1,1535,1693,-158,1,-12,62
-1,1556,1713,-157,0,-123,124
1,1648,1660,-12,6,84,51
-1,1333,1670,-337,0,-62,86
-1,1479,1521,-42,-3,-345,98
-1,1531,1500,31,0,-61,70
-1,1932,1779,153,0,4,86
1,1587,1608,-21,0,32,49
1,1648,1645,3,0,21,49
1,1917,1770,147,0,83,107
-1,1417,1513,-96,0,37,76
1,1707,1511,196,1,141,75
-1,1567,1567,0,-1,-54,108
1,1554,1454,100,0,27,71
1,1605,1486,119,-1,-8,59
1,1660,1635,25,0,468,117
-1,1769,1669,100,-2,-232,80
1,1557,1458,99,1,43,49
0,1598,1835,-237,-3,-45,94
-1,1399,1415,-16,-3,-153,96
-1,1670,1512,158,-4,-41,74
-1,1845,1548,297,-1,-122,90
1,1745,1488,257,1,59,109
1,1550,1598,-48,-2,141,57
-1,1648,1529,119,0,78,84
1,1774,1582,192,0,-6,125
-1,1997,2104,-107,0,-18,56
0,1466,1643,-177,7,303,102
-1,1500,1396,104,-4,-365,64
-1,1869,1700,169,0,150,88
-1,1763,1926,-163,-1,-95,90
-1,1655,1633,22,-1,13,52
-1,1715,1867,-152,-3,-491,82
1,1531,1469,62,1,270,95
-1,1394,1433,-39,0,-1,84
-1,1565,1673,-108,-1,-457,106
1,1699,1664,35,-1,-10,105
-1,1605,1399,206,6,221,60
1,1593,1357,236,-8,-119,61
0,1566,1428,138,3,423,151
-1,1521,1409,112,-3,-410,98
1,1345,1550,-205,3,270,75
1,1406,1265,141,9,216,55
-1,1777,1644,133,0,-10,56
1,1443,1493,-50,0,-5,65
1,1621,1232,389,5,339,65
1,1713,1530,183,1,183,97
1,1556,1514,42,-5,197,147
-1,1568,1824,-256,0,4,55
-1,1934,1757,177,1,36,78
1,1734,1658,76,-4,237,89
-1,1828,1989,-161,-3,-179,83
-1,1769,1849,-80,-2,-196,66
-1,1229,1691,-462,-14,-585,62
-1,1608,1529,79,0,-328,140
1,1761,1518,243,0,1,129
1,1544,1632,-88,0,7,47
1,1500,1486,14,9,193,51
1,1623,1658,-35,0,10,67
1,1460,1540,-80,0,-72,69
-1,1365,1441,-76,-8,-454,104
1,1491,1588,-97,1,17,57
1,1709,1536,173,0,4,69
-1,1740,1746,-6,-1,-94,114
-1,1636,1647,-11,2,33,44
-1,1647,1742,-95,-2,-128,66
1,1829,1563,266,6,114,51
-1,1773,1913,-140,1,-68,131
1,1625,1657,-32,-2,120,83
-1,1613,1642,-29,-10,-239,60
-1,1786,1870,-84,0,53,56
-1,1506,1587,-81,2,-180,92
-1,1712,1500,212,-1,-64,78
-1,1527,1622,-95,-2,-79,112
-1,1873,1911,-38,-1,-206,126
1,1682,1556,126,-3,27,53
1,1749,1717,32,0,98,149
1,1578,1513,65,-2,88,95
-1,1444,1720,-276,5,64,42
1,1319,1556,-237,-6,-42,43
-1,1635,1750,-115,2,-295,114
-1,1792,1853,-61,0,-33,114
1,1626,1656,-30,5,226,51
-1,1232,1731,-499,-3,-91,42
-1,1559,1833,-274,-8,-64,44
1,1542,1324,218,11,112,41
-1,1784,1653,131,-1,-102,84
-1,1578,1423,155,-1,30,86
1,1787,2041,-254,-3,-71,61
1,1639,1644,-5,0,-17,59
-1,1922,1766,156,0,-63,108
-1,1480,1466,14,-1,-31,56
1,1500,1320,180,-5,-65,47
-1,1628,1814,-186,-1,-37,62
1,1510,1441,69,-4,-13,67
-1,1648,1918,-270,3,61,54
1,1715,1558,157,5,650,115
1,1551,1453,98,-1,-18,57
1,1820,1622,198,2,757,133
-1,1627,1733,-106,-9,-182,46
1,1589,1780,-191,0,132,139
-1,1586,1474,112,0,9,74
1,1720,1523,197,0,70,65
0,1744,1720,24,2,-23,135
-1,1576,1819,-243,-4,44,40
1,1314,1604,-290,2,635,93
1,1724,1485,239,4,66,45
-1,1543,1594,-51,1,4,44
-1,1440,1524,-84,0,-148,124
1,1782,1902,-120,2,183,81
1,1592,1445,147,2,667,161
1,1826,1617,209,2,255,71
-1,1862,1874,-12,0,-13,68
-1,1620,2026,-406,-3,-344,82
1,1439,1263,176,0,8,53
-1,1561,1753,-192,-4,-525,98
-1,1398,1163,235,3,95,58
-1,1233,1556,-323,-5,-138,48
1,1576,1695,-119,-3,-42,53
-1,1747,1612,135,0,6,44
-1,1298,1673,-375,0,-28,66
1,1602,1277,325,1,53,49
-1,1544,1457,87,-5,-21,56
-1,1652,1627,25,0,-125,112
-1,1549,1472,77,0,-327,110
0,1688,1711,-23,-1,-318,114
-1,1783,1858,-75,-1,-19,44
1,1742,1218,524,14,286,47
1,1841,1723,118,0,70,65
1,1823,1563,260,-1,-21,55
1,1551,1321,230,0,-41,57
1,1497,1284,213,-2,20,43
1,1551,1502,49,3,105,51
1,1715,1849,-134,-2,14,45
-1,1439,1757,-318,1,-32,77
-1,1775,1852,-77,0,-433,112
0,1582,1533,49,7,279,71
1,1741,1330,411,2,296,107
-1,1485,1347,138,-1,-122,71
-1,1394,1438,-44,-8,-90,72
-1,1473,1606,-133,0,4,62
-1,1751,1618,133,-3,6,101
-1,1923,1838,85,1,34,144
-1,1637,1730,-93,0,2,44
1,1674,1609,65,2,279,78
1,1679,1695,-16,0,20,75
1,1728,1821,-93,-1,-457,135
-1,1739,1627,112,0,30,94
1,1739,1689,50,-2,-125,91
-1,1534,1468,66,-7,-218,85
1,1503,1321,182,-1,24,51
1,1643,1452,191,1,427,87
-1,1399,1418,-19,-1,-755,138
-1,1527,1676,-149,-1,-267,124
1,1645,1724,-79,2,16,47
1,1622,1640,-18,1,8,43
-1,1539,1551,-12,2,51,58
1,1710,1661,49,2,559,159
-1,1633,2028,-395,-2,-142,70
-1,1606,1274,332,-1,-86,62
1,1365,1208,157,-6,-149,43
1,1556,1195,361,5,125,53
1,1521,1434,87,0,213,71
-1,1106,1429,-323,-10,-121,46
1,1733,1206,527,12,595,61
1,1860,1767,93,0,14,77
-1,1242,1431,-189,3,-333,132
1,1384,1571,-187,-5,-173,49
1,2031,1631,400,2,68,55
-1,1284,1444,-160,-5,-247,72
-1,1649,1720,-71,2,26,50
-1,1501,1587,-86,-5,-169,60
1,1555,1407,148,-3,-30,55
1,1822,1619,203,0,60,41
-1,1729,1745,-16,0,-15,78
-1,1491,1669,-178,4,136,66
-1,1184,1709,-525,-2,-130,54
1,1714,1595,119,4,58,41
1,1687,1478,209,2,154,63
1,1879,1613,266,-3,126,71
1,1508,1533,-25,0,1,45
-1,1583,1503,80,-3,-99,57
-1,1474,1557,-83,1,2,40
-1,1743,1731,12,0,3,44
1,1690,1534,156,1,94,53
1,1657,1626,31,-1,-281,85
-1,1564,1535,29,-3,-303,96
-1,1754,1794,-40,0,43,95
-1,1559,1379,180,0,-17,70
1,1930,1836,94,0,-51,49
1,1609,1742,-133,-3,-33,47
1,1762,1606,156,0,145,163
-1,1683,1520,163,0,-11,74
0,1447,1521,-74,-6,-398,85
-1,1725,1682,43,-4,-287,76
1,1465,1521,-56,0,29,71
1,1868,1807,61,1,189,81
1,1695,1727,-32,1,648,97
-1,1763,1930,-167,-4,-19,46
1,1436,1090,346,1,248,73
-1,1186,1842,-656,-2,-302,70
-1,1277,1585,-308,-7,-124,48
-1,1930,1795,135,0,42,102
1,1490,1478,12,-2,-53,85
1,1528,1568,-40,2,46,50
-1,1492,1632,-140,5,93,52
-1,1716,1741,-25,3,-264,136
1,1495,1380,115,0,-90,47
1,1503,1294,209,13,311,53
1,1568,1727,-159,1,46,65
1,1747,1254,493,-2,-5,57
-1,1315,1531,-216,-1,-600,124
1,1575,1479,96,7,385,89
-1,1440,1656,-216,-8,-312,64
1,1710,1183,527,13,315,45
-1,1640,1637,3,-4,-143,54
-1,1453,1565,-112,-4,-253,74
-1,1558,1434,124,-2,92,68
-1,1273,1438,-165,-1,-104,117
1,1394,1431,-37,-2,26,51
1,1373,1437,-64,-2,-36,51
1,1629,1286,343,2,434,81
1,1562,1574,-12,-2,-57,83
1,1721,1598,123,5,56,47
1,1828,1742,86,2,79,67
1,1651,1665,-14,1,23,55
0,1468,1518,-50,0,-375,123
1,1631,1784,-153,-2,98,67
-1,1694,1249,445,1,86,68
1,1291,1389,-98,0,36,53
1,1776,1587,189,0,115,53
1,1515,1162,353,0,91,95
1,1640,1639,1,-1,-45,73
-1,1798,1877,-79,-1,-18,56
1,1742,1657,85,4,68,47
1,1581,1794,-213,1,448,103
1,1586,1614,-28,0,-172,95
1,1527,1207,320,0,-14,113
-1,1500,1648,-148,-1,-59,54
1,1556,1728,-172,-1,-52,63
-1,1349,1404,-55,-2,-354,90
-1,1586,1654,-68,5,34,48
-1,1509,1684,-175,-1,-110,61
1,1839,2002,-163,-9,-103,93
1,1886,1790,96,1,5,45
-1,1599,1766,-167,-2,-643,134
1,2088,1759,329,3,227,99
-1,1724,1743,-19,0,-19,52
1,1535,1389,146,1,117,53
1,1711,1423,288,0,3,79
-1,1642,1663,-21,-3,-58,58
1,1409,1582,-173,2,716,115
1,1751,1669,82,3,33,43
-1,1596,1489,107,-5,-254,100
1,1695,1712,-17,5,239,61
1,1327,1076,251,-1,-11,49
1,1772,1714,58,0,232,97
1,1500,1427,73,-6,-29,47
-1,1062,1283,-221,0,4,42
1,1760,1660,100,3,203,61
1,1469,1351,118,7,158,43
1,1266,1388,-122,8,689,99
1,1396,1413,-17,-3,60,45
-1,1518,1449,69,-1,-16,62
-1,1782,1716,66,0,148,96
0,1772,1651,121,0,237,164
1,1590,1733,-143,-3,0,61
-1,1169,1770,-601,-7,-197,65
1,1760,1252,508,-2,77,107
1,1702,1620,82,3,105,69
-1,1445,1482,-37,1,-32,76
-1,1773,2141,-368,-3,-37,56
0,1768,1639,129,-1,37,97
-1,1350,1517,-167,-8,-359,68
-1,1692,1500,192,-3,-178,102
-1,1768,1655,113,-1,-9,40
1,1407,1308,99,2,326,89
1,1795,1684,111,0,266,86
1,1410,1643,-233,-5,64,101
1,1666,1748,-82,-1,19,61
-1,1276,1476,-200,0,-62,102
0,1903,1836,67,0,-154,117
-1,1500,1708,-208,-3,44,40
0,1662,1467,195,-2,-156,101
1,1563,1575,-12,3,250,85
-1,1629,1858,-229,1,153,102
-1,1599,1602,-3,1,-27,92
-1,1846,1572,274,-6,35,52
-1,1505,1756,-251,-7,-112,48
1,1883,1754,129,0,9,57
-1,1266,1650,-384,0,1,50
-1,1715,1462,253,2,184,86
1,1546,1585,-39,0,-57,135
1,1201,1556,-355,3,249,77
-1,1500,1622,-122,-12,-284,40
-1,1670,1539,131,-4,-147,54
1,1746,1796,-50,3,77,59
-1,1282,1589,-307,1,82,50
1,1375,1403,-28,-2,319,163
1,1700,1759,-59,-3,116,127
1,1776,1162,614,2,54,159
0,1890,1760,130,0,92,143
1,1765,1655,110,-2,55,107
1,1704,1650,54,0,175,97
1,1759,1590,169,5,441,93
1,1921,1475,446,2,329,109
1,1545,1339,206,2,14,41
-1,1741,1503,238,-6,-245,54
-1,1855,2009,-154,-1,-49,56
-1,1433,1443,-10,-9,-265,50
1,1783,1637,146,0,7,67
1,1674,1492,182,4,97,53
1,1562,1591,-29,-2,-31,73
-1,1588,1600,-12,-6,-333,106
-1,1759,1838,-79,0,-34,78
1,1670,1402,268,0,182,127
1,2144,1825,319,0,-30,77
1,1232,1052,180,8,690,75
1,1538,1472,66,2,84,47
1,1872,1666,206,-1,345,79
-1,1624,1863,-239,-2,-62,56
1,1640,1069,571,5,408,97
-1,1617,1586,31,0,-364,166
-1,1916,1857,59,-2,-52,50
1,1786,2004,-218,0,76,128
-1,1901,1789,112,2,19,46
1,1727,1508,219,1,-24,89
1,1811,1801,10,2,431,117
1,1250,1314,-64,-2,-28,55
1,1632,1586,46,4,396,139
-1,1492,1666,-174,-6,-135,56
1,1486,1680,-194,2,80,53
1,1868,1765,103,0,-6,79
-1,1509,1599,-90,0,139,76
1,1659,1579,80,-4,-15,43
-1,1463,1551,-88,-3,-425,108
-1,1523,1347,176,-1,-58,66
0,1500,1464,36,-4,-33,103
-1,1279,1245,34,-2,-161,90
1,1780,1601,179,-1,28,61
-1,1536,1298,238,2,73,72
-1,1798,1878,-80,-3,-399,162
-1,1987,1803,184,-1,-22,124
1,1656,1764,-108,0,-187,115
1,1792,1595,197,21,921,59
-1,1590,1802,-212,-5,-61,44
-1,1556,1606,-50,0,-344,160
1,1662,1503,159,2,140,127
-1,1569,1233,336,1,-83,130
-1,1648,1750,-102,0,-42,64
-1,1710,1801,-91,0,23,88
-1,1573,1799,-226,-1,-227,104
1,1759,1714,45,-2,-210,81
1,1563,1454,109,3,257,79
-1,1107,1477,-370,-3,-159,64
-1,1887,1877,10,0,50,100
-1,1629,1855,-226,-6,-169,54
1,2026,2039,-13,0,56,71
-1,1776,2106,-330,-1,26,84
-1,1572,1590,-18,0,-80,90
1,1546,1722,-176,4,103,47
1,1963,1727,236,2,56,43
1,1832,1670,162,-5,55,57
1,1639,1622,17,-1,-82,79
-1,1747,1595,152,1,-205,108
-1,1809,1992,-183,2,98,96
1,1331,1410,-79,0,250,85
-1,1538,1509,29,-1,-423,116
-1,1773,2110,-337,2,-83,76
1,2026,2038,-12,-2,-37,49
-1,1658,1722,-64,-5,-49,46
1,1755,1660,95,0,-6,57
1,1474,1536,-62,-2,-33,59
-1,1509,1486,23,0,24,48
1,1700,1616,84,6,345,74
1,1487,1523,-36,1,245,103
-1,2027,2039,-12,0,17,100
-1,1770,1822,-52,-3,-483,82
-1,1603,1694,-91,7,484,86
1,1627,1743,-116,1,47,65
1,1500,1365,135,4,63,49
1,1666,1247,419,-1,-21,49
-1,1832,1761,71,-1,-23,70
1,1873,1552,321,0,41,105
-1,1716,1776,-60,-2,-55,52
1,1598,1578,20,7,538,88
-1,1521,1498,23,-4,-183,64
-1,1394,1663,-269,1,6,76
1,1863,1791,72,1,401,131
-1,1283,1536,-253,0,-174,107
-1,1555,1705,-150,-5,-87,54
1,1813,1304,509,7,530,87
1,1607,1708,-101,1,89,101
1,1829,1800,29,-3,42,123
-1,2051,2016,35,-2,-30,40
-1,1512,1444,68,-5,-9,40
1,1500,1732,-232,0,259,121
1,1774,1692,82,3,112,59
1,2028,2037,-9,2,16,41
1,1702,1595,107,0,-273,103
-1,1442,1623,-181,2,25,50
-1,1780,1935,-155,-4,-298,122
-1,1708,1781,-73,0,-103,72
-1,1608,1566,42,0,187,96
-1,1438,1237,201,-1,-12,62
-1,2025,2039,-14,-2,-52,82
-1,1310,1510,-200,0,0,46
1,1868,1553,315,2,104,77
-1,1707,1807,-100,-1,-110,98
1,1459,1496,-37,3,123,65
1,1840,1783,57,-2,-451,115
1,1683,1597,86,2,189,75
-1,1548,1899,-351,-5,-51,44
-1,1536,1667,-131,-7,-65,42
1,1889,1459,430,5,315,67
1,1337,1580,-243,-1,-145,83
-1,1694,1621,73,0,-25,106
1,1509,1489,20,3,59,49
-1,2050,2013,37,0,-1,100
-1,1773,1774,-1,-5,-298,68
-1,1460,1588,-128,-1,-19,60
-1,1514,1616,-102,-4,30,42
1,1920,1542,378,2,98,67
1,1775,1675,100,0,-8,45
1,1601,1492,109,2,140,107
1,1873,1989,-116,-3,173,69
-1,1790,1699,91,-1,-39,54
1,1850,1763,87,-2,-13,43
-1,1529,1620,-91,-5,-233,72
-1,1788,1802,-14,0,-186,110
-1,1713,1641,72,-2,17,48
1,1595,1516,79,-3,10,51
-1,1520,1787,-267,-5,-135,68
-1,1720,1829,-109,0,-354,116
1,1858,1754,104,-8,-924,155
1,1730,1636,94,1,-15,117
1,1506,1545,-39,0,61,61
-1,1689,1639,50,-2,-358,104
-1,1691,1833,-142,2,121,82
-1,1507,1284,223,-2,-301,76
-1,1303,1614,-311,-12,-378,58
1,1578,1586,-8,1,67,67
1,1642,1395,247,0,7,49
1,1596,1792,-196,0,377,77
0,1753,1837,-84,-1,-15,119
-1,1462,1579,-117,-2,-102,56
-1,1526,1443,83,1,14,44
-1,1496,1535,-39,-4,-60,92
-1,2026,1803,223,0,-49,68
1,1519,1473,46,-1,66,71
1,1362,1539,-177,2,29,45
1,1866,1746,120,0,165,61
-1,1834,1691,143,-11,-225,46
-1,1567,1581,-14,0,34,44
-1,1520,1726,-206,0,-17,54
1,1821,2008,-187,0,-2,57
1,1786,1886,-100,0,0,91
-1,1685,1622,63,-9,-313,118
-1,1813,1777,36,6,448,86
-1,1244,1601,-357,-7,-93,46
1,1708,1790,-82,-2,-22,77
1,1586,1444,142,-2,55,89
1,1772,1422,350,3,207,65
-1,1369,1387,-18,0,-8,40
-1,1700,1660,40,-2,-44,52
-1,1500,1648,-148,-1,-290,64
1,1880,1732,148,-4,-113,63
-1,1990,1839,151,-3,-17,58
-1,1239,1281,-42,0,-19,54
-1,1523,1384,139,1,-188,84
-1,1650,1783,-133,0,-4,90
-1,1419,1776,-357,0,-309,76
1,1669,1603,66,-2,-10,65
-1,1334,1848,-514,0,-41,70
-1,1726,1887,-161,0,-109,96
-1,1326,1488,-162,5,154,66
1,1291,1305,-14,-11,-202,61
1,1290,1229,61,9,260,55
-1,1856,1973,-117,-1,-158,90
1,1789,1776,13,0,3,47
-1,1243,1488,-245,0,5,60
1,1789,1701,88,-1,-29,51
1,1230,1380,-150,1,44,55
1,1671,1840,-169,1,39,43
1,1537,1452,85,1,17,43
1,1572,1629,-57,0,-35,49
-1,1893,1719,174,-6,-54,40
1,1451,1425,26,2,150,59
-1,1221,1299,-78,-1,203,96
1,1779,1388,391,1,42,75
1,1981,1848,133,3,205,71
-1,1179,1439,-260,-2,-64,58
-1,1416,1679,-263,-6,-233,54
1,1654,1474,180,-3,-14,76
1,1688,1735,-47,5,180,53
-1,1307,1212,95,-6,-75,40
1,1556,1385,171,-1,-33,46
-1,1840,1989,-149,0,-53,72
1,1512,1395,117,6,663,97
1,1800,1815,-15,-2,-243,117
1,1628,1600,28,6,424,81
1,1439,1415,24,9,65,45
-1,1226,1294,-68,0,-92,54
-1,1533,1567,-34,0,-93,90
-1,1683,1412,271,2,-137,76
1,1618,1434,184,0,3,53
-1,1404,1508,-104,2,88,56
1,1274,1514,-240,-4,521,109
-1,1700,1877,-177,3,-6,72
-1,1256,1350,-94,-3,-22,66
1,1546,1677,-131,1,29,51
-1,1383,1784,-401,3,44,100
1,1740,1401,339,0,343,81
1,1731,1647,84,-9,62,101
1,1865,1578,287,-3,-7,63
1,1349,1059,290,15,1167,109
1,1726,1676,50,-1,-10,45
1,1589,1638,-49,0,27,81
0,1495,1712,-217,-3,-85,131
-1,1500,1550,-50,0,80,78
1,1973,1891,82,0,211,94
-1,1385,1834,-449,-4,-497,110
-1,1624,1613,11,0,-2,76
-1,1280,1326,-46,0,12,42
-1,1628,1739,-111,-6,-56,86
1,1968,1713,255,-3,-174,75
-1,1723,1486,237,3,16,66
1,1786,1381,405,1,90,51
1,2001,1691,310,1,60,63
-1,1664,1602,62,-3,-75,60
1,1398,1753,-355,-1,-17,45
-1,1079,1500,-421,1,30,48
-1,1789,1706,83,0,30,56
1,1458,1652,-194,2,154,59
1,1757,1719,38,1,31,61
1,1379,1130,249,9,600,67
1,1625,1543,82,-1,82,87
-1,1379,1556,-177,2,9,62
1,1562,1670,-108,4,88,61
1,2005,1826,179,0,-3,59
1,1622,1399,223,1,89,73
0,1615,1560,55,-2,-224,133
1,1313,1446,-133,1,7,69
1,1687,1508,179,2,96,54
-1,1413,1501,-88,4,239,76
1,1518,1458,60,6,89,45
-1,1460,1661,-201,6,319,94
1,1393,1627,-234,0,133,75
1,1508,1500,8,1,146,63
-1,1389,1463,-74,6,71,42
-1,1519,1400,119,-3,287,146
1,1651,1362,289,3,167,79
1,1812,1833,-21,-1,-56,97
1,1487,1651,-164,0,40,57
1,1029,1744,-715,-5,-96,51
1,1414,1461,-47,0,22,51
0,1647,1762,-115,-3,-180,229
-1,1445,1494,-49,-1,-10,48
-1,1708,1988,-280,0,-339,120
-1,1693,1616,77,0,-14,60
1,1608,1436,172,4,115,49
-1,1624,1781,-157,-2,-89,64
0,1527,1626,-99,-3,-445,194
0,1516,1431,85,2,16,102
1,2003,1467,536,0,-5,41
-1,1534,1634,-100,-1,-55,80
-1,1429,1615,-186,-3,-626,86
-1,1444,2004,-560,-1,-39,56
1,1386,1624,-238,-5,-139,53
-1,1389,1824,-435,0,-4,58
-1,1882,1982,-100,0,-78,76
1,1680,1531,149,0,6,73
1,2006,1426,580,4,158,61
-1,1510,1402,108,2,-223,103
0,1423,1883,-460,-5,-595,72
1,1449,1427,22,9,721,93
1,1503,1584,-81,3,148,109
1,1704,1805,-101,-1,-3,69
1,1621,1387,234,1,34,69
1,1641,1576,65,3,193,79
1,1606,1438,168,3,537,89
1,1826,1707,119,0,52,137
1,1500,1429,71,3,152,99
1,1882,1769,113,0,142,61
1,1292,1189,103,1,-36,113
1,1265,1372,-107,0,197,105
1,1877,1700,177,1,-5,41
-1,1602,1639,-37,-5,-279,82
1,1874,1434,440,0,51,83
-1,1410,2008,-598,0,-15,56
-1,1473,1310,163,1,28,64
-1,1360,1504,-144,-5,-421,64
-1,1046,1353,-307,0,-183,70
-1,1382,1626,-244,5,-298,72
-1,1875,2009,-134,-5,-2,64
-1,1837,1708,129,0,54,74
-1,1395,1792,-397,-5,-73,44
1,1855,1707,148,-1,267,137
1,1833,1748,85,1,71,67
-1,1663,1543,120,-1,-87,62
1,2017,2038,-21,0,44,97
1,1632,1548,84,0,185,93
-1,1641,1704,-63,-2,-41,54
1,1672,1671,1,-1,-38,49
1,1873,1500,373,1,13,43
-1,1693,1775,-82,-4,-48,44
-1,1721,1180,541,1,20,52
-1,1695,1728,-33,-6,-275,62
1,2026,2031,-5,-3,72,87
1,1694,1884,-190,-1,-18,85
1,1632,1659,-27,0,4,51
-1,1304,1567,-263,-2,-344,79
-1,1991,1707,284,-1,-57,64
-1,1420,1495,-75,0,-17,130
1,1597,1384,213,-2,-31,67
-1,1562,1573,-11,0,130,146
1,1665,1587,78,1,511,115
1,1685,2026,-341,0,34,65
-1,1659,1682,-23,-1,-62,48
1,1573,1557,16,6,259,61
1,1876,1703,173,0,164,89
-1,1517,2031,-514,0,-19,52
1,1877,1802,75,0,8,51
1,1719,1500,219,6,597,77
-1,1634,1709,-75,-3,-154,82
1,1560,1648,-88,-3,-84,53
-1,1634,1496,138,-1,-67,56
-1,1436,1392,44,4,67,46
-1,1515,1502,13,-1,-301,106
-1,1554,1457,97,0,-77,68
1,1647,1623,24,-1,12,83
-1,1868,1996,-128,-6,-23,42
-1,2006,2033,-27,-1,12,46
1,1723,1667,56,5,0,47
-1,1201,1247,-46,-3,-91,44
-1,1567,1516,51,-3,-57,54
1,1571,1261,310,1,77,41
-1,1638,1905,-267,-1,-48,60
0,1398,1605,-207,0,-125,164
1,1665,1562,103,2,88,61
1,2004,1861,143,-2,37,53
1,1502,1472,30,6,347,85
-1,1265,1594,-329,2,49,46
1,1648,1465,183,9,463,74
-1,1700,1717,-17,-10,-64,68
1,1813,1838,-25,1,6,77
1,1421,1200,221,3,451,123
-1,1625,1701,-76,-2,56,50
-1,1584,1692,-108,0,-199,112
1,1555,1706,-151,-1,-1,59
-1,1405,1528,-123,-2,-441,82
0,1705,1723,-18,-1,346,95
-1,1644,1714,-70,-8,-383,94
1,1547,1646,-99,0,4,49
1,1726,1638,88,5,136,47
1,1988,1876,112,0,515,93
-1,1231,1574,-343,-6,-241,54
-1,1300,1538,-238,-9,-32,40
0,1727,1662,65,0,-25,146
-1,1659,1618,41,0,-95,78
1,1514,1219,295,0,5,61
-1,1400,1733,-333,-4,-99,50
1,1729,1971,-242,3,54,49
1,1414,1642,-228,-5,-11,109
-1,1868,1996,-128,-1,-519,116
1,1431,1048,383,-3,-152,77
1,1569,1560,9,1,12,103
-1,1463,1677,-214,0,-31,60
-1,1504,1759,-255,-2,-8,40
-1,1706,1436,270,-8,-545,98
1,1883,1407,476,7,222,55
1,2003,1861,142,1,232,99
1,1518,1527,-9,2,-10,71
-1,1516,1543,-27,-14,-610,82
1,1500,1535,-35,1,-110,85
1,1693,1193,500,-8,-487,65
-1,1711,1980,-269,1,-8,46
1,1616,1500,116,0,-15,45
-1,1854,2010,-156,-1,-146,92
-1,1436,1396,40,-8,-748,122
1,1736,1799,-63,1,95,71
-1,1687,1826,-139,-1,-214,90
1,1458,1516,-58,-9,-370,69
1,1842,1495,347,-1,-30,65
1,1515,1233,282,5,322,63
-1,1267,1596,-329,-1,-318,122
1,1613,1937,-324,-4,-120,65
1,1714,1181,533,-7,-32,41
1,1669,1726,-57,-1,-36,117
-1,1885,1831,54,-3,-158,67
1,1561,1503,58,8,391,71
-1,1330,1577,-247,-2,-234,74
-1,1680,1833,-153,-3,-100,48
-1,1703,1988,-285,-2,-214,90
1,1209,1161,48,-6,-116,57
1,1759,1651,108,0,68,99
-1,1645,1457,188,-4,-44,42
1,1505,1508,-3,2,99,67
-1,1471,1493,-22,-3,-181,64
-1,1445,1555,-110,1,-374,107
-1,1492,1554,-62,-2,-41,96
1,1682,1719,-37,2,357,113
1,1492,1497,-5,1,696,117
1,1502,1731,-229,0,145,87
1,1814,1630,184,1,108,71
0,1484,1462,22,-1,-265,150
1,1461,1520,-59,13,1120,99
-1,1882,1847,35,0,-92,130
0,1700,1886,-186,0,7,155
1,1508,1278,230,-3,97,67
-1,1548,1622,-74,-1,-225,124
1,1507,1437,70,8,48,41
1,1531,1552,-21,1,130,129
-1,1417,1493,-76,-5,-611,96
1,1582,1504,78,-6,-136,55
1,1529,1470,59,4,998,129
-1,1325,1187,138,-1,-96,82
-1,1527,1656,-129,2,16,128
-1,1543,1551,-8,-2,-156,80
-1,1497,1649,-152,0,5,80
1,1697,1724,-27,0,-8,129
1,1474,1496,-22,-3,-162,79
1,1417,1500,-83,17,323,49
-1,1045,1434,-389,-3,-224,66
0,1500,1364,136,-2,-620,126
-1,1711,1851,-140,0,-78,86
-1,1673,2016,-343,-5,-28,46
1,1745,1870,-125,1,43,67
0,1540,1342,198,0,136,89
1,1295,1381,-86,-2,-58,59
-1,1406,1496,-90,0,-18,44
-1,1748,1846,-98,-3,-352,120
1,1486,1505,-19,0,392,95
-1,1656,1849,-193,0,-141,74
1,1897,1525,372,2,291,177
1,1428,1517,-89,2,76,47
1,2047,1449,598,0,7,51
-1,1569,1707,-138,0,-550,150
-1,1250,1713,-463,0,-24,78
-1,1584,1490,94,-10,-3,40
-1,1634,1763,-129,1,47,86
-1,1546,1542,4,-1,-40,70
1,1779,1522,257,0,158,121
1,1570,1504,66,-3,-10,57
-1,1533,1517,16,2,152,86
1,1573,1658,-85,1,119,64
1,1329,1272,57,5,223,149
-1,1221,1492,-271,-3,19,54
-1,1579,1495,84,-5,-204,60
-1,1498,1723,-225,-3,-227,80
0,1761,2019,-258,3,317,103
1,1632,1539,93,-1,5,43
-1,1530,1687,-157,-1,-69,58
-1,1446,1619,-173,0,-186,95
-1,1859,1826,33,0,-183,134
-1,1565,1509,56,-1,-3,44
1,1933,1797,136,1,160,101
1,1749,1493,256,11,411,55
-1,1507,1443,64,-6,-290,55
-1,1460,1624,-164,0,-17,54
1,1379,1273,106,2,148,57
-1,1750,1457,293,-1,-22,50
1,1553,1521,32,-10,-188,51
1,1420,1382,38,2,127,61
1,1740,1735,5,0,-38,59
1,1648,1661,-13,-3,3,71
-1,1396,1603,-207,-2,-184,76
-1,1562,1511,51,-4,-134,48
1,1553,1526,27,-1,-332,129
1,1521,1770,-249,-4,-39,61
1,1310,1474,-164,0,338,99
-1,2048,2137,-89,0,-104,82
1,1550,1524,26,0,90,49
1,1619,1695,-76,0,28,67
0,1531,1642,-111,-1,-159,122
-1,1713,1535,178,4,56,46
1,1659,1426,233,-3,20,83
-1,1538,1690,-152,-2,-41,48
-1,1265,1472,-207,-1,-29,44
1,1309,1356,-47,19,1350,89
-1,1530,1687,-157,0,-66,76
1,1390,1463,-73,4,108,65
1,1433,1238,195,1,56,79
-1,1782,2012,-230,-2,-253,100
1,1517,1562,-45,0,-13,63
1,1831,1998,-167,-2,-140,85
1,2004,1770,234,-6,-86,43
-1,1413,1266,147,0,-67,64
-1,1226,1440,-214,-3,-510,98
-1,1483,1300,183,-16,-964,70
1,1608,1551,57,1,10,49
-1,1493,1550,-57,-1,-128,86
-1,1567,1663,-96,0,-147,88
-1,1982,1847,135,0,-10,60
0,1570,1583,-13,-1,270,93
1,1379,1248,131,1,27,61
-1,1258,1370,-112,-1,-26,60
1,1651,1663,-12,3,441,115
-1,1721,1551,170,2,-330,114
-1,1609,1430,179,3,54,44
1,1309,1448,-139,-4,-178,55
-1,1367,1432,-65,-2,-52,46
-1,1524,1561,-37,1,-131,100
-1,1524,1688,-164,-3,-155,90
1,1630,1709,-79,0,83,91
-1,1437,1436,1,-9,-240,44
-1,1641,1517,124,0,-280,106
1,1893,1531,362,5,624,77
1,1634,1856,-222,-3,7,41
-1,1447,1215,232,-1,16,82
0,1645,1874,-229,0,86,122
-1,1650,1875,-225,0,-373,128
-1,1421,1623,-202,-4,-129,52
1,1766,2023,-257,1,57,137
1,980,0,980,6,31,49
-1,1531,1391,140,3,33,64
1,957,0,957,4,450,73
1,1862,1967,-105,-7,-198,87
-1,1449,1374,75,-6,-300,66
1,1619,1578,41,-3,-85,53
1,1638,1534,104,-3,13,133
1,1386,1671,-285,0,128,119
-1,1706,1931,-225,0,-251,162
-1,1582,1559,23,-6,-211,62
1,1571,1483,88,1,136,97
1,1762,1531,231,7,219,67
1,1357,1372,-15,-2,495,119
1,1447,1432,15,1,61,45
-1,1321,1160,161,2,-25,44
1,1397,1338,59,3,247,71
1,1325,1570,-245,2,67,55
1,1568,1630,-62,-2,489,107
1,1729,1155,574,0,501,103
-1,1514,1696,-182,0,-7,54
1,1936,1691,245,0,24,81
-1,1591,1594,-3,-4,-321,136
0,1436,1559,-123,-3,-519,128
1,1247,1343,-96,-9,-273,55
-1,1633,1423,210,1,193,90
1,1406,1453,-47,2,128,85
1,1515,1488,27,0,47,49
-1,1226,1426,-200,-4,-609,115
-1,1856,1699,157,0,-17,54
-1,1678,1941,-263,-1,-118,110
1,1595,1182,413,4,493,79
0,1613,1534,79,0,330,156
-1,1615,1581,34,0,-263,136
1,1369,1320,49,0,11,49
1,1579,1525,54,2,245,83
1,1508,1569,-61,3,651,129
-1,1629,1663,-34,-2,-146,52
1,1526,1451,75,0,39,59
-1,1370,1389,-19,1,-85,124
1,1526,1487,39,-1,224,99
1,1503,1150,353,5,162,51
-1,1473,1531,-58,0,3,42
1,1799,1617,182,7,451,81
1,1807,1456,351,-1,95,63
1,1590,1595,-5,3,672,123
-1,1745,1744,1,-2,-205,91
-1,1455,1892,-437,-2,-91,88
-1,1753,1835,-82,1,71,78
1,1488,1403,85,-1,119,75
-1,1542,1842,-300,-1,-85,66
1,1624,1499,125,3,517,111
-1,1499,1626,-127,-13,-411,58
-1,2078,2087,-9,-1,-8,54
-1,1557,1671,-114,-1,-22,40
-1,1702,1676,26,-8,-7,58
-1,1759,1851,-92,3,5,51
1,1455,1378,77,2,98,59
0,1844,1744,100,0,-51,100
1,1907,1896,11,-1,45,131
1,1422,1426,-4,0,25,79
1,1741,1867,-126,4,65,45
-1,1146,1506,-360,-1,-118,64
1,1806,1738,68,0,237,101
1,1611,1451,160,-3,7,83
0,1583,1563,20,8,455,147
-1,1771,1839,-68,0,-425,114
1,1519,1473,46,-1,66,57
-1,1586,1599,-13,1,-429,116
-1,1494,1836,-342,-1,26,50
-1,1747,1841,-94,-3,-233,142
1,1532,1833,-301,0,7,91
-1,1681,1636,45,-3,-376,142
1,1856,1612,244,-3,-15,47
1,1663,1595,68,-1,15,79
1,1615,1190,425,31,571,45
0,1610,1576,34,12,1061,75
-1,1444,1617,-173,0,118,82
1,1463,1401,62,0,-128,101
1,1693,1468,225,2,87,51
-1,1698,1690,8,-1,-23,58
-1,1185,1617,-432,-6,-103,44
0,1566,1573,-7,-3,-460,103
-1,1894,1453,441,-7,-136,56
-1,1849,1738,111,-2,-137,80
-1,1468,1548,-80,-4,-188,128
-1,1725,1817,-92,0,-88,86
-1,1577,1609,-32,-9,-399,78
1,1217,918,299,4,39,47
1,1664,1579,85,-1,146,61
-1,1493,1616,-123,0,-6,46
-1,1548,1604,-56,0,-10,82
1,1753,1835,-82,4,291,83
0,1781,1852,-71,0,11,127
1,1589,1458,131,-3,-26,141
1,1717,1687,30,0,43,89
-1,1694,1798,-104,-4,-151,68
-1,1517,1342,175,1,66,50
0,1628,1558,70,2,627,188
-1,1477,1869,-392,-5,-167,60
-1,1769,1893,-124,-3,-81,66
1,1632,1401,231,1,320,119
-1,1822,1767,55,-1,-178,118
1,1567,1527,40,-2,-33,69
1,1623,1223,400,0,-51,99
1,1656,1831,-175,1,33,119
1,1344,1483,-139,15,2012,131
1,1820,1672,148,2,1,103
1,1594,1826,-232,5,91,47
-1,1375,1610,-235,-5,-228,50
-1,1665,1381,284,1,-105,142
1,1846,1783,63,-9,49,97
-1,1882,1408,474,1,30,53
1,1487,1435,52,1,380,101
1,1780,1809,-29,4,238,86
-1,1347,1611,-264,-1,-101,70
-1,1624,1519,105,-7,-342,76
-1,1620,1454,166,-1,33,118
1,1111,1400,-289,-1,334,79
-1,1806,1616,190,0,8,64
1,1798,1793,5,-6,-207,117
1,1573,1358,215,20,649,51
1,1538,1566,-28,7,541,73
-1,1693,2108,-415,-1,-139,104
-1,1472,1392,80,-2,-200,131
-1,1586,1806,-220,-1,-20,82
1,1596,1734,-138,0,397,127
1,1877,1469,408,2,227,73
1,1358,1534,-176,2,13,55
1,1774,1870,-96,-5,13,99
-1,1582,1609,-27,-6,-631,128
1,1177,1443,-266,-1,-103,79
1,1364,1265,99,0,-24,51
1,1855,1859,-4,-2,117,83
1,1781,1808,-27,2,121,81
1,1517,1686,-169,3,142,64
-1,1658,1768,-110,-9,-282,96
-1,1734,1841,-107,-4,-129,58
1,1388,1459,-71,-1,569,109
-1,1469,1485,-16,-1,-130,88
-1,1633,1615,18,-3,-103,58
1,1623,1674,-51,3,85,45
0,1572,1620,-48,-7,-741,86
-1,1691,2111,-420,-5,-31,44
0,1517,1793,-276,-5,7,125
1,1543,1527,16,4,58,41
-1,2113,1689,424,-2,-193,128
1,1686,1841,-155,1,197,77
0,1272,1836,-564,-2,-73,129
1,1618,1398,220,-6,-13,51
1,1548,1390,158,-2,103,127
0,1650,1669,-19,0,-107,139
1,1467,1492,-25,1,188,61
-1,1635,1572,63,0,31,66
-1,1392,1624,-232,6,114,50
1,1833,1659,174,3,79,43
1,1558,1574,-16,9,724,79
-1,1786,1797,-11,-4,-235,98
1,2015,1832,183,0,229,125
-1,1141,1380,-239,-1,-151,93
-1,1406,1459,-53,1,28,80
-1,1589,1496,93,-4,-461,114
-1,1359,1547,-188,-3,-294,122
-1,1563,1573,-10,-8,-872,104
1,1637,1500,137,26,651,53
1,1510,1791,-281,1,4,53
-1,1615,1815,-200,-9,-231,44
1,1815,1565,250,7,632,97
-1,1484,1635,-151,-1,-20,50
-1,1775,1807,-32,0,77,124
-1,1629,1525,104,-4,-121,78
-1,1426,1496,-70,0,8,114
-1,1480,1481,-1,-5,-791,98
1,1776,1650,126,3,539,117
-1,1653,1840,-187,-4,-304,80
1,1627,1577,50,2,133,65
-1,1322,1668,-346,-2,-3,52
-1,1836,1574,262,0,-3,90
-1,1381,1644,-263,-5,-561,98
1,1883,1570,313,9,403,66
1,1673,1330,343,9,246,61
1,1817,1765,52,0,209,145
-1,1614,1540,74,4,285,88
-1,1609,1822,-213,-2,-148,70
-1,1353,1581,-228,2,65,50
-1,1594,1534,60,-1,-876,174
1,2068,1703,365,0,185,129
-1,1528,1825,-297,-1,-28,50
1,1639,1320,319,3,129,57
1,1497,1464,33,1,190,97
-1,1383,1555,-172,-3,-366,96
1,1751,2022,-271,2,229,73
1,1826,1872,-46,-4,-3,69
1,1600,1554,46,1,-88,85
1,1634,1431,203,0,137,75
1,1553,1273,280,-2,-78,69
1,1827,1820,7,-1,48,45
-1,1296,1494,-198,-2,-92,106
1,1570,1524,46,0,-17,65
-1,1568,1833,-265,0,-349,114
-1,1328,1458,-130,1,47,66
-1,1813,1672,141,1,34,82
0,1568,1637,-69,0,-215,144
-1,1648,1694,-46,-1,48,84
-1,1415,1669,-254,0,-116,72
-1,1719,1617,102,0,65,74
-1,1858,1837,21,-1,227,86
1,1809,1837,-28,0,-72,111
0,1849,1755,94,-4,-177,103
-1,1426,1747,-321,-3,-75,54
-1,1656,1647,9,-1,-6,50
1,1738,1701,37,0,38,73
1,1453,1399,54,-2,295,145
1,1384,1535,-151,-3,-66,45
-1,1402,1536,-134,-1,-23,138
0,1827,1933,-106,0,-29,121
-1,1553,1353,200,0,71,126
-1,1610,1536,74,-1,9,52
1,1734,1834,-100,1,84,69
1,1776,1606,170,6,516,87
1,1842,1487,355,-1,5,57
-1,1763,1459,304,-7,-32,40
-1,2088,2070,18,-1,-284,106
1,1839,1561,278,0,152,95
-1,1636,1683,-47,0,150,110
-1,1288,1348,-60,0,-264,118
1,1848,1846,2,-3,-171,101
1,1544,1550,-6,1,338,99
-1,1591,1596,-5,0,212,122
-1,1469,1691,-222,0,-44,62
1,1673,1213,460,-4,-293,83
1,1658,1642,16,0,-22,59
1,1285,1468,-183,3,66,51
-1,1834,1858,-24,0,15,64
-1,1328,1848,-520,-1,-70,58
1,1932,1693,239,0,63,61
-1,1484,2074,-590,0,15,46
1,1724,1768,-44,2,291,109
1,1607,1581,26,5,349,63
-1,1710,1500,210,-2,44,72
-1,1696,1463,233,0,-58,58
1,1407,1320,87,1,72,61
-1,1868,1823,45,-1,-530,106
1,1516,1400,116,2,52,51
1,1571,1618,-47,4,93,77
-1,1417,1542,-125,-11,-93,42
-1,1266,1545,-279,-1,-365,130
-1,2082,2075,7,1,-16,90
-1,1738,1740,-2,-1,-76,44
1,1309,1368,-59,16,258,47
1,1557,1121,436,-4,-25,93
1,1751,1423,328,8,155,49
1,1795,1707,88,-1,52,83
1,1786,1613,173,0,4,45
1,1466,1229,237,4,704,101
1,1826,1843,-17,1,81,113
1,1712,1634,78,0,5,43
-1,1605,1583,22,2,-521,116
-1,1856,1870,-14,-1,-682,100
-1,1665,1409,256,1,-90,90
-1,1384,1341,43,0,-118,70
1,1730,1937,-207,0,26,57
1,2088,2070,18,0,-3,71
-1,1491,1538,-47,-2,-209,78
0,1669,1505,164,-5,-801,128
-1,1492,1850,-358,-1,-97,92
-1,1594,1593,1,-2,-70,104
-1,1442,1856,-414,-4,-62,78
1,1676,1784,-108,2,294,89
1,1687,1796,-109,-2,-322,151
1,1816,1803,13,6,55,53
0,2060,2101,-41,1,54,111
0,1846,1781,65,0,-522,109
1,1708,1732,-24,2,603,153
-1,1519,1683,-164,-1,-18,70
1,1501,1728,-227,0,19,55
-1,1500,1371,129,6,36,42
1,1612,1615,-3,2,239,103
1,1566,1465,101,0,40,51
1,1549,1556,-7,0,362,107
1,1887,1779,108,1,27,69
-1,1595,1592,3,2,-94,92
-1,1656,1651,5,-1,-261,94
-1,1370,1536,-166,-1,-73,68
-1,1783,1844,-61,0,-151,76
-1,1118,1559,-441,-8,-145,48
1,1888,1856,32,2,377,121
-1,1545,1638,-93,-1,-181,104
-1,1166,1447,-281,-3,-333,102
1,2100,2061,39,0,2,73
1,1604,1584,20,8,893,107
1,1857,1927,-70,5,123,53
-1,1853,1774,79,-2,-531,96
-1,1411,1331,80,0,-11,118
1,1959,1951,8,-1,237,145
-1,1382,1560,-178,4,141,54
-1,1574,1614,-40,-14,-723,74
-1,1390,1693,-303,0,-92,68
-1,1640,1474,166,2,-3,60
-1,1861,1985,-124,-3,-110,74
1,1453,1312,141,-2,-10,41
1,1631,1645,-14,1,6,43
1,1510,1580,-70,5,437,95
-1,1701,1664,37,-3,-320,96
-1,1420,1754,-334,-2,-817,102
1,1567,1204,363,-1,-54,53
-1,1375,1426,-51,-6,-393,70
-1,1560,1510,50,-1,-82,90
1,1624,1565,59,2,326,109
-1,1661,1548,113,-5,-303,80
-1,1647,1629,18,0,-4,68
1,1919,1837,82,-2,-30,41
1,1644,1236,408,0,392,98
1,1693,1512,181,-1,-40,71
-1,1913,1852,61,-3,-130,62
1,1186,1457,-271,10,298,71
1,1652,1578,74,0,263,91
1,1847,1569,278,0,327,147
-1,1180,1378,-198,-7,-595,106
1,1857,1712,145,10,622,107
-1,1301,1422,-121,-7,-80,48
-1,1904,1870,34,-1,-2,58
-1,1928,1829,99,-2,-87,62
1,1704,1867,-163,6,271,71
1,1712,1895,-183,2,45,41
-1,1500,1633,-133,-17,-1713,104
-1,1595,1543,52,-5,-257,65
-1,1455,1254,201,1,74,62
1,1440,1185,255,19,675,55
1,1565,1361,204,-11,-396,69
1,1411,1500,-89,6,250,61
1,1505,1469,36,0,120,65
-1,1560,1563,-3,-4,-107,68
1,1745,1699,46,0,7,43
-1,1701,1310,391,-7,-70,54
1,1523,1548,-25,0,253,139
-1,1633,1804,-171,5,213,78
-1,1330,1363,-33,-1,-845,168
-1,1409,1258,151,-6,-219,60
-1,1826,1787,39,-8,-251,44
-1,1627,1722,-95,-7,-623,96
1,1525,1402,123,6,94,47
1,1555,1573,-18,0,173,63
-1,1840,1993,-153,-2,37,54
-1,1726,1905,-179,-3,-34,60
1,1883,1754,129,-2,4,63
-1,1573,1513,60,0,-165,120
1,1842,1716,126,0,60,99
-1,1481,1872,-391,0,-3,42
-1,1813,1636,177,0,5,54
1,1467,1394,73,4,685,105
0,1619,1731,-112,0,-654,118
-1,1485,1754,-269,0,-39,62
1,2000,1834,166,-1,-42,57
1,1755,1579,176,-1,-9,61
-1,1569,1663,-94,0,-2,48
1,1874,1478,396,-1,-27,45
-1,1714,1913,-199,-1,-49,78
-1,1459,1517,-58,0,-2,56
-1,1319,1797,-478,-12,-638,78
0,1828,2006,-178,-5,-723,90
-1,1500,1549,-49,-6,-226,60
-1,1476,1877,-401,1,15,48
1,1622,1556,66,7,625,111
-1,1377,1303,74,1,-14,86
1,1451,1506,-55,5,260,59
1,2098,1842,256,1,62,73
1,1828,1780,48,-1,41,117
-1,1879,1473,406,1,83,58
1,1879,1387,492,6,205,67
-1,1833,2001,-168,0,3,50
1,1758,1535,223,0,105,67
1,1444,1491,-47,-1,0,75
-1,1631,1548,83,0,-1002,88
1,1616,1588,28,1,57,61
-1,1837,2103,-266,-1,-60,60
-1,1556,1726,-170,-1,-58,96
1,1826,1209,617,0,61,59
1,2007,1827,180,5,93,45
1,1497,1855,-358,7,207,55
-1,1484,1709,-225,0,125,102
-1,1650,1721,-71,0,29,128
-1,1561,1618,-57,-18,-1329,122
-1,1821,2013,-192,-8,-523,88
1,2107,1833,274,1,123,79
-1,1804,1744,60,-4,-51,58
1,1718,1643,75,4,44,47
-1,1563,1561,2,-4,-191,89
1,1811,1761,50,0,85,133
1,1832,1519,313,-4,-141,53
-1,1577,1627,-50,1,-37,68
1,1355,1430,-75,0,276,117
0,1554,1566,-12,-1,-6,119
1,1627,1552,75,3,813,117
1,2019,1816,203,0,188,101
-1,1829,2112,-283,-7,-237,70
-1,1515,1836,-321,1,25,52
-1,1527,1347,180,-10,-133,42
-1,1216,1631,-415,-3,-119,60
0,1372,1266,106,0,115,97
-1,1624,1728,-104,-2,-112,66
-1,1721,1849,-128,0,-10,80
0,1840,1512,328,-6,-430,101
0,1811,2025,-214,-1,-743,124
-1,1360,1636,-276,-4,-198,76
1,1500,1636,-136,0,11,73
1,1383,1231,152,0,59,53
1,1673,1561,112,3,454,83
1,1647,1530,117,3,166,69
1,1732,1550,182,3,176,117
-1,1339,1364,-25,3,28,44
-1,1642,1699,-57,-4,-209,64
1,1521,1830,-309,1,21,51
1,1207,1421,-214,3,555,89
1,1770,1556,214,1,42,65
-1,1821,1490,331,-3,-6,40
1,1639,1355,284,3,86,49
1,1571,1524,47,-6,23,63
-1,1817,2120,-303,-2,-184,74
1,1634,1422,212,3,83,53
1,1808,1544,264,-6,-339,63
-1,1785,1565,220,-4,-127,66
-1,1523,1488,35,-2,-323,78
1,1500,1548,-48,-4,-158,63
1,1544,1347,197,5,268,79
1,1827,1714,113,-1,26,89
1,1711,1647,64,-1,324,101
-1,1534,1513,21,4,115,52
-1,1567,1572,-5,-4,-401,82
1,1539,1813,-274,-4,-63,45
0,1341,1549,-208,-2,1059,237
-1,1098,1693,-595,-5,-474,86
-1,1791,1560,231,-3,-84,52
-1,1563,1751,-188,1,39,54
1,1417,1409,8,-2,522,89
-1,1662,1639,23,3,20,50
-1,1581,1770,-189,-1,47,42
1,1394,1655,-261,0,-49,121
-1,1720,1909,-189,-2,-16,48
1,1334,1397,-63,-3,167,99
-1,1927,2146,-219,-2,-87,56
-1,1110,1498,-388,1,-110,60
-1,1344,1880,-536,-3,-137,78
1,1777,1574,203,-3,-157,69
1,1714,1648,66,11,363,57
1,1550,1861,-311,-1,445,87
1,1584,1291,293,-1,9,47
-1,1461,1772,-311,-9,-293,62
1,1529,1471,58,0,183,71
1,1283,1369,-86,0,-35,41
1,1356,1369,-13,1,361,155
-1,1459,1551,-92,-2,-306,120
1,1568,1783,-215,3,390,75
-1,1390,1117,273,-15,-553,68
-1,1530,1571,-41,0,194,88
-1,1324,1309,15,-6,-121,46
1,1443,1316,127,6,633,219
1,1753,1459,294,0,11,55
1,1856,1835,21,0,42,79
1,1510,1548,-38,-6,-11,53
-1,1332,1591,-259,-9,-131,50
-1,1221,1043,178,-6,-99,49
1,1763,1588,175,-3,-62,47
0,1827,1572,255,1,-202,135
1,1633,1771,-138,8,220,43
-1,1624,1534,90,0,4,44
1,1671,1733,-62,4,-99,121
-1,1581,1770,-189,4,110,70
1,1581,1633,-52,2,100,63
-1,1621,1726,-105,-1,20,74
1,1596,1463,133,0,-28,47
1,1630,1271,359,-2,5,51
1,1500,1533,-33,-5,-199,61
1,1807,1697,110,1,51,91
-1,1820,1468,352,-4,-159,60
-1,1384,1361,23,0,-43,76
1,1605,1742,-137,-9,-66,45
1,1567,1885,-318,3,39,43
1,1536,1523,13,0,119,69
0,1236,1655,-419,7,1201,145
1,1592,1763,-171,-1,-177,99
-1,1314,1347,-33,-1,-64,90
-1,1649,1826,-177,0,3,46
1,1785,1338,447,-1,-20,47
-1,1319,1428,-109,-4,-420,96
-1,1824,1866,-42,-5,-99,64
0,1614,1438,176,0,520,97
-1,1550,1611,-61,2,93,90
-1,1389,1500,-111,-2,144,72
-1,1801,2151,-350,-6,-381,94
-1,1788,1777,11,-8,-462,76
-1,1501,1283,218,4,252,52
-1,1519,1608,-89,4,160,74
1,1784,1458,326,-10,-141,57
-1,1549,1919,-370,0,-67,106
1,1456,1608,-152,-2,3,55
-1,1362,1402,-40,0,-113,72
1,1727,1493,234,5,219,53
1,1599,1320,279,-1,22,75
-1,1721,1685,36,1,3,50
-1,1347,1544,-197,-11,-116,50
1,1512,1520,-8,-2,-2,57
-1,1756,1769,-13,7,157,58
1,1341,1219,122,-4,39,53
-1,1464,1587,-123,0,-9,98
-1,1283,1627,-344,-1,-46,66
-1,1163,1571,-408,0,-11,46
-1,1427,1643,-216,2,77,60
1,1641,1763,-122,-1,-2,139
-1,1226,1357,-131,1,-207,88
-1,1538,1652,-114,-5,-64,46
-1,1559,1451,108,0,-32,58
-1,1745,1786,-41,0,-35,108
1,2154,1798,356,2,105,67
-1,1284,1182,102,-14,-767,104
-1,1709,1832,-123,0,-104,80
1,1500,1483,17,3,89,67
1,1875,1814,61,-5,10,113
-1,1621,1790,-169,-5,-47,58
1,1618,1510,108,4,293,75
-1,1647,1258,389,-7,-203,52
-1,1746,1788,-42,-2,129,116
-1,1797,1615,182,-7,-429,82
-1,1795,2156,-361,0,-33,70
1,1566,1758,-192,2,79,67
0,1710,1508,202,1,5,120
-1,1562,1615,-53,0,-7,56
-1,1740,1801,-61,0,-167,88
1,1547,1512,35,7,127,47
-1,1373,1500,-127,0,-26,56
1,1782,1584,198,0,134,61
-1,1218,1523,-305,1,-52,68
-1,1367,1378,-11,-5,-470,74
-1,1500,1340,160,-4,-48,44
1,1786,1624,162,2,183,125
1,1475,1502,-27,2,556,107
-1,1603,1628,-25,0,13,86
1,2159,1793,366,-9,127,91
-1,1388,1444,-56,-12,-719,80
1,1705,1582,123,-3,-55,49
1,1988,1969,19,-4,193,69
1,1930,1599,331,0,343,75
-1,1712,1574,138,0,-83,60
1,1779,1659,120,8,199,53
1,1697,1610,87,-1,26,53
1,1678,1621,57,0,795,143
1,1499,1631,-132,-1,138,73
1,1590,1499,91,-1,74,69
1,1979,1929,50,0,20,59
-1,1479,1678,-199,1,-1,76
-1,1697,1589,108,7,249,40
-1,2000,1933,67,1,-86,110
1,1500,1437,63,0,260,141
-1,1327,1463,-136,-2,-138,72
1,1797,1787,10,2,95,81
-1,2104,1968,136,-1,-38,49
1,1724,1765,-41,0,75,89
-1,1896,1988,-92,-3,-91,54
-1,1658,1451,207,9,711,78
-1,1510,1465,45,-1,-249,88
-1,1587,1598,-11,-1,-14,70
-1,1688,1525,163,-5,4,42
1,1699,1587,112,8,749,89
1,1677,1710,-33,-4,-215,97
-1,1996,1870,126,0,-134,96
-1,1500,1782,-282,1,42,58
-1,1947,1985,-38,0,-681,120
1,1740,1403,337,-1,295,131
-1,1772,1601,171,1,28,86
1,1685,1285,400,1,145,139
-1,1707,1579,128,-10,-147,50
1,1367,1376,-9,1,115,59
-1,1983,2075,-92,1,-43,88
-1,1470,1786,-316,2,-409,98
1,1692,1594,98,8,770,75
-1,1514,1573,-59,-1,-18,64
1,1996,1937,59,0,461,171
1,1647,1557,90,0,339,131
-1,1397,1443,-46,6,152,48
1,1485,1344,141,0,189,137
0,1528,1361,167,0,25,99
1,1663,1328,335,-13,-303,63
1,1627,1660,-33,1,21,97
1,1700,1586,114,-7,-131,41
-1,1858,1831,27,-2,-343,88
1,1056,1356,-300,-4,-105,43
1,1453,1361,92,2,149,63
-1,1281,1505,-224,-19,-832,59
1,1699,1599,100,2,159,61
1,1708,1579,129,11,90,45
1,1713,1737,-24,2,259,83
1,1702,1631,71,1,25,53
1,1320,1634,-314,0,167,65
0,1927,2006,-79,-1,-413,147
-1,1481,1737,-256,-4,-177,60
-1,1541,1672,-131,-1,-61,66
-1,1618,1751,-133,-1,-103,78
-1,1626,1635,-9,0,-189,70
1,1629,1659,-30,-1,-25,49
1,1715,1574,141,-1,-68,67
-1,1770,1731,39,-1,9,58
1,1529,1392,137,0,-116,71
-1,2090,1974,116,-2,-47,72
-1,1576,1646,-70,-7,-158,56
1,1397,1388,9,-4,0,57
0,1695,1609,86,1,43,62
1,1789,1929,-140,2,23,43
1,1236,1352,-116,2,-26,65
1,1489,1447,42,3,158,49
1,1500,1636,-136,0,37,65
1,1643,1712,-69,2,356,125
-1,1736,2003,-267,0,-12,52
-1,1619,1651,-32,-5,-53,132
-1,1630,1657,-27,-3,-41,50
1,1559,1464,95,8,221,51
1,1728,1560,168,2,79,47
-1,1760,1610,150,-3,-39,98
1,1296,1177,119,0,31,43
1,1655,1622,33,0,175,121
1,1734,1554,180,-2,42,73
1,1743,1549,194,0,35,79
1,1982,1483,499,6,474,78
1,2008,1913,95,0,2,49
1,1668,1620,48,0,181,55
1,1651,1517,134,9,435,79
1,1500,1310,190,5,143,45
-1,1433,1560,-127,-3,-31,44
1,1636,1548,88,2,199,88
1,1527,1527,0,0,-3,79
1,1337,1492,-155,1,70,71
-1,1340,1442,-102,5,151,90
1,1604,1283,321,2,74,73
1,1756,1691,65,-2,-92,51
1,1610,1678,-68,0,-305,79
-1,1500,1481,19,1,403,86
-1,1905,2017,-112,0,-308,102
-1,1740,1877,-137,-3,-80,50
1,1740,1563,177,-1,7,57
1,1843,1846,-3,0,39,99
-1,1692,1989,-297,-8,-299,64
-1,1612,1717,-105,2,127,76
1,1652,1266,386,0,2,61
1,1679,1616,63,0,6,41
-1,1281,1687,-406,-2,-129,80
-1,1686,1692,-6,4,226,78
-1,1665,1623,42,6,268,76
-1,2025,1897,128,2,161,100
-1,1471,1740,-269,5,126,58
-1,1505,1162,343,-4,8,42
-1,1755,1892,-137,0,-33,68
-1,1711,1589,122,0,-31,70
1,1814,1500,314,4,441,119
1,1742,1494,248,-2,-43,61
1,1569,1534,35,7,91,91
0,1725,1725,0,-2,-46,97
-1,1818,1574,244,-1,293,98
1,1636,1652,-16,-1,-103,61
1,1683,1591,92,0,178,65
-1,1912,2009,-97,-3,-599,124
-1,1304,1488,-184,1,107,66
-1,1534,1453,81,0,-123,94
0,1608,1819,-211,-2,-301,112
1,1391,1336,55,6,753,93
0,1690,1611,79,0,17,157
0,1479,1502,-23,1,90,103
1,1487,1747,-260,-8,538,87
1,1640,1647,-7,6,246,65
1,1653,1616,37,0,60,79
-1,1159,1500,-341,1,1,48
1,1583,1589,-6,4,573,113
1,1688,1745,-57,4,228,71
-1,1251,1519,-268,-4,-41,54
1,2018,1911,107,-3,115,121
1,1253,1415,-162,2,44,49
-1,1636,1651,-15,-1,-264,78
1,1709,1556,153,-1,-39,57
1,1477,1773,-296,-1,112,85
1,1728,1516,212,-9,188,95
-1,2079,1578,501,2,59,44
-1,1671,1519,152,2,31,94
-1,1321,1468,-147,-5,-182,72
-1,1343,1666,-323,-14,-405,54
1,1382,1548,-166,5,348,65
-1,1602,1729,-127,0,-9,48
1,1302,1300,2,-1,-35,67
-1,1625,1662,-37,0,-7,56
-1,1560,1510,50,-3,-582,138
1,1746,1599,147,6,415,67
-1,1903,2055,-152,-1,17,72
-1,1317,1477,-160,-8,-253,46
-1,1951,1809,142,-2,-76,60
0,1604,1927,-323,0,-543,142
-1,1731,1858,-127,-6,-178,76
-1,2026,1728,298,3,180,80
-1,1507,1734,-227,-1,-121,86
1,1510,1562,-52,19,595,63
1,1672,1616,56,6,1031,105
1,1613,1690,-77,0,352,143
-1,1620,1611,9,0,-6,40
-1,1728,1707,21,-2,-30,56
-1,1741,1593,148,-2,14,60
-1,1697,1698,-1,0,-137,122
1,1689,1278,411,-2,11,55
1,1500,1298,202,1,492,83
-1,1664,1834,-170,-4,-71,72
-1,1287,1532,-245,-2,-51,50
1,1663,1617,46,1,90,66
-1,1682,2065,-383,-7,-222,52
1,1962,1634,328,-2,119,67
-1,1746,1500,246,-2,-40,50
1,1254,1187,67,-6,110,71
-1,1495,1364,131,1,150,90
1,2067,1679,388,-1,-85,79
-1,1615,1759,-144,0,-35,88
1,1966,1631,335,1,14,41
-1,1875,1622,253,7,122,42
-1,1309,1729,-420,-2,-263,86
1,1969,1628,341,0,28,51
1,1338,1500,-162,5,147,57
1,1539,1688,-149,8,825,113
-1,1615,1661,-46,2,-212,168
1,1417,1521,-104,0,299,121
1,1799,1611,188,-1,-13,51
1,1412,1381,31,2,9,41
1,1753,1625,128,3,27,43
1,1671,1627,44,1,-1,43
-1,1724,1515,209,0,-115,96
-1,1710,1748,-38,0,-31,60
-1,1539,1747,-208,-3,-609,110
-1,1482,1513,-31,0,-13,70
1,1597,1500,97,10,244,47
1,1794,1255,539,9,262,51
1,1501,1648,-147,-1,-11,51
1,1483,1443,40,2,103,59
1,1397,1537,-140,8,256,43
-1,1770,1899,-129,0,8,50
0,1821,1832,-11,-1,-10,143
-1,1359,1597,-238,2,-549,80
-1,1808,1788,20,-3,-61,84
1,1350,1326,24,0,26,51
-1,1605,1919,-314,-1,-154,70
-1,1808,1803,5,-2,-21,46
1,1627,1553,74,0,57,67
1,1782,1765,17,0,29,55
1,1763,1687,76,1,34,45
1,1607,1081,526,1,225,108
1,1767,1610,157,-5,-106,117
-1,1474,1613,-139,-6,-83,43
1,1509,1505,4,0,136,133
-1,1251,1796,-545,-8,-199,44
1,1521,1412,109,6,351,87
-1,1466,1602,-136,-10,-1041,100
-1,1861,1671,190,1,33,76
1,1681,1672,9,1,324,107
1,1678,1807,-129,9,135,45
1,1629,1539,90,7,176,41
1,1779,1596,183,-2,-46,91
-1,1801,1796,5,-5,-448,128
1,1493,1192,301,4,143,47
-1,1764,1784,-20,-5,3,48
1,1734,1533,201,0,161,67
1,1755,1792,-37,1,700,117
-1,1623,1511,112,3,94,98
1,1732,1304,428,-2,8,51
1,1123,1313,-190,7,536,95
0,1661,1466,195,1,67,124
1,1692,1602,90,10,499,69
-1,1612,1434,178,-1,-67,72
-1,1500,1523,-23,-1,-784,122
1,1725,1755,-30,0,3,67
-1,1716,1857,-141,-7,-54,48
1,1785,1590,195,-2,-79,47
-1,1366,1607,-241,-6,-565,132
1,1791,1584,207,-5,-101,67
1,1930,1289,641,-2,-89,153
1,1601,1749,-148,4,63,61
-1,1544,1636,-92,2,41,42
1,1313,1356,-43,-1,-118,49
1,1918,1941,-23,1,22,53
1,1656,1671,-15,3,529,95
-1,1325,1794,-469,-2,-17,44
1,1824,1814,10,3,91,49
-1,1501,1480,21,1,-143,132
1,1701,1322,379,0,-36,45
-1,1807,1788,19,1,-11,74
-1,1607,1722,-115,-5,-93,44
1,1914,1694,220,0,116,83
1,1687,1650,37,-1,-37,47
-1,1741,1692,49,1,-19,46
1,1796,1578,218,0,180,69
-1,1361,1528,-167,-3,-31,48
-1,1345,1993,-648,-6,-417,66
1,1896,1796,100,0,26,101
1,1781,1837,-56,0,196,87
1,1745,1600,145,9,1181,117
-1,1709,1864,-155,0,-179,130
1,1801,1573,228,1,23,59
1,1593,1612,-19,0,-53,101
1,1472,1628,-156,-3,188,87
-1,1536,1927,-391,0,32,98
1,1992,1687,305,1,25,69
1,1531,1616,-85,-1,2,57
0,1801,1796,5,1,-56,74
1,1904,1788,116,-3,365,97
-1,1680,1674,6,4,151,88
-1,1361,1536,-175,-3,-10,40
1,1933,1533,400,7,173,69
1,1835,1803,32,0,-12,51
1,1815,1558,257,6,329,83
-1,1401,1295,106,-4,-356,69
-1,1228,1593,-365,-1,-1,40
1,1455,1170,285,1,85,53
1,1763,1755,8,-3,-7,45
1,1609,1573,36,0,-7,71
-1,1530,1939,-409,-2,-60,58
1,1843,1687,156,0,85,87
-1,1598,1700,-102,4,33,50
1,1820,1553,267,-2,-169,127
1,1326,1449,-123,-1,-62,55
1,1704,1691,13,0,30,83
1,1796,1801,-5,-5,-160,75
1,1712,1611,101,9,391,73
-1,1781,1737,44,-2,-153,72
-1,1437,1527,-90,1,-147,66
1,1495,1549,-54,0,54,59
-1,1648,1745,-97,-5,-439,76
-1,1945,1720,225,0,0,68
-1,1603,1535,68,3,66,50
1,1633,1511,122,-4,-98,69
0,1542,1348,194,0,-56,85
1,1509,1539,-30,3,80,65
1,1619,1383,236,1,-5,40
-1,1793,1932,-139,0,-51,62
-1,1305,1489,-184,-4,-568,90
-1,1291,1295,-4,3,20,91
-1,1738,1901,-163,-8,-222,84
-1,1373,1822,-449,-1,-305,98
-1,1677,1549,128,-1,63,86
-1,1844,1793,51,-1,-89,104
1,1442,1279,163,10,611,93
-1,1697,1722,-25,0,-122,92
1,1626,1702,-76,-5,127,129
-1,1318,1865,-547,0,-6,42
-1,1872,1966,-94,0,-10,96
1,1731,1522,209,1,-75,97
-1,1659,1668,-9,-1,-162,112
-1,1590,1522,68,-4,-50,44
1,1461,1210,251,5,177,53
1,1753,1850,-97,0,19,61
1,1662,1565,97,-1,220,65
1,1537,1577,-40,0,-14,53
-1,1639,1685,-46,-1,-111,80
-1,1642,1916,-274,1,50,80
1,1624,1331,293,0,-6,87
-1,1866,1639,227,-5,-710,122
-1,1501,1536,-35,-6,-288,73
1,1679,1574,105,7,140,47
1,1517,1666,-149,0,2,45
-1,1564,1551,13,-3,59,68
-1,1602,1749,-147,-3,-3,46
1,1236,1375,-139,1,-40,67
-1,1925,1670,255,0,-6,74
-1,1572,1608,-36,0,-105,112
1,1664,1557,107,8,204,55
-1,1663,1848,-185,-3,-205,98
1,1737,1427,310,-9,-86,49
-1,1526,1562,-36,-1,-20,54
0,1786,1912,-126,0,-131,168
-1,1688,1885,-197,-1,-37,48
0,1665,1629,36,0,49,88
-1,1563,1553,10,-1,97,74
-1,1275,1619,-344,-1,-359,80
1,1854,1655,199,6,645,85
1,1566,1689,-123,0,215,93
-1,1296,1505,-209,-9,-110,46
-1,1825,1766,59,-3,-140,78
1,1897,1682,215,0,158,81
0,1423,1740,-317,8,584,128
-1,1833,1549,284,-1,3,58
-1,1860,1648,212,-3,-64,94
1,1539,1575,-36,-3,-105,57
1,1790,1497,293,3,117,57
1,1621,1601,20,0,149,67
-1,1648,1761,-113,0,-149,74
-1,1677,1907,-230,0,-6,54
1,1529,1404,125,5,41,55
-1,1807,1568,239,-3,-38,52
0,1608,1543,65,1,167,97
1,1766,1623,143,-4,-50,57
-1,1631,1664,-33,-6,-137,46
1,1708,1665,43,-3,-19,79
-1,1326,1628,-302,0,-28,44
-1,1165,1181,-16,-11,-241,68
-1,1253,1697,-444,-1,-481,96
-1,1563,1552,11,0,-13,64
1,1685,1607,78,0,38,92
1,1842,1732,110,0,33,73
1,1917,1618,299,-4,-117,69
-1,1586,1587,-1,0,-72,90
-1,1806,1832,-26,-1,-87,70
-1,1619,1515,104,0,-3,60
1,1899,1789,110,-6,100,93
-1,1761,1806,-45,-4,-31,40
-1,1835,1910,-75,-2,-125,98
1,1564,1551,13,-5,-136,45
-1,1710,1732,-22,-2,-237,84
-1,1570,1850,-280,1,17,52
-1,1682,1567,115,-1,-11,44
-1,1537,1464,73,-6,-129,40
-1,1217,1246,-29,-1,10,58
1,1448,1471,-23,0,411,105
1,1758,1530,228,12,1038,101
1,1558,1676,-118,-1,39,67
1,1614,1697,-83,-1,-22,57
1,1541,1576,-35,4,90,49
-1,1659,1698,-39,-1,-168,98
1,1689,1657,32,0,-8,43
-1,1565,1854,-289,1,8,46
-1,1516,1769,-253,0,54,40
0,1824,1623,201,-2,34,124
1,1523,1605,-82,-2,5,75
-1,1700,1774,-74,1,-175,100
1,1863,1939,-76,0,-6,89
-1,1705,1780,-75,0,160,76
-1,1813,1773,40,0,-9,52
1,1563,1553,10,8,217,61
1,1598,1693,-95,0,472,95
1,1858,1628,230,-3,-108,75
-1,1768,1739,29,-7,-185,44
-1,1374,1619,-245,-1,18,54
1,1683,1473,210,0,139,91
-1,1194,1102,92,1,15,54
-1,1996,2130,-134,0,28,70
1,1542,1574,-32,-5,-322,75
-1,1548,1684,-136,0,-8,58
-1,1471,1661,-190,-1,-47,58
-1,1446,1623,-177,-3,-173,62
1,1709,1445,264,-3,-240,79
-1,1368,1500,-132,-1,-153,108
-1,1500,1863,-363,-8,-59,46
1,1866,1614,252,-5,-169,69
0,1801,1785,16,1,34,59
-1,1468,1688,-220,-11,-519,64
1,1554,1665,-111,-2,-21,43
1,1640,1590,50,2,80,73
1,1672,1605,67,1,22,49
-1,1525,1763,-238,-2,-258,90
-1,1679,1785,-106,-9,-498,73
1,1354,1573,-219,0,0,44
-1,1387,1524,-137,-3,-157,56
1,1924,1629,295,1,26,51
1,1871,1610,261,0,-12,45
1,1414,1691,-277,4,40,45
-1,1336,1757,-421,-1,-79,80
1,1436,1567,-131,2,523,79
1,1784,1240,544,8,306,61
-1,1693,1606,87,3,11,40
-1,1782,1589,193,-4,-98,52
-1,1632,1563,69,-4,-320,84
0,1500,1377,123,0,25,131
1,1931,1620,311,9,579,99
-1,1484,1275,209,-7,-141,52
-1,1432,1292,140,2,81,58
-1,1785,1801,-16,-1,-128,90
-1,1491,1701,-210,-3,-93,68
-1,1601,1596,5,0,16,74
1,1805,1725,80,-3,-28,43
-1,1628,1595,33,-2,-590,126
1,1658,1572,86,2,82,47
1,1793,1672,121,-2,-3,95
-1,1583,1274,309,0,10,58
-1,1982,2145,-163,-5,-17,40
-1,1676,1515,161,-8,-434,112
1,1606,1314,292,0,5,49
-1,1675,1647,28,-3,-172,66
0,1553,1477,76,2,498,112
1,1751,1757,-6,2,247,99
1,1549,1539,10,-5,295,153
-1,1433,1672,-239,-10,-49,40
-1,1785,1923,-138,-1,-6,56
1,1635,1288,347,-2,118,55
1,1913,1890,23,-2,55,77
1,1688,1530,158,8,295,61
1,1645,1813,-168,-1,24,103
1,1838,1097,741,0,98,69
-1,1505,1616,-111,5,327,120
-1,1432,1692,-260,-1,-12,46
1,1576,1618,-42,4,139,53
1,1879,1427,452,3,364,71
-1,1368,1678,-310,-4,-10,40
-1,1878,1925,-47,-3,-5,88
1,1454,1426,28,1,153,73
1,1703,1521,182,4,272,95
-1,1460,1483,-23,-4,-148,66
-1,1547,1534,13,-4,-44,54
-1,1536,1500,36,4,-465,118
1,1292,1420,-128,3,196,69
-1,1564,1668,-104,-1,-117,72
1,1500,1551,-51,0,4,59
0,1547,1606,-59,-1,-155,81
1,1620,1812,-192,1,23,67
1,1580,1618,-38,0,25,59
-1,1981,1796,185,-1,-40,86
-1,1702,1880,-178,0,-477,124
1,1617,1630,-13,5,236,69
-1,1724,1554,170,-9,-153,46
-1,2091,2152,-61,-1,-31,50
1,1781,1156,625,11,781,109
-1,1810,1775,35,2,33,66
-1,1428,1697,-269,-1,-18,62
1,1688,1520,168,0,91,63
1,1543,1679,-136,-3,-92,79
1,1665,1720,-55,2,10,61
-1,1677,1595,82,-6,-209,70
-1,1467,1826,-359,-1,-364,104
1,1761,1169,592,11,466,55
1,1887,1795,92,3,-155,87
-1,1608,1497,111,-12,-136,100
-1,1604,1514,90,0,-313,144
-1,1435,1537,-102,-3,-62,56
1,1191,1625,-434,7,290,79
1,1634,1557,77,7,558,117
1,1629,1595,34,1,19,43
-1,1717,1534,183,-5,-198,57
-1,1786,1897,-111,0,-22,90
-1,1530,1817,-287,-3,-433,130
1,1661,1515,146,-4,6,43
-1,1396,1438,-42,0,-5,84
1,1546,1536,10,7,182,61
-1,1624,1500,124,0,-135,64
1,1697,1876,-179,0,39,83
1,1787,1799,-12,2,305,111
1,1716,1767,-51,0,127,107
1,1364,1518,-154,4,378,101
1,1906,1777,129,0,-31,87
-1,1257,1292,-35,-6,-241,82
1,1569,1511,58,-2,-57,55
1,1764,1167,597,15,148,41
-1,1619,1563,56,-7,-114,62
-1,1351,1607,-256,-4,-151,54
1,1464,1687,-223,-5,-155,49
-1,1423,1708,-285,-1,-71,70
0,1604,1551,53,-1,-61,71
0,1829,1883,-54,-2,-37,44
-1,1835,1631,204,-1,-273,88
-1,1930,1975,-45,0,5,96
-1,1299,1914,-615,0,1,44
-1,1575,1586,-11,-1,52,80
-1,1228,1564,-336,0,-240,58
-1,1507,1377,130,1,264,140
-1,1621,1808,-187,-1,-165,152
-1,1692,1610,82,0,-91,134
-1,1600,1634,-34,2,32,56
1,1810,1573,237,1,196,139
-1,1786,1537,249,-7,-204,118
-1,1498,1500,-2,-2,-462,150
1,1512,1356,156,2,665,123
1,1364,1667,-303,-1,-32,47
-1,1753,1699,54,-5,-159,77
-1,1339,1419,-80,-11,-571,72
1,1674,1490,184,2,809,161
-1,1560,1667,-107,0,-121,68
1,1624,1769,-145,6,78,42
-1,1610,1741,-131,0,-11,76
-1,1388,1503,-115,0,592,88
-1,1587,1558,29,-12,-395,64
1,1747,1294,453,5,59,45
1,1574,1511,63,-3,-24,59
0,1559,1596,-37,-1,12,100
1,1571,1676,-105,-2,-131,71
1,1464,1447,17,-2,-152,71
-1,1583,1406,177,3,-19,58
1,1741,1971,-230,0,311,81
1,1502,1833,-331,-9,-250,71
1,1511,1360,151,13,203,45
1,1744,1763,-19,-4,-57,81
1,1675,1553,122,0,40,53
-1,1576,1541,35,0,-74,64
-1,1585,1621,-36,-4,-280,82
1,1521,1310,211,-10,-52,47
-1,1470,1500,-30,0,-161,89
-1,1520,1740,-220,0,0,42
1,1397,1138,259,4,169,63
-1,1610,1704,-94,-3,-98,74
1,1715,953,762,6,92,45
1,1451,1725,-274,2,72,83
-1,952,1814,-862,-11,-123,44
-1,1755,1704,51,0,-39,62
1,1529,1848,-319,0,10,115
0,1915,1959,-44,1,-301,141
1,1631,1575,56,2,165,95
1,1795,1712,83,0,107,65
-1,1474,1567,-93,0,3,54
1,1718,1615,103,-2,-2,43
1,1626,1418,208,-2,-51,69
1,1618,1659,-41,-3,86,97
1,1350,1473,-123,1,258,71
1,1667,1626,41,5,192,66
-1,1291,1575,-284,-9,-293,60
-1,1433,1750,-317,-6,-61,60
1,1627,1579,48,4,69,45
-1,1421,1757,-336,-3,-13,94
-1,1492,1285,207,-3,-73,107
-1,1519,1611,-92,-6,-98,42
-1,1752,1768,-16,0,-94,74
-1,1569,1637,-68,-1,-74,56
-1,1350,1683,-333,-2,-125,98
-1,1542,1609,-67,-1,-16,52
-1,1632,1656,-24,1,39,64
1,1916,1957,-41,0,18,69
1,1718,1752,-34,-1,-45,46
-1,1608,1579,29,1,33,56
0,1552,1654,-102,0,-226,109
-1,1403,1621,-218,-4,-493,148
1,1485,1406,79,-4,-313,145
-1,1517,1604,-87,0,-299,164
1,1439,1378,61,-1,-39,59
-1,1717,1743,-26,-1,-20,122
-1,1638,1623,15,-3,-48,41
1,2172,1548,624,0,5,97
1,1803,1770,33,0,178,87
-1,1814,1783,31,-2,-62,54
1,1899,1644,255,6,1385,157
-1,1655,1656,-1,-3,-149,68
1,1765,1425,340,0,173,107
-1,1586,1815,-229,-8,-391,122
-1,1555,1516,39,-1,-24,62
1,1500,1359,141,3,184,69
1,1760,1555,205,-1,60,63
1,1751,1514,237,-3,64,43
1,1402,1342,60,3,125,59
1,1909,1818,91,2,-29,45
1,1776,1286,490,6,220,51
1,1758,1890,-132,0,79,57
-1,1667,1644,23,-6,-374,106
1,1591,1580,11,2,961,119
-1,1553,1518,35,-3,-87,58
-1,1618,1564,54,-2,-202,118
-1,1556,1740,-184,0,13,52
-1,1448,1363,85,-9,-352,110
1,1397,1285,112,7,102,43
-1,952,1860,-908,-8,-318,52
1,1928,1814,114,5,279,74
-1,1371,1591,-220,-4,-290,68
-1,1550,1765,-215,0,-29,46
1,1464,1399,65,9,168,51
1,1656,1655,1,2,145,73
-1,1857,1760,97,0,-248,110
-1,1746,1550,196,0,-9,62
-1,1742,1918,-176,-1,-47,140
-1,1531,1541,-10,-2,-53,72
1,1876,1772,104,0,5,105
1,1713,1613,100,6,240,69
1,1933,1627,306,1,136,75
1,2175,1928,247,0,18,51
1,1622,1666,-44,-6,-310,77
-1,1575,1659,-84,-2,-169,58
1,1914,1640,274,-3,-14,65
-1,1568,1729,-161,-4,-137,46
1,1730,1647,83,-3,-58,59
0,1389,1373,16,2,-35,174
1,1623,1598,25,2,16,41
-1,1552,1519,33,-3,-371,114
1,1966,1835,131,4,100,49
0,1959,1617,342,-3,-543,130
-1,1666,1713,-47,-3,-67,47
1,1680,1617,63,0,5,87
-1,1585,1688,-103,0,190,104
-1,1554,2164,-610,3,308,80
1,1917,1440,477,1,84,52
1,1497,1242,255,6,100,46
1,2181,1750,431,1,69,55
1,1542,1632,-90,-1,222,97
1,1629,1929,-300,1,29,59
1,1532,1540,-8,3,32,41
1,1499,1568,-69,1,73,63
1,1923,1926,-3,-1,476,87
-1,1611,1863,-252,-2,-67,48
-1,1738,1776,-38,0,2,62
-1,1529,1544,-15,0,-37,72
-1,1773,1748,25,-8,-195,126
-1,1474,1796,-322,0,-7,62
-1,1421,1435,-14,0,-4,49
-1,1598,1878,-280,2,18,46
1,1511,1654,-143,-2,-26,41
1,1619,1607,12,6,208,61
1,1870,1790,80,-3,110,59
-1,1587,1890,-303,-1,-77,64
-1,1765,1883,-118,0,-4,84
-1,1519,1553,-34,-5,-56,58
1,1829,1742,87,-1,-8,51
-1,1445,1381,64,-1,-114,82
-1,1332,1411,-79,0,-82,86
1,1393,1369,24,0,8,41
-1,1630,1868,-238,-1,-205,118
1,1712,1503,209,-2,2,71
-1,1577,1900,-323,-5,-191,62
-1,1438,1924,-486,-3,-165,88
1,1924,1734,190,-5,-370,93
0,1786,1729,57,1,94,137
-1,1584,1558,26,-6,-290,86
1,1919,1472,447,2,69,54
1,1550,1521,29,4,140,55
1,1887,1773,114,-1,-57,65
-1,1500,1447,53,-3,-501,98
-1,1405,1623,-218,0,-33,62
1,1491,1369,122,-2,200,71
-1,1596,1652,-56,1,-47,74
-1,1765,1894,-129,-1,-54,80
-1,1443,1436,7,-2,-108,80
1,1366,1500,-134,6,337,59
1,1918,1730,188,-4,-104,57
1,1526,1504,22,-4,-24,63
1,1317,1525,-208,0,154,79
1,1752,1460,292,4,357,125
-1,1607,1654,-47,0,1,44
1,1524,1548,-24,4,218,71
-1,1901,1757,144,0,-315,88
1,1572,1580,-8,5,391,107
1,1651,1487,164,-1,-42,45
-1,1297,1466,-169,2,101,58
1,1631,1412,219,5,193,57
0,1818,1524,294,0,175,145
0,1773,1886,-113,-4,127,144
1,1947,1723,224,0,-9,93
-1,1514,1535,-21,-3,-64,51
-1,1470,1921,-451,0,-136,88
-1,1612,1756,-144,0,-27,70
1,1730,1785,-55,0,97,87
1,2170,1658,512,0,11,63
1,1930,1733,197,-2,-83,73
1,1760,1728,32,5,752,103
1,1449,1431,18,2,119,57
-1,1536,1727,-191,-5,-82,46
1,1862,1376,486,1,75,71
-1,1283,1471,-188,-1,-251,104
1,949,1245,-296,-1,-116,79
1,1991,1657,334,2,66,47
-1,1718,2101,-383,-3,-188,86
1,1769,1890,-121,0,12,65
-1,1663,1586,77,2,54,42
-1,1735,1738,-3,-7,-112,46
1,1692,1667,25,7,571,77
1,1619,1740,-121,0,214,123
-1,1758,2111,-353,-1,-22,50
-1,1339,1538,-199,1,-55,62
-1,1653,1486,167,0,-156,81
-1,1383,1401,-18,-1,-110,60
0,1605,1560,45,0,19,173
1,1421,1461,-40,-3,-68,51
-1,1501,1634,-133,-9,17,94
1,1922,1743,179,0,21,87
1,1940,1450,490,1,281,107
1,1403,1636,-233,0,-18,71
-1,1760,1598,162,0,5,58
-1,1335,1515,-180,-3,-376,92
-1,1734,1930,-196,-1,-47,74
1,1643,1494,149,0,-1,51
-1,1728,1784,-56,-2,-12,40
1,1632,1600,32,-1,18,49
1,1852,1718,134,0,164,109
1,1870,976,894,22,478,49
1,1583,1431,152,3,202,74
-1,1810,1763,47,-8,-172,70
-1,1553,1612,-59,0,67,90
-1,1412,1372,40,-4,-140,108
1,1640,1636,4,5,158,49
1,1608,1456,152,1,-5,43
1,1488,1650,-162,8,391,63
-1,1447,1433,14,-4,-118,64
1,1543,1276,267,-5,273,143
1,1507,1472,35,0,-40,63
1,1632,1503,129,-1,-7,59
-1,1737,1929,-192,-4,-360,120
-1,1615,1728,-113,-3,-79,84
-1,1611,1699,-88,-3,-17,44
1,1410,1471,-61,1,-6,81
-1,1578,1387,191,0,15,64
1,1860,1578,282,1,84,79
1,1710,1630,80,3,303,91
-1,1648,1489,159,-10,-664,78
-1,1767,1743,24,0,-12,86
-1,1497,1734,-237,0,0,90
1,1365,1503,-138,0,-73,59
1,1705,1484,221,0,1,99
-1,1224,1894,-670,-8,-88,40
1,1445,1434,11,-1,34,121
0,1621,1720,-99,-4,-68,80
1,1739,1650,89,-2,-76,65
-1,1387,1511,-124,0,-90,76
1,1718,1995,-277,-1,-44,65
1,1775,1783,-8,0,2,143
1,1457,1712,-255,-4,-25,42
-1,1543,1810,-267,2,-151,110
-1,1521,1329,192,-1,-88,58
1,1717,1624,93,-1,-20,75
-1,1618,1432,186,-3,-314,110
-1,1936,1934,2,-3,-41,134
1,1517,1708,-191,-1,-35,53
1,1590,1616,-26,10,857,87
-1,1737,1864,-127,-3,-7,40
1,1604,1608,-4,0,173,111
1,1500,1541,-41,7,584,85
-1,1756,1756,0,0,33,108
1,1526,1633,-107,5,429,107
1,1448,1377,71,4,29,57
-1,1616,1725,-109,-4,-343,176
-1,1936,1871,65,0,-77,72
1,1551,1374,177,0,-55,41
-1,1405,1942,-537,-9,-488,102
1,1422,1455,-33,4,799,115
-1,1458,1872,-414,-1,-137,76
1,1470,1666,-196,-6,-206,62
1,1944,1404,540,2,222,91
-1,1734,1608,126,0,-181,86
-1,1945,2063,-118,-8,40,62
-1,1532,1516,16,-3,-157,56
-1,1323,1373,-50,-1,-32,52
1,1500,1672,-172,1,433,85
1,1329,1610,-281,-1,13,109
-1,1815,1533,282,0,-52,92
1,1368,972,396,13,127,43
1,1403,1946,-543,-1,-30,51
1,1428,1673,-245,-4,-69,65
1,1767,1749,18,0,-1,41
1,1500,1355,145,-4,-148,51
1,1618,1553,65,2,141,73
1,1906,1426,480,0,546,104
-1,1626,1653,-27,2,45,134
1,1698,1465,233,6,272,59
-1,1454,1602,-148,0,-174,70
0,1746,1772,-26,0,17,97
-1,1349,1502,-153,1,25,54
-1,1379,1534,-155,-5,-142,102
1,2075,1938,137,-1,12,97
1,1615,1602,13,2,335,100
1,1364,1229,135,14,1172,84
1,1800,1633,167,0,141,70
-1,1342,1616,-274,-9,170,82
-1,1441,1561,-120,-4,-138,50
1,1909,1555,354,-5,175,131
-1,1799,1728,71,2,285,84
1,1922,1548,374,1,23,51
1,1748,1657,91,-1,113,89
-1,1746,1924,-178,-9,-127,42
-1,1424,1454,-30,2,40,68
1,1765,1751,14,0,89,73
-1,968,1939,-971,-11,-361,58
1,1625,1447,178,-7,-101,61
1,1604,1500,104,-1,201,129
1,1698,1473,225,0,54,96
-1,1931,2086,-155,0,-60,132
0,1537,1628,-91,0,0,97
-1,1930,1740,190,2,92,68
-1,1491,1916,-425,-1,-295,148
1,1336,1480,-144,1,0,53
1,1606,1450,156,-4,-33,41
1,1790,1553,237,0,8,43
1,1536,2180,-644,0,242,77
1,1484,1214,270,4,363,81
-1,1316,1366,-50,-2,-365,96
-1,1353,1561,-208,-2,18,58
-1,1479,1804,-325,-2,-197,94
1,1544,1367,177,-2,172,71
1,1739,1925,-186,-1,-7,43
1,1492,1591,-99,1,120,82
1,1795,1746,49,-1,79,83
-1,1465,1919,-454,0,-2,40
-1,1780,1672,108,-3,-319,82
1,1764,1719,45,-3,7,45
-1,1638,1641,-3,0,-11,58
1,1913,1740,173,-1,21,59
1,1985,1940,45,0,-7,75
1,1666,1616,50,1,50,70
0,1752,1701,51,0,-30,106
-1,1625,1542,83,0,-157,124
1,1771,1761,10,-2,-45,53
1,1222,1371,-149,1,155,86
-1,1925,1622,303,1,45,62
1,1759,1575,184,3,29,48
-1,1909,1939,-30,-10,-138,46
1,1892,968,924,8,337,53
1,1388,1527,-139,-1,-5,65
-1,1371,1702,-331,-9,-55,42
1,1500,1896,-396,-2,323,119
1,1806,1428,378,0,17,83
-1,1566,1891,-325,-3,-329,90
0,1580,1669,-89,-3,250,156
1,1733,1919,-186,-1,12,49
1,1737,1803,-66,1,27,63
-1,1344,1739,-395,0,-55,66
1,1865,1930,-65,0,62,101
-1,1563,1896,-333,0,2,60
1,1360,1771,-411,-1,42,69
1,1299,1269,30,-3,-174,104
1,1618,1449,169,-3,-63,49
-1,1562,1771,-209,-8,34,47
1,1808,1685,123,0,23,71
1,1765,1426,339,1,92,69
1,1997,1966,31,0,20,57
-1,1504,1597,-93,-10,-350,62
-1,2048,1900,148,-5,33,92
1,1650,1538,112,0,15,49
-1,1917,1878,39,0,-42,64
1,1421,1377,44,2,63,69
1,1467,1612,-145,2,159,53
1,1467,1704,-237,0,-17,57
-1,1790,1750,40,-3,-25,44
1,1077,1442,-365,-5,-420,87
1,1790,1751,39,-1,-20,57
-1,1224,1867,-643,-1,-363,112
1,1981,1744,237,0,289,149
1,1577,1475,102,2,24,75
1,1552,1856,-304,1,20,43
1,1898,1488,410,3,124,56
1,1890,1905,-15,0,27,67
-1,1500,1670,-170,0,-26,54
-1,1199,1490,-291,-3,-218,68
1,1902,1786,116,0,104,80
-1,1703,1657,46,-2,-211,94
-1,1773,1458,315,0,-77,70
1,1306,1345,-39,4,89,43
1,1656,1762,-106,0,181,147
-1,1894,1915,-21,1,52,56
1,1380,1550,-170,2,-87,40
-1,1901,1621,280,1,136,106
-1,1761,1651,110,0,-4,98
1,1817,1404,413,3,123,49
1,1368,1146,222,6,707,75
1,1330,1667,-337,-5,-196,65
-1,1695,1758,-63,0,-101,104
-1,1537,1415,122,1,-40,50
-1,1596,1508,88,-5,-215,120
-1,1402,1819,-417,-9,-153,54
1,1448,1651,-203,0,179,101
-1,1310,1706,-396,0,1,50
-1,1874,1935,-61,1,151,82
1,1427,1447,-20,-1,-6,43
-1,1338,1462,-124,-1,-88,70
1,1699,1463,236,1,205,115
-1,1374,1585,-211,0,-286,106
1,1347,1521,-174,-5,121,77
-1,1597,1585,12,1,29,46
-1,1748,1985,-237,0,2,56
-1,1603,1467,136,-3,-74,60
-1,1520,1703,-183,0,-122,96
-1,1865,1944,-79,8,241,66
-1,1631,1476,155,0,0,48
1,1308,1151,157,0,120,65
-1,1732,1884,-152,0,-38,72
1,1711,1735,-24,2,402,113
-1,1603,1335,268,-2,-21,44
1,1818,1699,119,0,0,43
1,1439,1425,14,1,16,53
1,1612,1769,-157,-1,44,51
1,1557,1616,-59,0,5,49
1,1583,1668,-85,-4,-51,67
1,1551,1457,94,0,-577,113
-1,1596,1500,96,0,69,122
-1,1464,1493,-29,0,-55,84
1,1779,1746,33,2,44,65
1,1691,1827,-136,-1,0,65
1,1586,1710,-124,0,10,65
1,1686,1588,98,0,-1,41
1,1722,1709,13,0,90,61
-1,1549,1878,-329,1,-51,72
-1,1953,1856,97,-1,-92,67
1,1604,1616,-12,1,31,59
1,1721,1709,12,-1,29,50
1,1308,1320,-12,-6,-118,49
1,1590,1336,254,2,171,87
1,1580,1694,-114,3,218,75
1,1496,1185,311,0,205,103
-1,1892,1813,79,0,-577,118
-1,1870,1939,-69,0,-15,54
-1,1615,1717,-102,-3,-158,69
1,1810,1368,442,1,5,53
-1,1450,1138,312,4,335,78
1,1454,1425,29,-1,97,87
-1,1657,1664,-7,4,89,114
-1,1473,1715,-242,-4,-434,108
1,1675,1692,-17,0,6,49
-1,1679,1595,84,0,-45,70
-1,1410,1719,-309,1,-42,82
1,1543,1583,-40,0,-10,71
-1,1329,1547,-218,-9,-409,82
-1,1812,1729,83,-2,-207,78
1,1948,1861,87,-1,-71,65
1,1315,1444,-129,1,95,79
1,1500,1785,-285,-8,-96,99
-1,1508,1520,-12,-1,-505,100
-1,1687,1825,-138,-1,-256,94
1,1277,1072,205,3,665,137
-1,1483,1597,-114,1,43,66
1,1609,1665,-56,1,86,69
1,1856,1680,176,1,23,49
-1,1843,1876,-33,-1,-171,83
-1,1519,1442,77,0,0,88
0,1853,1956,-103,-3,368,136
-1,1674,1880,-206,-1,-95,112
1,1607,1574,33,-1,-157,75
-1,1425,1744,-319,-2,-232,111
-1,1430,1354,76,0,-2,56
-1,1743,1741,2,-3,0,110
1,1470,1489,-19,-7,-122,53
-1,1176,1455,-279,-14,-915,72
1,1900,1668,232,0,141,73
-1,1738,2079,-341,-2,-105,60
0,1324,1675,-351,-4,-514,108
1,1879,1551,328,3,82,65
1,1387,1577,-190,-2,23,65
1,1316,1331,-15,0,48,51
-1,1500,1735,-235,-12,-182,46
1,1953,1856,97,-3,-40,47
1,1888,1304,584,9,110,41
1,1477,1663,-186,-2,-3,61
1,1748,1415,333,1,179,75
1,1498,1606,-108,-1,41,61
1,1706,2014,-308,0,42,103
-1,1802,1735,67,-1,-47,68
1,1646,1494,152,0,61,67
-1,1652,1600,52,0,16,62
-1,1331,1547,-216,-6,-104,48
1,1848,1961,-113,2,97,61
-1,1487,1653,-166,-3,-63,40
-1,1261,1320,-59,1,19,42
1,1740,1411,329,2,162,83
1,1587,1409,178,9,266,51
0,1655,1779,-124,-3,-94,61
-1,1659,1481,178,0,13,54
1,1889,1455,434,1,52,59
-1,1564,1778,-214,0,-101,80
1,1538,1201,337,2,4,63
0,1563,1664,-101,0,-122,105
-1,1497,1642,-145,-13,-315,54
1,1916,1752,164,0,68,69
1,1500,1405,95,2,72,55
1,1806,1202,604,5,546,79
0,1500,1695,-195,0,20,41
1,2188,1346,842,0,16,49
-1,1763,1770,-7,-1,-1,56
-1,1554,1470,84,1,30,54
-1,1630,1618,12,-2,-85,54
1,1533,1521,12,1,345,137
1,1425,1559,-134,-1,0,43
1,1705,1579,126,0,7,51
-1,1402,1653,-251,0,68,86
1,1676,1440,236,14,910,87
-1,1468,1565,-97,0,-413,132
0,1710,1690,20,1,115,120
1,1340,1541,-201,4,59,57
-1,1607,1786,-179,-1,-25,54
0,1652,1626,26,0,38,141
-1,1342,1348,-6,0,-57,62
-1,1116,1539,-423,-4,-56,44
-1,1828,1583,245,0,-34,60
-1,1528,1425,103,-1,-98,60
-1,1208,1595,-387,-5,-57,46
1,1788,1799,-11,4,149,63
1,2105,1876,229,0,8,85
1,1658,1398,260,2,291,81
1,1808,1601,207,3,12,47
-1,1494,1453,41,4,124,64
1,1359,1485,-126,-6,333,95
-1,1535,1684,-149,0,-19,92
-1,1393,1596,-203,4,109,48
1,1398,1367,31,-4,-103,59
1,1597,1557,40,-2,-9,91
-1,1333,1414,-81,1,7,81
1,1693,1681,12,0,11,81
1,1540,1550,-10,0,1,69
0,1571,1716,-145,0,141,132
1,1388,1524,-136,0,-49,93
1,1814,1601,213,9,660,87
-1,1857,1659,198,-10,-10,114
1,1320,1497,-177,0,202,99
1,1573,1543,30,0,-106,73
1,1627,1651,-24,5,69,45
1,1671,1869,-198,0,18,52
1,1688,1631,57,0,17,64
-1,1500,1582,-82,-5,-643,98
1,1597,1206,391,0,18,49
-1,1792,1601,191,0,100,74
-1,1529,1603,-74,-2,-5,98
-1,905,1298,-393,-2,-69,48
-1,1690,1709,-19,-1,-35,45
-1,1468,1375,93,-3,-37,44
1,1763,1659,104,3,307,103
-1,1602,1513,89,0,22,62
-1,1650,1664,-14,0,78,108
1,1709,1513,196,0,2,105
1,1509,1421,88,-6,-498,95
-1,1390,1452,-62,9,369,70
1,1629,1432,197,9,397,81
1,1799,1931,-132,0,118,69
-1,1809,1877,-68,-1,-116,144
1,1781,1711,70,1,103,63
1,1527,1434,93,1,13,59
-1,1720,1680,40,-2,-31,76
-1,1682,1652,30,-3,-55,56
-1,1412,1517,-105,-3,-289,92
-1,1441,1300,141,-4,-177,56
1,1387,1384,3,2,46,47
1,1457,901,556,3,222,69
1,1322,1469,-147,1,563,109
1,1463,1380,83,0,-183,93
-1,1743,1500,243,3,477,104
1,1525,1404,121,0,-8,83
1,1460,1203,257,0,291,66
-1,1635,1801,-166,0,181,96
-1,1710,1575,135,-1,4,70
-1,1782,1952,-170,-1,-129,132
1,1533,1480,53,-3,-49,85
-1,1613,1520,93,0,9,52
-1,1396,1533,-137,-8,-478,118
-1,1692,1708,-16,2,87,90
1,1691,1518,173,1,190,91
1,1681,1731,-50,1,555,135
-1,1371,1472,-101,2,50,96
-1,1434,1574,-140,1,7,82
1,1453,1339,114,-2,11,63
1,1277,1435,-158,0,330,105
-1,1539,1389,150,-2,-111,78
1,1348,1599,-251,0,98,76
1,1675,1639,36,0,-18,53
0,1331,1461,-130,0,259,149
1,1567,1440,127,1,-7,53
-1,1715,1862,-147,0,-117,140
-1,1562,1567,-5,-5,-478,96
1,1485,1317,168,11,455,71
-1,1534,1598,-64,-6,416,128
-1,1767,1926,-159,0,-31,66
-1,1405,1524,-119,-1,231,82
1,1751,1765,-14,0,-71,73
1,1629,1632,-3,-3,83,85
1,1481,1363,118,-2,-56,49
-1,1599,1607,-8,-2,-180,70
-1,1876,1792,84,1,-75,112
1,1813,1776,37,0,27,75
1,1485,1375,110,1,27,47
-1,1531,1397,134,-3,-353,84
1,1589,1361,228,8,278,45
1,1434,1392,42,-2,-70,61
-1,1355,1489,-134,-2,-59,60
1,1699,1583,116,0,9,50
-1,1492,1640,-148,-2,-205,180
-1,1457,1335,122,-3,-309,104
1,1975,1738,237,-2,458,99
-1,1413,1516,-103,-1,0,48
-1,1808,1862,-54,2,30,54
0,1310,1491,-181,3,-127,164
-1,1187,1471,-284,-14,-408,56
-1,1620,1639,-19,0,-15,78
1,1524,1405,119,11,427,63
1,1497,1347,150,-4,-46,85
1,1379,1546,-167,7,106,43
1,1845,1752,93,0,61,99
1,1787,1881,-94,4,59,47
1,1752,1416,336,1,24,51
-1,1397,1532,-135,-10,-149,96
-1,1124,1545,-421,1,-17,72
-1,1630,1845,-215,0,-2,52
1,1474,1130,344,4,153,69
-1,1660,1608,52,1,39,49
1,1762,1860,-98,0,7,99
-1,1539,1579,-40,-2,-27,66
1,1539,1390,149,0,83,79
-1,1551,1740,-189,-3,-66,84
-1,1381,1198,183,4,86,92
-1,1854,1625,229,3,212,64
-1,1685,1761,-76,0,3,47
1,1383,1545,-162,10,1209,99
1,1834,1172,662,13,404,53
-1,1584,1711,-127,4,76,68
1,1649,1506,143,-4,-98,77
1,1393,1387,6,2,18,44
-1,1307,1474,-167,-6,-542,84
1,1704,1490,214,0,59,81
-1,1799,1687,112,-1,-163,104
-1,1689,1591,98,0,144,140
1,1822,1755,67,0,6,45
-1,1530,1399,131,-1,26,58
1,1472,1464,8,0,134,111
-1,1486,1316,170,-4,-797,132
1,1708,1900,-192,0,35,63
-1,1645,1500,145,1,19,44
1,1775,1726,49,7,207,55
-1,1746,1749,-3,0,3,66
-1,1547,1609,-62,-2,-933,128
-1,1654,1637,17,-3,-212,80
-1,1656,1777,-121,-1,-145,96
1,1747,1545,202,4,23,153
1,1980,1903,77,-1,-3,57
1,1670,1342,328,0,-53,89
1,1679,1752,-73,-2,-56,57
-1,1501,1429,72,2,79,68
1,1644,1449,195,0,51,59
1,1415,1515,-100,2,143,51
1,1575,1710,-135,2,74,58
1,1798,1872,-74,-5,47,105
1,1647,1499,148,7,297,61
1,1485,1477,8,7,131,51
-1,1218,1154,64,-8,-292,60
1,1823,1643,180,1,12,49
-1,1672,1649,23,-3,-174,74
1,1897,1852,45,-2,-7,53
-1,1426,1533,-107,-2,-51,52
1,1784,1877,-93,-1,-68,89
1,1442,1488,-46,2,6,51
1,1832,1959,-127,0,-82,119
-1,1579,1843,-264,-2,-91,54
-1,1618,1503,115,-2,-565,134
-1,1300,1216,84,-6,-116,54
1,1659,1755,-96,-1,-6,87
1,1600,1784,-184,1,-3,51
-1,1496,1702,-206,0,4,54
1,1661,1575,86,4,523,97
-1,1647,1584,63,0,145,124
-1,1413,1510,-97,-3,-531,134
1,1836,1584,252,2,140,59
-1,1818,1649,169,-5,10,122
1,1475,1455,20,6,242,71
-1,1448,1416,32,4,-23,62
-1,1488,1439,49,-2,-88,48
-1,1664,1684,-20,0,-562,106
1,1723,1759,-36,2,176,67
-1,1674,1566,108,1,-173,110
1,1768,1616,152,-1,-40,65
1,1547,1117,430,-2,194,61
-1,1444,1485,-41,0,-80,72
-1,1539,1603,-64,0,91,88
-1,1280,1541,-261,-8,-86,42
1,1739,1741,-2,-2,54,83
1,1367,1488,-121,-4,-112,59
1,1580,1554,26,12,362,49
1,1724,1443,281,-1,118,127
-1,1669,1745,-76,0,-51,51
1,1659,1581,78,-3,-21,67
-1,1334,1470,-136,-5,-345,144
-1,1495,1435,60,-6,-150,62
-1,1586,1852,-266,1,5,66
0,1490,1500,-10,-5,71,121
-1,1340,1533,-193,0,-11,58
1,1668,1572,96,5,272,75
1,1612,1518,94,1,17,61
-1,1663,1500,163,-1,-4,56
-1,1448,1482,-34,3,132,50
0,1479,1710,-231,0,119,120
-1,1428,1390,38,-1,-35,72
1,1859,1582,277,-2,167,97
1,1677,1564,113,1,378,75
-1,1649,1753,-104,-2,-62,66
1,1492,1438,54,7,478,61
1,1607,1644,-37,0,174,65
1,1650,1621,29,3,72,49
0,1309,1239,70,1,-201,78
-1,1540,1550,-10,0,-374,86
-1,1776,1654,122,0,74,126
-1,1684,1556,128,4,69,60
-1,1578,1865,-287,-2,-64,120
1,1428,1501,-73,0,19,55
0,1543,1591,-48,1,131,104
1,1657,1757,-100,0,68,95
1,1669,1571,98,-4,30,69
1,1797,1707,90,3,635,99
1,1494,1503,-9,7,51,45
1,1488,1442,46,4,671,121
-1,1143,1224,-81,-3,-75,48
1,1677,1563,114,0,234,73
1,1778,1542,236,-3,7,49
-1,1492,1505,-13,1,214,62
1,1665,1603,62,0,20,109
-1,1432,1498,-66,-4,-314,76
1,1687,1702,-15,1,237,95
-1,1685,1555,130,1,-362,88
0,1660,1784,-124,0,63,130
-1,1529,1634,-105,-7,-300,62
-1,1474,1500,-26,1,-42,110
0,1704,1601,103,0,57,127
1,1595,1662,-67,0,159,85
-1,1491,1372,119,0,-59,76
1,1391,1673,-282,1,228,93
1,1506,1423,83,-1,-9,65
-1,1479,1570,-91,2,127,78
-1,1110,1549,-439,-1,-259,82
1,1442,1416,26,5,51,41
1,1750,1748,2,1,120,107
1,1736,1229,507,8,162,48
-1,1654,1554,100,3,180,90
1,1608,1440,168,0,18,55
-1,1648,1609,39,-4,-81,70
1,1600,1418,182,5,418,89
1,1544,1500,44,2,102,60
1,1415,1515,-100,0,171,73
1,1805,1830,-25,0,-137,87
-1,1523,1673,-150,1,64,126
-1,1471,1579,-108,0,10,62
-1,1360,1470,-110,-3,-148,66
1,1622,1635,-13,1,207,77
-1,1422,1370,52,0,-3,44
1,1568,1635,-67,0,106,117
1,1501,1429,72,-2,-55,65
1,1677,1659,18,6,270,62
-1,1495,1550,-55,0,-431,136
1,1703,1493,210,-3,54,101
-1,1653,1889,-236,0,5,50
-1,1516,1755,-239,-2,-196,82
1,1521,1296,225,2,150,77
-1,1617,1586,31,-1,-9,48
1,1530,1454,76,-2,95,77
-1,1658,1771,-113,0,19,72
1,1871,1670,201,0,238,81
0,1459,1465,-6,1,250,102
1,1623,1634,-11,0,115,61
1,1466,1262,204,4,64,67
1,1420,1510,-90,0,40,69
-1,1656,1560,96,-1,-136,58
1,1728,1642,86,-2,41,87
1,1617,1598,19,-1,159,81
-1,1664,1879,-215,-1,-178,100
1,1476,1406,70,0,209,117
1,1496,1434,62,-5,18,80
-1,1459,1531,-72,0,-68,98
1,1432,1615,-183,-3,-151,105
-1,1726,1612,114,-9,-271,58
1,1634,1588,46,2,62,65
-1,1443,1408,35,1,13,78
-1,1449,1530,-81,-10,-258,44
1,1649,1893,-244,-6,-40,59
-1,1425,1505,-80,6,521,100
1,1783,1540,243,7,207,47
1,1672,1464,208,10,379,53
1,1500,1500,0,6,264,67
-1,1644,1579,65,-4,-41,40
-1,1429,1650,-221,1,-16,72
-1,1737,1571,166,-1,-22,56
1,1513,1416,97,1,5,83
-1,1631,1582,49,1,22,54
1,1544,1477,67,16,668,63
1,1630,1591,39,-1,-48,73
-1,1649,1633,16,-14,-146,42
-1,1666,1585,81,0,-302,104
-1,1640,1582,58,-7,-276,58
1,1408,1521,-113,-1,-11,57
0,1306,939,367,-2,801,95
-1,1683,1453,230,2,248,84
-1,1761,1722,39,0,-35,80
1,1563,1404,159,3,37,50
1,1664,1458,206,1,128,67
0,1314,1450,-136,0,55,106
1,1662,1623,39,1,216,97
1,1466,1500,-34,3,258,95
-1,1507,1422,85,-2,19,66
1,1535,1604,-69,0,78,79
-1,1597,1881,-284,3,15,42
-1,1518,1490,28,-3,-148,76
-1,1482,1709,-227,2,61,66
1,1582,1524,58,-3,-350,164
-1,1436,1494,-58,0,23,62
-1,1472,1532,-60,2,48,66
1,1526,1397,129,-1,-134,85
0,1404,1760,-356,0,18,85
-1,1573,1552,21,0,13,55
1,1730,1641,89,-6,-88,45
-1,1175,1380,-205,-4,-327,170
1,1810,1337,473,-1,456,121
-1,1398,1249,149,-3,-127,62
-1,1503,1427,76,3,17,94
1,1695,1662,33,-1,422,115
1,1570,1619,-49,0,8,41
-1,1548,1634,-86,-4,6,42
1,1747,1599,148,4,475,69
-1,1745,1819,-74,0,-57,66
1,1885,1593,292,0,-9,65
1,1637,1846,-209,1,87,69
1,1573,1504,69,0,91,109
0,1379,1481,-102,-1,3,115
1,1440,1490,-50,2,105,61
1,1540,1583,-43,-2,-135,65
-1,1789,1670,119,-4,-211,92
1,1489,1516,-27,3,262,93
-1,1459,1640,-181,2,87,88
1,1754,1743,11,0,36,147
1,1478,1452,26,-3,85,73
-1,1788,1576,212,-4,-466,98
-1,1405,1425,-20,0,-475,188
-1,1426,1364,62,3,301,102
1,1750,1413,337,0,189,73
1,1627,1592,35,-1,-28,63
-1,1442,1488,-46,1,470,82
-1,1389,1533,-144,-3,-224,64
-1,1589,1888,-299,0,4,68
1,1431,1384,47,3,575,129
1,1637,1582,55,-3,280,79
-1,1699,1691,8,-1,3,41
1,1525,1471,54,-3,-57,41
1,1497,1433,64,-2,-676,87
-1,1538,1617,-79,2,450,110
1,1721,1688,33,4,190,71
-1,1564,1542,22,2,-342,92
-1,1748,1574,174,-1,-170,92
-1,1009,1383,-374,-1,-152,84
-1,1424,1506,-82,-4,135,68
-1,1474,1278,196,1,40,42
1,1485,1604,-119,0,45,45
1,1619,1565,54,1,576,105
-1,1294,1295,-1,-5,-369,126
-1,1514,1416,98,-10,-472,72
-1,1587,1389,198,-1,-32,40
-1,1429,1500,-71,0,-70,62
1,1608,1610,-2,2,118,61
1,1745,1380,365,2,156,83
1,1632,1708,-76,1,-42,67
1,1509,1421,88,6,142,55
-1,1389,1369,20,-1,-24,54
1,1247,1021,226,11,348,61
1,1540,1308,232,4,94,57
-1,1922,1838,84,0,-3,44
1,1412,1550,-138,-1,-14,45
-1,1775,1812,-37,0,-336,118
1,1643,1734,-91,0,57,91
1,1413,1517,-104,-10,-62,61
1,1629,1754,-125,0,0,89
1,1499,1322,177,7,137,41
1,1571,1552,19,1,225,75
-1,1756,1532,224,2,22,52
-1,1387,1328,59,-2,-603,132
1,1377,1436,-59,0,14,65
1,1418,1288,130,1,42,55
1,1639,1585,54,1,38,67
1,1951,1555,396,-3,8,53
1,1620,1619,1,1,108,67
1,1503,1426,77,1,30,63
-1,1625,1574,51,0,-47,71
1,1505,1415,90,2,486,145
1,1657,1720,-63,-1,7,79
1,1732,1753,-21,0,-97,99
-1,1702,1735,-33,-6,-420,110
1,1339,1376,-37,4,243,65
-1,1464,1616,-152,-2,-293,109
-1,1418,1512,-94,-2,12,58
-1,1669,1892,-223,-1,30,102
-1,1651,1453,198,-1,-157,76
1,1352,1387,-35,-1,-231,79
1,1612,1761,-149,-2,45,55
1,2016,1595,421,-1,-3,67
1,1466,1359,107,7,257,84
1,1481,1399,82,-1,139,77
-1,1519,1410,109,-6,-672,118
-1,1670,1707,-37,-1,-86,52
-1,1745,1628,117,0,138,90
1,1660,2018,-358,-1,282,83
1,1424,1506,-82,-1,171,101
1,1363,1231,132,1,12,43
-1,1746,1459,287,-15,-185,62
-1,1570,1767,-197,-2,-21,56
-1,1459,1384,75,-1,-10,52
1,1590,1644,-54,3,54,43
1,1707,1742,-35,0,95,81
-1,1493,1437,56,-9,-359,78
1,1632,1645,-13,1,147,129
1,1672,1590,82,2,172,80
1,1998,1679,319,1,109,97
-1,1452,1437,15,-3,-110,98
1,1541,1595,-54,-1,-95,53
-1,1587,1956,-369,1,-41,110
1,1462,1545,-83,0,-20,41
1,1500,1447,53,1,51,59
1,1705,1500,205,1,45,41
1,1449,1480,-31,-3,118,75
1,1852,1902,-50,-1,-154,99
-1,1398,1239,159,-4,-262,68
1,1530,1477,53,1,96,49
-1,1371,1770,-399,-1,-33,60
-1,1354,1659,-305,1,26,68
1,1623,1467,156,-1,11,49
1,1469,1461,8,7,-37,75
-1,1676,2001,-325,0,-317,156
-1,1460,1630,-170,-2,-858,92
1,1631,1588,43,-1,1,65
1,1296,1759,-463,-2,8,53
-1,1364,1280,84,-5,-300,78
-1,1701,1645,56,0,17,50
-1,1451,1479,-28,4,44,64
0,1854,1930,-76,0,-10,91
-1,1005,1514,-509,-16,-736,70
-1,1727,1677,50,0,64,80
1,1659,1688,-29,1,199,93
1,1712,1368,344,6,72,41
-1,1332,1382,-50,3,128,60
-1,1489,1441,48,0,-82,78
-1,1514,1745,-231,-1,-138,90
-1,1676,1738,-62,-7,-289,53
1,2005,1673,332,0,6,65
-1,1664,1703,-39,0,15,62
1,1448,1466,-18,0,-11,41
-1,1650,1407,243,-6,-246,62
-1,1676,1704,-28,-6,-418,90
1,1567,1554,13,-1,61,85
-1,1453,1477,-24,-4,-409,82
1,1703,1636,67,-1,461,125
1,1530,1787,-257,-5,983,167
-1,1594,1645,-51,1,-10,48
0,1670,2008,-338,0,-89,149
0,1525,1562,-37,2,-352,112
1,1606,1500,106,-3,418,132
1,1672,1593,79,-3,148,75
1,1392,1490,-98,1,126,59
0,1564,1646,-82,2,33,142
1,1714,1665,49,5,536,85
1,1799,1627,172,2,249,95
-1,1712,1748,-36,-1,-41,50
-1,1455,1475,-20,1,120,96
1,1485,1445,40,0,215,115
-1,1471,1441,30,2,68,64
-1,1745,1822,-77,-1,-67,70
0,1692,1715,-23,-2,-201,89
1,1621,1806,-185,-4,-390,101
1,1561,1527,34,0,-2,51
1,1459,1585,-126,5,300,111
-1,1655,1724,-69,0,-401,146
-1,1577,1959,-382,0,-111,100
-1,1923,1857,66,0,-30,56
-1,1679,1758,-79,-12,-528,66
1,1666,1800,-134,3,124,63
1,1702,1670,32,1,423,115
1,1999,1681,318,2,92,51
1,1460,1564,-104,-12,-878,107
1,1544,1407,137,9,266,65
-1,1372,1441,-69,0,-32,42
-1,1436,1494,-58,-1,-759,106
1,1962,1575,387,1,-205,145
1,1865,1692,173,-3,-2,65
1,1460,1434,26,12,802,73
1,1788,1638,150,8,179,57
-1,1770,2002,-232,-9,-256,106
-1,1351,1453,-102,-2,-108,62
-1,1767,1670,97,2,12,60
-1,1516,1571,-55,-8,-437,84
-1,1631,1795,-164,4,15,40
-1,1381,1516,-135,-1,-97,55
1,1732,1646,86,0,-4,95
-1,1104,1772,-668,-11,-300,52
1,1471,1331,140,5,70,43
-1,1802,1624,178,0,-44,76
1,1654,1558,96,4,169,59
-1,1478,1718,-240,-1,-96,66
1,1641,1426,215,0,7,51
-1,1558,1732,-174,-1,-43,52
1,1400,1557,-157,0,78,61
1,1660,1552,108,-1,-32,61
1,1684,1723,-39,5,162,61
1,1641,1785,-144,0,124,67
1,1580,1505,75,2,321,95
1,1426,1303,123,12,310,45
-1,1734,1730,4,-1,-48,50
-1,1637,1741,-104,-9,-840,96
1,1768,1657,111,-6,-335,87
-1,1467,1666,-199,-1,-69,76
1,1871,1801,70,0,26,81
-1,1572,1965,-393,-2,-109,90
-1,1500,1572,-72,-16,-317,51
1,1457,1452,5,6,349,69
1,1710,1697,13,4,533,109
-1,1544,1528,16,-5,-81,44
-1,1554,1673,-119,1,-76,90
1,1854,1830,24,10,389,67
-1,1705,2095,-390,-1,-122,84
-1,1568,1669,-101,-14,-331,58
-1,1685,1891,-206,-7,-358,100
1,1604,1523,81,0,90,65
1,1714,1599,115,4,69,47
-1,1862,1850,12,-2,-107,79
-1,1539,1646,-107,2,265,88
1,1570,1510,60,5,152,45
0,1817,1771,46,-2,-249,139
-1,1703,2098,-395,-3,-109,56
1,1737,1302,435,2,99,59
-1,1667,1285,382,-5,-55,128
-1,1808,1772,36,-3,-63,134
-1,1917,1913,4,-2,-101,56
-1,1121,1375,-254,-7,-87,58
1,1762,1557,205,-1,60,69
1,1534,1526,8,0,587,95
1,1451,1636,-185,2,140,75
1,1585,1722,-137,-4,69,69
1,1500,1701,-201,1,53,71
1,1804,1690,114,-2,-285,107
-1,1221,2189,-968,-3,-157,68
1,1607,1432,175,-3,-33,50
0,1909,2058,-149,0,207,137
-1,1466,1372,94,-4,-743,198
1,1861,1850,11,4,114,61
1,1896,1682,214,6,72,41
-1,1621,1531,90,0,-307,136
1,1772,1739,33,-1,-45,77
1,1371,1062,309,9,228,49
1,1706,1612,94,5,218,87
1,1851,1608,243,-2,130,129
-1,1654,1658,-4,0,-456,92
-1,1502,1686,-184,1,-160,90
1,1379,1310,69,4,163,57
1,1980,1680,300,-2,-114,53
-1,1452,1458,-6,-3,-364,106
1,1458,1361,97,-1,90,129
1,1502,1306,196,-1,-240,145
1,1552,1345,207,3,404,83
-1,1673,2119,-446,-1,85,102
-1,1575,1662,-87,-8,-114,48
1,1521,1337,184,1,118,77
1,1558,1607,-49,-2,83,99
0,2005,1676,329,-12,-1225,111
1,1871,1803,68,0,31,111
-1,1394,1420,-26,6,195,68
1,1606,1617,-11,9,405,65
0,1676,1521,155,-6,-104,219
-1,1606,1874,-268,0,-18,89
1,1661,1671,-10,-4,-44,107
1,2121,1837,284,0,-14,67
1,1632,1469,163,0,58,61
-1,1642,1714,-72,-7,-215,60
-1,1953,1683,270,0,83,76
1,1633,1459,174,-1,-19,53
-1,1219,1674,-455,-7,-122,50
-1,1546,1658,-112,-4,-115,46
-1,1689,1785,-96,-2,-160,84
-1,1447,1772,-325,-10,-294,50
-1,1797,1840,-43,-5,9,102
1,1642,1395,247,-9,-125,43
-1,1958,1801,157,-1,5,70
-1,1297,1557,-260,1,-45,78
-1,1674,1700,-26,-3,-124,52
1,1594,1354,240,5,164,43
0,1847,2125,-278,-3,-455,86
1,1606,1618,-12,5,67,43
-1,1250,1832,-582,-4,-79,50
1,1633,1526,107,-1,-4,43
-1,1666,1711,-45,0,-69,82
-1,1518,1420,98,-3,-84,88
1,1912,2071,-159,-1,122,79
1,1598,1593,5,0,33,101
-1,1352,1344,8,-12,-139,42
1,1483,1349,134,-4,-388,87
1,1527,1502,25,-1,156,65
-1,1599,1662,-63,2,-57,102
-1,1833,1886,-53,3,253,72
-1,1288,1527,-239,-3,-296,78
-1,1559,1333,226,6,115,40
1,1721,1656,65,0,1,65
-1,1604,1855,-251,-1,-190,108
1,1454,1254,200,4,194,67
-1,1471,1270,201,0,45,72
1,1819,1816,3,0,67,93
1,1606,1617,-11,0,-7,49
1,1489,1476,13,0,115,59
1,1139,1293,-154,3,81,89
-1,1464,1897,-433,-5,-55,42
1,1646,1928,-282,1,355,101
-1,1730,1821,-91,0,-52,82
-1,1676,1205,471,1,-18,54
-1,1290,1590,-300,-4,75,68
1,1915,1447,468,4,216,55
-1,1445,1535,-90,-1,7,58
-1,1500,1647,-147,-1,-161,70
1,1542,1390,152,-1,0,85
1,1590,1535,55,-11,-319,57
1,1681,1641,40,0,176,69
1,1751,1356,395,6,456,104
1,1634,1519,115,0,55,85
1,1850,1722,128,1,6,67
-1,1606,1618,-12,-4,-176,56
1,1549,1727,-178,-3,80,119
-1,1478,1599,-121,8,207,62
1,1727,1756,-29,-4,-25,57
-1,1283,1491,-208,-2,-911,126
1,1672,1539,133,8,438,67
-1,1568,1422,146,0,33,100
1,1805,1830,-25,-2,-110,67
1,1653,1385,268,-1,-131,91
-1,1412,1481,-69,-1,91,74
1,1843,1247,596,5,267,81
-1,1658,1663,-5,0,-117,98
-1,1798,1510,288,-9,-2073,126
-1,1282,1917,-635,-7,-583,84
-1,1606,1680,-74,5,329,68
-1,1822,1730,92,-5,-252,52
1,1595,1705,-110,3,180,65
-1,1572,1719,-147,-4,-65,124
-1,1356,1453,-97,0,-257,108
1,1629,1596,33,-9,-214,65
-1,1358,1567,-209,1,-72,76
1,1546,1589,-43,-1,-23,47
1,1682,1832,-150,1,347,123
1,1899,1462,437,3,215,72
1,1459,1631,-172,4,838,111
1,1691,1794,-103,0,191,111
1,1641,1273,368,16,637,59
0,1743,1837,-94,-4,-427,124
-1,1511,1641,-130,-1,43,72
1,1461,1513,-52,0,45,83
1,1690,1527,163,0,7,49
-1,1568,1599,-31,1,-32,62
1,1410,1408,2,9,353,61
1,1699,1811,-112,0,318,125
-1,1674,1647,27,1,17,64
1,1739,1500,239,0,35,49
-1,1472,1492,-20,0,-32,84
1,1556,1501,55,5,527,69
1,1532,1281,251,0,126,91
1,1662,1571,91,12,296,55
1,1597,1500,97,2,163,77
-1,1584,1825,-241,1,52,78
-1,1196,1571,-375,2,140,64
1,1607,1526,81,1,187,127
-1,1746,1520,226,1,32,54
1,1697,1653,44,1,81,61
1,1792,1715,77,2,182,81
1,1321,1454,-133,6,87,49
1,1659,1662,-3,5,235,91
-1,1307,1462,-155,-8,-552,84
1,1734,1705,29,0,53,101
1,1352,1466,-114,3,242,137
1,1636,1540,96,8,140,43
-1,1566,1710,-144,-1,-78,54
-1,1413,1743,-330,-4,-109,54
-1,1449,1615,-166,-4,-22,40
1,1574,1173,401,1,5,41
1,1544,1408,136,-3,-47,61
1,1550,1382,168,3,35,47
1,1694,1531,163,1,15,45
-1,1500,1500,0,-7,-282,78
1,1648,1504,144,0,-2,53
0,1720,1700,20,-2,-147,202
1,1706,1580,126,0,-5,63
-1,1562,1671,-109,-4,-439,128
1,1337,1228,109,-8,-48,45
1,1499,1402,97,6,453,74
1,1610,1559,51,-6,-2,49
1,1650,1670,-20,-1,-2,143
1,1900,1805,95,-3,83,95
-1,1621,1443,178,-5,-436,92
-1,1442,1686,-244,-5,-261,66
-1,1603,1524,79,-1,-26,46
1,1222,1285,-63,-1,-75,47
1,1497,1654,-157,-6,-178,43
-1,1491,1754,-263,0,-98,114
-1,1516,1644,-128,-1,-81,60
-1,1203,1379,-176,-9,-201,52
1,1968,1782,186,2,58,75
0,1747,1368,379,1,389,118
1,1589,1539,50,1,190,87
-1,1276,1557,-281,-7,-178,52
-1,1499,1517,-18,-1,30,84
1,1500,1316,184,3,129,60
-1,1795,1701,94,0,26,66
-1,1199,1363,-164,17,331,52
-1,1717,1657,60,-5,-158,70
-1,1910,1528,382,2,275,92
-1,1565,1726,-161,0,-132,102
-1,1716,1777,-61,0,-12,108
1,1456,1420,36,2,62,77
1,1729,1559,170,-2,-79,119
-1,1435,1573,-138,-3,-96,70
-1,1528,1551,-23,-12,-176,52
-1,1477,1544,-67,-5,-155,60
1,1549,1691,-142,1,50,73
-1,1450,1619,-169,-3,-236,102
-1,1539,1662,-123,1,142,108
0,1518,1536,-18,1,-27,105
1,1658,1662,-4,0,-66,81
-1,1405,1785,-380,-2,-90,70
1,1841,1278,563,6,562,79
-1,1706,1789,-83,-1,-543,146
-1,1500,1758,-258,-5,-459,80
1,1509,1609,-100,-2,-75,61
-1,1714,1779,-65,-5,-108,54
-1,1263,1311,-48,1,-541,124
-1,1575,1500,75,-12,-137,62
-1,1886,1573,313,2,236,80
0,1395,1515,-120,2,214,110
1,1507,1719,-212,-3,-33,43
1,1552,1735,-183,2,183,71
1,1525,1420,105,3,81,41
-1,1329,1394,-65,-6,1,40
1,1637,1347,290,18,171,41
1,1580,1428,152,4,355,133
-1,1521,1704,-183,-1,-13,72
1,1444,1613,-169,0,196,85
-1,1540,1731,-191,1,52,60
1,1400,1418,-18,0,83,71
-1,1351,1461,-110,3,83,56
1,1867,1589,278,2,112,67
-1,1718,1569,149,-6,-149,76
1,1550,1567,-17,-2,21,68
1,1665,1107,558,3,315,77
-1,1701,1532,169,-3,13,40
1,1599,1710,-111,0,-9,83
-1,1788,1704,84,0,295,108
0,1620,1559,61,-1,-228,132
1,1684,1585,99,7,220,61
-1,1669,1781,-112,-2,-261,94
1,2189,1940,249,0,42,55
-1,1423,1450,-27,2,-91,72
-1,1163,1260,-97,-1,-1581,210
1,1552,1695,-143,0,41,49
1,1876,2106,-230,0,110,61
-1,1935,2196,-261,-4,-304,122
1,1703,1585,118,2,82,58
-1,1733,1558,175,-5,-84,50
-1,1291,1446,-155,-6,-255,60
-1,1700,1568,132,-2,-15,42
1,1474,1632,-158,0,27,65
-1,1787,1335,452,1,0,64
1,1786,1679,107,0,57,47
1,1684,1584,100,0,105,89
1,1641,1655,-14,3,418,93
1,1780,1832,-52,-2,246,121
1,2202,1931,271,-1,-24,45
1,1568,1671,-103,-1,-26,45
-1,1456,1904,-448,-10,-211,93
1,1898,1794,104,0,16,77
1,1656,1761,-105,-1,58,89
1,1583,1693,-110,-7,-613,85
1,1737,1535,202,1,555,131
-1,1495,1671,-176,1,4,62
1,1711,1577,134,0,61,99
1,1503,1417,86,0,737,113
-1,1393,1343,50,1,6,44
-1,1321,1542,-221,-6,-110,42
1,1789,1662,127,-1,0,41
1,1907,1575,332,-1,-58,43
1,1421,1492,-71,-1,-42,137
-1,1573,1629,-56,-5,-209,62
1,1622,1668,-46,0,-11,65
1,1740,1198,542,6,128,42
-1,1230,1495,-265,-1,-143,78
1,1626,1444,182,1,14,71
-1,1829,1526,303,0,69,104
1,1911,1805,106,-1,-125,107
-1,1654,1796,-142,1,32,78
-1,1615,1657,-42,0,-581,102
1,1452,1369,83,-3,-14,47
-1,1383,1460,-77,0,-7,54
1,1386,1548,-162,-1,257,109
-1,1575,1716,-141,0,-374,133
-1,1396,1518,-122,0,-8,130
-1,1718,1872,-154,-3,-199,72
1,1718,1566,152,-5,-43,55
1,1742,1489,253,0,164,133
-1,1570,1718,-148,-2,-38,54
1,1410,1193,217,4,116,51
-1,1921,2118,-197,1,85,74
-1,1284,1260,24,-9,-118,53
1,1797,1667,130,1,57,93
1,1766,1678,88,-1,803,135
1,1617,1747,-130,0,-8,47
1,1639,1562,77,-1,30,89
1,1591,1812,-221,6,50,53
-1,1926,2124,-198,-14,-73,40
1,1708,1567,141,7,264,55
-1,1660,1804,-144,0,-26,66
1,2131,1920,211,1,133,73
1,1530,1716,-186,-1,37,89
-1,1563,1587,-24,0,-11,62
-1,1733,1559,174,0,-274,80
1,1434,1272,162,-5,-97,52
1,1284,1353,-69,0,117,85
1,1543,1453,90,0,-5,65
-1,1526,1422,104,-3,-511,110
-1,1915,2137,-222,0,-609,148
-1,1614,1653,-39,-1,-430,108
1,1273,1271,2,3,83,57
-1,1796,1647,149,0,-57,74
-1,1660,1746,-86,-1,-48,82
1,1548,1497,51,7,287,72
1,1679,1576,103,-3,-52,67
1,1476,1373,103,3,247,67
1,1526,1229,297,9,586,81
1,2020,1775,245,-5,137,127
1,1802,1719,83,4,41,43
-1,1343,1153,190,-7,-668,88
1,1704,1568,136,0,-50,41
1,1613,1555,58,0,-72,83
1,1811,1663,148,0,-5,55
1,1651,1604,47,-12,-278,101
1,1712,1529,183,-1,-39,69
1,1879,1794,85,0,-10,57
-1,2143,1909,234,-3,83,110
1,1644,1579,65,2,98,55
-1,1724,1560,164,-9,-43,40
-1,1398,1438,-40,-6,-708,96
0,1410,1434,-24,-1,-527,132
1,1694,1781,-87,-5,-158,65
1,1914,1656,258,1,47,69
1,1681,1577,104,0,7,45
1,1559,1631,-72,0,-57,77
-1,1800,1826,-26,2,8,86
1,1728,1793,-65,-1,-217,93
1,1594,1590,4,-2,165,105
-1,1583,1531,52,-2,-109,58
-1,1106,1586,-480,-1,-1624,180
-1,1919,2122,-203,-1,-366,78
1,1540,1662,-122,-1,45,117
-1,1479,1432,47,-7,2,44
-1,1652,1453,199,-1,-81,58
-1,1746,1734,12,-2,-16,88
1,1416,1447,-31,-3,243,117
1,1667,1610,57,-2,-97,61
-1,1710,1810,-100,-1,-28,66
-1,1785,1889,-104,2,112,60
-1,1481,1513,-32,-10,-180,52
1,1723,1568,155,-1,109,95
1,1768,1733,35,1,190,95
1,1706,1592,114,0,56,57
1,1906,1454,452,0,86,57
1,1298,1521,-223,5,134,61
-1,1721,1584,137,-8,-349,62
-1,1605,1635,-30,-2,-27,48
1,1565,1222,343,2,150,69
-1,1618,1573,45,2,76,76
-1,1293,1449,-156,0,-5,40
1,1327,1154,173,0,237,63
1,1495,1421,74,-4,-42,69
-1,1585,1530,55,-3,-192,68
1,1594,1524,70,-3,-93,43
-1,1837,1660,177,1,-101,90
-1,1822,2129,-307,-1,31,94
-1,1718,1500,218,2,26,76
1,1323,972,351,6,186,43
1,1500,1669,-169,2,828,101
-1,1541,1456,85,1,-203,106
-1,1604,1928,-324,0,-132,74
-1,1326,1500,-174,-8,-243,56
1,1824,1371,453,2,73,57
1,1897,1778,119,-2,3,51
1,1727,1544,183,1,222,93
-1,1932,1611,321,2,-699,126
1,1601,1655,-54,-9,-80,45
-1,1570,1810,-240,0,-20,100
-1,1445,1539,-94,-5,-78,108
-1,1933,1842,91,-1,-252,94
-1,1500,1745,-245,-10,-380,64
1,2133,1818,315,2,85,45
-1,1614,1641,-27,0,-80,66
-1,1818,2133,-315,-1,-16,46
1,1775,1861,-86,0,147,79
1,1603,1295,308,1,37,143
1,1874,1629,245,1,645,199
1,1376,1530,-154,-1,102,83
-1,1630,1911,-281,0,-15,112
-1,1471,1578,-107,-6,-113,52
1,1978,1771,207,9,211,57
-1,1906,1585,321,0,8,68
1,2136,1814,322,2,119,57
-1,1146,1369,-223,2,47,58
1,1603,1415,188,-7,-449,85
0,1859,1770,89,4,383,96
1,1646,1458,188,1,76,47
1,1915,1626,289,8,141,43
-1,1811,2140,-329,0,-19,65
-1,1605,1658,-53,0,45,86
-1,1712,1622,90,5,-211,90
-1,1429,1391,38,-2,-54,74
-1,1487,1524,-37,-1,-49,52
-1,1325,1530,-205,-2,25,42
1,2144,1807,337,1,102,73
1,1750,1511,239,6,126,79
1,1690,1417,273,8,157,47
1,1517,1478,39,0,136,78
-1,1765,1984,-219,-1,-141,64
-1,1707,1713,-6,-1,-287,144
-1,1463,1451,12,-4,-221,148
1,1547,1534,13,7,97,45
-1,1435,1606,-171,-3,-188,96
1,1717,1439,278,1,237,107
1,1740,1780,-40,0,-35,57
1,1568,1507,61,-5,-30,68
-1,1493,1723,-230,-6,-27,42
1,1734,1605,129,-9,-114,55
-1,1804,2147,-343,-2,-38,46
1,1884,1772,112,2,93,77
-1,1524,1558,-34,-13,-366,54
1,1637,1652,-15,0,21,54
-1,1564,1631,-67,-2,-79,56
-1,1439,1490,-51,-1,1,68
1,1919,1676,243,-8,-111,65
1,1382,1574,-192,4,128,77
-1,1471,1514,-43,-1,347,88
-1,1138,1708,-570,-1,-65,89
1,1660,1629,31,8,217,45
-1,1583,1683,-100,3,68,52
1,1606,1533,73,0,29,111
1,1913,1672,241,-2,113,53
1,1565,1535,30,1,33,97
-1,1448,1500,-52,0,36,56
1,2151,1924,227,1,17,51
-1,1765,1893,-128,0,-20,68
1,1320,1603,-283,7,297,63
1,1670,1619,51,-7,-291,49
1,1691,1575,116,-6,60,54
-1,1919,2157,-238,1,124,76
-1,1582,1586,-4,2,24,44
1,1788,1743,45,-3,41,91
1,1918,1667,251,0,52,65
-1,1567,1699,-132,0,24,70
1,1625,1500,125,9,383,53
1,1923,1663,260,3,272,75
-1,1832,1697,135,0,-110,102
1,1720,1769,-49,-1,-4,47
-1,1385,1598,-213,-16,-178,40
1,1909,2167,-258,-2,198,107
1,1928,1327,601,9,440,73
1,1551,1603,-52,0,-3,63
1,1571,1400,171,2,151,69
-1,1514,1411,103,-5,-141,54
1,1662,1779,-117,1,355,77
1,1706,1567,139,3,0,81
1,1648,1773,-125,0,51,73
-1,1651,1695,-44,0,-182,84
-1,2146,1929,217,2,332,102
1,1451,1488,-37,-2,-42,83
1,1756,1734,22,0,-9,67
-1,1500,1457,43,-6,-645,84
1,1525,1615,-90,2,213,105
-1,1659,1604,55,-2,-3,42
1,1334,1412,-78,4,69,41
1,1753,1797,-44,2,-18,63
-1,1780,1808,-28,0,-74,82
1,1857,1765,92,1,262,67
-1,1566,1616,-50,0,0,50
-1,1375,1525,-150,-11,-198,68
0,1497,1509,-12,0,21,113
1,1929,1469,460,4,298,101
1,1713,1532,181,5,814,79
-1,1576,1434,142,3,54,56
1,1407,1500,-93,1,47,77
1,1733,1484,249,3,132,63
1,1659,1525,134,-1,80,93
-1,1539,1654,-115,-10,-75,46
1,1922,1927,-5,1,10,43
-1,1476,1464,12,2,12,62
1,1621,1624,-3,1,22,43
-1,1766,1756,10,0,-73,106
1,1948,1626,322,2,168,49
1,1694,1455,239,-1,0,45
1,1909,1450,459,0,127,69
1,1500,1500,0,0,309,113
1,1931,1467,464,1,244,75
-1,1372,1459,-87,0,35,42
-1,1756,1937,-181,0,-174,171
1,2025,1476,549,5,275,77
1,1951,1623,328,1,62,59
-1,1349,1716,-367,-8,-106,46
1,1954,1620,334,5,109,47
1,1518,1667,-149,0,60,45
1,1321,1300,21,7,364,83
1,1443,1245,198,0,287,153
1,1251,1500,-249,3,61,55
-1,1443,1453,-10,-3,-241,92
1,1998,1833,165,0,449,123
-1,1452,1524,-72,-4,-375,98
1,1725,1757,-32,5,176,61
-1,1508,1424,84,-13,-232,40
-1,1778,1757,21,-4,-295,88
-1,1738,1963,-225,1,-35,90
-1,1768,1738,30,-1,-21,52
-1,1524,2024,-500,-3,-100,98
-1,1458,1266,192,-2,-63,54
1,1662,1751,-89,2,396,83
-1,1969,1940,29,-1,-26,48
-1,1515,1599,-84,-4,8,68
1,1875,1731,144,0,31,103
-1,1467,1408,59,-3,-45,48
-1,1751,1755,-4,-1,-78,70
-1,1392,1316,76,-3,-242,78
-1,1466,1642,-176,0,-70,60
1,1890,1727,163,0,-3,63
-1,1769,1766,3,-5,4,100
-1,1766,1739,27,0,66,88
1,1968,2004,-36,-2,32,69
1,1349,1448,-99,-1,-65,67
-1,1523,1362,161,1,-149,96
-1,1592,1506,86,-5,-196,118
0,1575,1537,38,-4,-593,94
-1,1038,1278,-240,-6,-521,112
-1,1951,1957,-6,5,240,104
0,1765,1740,25,1,15,40
1,1529,1504,25,2,42,49
-1,1721,1897,-176,0,-13,48
1,1741,1765,-24,6,523,75
-1,1470,1295,175,1,-127,122
-1,1733,1799,-66,0,-92,60
-1,1748,1877,-129,0,12,64
1,1981,1461,520,-1,-12,45
-1,1728,1622,106,-1,-353,90
1,1496,1408,88,3,204,65
-1,1753,1753,0,2,47,46
-1,1578,1842,-264,0,-99,126
-1,1500,1649,-149,-5,-40,40
1,1652,1686,-34,3,77,49
1,1764,1742,22,-1,-35,55
1,1760,1794,-34,0,162,91
1,1982,1893,89,9,432,67
1,2196,1895,301,5,76,41
1,1330,1539,-209,2,-166,83
-1,1731,1775,-44,0,-763,130
-1,1610,1525,85,1,17,67
1,1448,1566,-118,-3,15,87
-1,1294,1232,62,-4,-850,138
1,1902,1991,-89,0,38,75
1,1715,1715,0,4,44,49
1,1766,1787,-21,2,74,55
1,1788,1724,64,3,170,65
1,1396,1505,-109,-1,10,85
-1,1741,1704,37,-2,-219,118
1,1678,1585,93,-2,-34,91
1,1968,1941,27,-5,-176,117
-1,1537,1392,145,2,134,74
1,1501,1582,-81,-1,-12,67
-1,1296,1434,-138,-1,-729,156
-1,1553,1673,-120,-1,-199,74
-1,1931,1977,-46,2,-40,86
-1,1727,1715,12,0,-18,62
0,1575,1617,-42,-5,-254,163
1,1674,1664,10,3,128,65
1,1607,1506,101,3,155,75
-1,1987,1912,75,-2,-81,86
1,1329,1186,143,1,266,73
-1,1716,1729,-13,-2,-83,54
-1,1490,1417,73,0,-67,68
1,1312,1411,-99,-6,-5,69
-1,1531,1499,32,-14,-142,44
1,1729,1713,16,3,32,43
-1,2106,2209,-103,0,15,64
1,1589,1443,146,-2,5,97
1,1394,1361,33,-12,-293,57
1,1774,1795,-21,1,114,79
0,1304,1082,222,-4,-408,125
1,1511,1519,-8,3,225,58
1,1514,1529,-15,11,218,49
-1,1973,1891,82,-2,27,76
-1,1931,1978,-47,0,-21,96
-1,1569,1738,-169,-1,-110,128
-1,1904,1960,-56,-4,-46,44
1,1739,1993,-254,-1,10,51
1,1695,1546,149,-2,351,127
-1,1526,1400,126,2,92,58
-1,1484,1663,-179,0,11,58
1,1555,1179,376,9,630,75
1,1717,1587,130,1,30,59
-1,1736,2224,-488,-3,-269,88
1,1508,1522,-14,-1,194,78
-1,1640,1974,-334,0,-33,62
-1,2033,1969,64,-1,-434,96
1,1883,1383,500,5,322,93
-1,1422,1519,-97,0,13,60
-1,1757,1977,-220,-6,-58,54
-1,1453,1552,-99,0,6,54
-1,1737,1637,100,-6,-183,52
-1,1397,1583,-186,1,53,50
-1,1565,1596,-31,1,61,80
-1,1878,1937,-59,-3,-30,80
1,1983,1827,156,5,144,53
1,1526,1517,9,-2,366,97
1,1759,1624,135,-1,-24,127
-1,1396,1465,-69,1,9,92
-1,1820,1989,-169,-3,-666,100
-1,1416,1504,-88,-2,-155,82
-1,1574,1668,-94,2,39,48
-1,1903,1868,35,0,-267,86
1,1498,1654,-156,3,79,43
-1,1175,1435,-260,-14,-677,90
-1,1560,1440,120,1,-20,54
1,1810,1177,633,6,380,71
-1,1996,1814,182,3,11,62
-1,1560,1576,-16,1,34,58
1,1589,1577,12,4,296,69
-1,1722,1604,118,-2,-120,76
0,1535,1441,94,-1,-369,86
-1,1744,1562,182,0,-339,168
1,1517,1209,308,5,679,99
1,1526,1413,113,0,-1,43
-1,2226,1922,304,0,-163,110
1,1981,1882,99,0,703,117
1,1480,1179,301,7,239,47
-1,1370,1436,-66,-7,-485,78
-1,1534,1537,-3,0,-6,40
-1,1830,1888,-58,-6,-316,84
1,1391,1589,-198,0,216,119
1,1539,1712,-173,-2,31,61
0,1701,1771,-70,0,283,120
-1,1355,1476,-121,-4,-579,124
1,1904,1505,399,3,33,47
-1,1873,1989,-116,-8,-287,76
-1,1320,1632,-312,-1,3,50
1,1650,1710,-60,8,42,41
1,1996,1864,132,0,245,89
1,1547,1333,214,-1,21,45
1,1596,1651,-55,-3,-77,91
1,1537,1519,18,0,424,95
1,1405,1534,-129,3,206,106
1,1477,1386,91,-1,-19,43
1,1198,1520,-322,2,422,195
1,1562,1702,-140,1,47,67
1,1499,1455,44,-5,17,77
-1,1951,1907,44,-3,-109,48
1,1795,1574,221,-3,53,79
-1,1821,1899,-78,-3,-36,46
-1,1857,2003,-146,0,-173,70
1,1756,1507,249,2,94,73
-1,1940,2191,-251,-1,-46,78
-1,1680,1725,-45,-1,278,90
1,1636,1534,102,3,245,107
1,1409,1708,-299,-1,12,41
-1,1478,1521,-43,4,-22,96
1,2010,1849,161,3,118,69
-1,1596,1722,-126,0,-37,58
-1,1635,1787,-152,0,-37,78
1,1807,1457,350,4,76,45
1,1729,1588,141,5,139,51
-1,1672,1555,117,0,-40,60
-1,1842,2016,-174,-1,-99,74
1,1508,1547,-39,0,75,105
1,1300,1176,124,1,275,65
1,1891,1707,184,2,74,53
-1,1581,1736,-155,-3,-57,58
-1,1447,1920,-473,0,113,112
1,1582,1506,76,6,71,41
1,1579,1728,-149,6,253,69
1,1742,1574,168,15,1156,83
-1,1429,1687,-258,-2,-167,112
1,1291,1500,-209,6,195,79
-1,1544,1407,137,-15,-165,44
-1,1431,1348,83,-2,-21,52
-1,1611,1606,5,-5,-493,118
1,1832,1793,39,1,86,65
0,1150,1508,-358,-1,345,122
-1,1614,1421,193,0,-78,54
-1,1576,1861,-285,-2,-101,66
-1,1502,1385,117,0,-69,68
1,2199,1935,264,1,15,61
1,1688,1513,175,-2,86,117
-1,1749,1836,-87,-11,-245,50
-1,1502,1258,244,-2,-86,55
-1,1574,1489,85,2,76,48
1,1845,1740,105,-1,28,51
-1,1314,1761,-447,0,-65,68
1,1484,1546,-62,3,51,45
1,1922,1337,585,4,151,53
-1,1535,1520,15,2,-100,70
-1,1552,1617,-65,1,-65,74
1,1673,1689,-16,-2,-19,43
-1,1597,1863,-266,-7,-105,52
1,1632,1641,-9,2,256,97
1,1867,1571,296,1,-17,49
-1,1532,1438,94,0,-581,124
-1,1532,1524,8,0,-775,222
-1,1637,1835,-198,-1,-214,96
1,1292,1507,-215,-4,9,43
-1,1931,2206,-275,1,80,90
-1,1551,1871,-320,-1,-26,44
-1,1523,1591,-68,-1,-10,62
1,1507,1561,-54,-2,-170,91
-1,1589,1505,84,-1,-56,54
1,1598,1662,-64,2,51,55
1,1874,1534,340,3,26,41
1,1797,1672,125,-9,134,65
-1,1787,1753,34,-1,-31,50
1,1490,1313,177,5,123,45
-1,1302,1145,157,-4,-121,53
-1,1569,1622,-53,-6,-209,64
-1,1520,1878,-358,1,43,48
-1,1607,1655,-48,0,10,52
1,1847,1466,381,4,125,54
-1,1468,1782,-314,-2,-87,58
1,1881,1508,373,15,289,51
-1,1311,1617,-306,-1,12,40
1,1644,1531,113,4,163,55
1,1589,1507,82,8,341,95
-1,1451,1444,7,5,36,64
-1,1497,1884,-387,0,2,46
-1,2213,1927,286,0,-5,42
1,1886,1488,398,2,252,61
1,2181,1840,341,0,-56,61
1,1554,1591,-37,7,417,97
-1,1769,1703,66,0,-33,92
-1,1443,1780,-337,-4,-621,118
1,1597,1214,383,2,251,65
-1,1479,1889,-410,-3,-115,70
-1,1445,1449,-4,6,127,48
-1,1347,1505,-158,0,-4,44
1,1786,1465,321,-1,337,77
1,1891,1471,420,0,-23,51
-1,1113,1545,-432,-4,-138,57
1,1740,1719,21,1,26,43
-1,1488,1500,-12,1,-58,70
1,1624,1579,45,1,22,65
1,1625,1440,185,0,-1,57
-1,1773,1696,77,-3,47,82
-1,1464,1894,-430,-2,-121,68
1,1541,1978,-437,4,153,47
-1,1319,1500,-181,-15,-315,52
-1,1804,1979,-175,-1,-170,92
-1,1477,1669,-192,-1,-84,74
1,1562,1575,-13,2,51,103
1,1600,1512,88,0,729,143
1,1896,1457,439,-2,90,69
-1,1464,1647,-183,0,-119,56
1,1946,1629,317,2,69,53
1,1394,1182,212,7,276,51
-1,1527,1807,-280,-3,-128,54
1,1821,1706,115,0,176,65
1,1547,1111,436,2,567,149
-1,1462,1539,-77,0,-206,68
-1,1629,1755,-126,0,-3,50
-1,1335,1564,-229,-1,-210,126
-1,1601,1513,88,-3,-342,92
1,1451,1898,-447,-3,-72,49
1,1734,1390,344,1,419,85
-1,1655,1568,87,0,-235,142
1,1460,1429,31,7,152,49
1,1875,1523,352,0,78,63
1,1627,1412,215,-1,407,135
-1,1535,1839,-304,-3,-40,98
1,1708,1750,-42,0,78,119
1,1512,1489,23,0,114,67
1,1843,2186,-343,0,28,63
-1,1625,1949,-324,-1,-174,76
1,1462,1382,80,1,-14,55
1,1622,1592,30,0,-4,41
0,1500,1766,-266,2,921,152
1,1762,1504,258,-3,113,73
1,1622,1493,129,5,130,51
1,1884,1665,219,0,-5,43
1,1634,1584,50,4,49,45
1,1604,1314,290,-5,-96,49
1,1700,1595,105,3,289,97
1,1693,1640,53,5,531,96
1,1733,1204,529,1,138,79
1,1952,1622,330,2,111,73
1,1531,1372,159,0,196,73
-1,1776,1894,-118,0,400,110
-1,1593,1863,-270,0,-30,84
1,1617,1473,144,1,33,41
-1,1495,1366,129,-2,-86,60
-1,1306,1520,-214,6,452,70
1,1742,1202,540,11,579,63
1,1767,1484,283,0,62,109
1,1666,1556,110,3,196,71
-1,1478,1417,61,0,-9,62
1,1528,1506,22,5,-2,43
1,1625,1656,-31,0,353,111
0,1655,1912,-257,-1,856,107
1,1529,1500,29,0,311,95
-1,1109,1519,-410,-2,-80,66
0,1200,1751,-551,-2,325,114
1,1415,1470,-55,4,645,127
-1,1386,1365,21,0,161,82
-1,1344,1789,-445,-2,-254,92
1,2022,1812,210,0,9,45
-1,1476,1571,-95,-5,-821,92
-1,1481,1646,-165,4,13,82
-1,1904,1664,240,-1,-595,108
-1,1342,1346,-4,-3,-48,52
1,1751,1726,25,2,68,67
1,1685,1439,246,2,104,55
-1,1538,1634,-96,-1,-339,84
-1,1807,2027,-220,-1,-428,106
1,1595,1619,-24,-2,232,85
1,1503,1814,-311,0,213,95
1,1670,1213,457,12,314,57
1,1690,1883,-193,3,325,81
1,1602,1453,149,-3,-207,87
-1,1716,1762,-46,1,16,52
1,1718,1845,-127,-4,9,61
1,2032,1802,230,1,50,55
1,1548,1549,-1,0,178,81
-1,1378,1569,-191,-1,-3,66
-1,1210,1682,-472,-3,-318,92
-1,1738,1721,17,-1,-171,134
1,1797,2037,-240,-4,-225,103
1,1771,1706,65,0,-17,61
-1,1534,1106,428,-1,-12,40
-1,1864,1713,151,-3,-344,100
-1,1633,1637,-4,0,7,56
1,1350,1465,-115,10,266,69
-1,1568,1794,-226,0,66,62
-1,1516,1432,84,-9,-124,48
-1,1436,1625,-189,0,-343,146
-1,1427,1791,-364,-2,-61,60
0,1207,1693,-486,-1,351,124
-1,1523,1613,-90,-1,-102,68
1,1697,1761,-64,1,51,65
-1,1447,1791,-344,-4,-43,44
1,2019,1815,204,5,142,55
1,1735,1846,-111,1,356,87
1,1530,963,567,3,155,47
-1,1599,1780,-181,0,46,85
1,1799,1561,238,0,1,59
-1,1539,1504,35,0,-208,108
1,1718,1748,-30,2,122,61
1,1506,1130,376,2,94,65
-1,1500,1755,-255,-9,-155,46
1,1786,1570,216,-1,95,83
-1,1579,1644,-65,0,-88,68
1,1830,2025,-195,0,7,89
-1,1356,1614,-258,-2,-133,75
1,1536,1453,83,4,274,71
1,1626,1221,405,-2,-66,63
-1,1697,1346,351,-3,-114,56
1,1559,1500,59,6,576,91
0,1547,1791,-244,0,-456,127
-1,1554,1804,-250,-4,-57,42
0,1496,1656,-160,1,-19,105
1,1471,1281,190,0,40,51
1,2008,1849,159,-3,-32,49
-1,1217,1640,-423,-10,-197,52
-1,961,1531,-570,-3,-51,48
1,1393,1372,21,4,146,64
1,1841,1748,93,3,145,61
1,1327,1575,-248,5,525,105
-1,1214,1651,-437,-6,-12,58
-1,1632,1608,24,0,-82,64
1,1500,1392,108,7,0,41
1,1515,1462,53,0,5,49
0,1785,1575,210,2,173,113
-1,1484,1519,-35,0,-14,46
-1,1754,2014,-260,-3,-21,56
1,1317,1340,-23,6,175,49
1,1714,1439,275,0,15,59
1,1809,1548,261,1,36,43
-1,1698,2243,-545,0,49,58
1,1621,1569,52,3,144,69
-1,968,0,968,0,-289,84
-1,1352,1422,-70,-6,-232,70
1,1851,1661,190,-11,-92,63
-1,1732,2019,-287,0,-36,60
1,1597,1780,-183,3,239,65
1,1412,1524,-112,7,159,59
1,1485,1508,-23,7,119,42
1,1632,1454,178,-1,37,83
-1,1789,1486,303,-1,76,136
1,1857,1509,348,2,109,93
1,1532,1532,0,0,-179,89
1,1651,1505,146,5,448,93
0,1764,1655,109,-2,217,153
1,2022,1740,282,2,85,61
1,1373,1500,-127,-4,-2,59
1,1439,1166,273,11,346,59
1,2245,1697,548,2,117,69
0,1511,1479,32,0,190,207
1,1838,1527,311,5,513,91
-1,1736,2026,-290,0,-9,44
0,1725,1593,132,2,74,127
-1,1369,1500,-131,-1,-308,66
1,1667,1673,-6,2,156,74
1,1477,1352,125,0,359,95
-1,1769,1642,127,-1,204,98
1,1683,1467,216,-1,-7,47
1,2030,1732,298,-1,375,107
-1,1566,1595,-29,-1,-60,70
-1,1523,1841,-318,-3,-88,50
1,2138,2248,-110,0,133,117
-1,1493,1658,-165,-3,-443,146
1,1752,1810,-58,-3,104,83
1,1683,1754,-71,0,-10,77
-1,1560,1637,-77,0,-53,96
1,1923,1516,407,0,-103,77
-1,1520,1740,-220,-1,-11,40
1,1383,1386,-3,5,404,69
1,1735,1881,-146,0,1,103
1,1497,1351,146,5,880,115
-1,1685,1729,-44,0,1,124
-1,2034,1845,189,-1,-131,78
-1,1797,1765,32,1,-299,102
-1,1532,1756,-224,0,73,58
-1,1729,1741,-12,-7,-342,66
-1,1514,1448,66,-1,-317,104
1,2217,2152,65,0,21,59
-1,1529,1474,55,-6,4,42
-1,1776,1785,-9,-12,-355,78
-1,2016,1864,152,0,32,78
1,1771,1526,245,-1,-14,53
-1,1371,1395,-24,-3,-439,172
-1,1272,1432,-160,-4,-352,110
-1,1483,1510,-27,1,20,70
-1,1457,1432,25,-3,-132,108
1,1730,1740,-10,-1,-159,69
-1,1784,1766,18,-4,-506,92
1,1882,1667,215,-2,8,69
1,1368,1445,-77,10,191,49
-1,1633,1629,4,-1,-25,56
-1,1697,1500,197,-4,-311,100
1,2006,1790,216,1,228,69
1,2235,2143,92,-1,-9,65
-1,1728,1741,-13,0,-58,76
-1,1519,1680,-161,-3,-204,76
-1,1661,1887,-226,0,-118,58
-1,1780,1729,51,0,59,78
-1,1500,1654,-154,-6,-357,62
1,1609,1509,100,1,171,61
-1,1555,1718,-163,-8,-107,50
-1,1500,1548,-48,-2,-76,61
1,1893,1656,237,0,-20,45
1,2135,2251,-116,-2,-9,47
1,1537,1373,164,2,164,60
-1,1651,1898,-247,-4,-74,62
-1,1515,1563,-48,-1,-94,56
-1,1406,1357,49,-2,-26,50
-1,1487,1516,-29,-19,-269,44
1,1559,1658,-99,-1,-22,51
-1,1517,1640,-123,-12,-191,46
1,1651,1551,100,0,68,67
1,1329,1311,18,4,307,67
-1,1934,1778,156,1,-109,120
-1,1507,1458,49,1,13,48
-1,1332,1224,108,1,-329,150
1,1373,1393,-20,3,228,57
-1,1096,1260,-164,-5,-136,56
1,1506,1561,-55,0,-15,85
-1,2224,2149,75,0,14,62
-1,1429,1777,-348,-3,-108,82
1,1314,1341,-27,-4,-153,61
1,1700,1270,430,9,112,41
-1,1346,1590,-244,-4,-289,68
-1,2162,2200,-38,2,11,68
1,1676,1780,-104,-11,-109,79
1,1381,1161,220,3,370,75
-1,1760,1908,-148,2,-13,66
-1,1647,1619,28,-3,-335,136
1,1796,1642,154,10,444,59
-1,1543,1664,-121,-1,-157,184
0,1439,1555,-116,0,4,44
-1,1690,1471,219,-2,-19,46
-1,1467,1536,-69,1,-191,84
1,2217,2153,64,0,116,99
-1,1341,1365,-24,-4,-80,44
-1,1706,1414,292,-3,-16,42
-1,1528,1595,-67,-14,-65,40
-1,1635,1803,-168,-13,-268,60
1,1794,1475,319,0,-56,73
-1,1284,1327,-43,-5,-169,68
-1,1803,1635,168,-3,-262,46
1,1510,1755,-245,0,-68,71
-1,1698,1829,-131,-5,-21,50
-1,1268,1410,-142,-3,-139,58
1,1691,1725,-34,1,6,47
1,1330,1248,82,-6,64,109
1,1299,1417,-118,-1,129,93
1,1652,1472,180,-2,-161,67
-1,1786,2232,-446,-3,-188,80
-1,2144,1916,228,2,82,74
1,2235,1784,451,0,89,75
-1,1658,1468,190,2,33,58
1,1935,2126,-191,0,-78,107
1,1337,1259,78,7,331,65
-1,1783,2238,-455,-2,-54,56
-1,1543,1343,200,4,109,91
-1,1751,1487,264,-12,-863,86
1,2240,1781,459,1,-42,59
1,2109,1954,155,0,138,63
1,1676,1536,140,4,130,47
-1,1946,2116,-170,0,-31,52
1,1508,1727,-219,0,-41,99
1,1766,1679,87,-1,19,75
-1,1836,1691,145,0,-11,65
1,2243,1779,464,1,173,93
1,2122,1940,182,4,188,73
1,1704,1527,177,-7,52,53
-1,1340,1375,-35,-7,-456,80
1,1417,1655,-238,5,148,65
-1,1529,1686,-157,-10,-136,42
0,1724,1742,-18,0,49,144
1,1777,1520,257,4,224,81
1,1360,1238,122,6,180,60
-1,1520,1777,-257,1,24,40
1,1899,1828,71,0,197,135
-1,1754,1628,126,5,122,54
1,1464,1341,123,5,341,87
-1,1794,1662,132,-1,-132,66
1,1643,1581,62,-1,43,107
1,1730,1291,439,7,132,55
1,1926,1716,210,2,46,169
1,1468,1462,6,0,12,75
1,1866,1887,-21,2,137,87
1,1500,1514,-14,1,124,95
1,1860,1312,548,1,398,97
1,2022,1938,84,0,-7,47
1,1984,1785,199,0,-50,65
-1,1730,1711,19,-1,-373,122
1,1902,2078,-176,2,146,73
-1,1423,1674,-251,0,-33,64
-1,1546,1603,-57,-4,-303,106
1,1608,1765,-157,4,271,71
-1,1657,1500,157,0,27,58
1,1591,1385,206,4,96,57
-1,1922,1735,187,-1,-33,66
1,1191,1377,-186,-1,144,61
-1,1361,1302,59,-3,-199,68
1,1809,1692,117,0,-21,59
1,1927,1984,-57,1,126,101
-1,1590,1725,-135,-3,-71,86
-1,1642,1572,70,3,61,58
-1,1732,1632,100,-1,-36,78
0,1694,1578,116,-2,-148,177
0,1771,1565,206,-1,-68,100
1,1707,1414,293,0,220,81
-1,1901,1751,150,-1,-233,92
-1,1496,1528,-32,-1,-284,94
1,1334,1349,-15,1,72,59
-1,1585,1622,-37,-5,-259,92
-1,1476,1497,-21,-5,-369,82
-1,1876,1879,-3,0,-12,68
-1,1596,1734,-138,-2,-225,106
1,1636,1506,130,1,226,73
1,1731,1629,102,9,473,79
-1,1450,1479,-29,0,68,128
1,1657,1535,122,0,-37,99
1,2133,1806,327,0,164,207
-1,1444,1663,-219,0,-43,70
-1,1352,1500,-148,-1,-84,69
1,1713,1712,1,0,58,57
1,1639,1724,-85,-5,-104,59
-1,1647,1575,72,-6,-5,52
1,1424,1307,117,1,105,69
1,1681,1975,-294,1,41,94
-1,1574,1763,-189,0,-22,54
-1,1574,1781,-207,-3,-301,78
-1,1401,1718,-317,0,-127,110
-1,1664,1478,186,-1,-95,80
1,1371,1408,-37,-1,-57,55
0,1731,1576,155,-1,-101,90
1,1458,1648,-190,-13,-226,41
-1,1989,2056,-67,0,4,40
1,1699,1424,275,8,149,41
1,1523,1468,55,-4,101,60
-1,2142,1800,342,0,-40,112
1,1814,1493,321,4,205,69
-1,1803,2138,-335,-2,7,44
-1,1589,1637,-48,0,-41,84
-1,1293,1347,-54,-5,-81,56
1,1415,1626,-211,0,94,48
1,1404,1079,325,9,140,45
1,1759,1199,560,-1,86,79
1,1363,1508,-145,6,405,89
-1,1486,1513,-27,0,6,50
1,1621,1462,159,-2,34,61
-1,1818,1955,-137,-2,-76,78
-1,1295,1326,-31,0,-8,48
1,1716,1526,190,3,41,53
-1,1398,1344,54,0,12,48
-1,1628,1565,63,2,16,62
-1,1610,1315,295,3,213,60
1,1963,1796,167,0,0,49
-1,1469,1623,-154,-1,-91,96
-1,1724,1709,15,-1,114,80
-1,1455,1639,-184,-2,-784,100
1,1631,1462,169,-3,177,103
1,1771,1674,97,0,78,95
1,1678,1481,197,3,187,75
1,1865,1990,-125,-2,-12,41
1,1631,1476,155,2,-8,41
1,1949,1879,70,0,38,97
1,1589,1527,62,1,1,43
1,1871,1972,-101,0,-1,69
-1,1498,1253,245,-6,-328,60
-1,1731,1700,31,0,8,74
-1,1638,1441,197,-2,-935,142
-1,1790,1969,-179,-3,-46,42
1,1489,1441,48,0,-4,43
-1,1637,1525,112,-1,-6,60
-1,1671,1879,-208,0,-357,114
1,1454,1628,-174,0,273,123
1,1747,1646,101,4,118,54
0,1322,1500,-178,-1,112,171
-1,1812,1556,256,-8,-202,56
1,1601,1338,263,1,180,95
-1,1579,1871,-292,-5,-230,68
-1,1507,1247,260,-3,-166,76
1,1357,1282,75,-3,194,91
1,1380,1492,-112,-5,166,125
-1,1328,1477,-149,3,118,70
1,1938,1884,54,-2,-181,83
1,1435,1426,9,5,129,57
1,1615,1575,40,2,238,73
1,1607,1333,274,-5,48,67
1,1748,1194,554,7,192,59
1,1712,1647,65,2,263,98
1,1901,1400,501,3,192,69
1,1918,1975,-57,-1,93,95
1,1616,1273,343,2,88,41
1,1539,1674,-135,0,27,49
1,1533,1659,-126,6,511,73
-1,1592,1892,-300,-3,-84,62
-1,1475,1683,-208,-1,-297,112
1,1312,1261,51,0,82,49
-1,1485,1320,165,-2,-186,86
-1,1289,1427,-138,-6,-42,50
1,1720,1528,192,1,373,127
-1,1543,1421,122,-9,-83,94
-1,1606,1446,160,0,0,42
-1,1619,1743,-124,-1,-596,82
1,1280,1447,-167,3,634,143
1,1754,1578,176,0,-1,57
-1,1354,1536,-182,0,187,68
1,1535,1608,-73,0,75,155
-1,1519,1498,21,-4,-236,68
-1,1884,1666,218,0,-11,84
-1,1454,1398,56,0,-999,152
-1,1696,1779,-83,6,93,48
1,1610,1340,270,-1,23,51
-1,1758,1734,24,1,56,84
-1,1539,1622,-83,0,-59,70
1,1335,1615,-280,0,139,61
-1,1252,1322,-70,-4,-675,122
1,1689,1469,220,-1,46,81
0,1466,1438,28,-2,-526,90
-1,1779,1572,207,-6,-2,48
1,1861,1462,399,2,99,69
-1,1626,1721,-95,-1,-498,106
-1,1586,1529,57,0,7,52
1,1591,1357,234,0,-140,73
-1,1606,1434,172,-4,-58,52
-1,1557,1523,34,-3,-46,52
1,2120,1416,704,4,72,51
-1,1351,1597,-246,2,-3,52
1,1588,1714,-126,-1,-17,51
-1,1624,1424,200,-1,-182,78
-1,1549,1478,71,-5,-432,92
-1,1523,1489,34,-1,-123,82
1,1875,1820,55,0,50,123
1,1507,1075,432,18,507,55
1,1603,1346,257,-1,-20,61
1,1464,1694,-230,0,-152,87
-1,1691,1593,98,-2,-274,112
-1,1666,1782,-116,-1,-61,64
1,1535,1544,-9,0,-98,83
1,1543,1573,-30,3,595,133
-1,1341,1608,-267,-4,156,74
1,1782,1716,66,0,-26,57
1,1331,1243,88,-4,-79,41
-1,1402,1807,-405,2,175,84
-1,1601,1559,42,0,-20,100
-1,1613,1336,277,-4,-55,46
1,1409,1325,84,-1,116,65
1,1488,1439,49,-1,52,73
1,2121,1391,730,5,88,47
-1,1607,1650,-43,0,-19,44
1,1791,1686,105,1,34,51
-1,1358,1590,-232,-13,-319,46
-1,1498,1500,-2,-4,-126,60
1,1863,1413,450,4,176,55
1,1674,1676,-2,5,91,49
-1,1909,1884,25,-6,-16,42
1,2121,1910,211,-1,-1,55
-1,1596,1353,243,-6,-243,72
1,1522,1500,22,0,366,97
1,1590,1609,-19,2,58,53
-1,1532,1546,-14,2,-1,90
1,1676,1483,193,7,235,57
-1,1577,2129,-552,-4,-58,50
-1,1865,1773,92,-2,-26,70
1,1897,1895,2,-2,-53,67
1,1430,1303,127,12,417,59
-1,1578,1631,-53,-2,-64,46
1,1340,1411,-71,9,408,67
1,1581,1367,214,-5,-202,73
1,1477,1682,-205,-3,-128,59
1,1837,1583,254,3,96,65
-1,1361,1587,-226,0,-102,74
-1,1908,1885,23,-1,-104,82
-1,1792,1666,126,1,64,76
-1,1374,1574,-200,-2,197,74
-1,1962,1810,152,-5,-110,54
1,1561,1556,5,1,134,95
-1,1306,1428,-122,3,506,98
1,1469,1416,53,-6,281,87
1,1593,1355,238,3,259,73
-1,1710,1793,-83,-5,-236,70
1,1295,1272,23,-3,53,77
-1,1579,1811,-232,1,21,86
1,1781,1640,141,-2,126,117
1,1576,1642,-66,-2,-85,71
-1,1463,1569,-106,1,134,94
-1,1350,1599,-249,-2,6,104
-1,1826,1946,-120,0,14,62
1,1851,1589,262,0,210,103
-1,1604,1345,259,0,-276,80
-1,1799,1442,357,-1,-7,40
-1,1269,1568,-299,-6,-408,72
0,1816,1491,325,1,91,169
-1,1777,1829,-52,2,111,66
1,1415,1370,45,0,9,53
-1,1366,1582,-216,0,35,58
-1,998,1521,-523,-8,-197,48
1,1482,1464,18,1,114,53
-1,1658,1581,77,-8,-106,40
-1,1237,1365,-128,0,-26,72
1,1811,1569,242,12,124,41
-1,1588,1360,228,0,2,60
1,1954,1717,237,-1,8,43
-1,1534,1595,-61,-8,-236,54
-1,1564,1815,-251,-7,-181,68
1,1556,1436,120,-5,-18,99
-1,1337,1662,-325,5,265,82
-1,1869,1880,-11,-1,-21,70
1,1596,1529,67,3,209,55
-1,1381,1567,-186,-2,-142,88
-1,1260,1343,-83,-5,-163,112
1,1855,1816,39,1,-25,40
1,1153,1197,-44,5,253,61
-1,1702,1873,-171,-2,-153,94
-1,1517,1617,-100,-4,-261,70
1,1574,1374,200,-5,-134,59
-1,2055,1804,251,0,-115,92
-1,1234,1664,-430,0,-28,64
1,1694,1643,51,0,5,55
-1,1500,1732,-232,2,25,46
-1,1560,1820,-260,-1,-329,104
1,1367,1581,-214,-3,-79,57
-1,1520,1605,-85,0,-70,58
1,1359,1431,-72,0,-5,99
-1,1824,1555,269,1,35,66
-1,1572,1509,63,4,138,54
1,1432,1500,-68,0,163,75
-1,1509,1523,-14,1,-139,144
1,1866,1584,282,6,92,41
1,1647,1907,-260,-3,5,65
-1,1575,1805,-230,-1,-80,60
-1,1455,1532,-77,-2,-56,52
-1,1500,1577,-77,-3,-183,81
1,1466,1408,58,0,-11,61
1,1184,1195,-11,3,60,49
1,1810,1570,240,-2,325,101
-1,1352,1250,102,1,46,100
0,1358,1512,-154,-2,-102,83
-1,1325,1485,-160,1,45,66
-1,1829,1901,-72,8,232,64
-1,1373,1633,-260,-11,-145,42
1,1861,1605,256,6,256,61
1,1234,1498,-264,-1,515,173
-1,1523,1559,-36,0,-93,112
1,1534,1499,35,-5,-183,63
-1,1475,1788,-313,-1,-8,44
0,1619,1548,71,3,77,115
1,1583,1521,62,17,218,43
1,1637,1368,269,1,16,41
-1,1527,1767,-240,-4,-399,76
-1,1696,1656,40,2,85,44
1,1927,1908,19,-5,-127,97
-1,1783,1571,212,-3,-44,116
1,1898,1941,-43,3,135,65
1,1541,1266,275,-7,-217,57
-1,1482,1495,-13,0,-140,92
-1,1482,1802,-320,-2,36,72
-1,1489,1544,-55,-5,-376,86
-1,1925,1909,16,-4,-311,90
1,1879,1622,257,0,-99,125
1,1677,1508,169,0,17,51
0,1326,1552,-226,-5,-423,156
-1,1554,1718,-164,-16,-488,84
-1,1503,1790,-287,-4,-150,57
-1,1745,1463,282,-5,-163,50
0,1920,1911,9,0,110,118
1,1794,1323,471,6,147,55
1,1479,1255,224,1,105,71
-1,1896,1859,37,3,84,56
1,1363,1641,-278,-1,-3,67
1,1773,1737,36,0,19,67
1,1580,1322,258,7,171,51
1,1480,1512,-32,6,261,55
1,1725,1482,243,0,94,75
1,1132,1320,-188,4,671,83
-1,1666,1683,-17,1,3,73
1,1412,1335,77,2,155,55
0,1796,1742,54,0,91,170
1,1688,1333,355,6,110,41
-1,1911,1920,-9,-1,-337,88
1,1720,1279,441,-1,111,55
1,1715,1399,316,7,327,69
-1,1499,1492,7,-1,19,78
1,1557,1502,55,5,193,61
-1,1667,1669,-2,2,218,76
1,1936,2026,-90,1,7,51
-1,1578,1630,-52,0,-141,118
1,1987,1819,168,2,84,63
-1,1661,1771,-110,0,1,46
1,1760,1542,218,2,74,63
1,1680,1655,25,1,235,93
1,1514,1523,-9,-2,-39,91
-1,1283,1466,-183,-9,-218,50
1,1825,1730,95,2,297,87
1,2011,1952,59,0,194,95
-1,1813,1993,-180,-1,-31,58
1,1863,1719,144,-6,-193,91
-1,1354,1433,-79,0,-302,116
1,1656,1677,-21,0,19,67
0,1999,1807,192,-2,-153,134
-1,1374,1502,-128,0,-65,94
1,1371,1024,347,6,582,91
0,1596,1526,70,0,14,71
-1,1712,1870,-158,-8,-408,114
1,1537,1698,-161,3,50,47
0,1582,1849,-267,-1,-27,119
1,2021,1941,80,0,28,75
1,1476,1589,-113,3,253,95
-1,1525,1511,14,-3,-183,92
1,1722,1833,-111,-9,2,67
-1,1812,1994,-182,-3,-109,58
-1,1457,1555,-98,2,41,48
1,1974,1764,210,-1,259,99
-1,1865,1875,-10,1,-20,52
-1,1628,1825,-197,-1,-37,56
1,1876,1705,171,0,46,67
1,1553,1599,-46,-1,-27,43
-1,1552,1467,85,-6,-118,50
1,2000,1806,194,-2,216,88
1,1951,1464,487,1,209,61
1,1476,1466,10,2,77,67
-1,1585,1773,-188,-1,-231,84
1,1888,1693,195,2,1007,149
-1,1801,2005,-204,-1,-24,54
1,1523,1537,-14,-5,-97,65
1,1527,1457,70,1,49,55
1,1822,2030,-208,-2,4,43
-1,1521,1568,-47,-5,-829,244
1,1818,1736,82,-2,453,137
1,2011,1796,215,8,135,48
1,1385,1563,-178,6,159,59
-1,1514,1911,-397,-3,-125,50
1,1612,1791,-179,-3,-2,43
1,1738,1840,-102,0,26,53
1,1305,1503,-198,0,95,81
1,1509,1366,143,0,158,75
-1,1388,1224,164,3,128,70
1,2016,1790,226,2,133,65
-1,1914,2052,-138,-3,-69,54
-1,1538,1500,38,-1,69,70
-1,1492,1564,-72,1,21,58
1,1785,2021,-236,-1,-65,59
-1,1670,1779,-109,0,40,80
-1,1512,1847,-335,0,-134,82
1,2012,2003,9,0,109,87
-1,1530,1695,-165,-3,-55,56
1,1590,1534,56,0,3,40
1,1687,1894,-207,-2,279,131
-1,1441,1841,-400,1,-59,98
-1,1808,1813,-5,0,-74,94
1,1627,1659,-32,0,229,111
-1,1826,1754,72,-3,-86,56
-1,1525,1641,-116,0,17,82
0,1531,1329,202,-7,-74,50
1,1280,1091,189,12,545,59
1,1707,1735,-28,3,17,41
1,2024,1992,32,2,61,81
1,1500,1525,-25,3,64,71
1,1599,1766,-167,0,709,145
-1,1375,1850,-475,0,-4,42
1,1487,1465,22,-4,-200,95
-1,1372,1614,-242,-4,-383,103
1,1535,1492,43,-4,-33,49
-1,1768,1813,-45,-1,-50,68
1,1547,1402,145,2,67,53
1,1646,1517,129,3,52,45
-1,1456,1494,-38,0,30,46
1,1757,1648,109,-2,-123,63
1,1552,1516,36,1,37,53
-1,1675,1953,-278,0,-149,100
1,1528,1480,48,15,333,51
1,1545,1688,-143,6,213,59
1,1685,1391,294,9,427,56
-1,1481,1342,139,9,755,106
-1,1581,1545,36,0,-53,120
1,1506,1515,-9,2,68,55
-1,1557,1517,40,1,-57,72
-1,1476,1470,6,-4,-51,86
1,1653,1524,129,0,-10,60
1,1509,1683,-174,3,120,65
-1,1376,1367,9,0,7,56
0,1828,1759,69,0,34,127
-1,1513,1825,-312,-10,-67,52
-1,1594,1500,94,-1,-106,118
1,1500,1517,-17,6,100,45
1,1591,1638,-47,1,70,49
1,1590,1769,-179,-1,6,81
-1,1822,1758,64,-1,336,136
-1,1498,1578,-80,0,-18,68
1,1466,1501,-35,4,146,57
1,1625,1542,83,-3,-58,73
-1,1182,1176,6,2,-4,72
1,1617,1821,-204,1,178,109
-1,1867,1718,149,-4,-200,70
-1,1376,1499,-123,-4,53,148
-1,1546,1619,-73,-4,-280,76
-1,1395,1554,-159,-3,-281,120
1,1877,1500,377,-8,-93,77
-1,1379,1517,-138,-8,-71,51
1,1575,1593,-18,4,212,85
-1,1510,1829,-319,-1,-143,62
-1,1500,1504,-4,-1,-42,48
-1,1505,1562,-57,0,-61,66
1,1518,1500,18,-1,-224,83
-1,1446,1880,-434,-3,-121,46
1,1850,1599,251,-7,26,71
-1,1558,1728,-170,-3,-68,54
1,1882,1413,469,9,98,45
-1,1461,1538,-77,-1,-112,64
1,1720,1570,150,-2,214,75
1,1706,1606,100,1,81,75
-1,1481,1464,17,1,-14,53
1,1647,1640,7,1,51,71
-1,1538,1678,-140,-3,-264,116
-1,1534,1525,9,-5,-26,66
-1,1387,1689,-302,-7,-119,42
1,1772,1810,-38,1,34,53
1,1586,1435,151,0,19,77
-1,1688,1851,-163,0,12,56
-1,1439,1284,155,0,-98,80
-1,1886,1369,517,-7,-466,100
1,1661,1460,201,4,166,57
-1,1158,1500,-342,-1,-242,68
1,1592,1431,161,4,330,75
1,1685,1518,167,-2,-52,71
1,2034,2007,27,1,26,49
1,1802,1587,215,-1,17,52
1,1656,1868,-212,0,-41,91
1,1797,1785,12,4,56,45
1,1515,1500,15,-8,-125,47
1,1996,2045,-49,0,-33,77
-1,1382,1371,11,-3,-172,66
1,1765,1527,238,0,10,61
1,1531,1717,-186,-1,117,75
1,1476,1481,-5,-3,-114,69
1,1232,1523,-291,0,-22,47
-1,1571,1496,75,0,-63,94
-1,1774,1808,-34,-3,23,72
-1,1523,1232,291,0,-116,88
1,1666,1635,31,-1,93,79
-1,1613,1740,-127,-1,-13,54
1,1481,1479,2,4,58,49
1,1869,1798,71,9,164,43
1,1546,1635,-89,-5,106,67
1,2032,1853,179,0,214,77
1,1504,1496,8,2,79,73
1,1496,1425,71,0,40,67
1,1152,1469,-317,0,-56,76
1,1722,1740,-18,0,-12,41
1,1621,1502,119,0,29,49
1,1560,1540,20,3,381,95
1,1629,1453,176,-2,-48,59
-1,1398,1197,201,-3,-171,70
1,1845,1850,-5,10,153,49
-1,1442,1456,-14,1,-373,108
-1,1508,1470,38,-2,29,58
-1,1440,1353,87,-9,-731,156
1,1748,1605,143,-2,14,53
1,1658,1500,158,3,24,91
-1,1163,1519,-356,-2,-58,54
1,1861,1799,62,0,17,91
1,1818,1763,55,-1,-72,85
1,1547,1437,110,1,238,89
-1,1567,1352,215,-6,-131,54
1,1469,1515,-46,0,159,105
-1,1496,1490,6,1,-225,112
-1,1515,1468,47,1,64,62
-1,1474,1453,21,-2,-258,75
0,1838,1867,-29,0,110,111
1,1680,1505,175,7,188,54
-1,1553,1554,-1,-2,20,68
-1,1306,1295,11,-4,-36,48
-1,1383,1650,-267,-4,-52,40
-1,1476,1810,-334,0,-20,68
-1,1282,1634,-352,-7,-120,48
1,1855,1388,467,1,210,57
-1,1676,1841,-165,-2,-342,122
-1,1509,1484,25,0,-22,94
-1,1487,1326,161,0,24,68
1,1598,1538,60,0,77,117
1,1654,1732,-78,6,265,95
-1,1483,1773,-290,0,10,62
1,1558,1581,-23,0,412,147
1,1580,1660,-80,1,30,63
1,1305,1479,-174,0,-5,41
-1,1420,1413,7,-6,-349,91
1,1753,1827,-74,0,39,71
-1,1500,1873,-373,-3,-233,76
-1,1782,2038,-256,-4,-273,108
1,1331,1211,120,0,-8,43
-1,1631,1816,-185,0,20,56
1,1683,1703,-20,7,294,45
1,1634,1324,310,0,7,53
1,1543,1345,198,0,2,41
-1,1304,1462,-158,-3,-378,104
1,1498,1682,-184,0,726,103
-1,1906,2042,-136,-1,-76,84
-1,1549,1584,-35,1,0,70
-1,1475,1524,-49,-10,-211,51
1,1696,1638,58,10,891,127
-1,1741,1686,55,-5,-79,54
1,1670,1630,40,-2,275,69
1,1365,1395,-30,4,58,43
-1,1814,1767,47,2,150,74
-1,2050,1899,151,-5,-54,46
-1,1118,1468,-350,-10,-213,46
1,1766,1500,266,-1,4,57
1,1628,1706,-78,0,159,91
-1,1528,1608,-80,-3,-67,80
-1,1699,1728,-29,0,-9,58
-1,1915,2034,-119,-3,-197,60
1,1445,1529,-84,2,353,139
-1,1839,1865,-26,-6,-55,42
-1,1342,1471,-129,-3,71,54
1,1480,1137,343,0,-12,47
1,1637,1500,137,6,237,51
0,1500,1471,29,-2,31,156
1,2041,1907,134,3,81,55
1,1190,1047,143,-1,-30,45
1,1333,1494,-161,-1,22,100
-1,1486,1129,357,-2,-22,42
-1,1689,1594,95,-4,-253,70
1,1468,1152,316,-1,-192,55
-1,1680,1619,61,-1,5,76
1,0,1015,-1015,-2,-46,49
1,1468,1319,149,-3,-56,51
1,1702,1900,-198,-1,-31,77
1,1691,1642,49,-1,-269,103
1,1884,1719,165,10,389,59
-1,1390,1429,-39,0,-219,72
1,1429,1536,-107,2,83,60
-1,1890,2049,-159,-1,-48,54
1,1616,1518,98,-8,6,59
1,1253,1319,-66,9,97,43
-1,1713,1690,23,-7,-335,68
1,1479,1334,145,0,121,79
-1,1202,985,217,-14,-520,58
-1,1607,1675,-68,0,-18,66
-1,2055,1884,171,-3,-89,92
1,1428,1301,127,1,469,105
-1,1847,1834,13,-5,-443,94
-1,1643,1640,3,-4,-211,92
1,1678,1391,287,1,41,57
1,1700,1572,128,1,31,49
-1,1893,2046,-153,-3,-219,74
1,1533,1851,-318,-3,-47,53
-1,1357,1046,311,-3,-365,80
1,1720,1599,121,2,34,41
-1,1903,1832,71,0,120,114
-1,1381,1500,-119,-2,-121,72
1,2053,1886,167,-1,22,63
1,1667,1460,207,0,472,69
1,1113,1175,-62,5,463,79
1,1682,1269,413,9,159,45
-1,1807,1832,-25,1,29,48
-1,1463,1413,50,-1,-252,86
1,1724,1572,152,-2,509,147
1,1832,1552,280,5,111,53
1,1834,1845,-11,1,120,117
-1,1880,2059,-179,1,-3,52
0,1764,1552,212,6,196,153
1,1686,1475,211,6,570,93
-1,1522,1534,-12,-3,-144,70
-1,1500,1501,-1,1,-56,70
-1,1327,1485,-158,-6,-128,54
-1,1436,1190,246,-1,12,42
-1,1891,2048,-157,-3,-358,88
-1,1548,1835,-287,2,-210,94
0,1469,1574,-105,0,659,131
-1,1684,1721,-37,0,7,42
-1,1293,1743,-450,0,-374,102
-1,1350,1690,-340,-2,-42,52
1,1692,1588,104,0,433,181
1,1846,1831,15,0,32,89
1,1367,1338,29,2,117,63
-1,1496,1629,-133,0,-123,116
-1,1358,1510,-152,-2,-145,58
1,1485,1312,173,-1,176,93
-1,1106,1133,-27,-3,-629,108
1,1839,1545,294,4,99,53
1,1292,1396,-104,3,202,63
-1,1492,1321,171,0,-389,88
0,1672,1640,32,2,76,93
1,1695,1726,-31,3,76,85
1,1818,1741,77,0,3,47
1,1768,1701,67,1,33,55
-1,1358,1327,31,-2,93,64
-1,1670,1651,19,-10,-185,46
-1,1820,1708,112,0,-6,48
-1,1599,1769,-170,0,-161,84
1,1536,1474,62,1,92,93
1,1423,1490,-67,1,293,115
-1,1466,1483,-17,-3,-390,94
1,1541,1500,41,3,120,63
1,1886,1697,189,5,291,74
-1,1704,1768,-64,0,-98,120
1,1601,1538,63,0,139,83
-1,1791,1737,54,2,-6,70
-1,1446,1626,-180,-4,-5,88
1,1683,1671,12,0,1,49
-1,1447,1367,80,0,-50,76
1,1573,1758,-185,0,-46,67
1,1479,1245,234,0,-5,51
1,1849,2015,-166,0,356,145
1,1162,1313,-151,3,160,75
-1,1822,1768,54,-4,-20,40
1,1531,1445,86,-1,43,77
-1,1500,1698,-198,-6,34,50
-1,1529,1613,-84,0,-400,118
1,1512,1468,44,-4,-80,49
1,1812,1690,122,0,-9,67
-1,1472,1924,-452,-3,-67,50
1,1971,1738,233,0,137,137
-1,1500,1608,-108,0,28,66
1,1275,1145,130,5,79,49
1,1681,1320,361,9,242,45
1,1828,1530,298,4,125,51
-1,1259,1652,-393,1,-17,76
1,1750,1454,296,2,10,49
1,1660,1709,-49,1,82,87
1,1766,1885,-119,1,58,61
1,1568,1500,68,0,42,63
-1,1500,1577,-77,-14,-533,64
1,1892,1876,16,-3,16,123
1,1626,1706,-80,-8,-152,45
1,1596,1446,150,0,308,91
1,1685,1396,289,-6,-239,85
1,1825,1625,200,7,874,103
-1,1250,1831,-581,1,22,46
-1,1847,1889,-42,0,-7,52
-1,1090,1444,-354,-8,-242,80
-1,1528,1553,-25,1,-154,118
-1,1459,1522,-63,-2,-56,40
-1,1527,1832,-305,2,74,56
1,1392,1206,186,0,295,91
1,1620,1664,-44,2,417,109
-1,1750,1640,110,3,185,64
-1,1735,1502,233,0,20,78
-1,1357,1688,-331,-6,-215,84
-1,1234,1484,-250,3,88,52
1,1772,1419,353,-3,-11,87
-1,1531,1450,81,-2,121,132
1,1431,1515,-84,0,-542,129
-1,1640,1822,-182,0,-353,96
1,1835,1693,142,0,185,143
-1,1680,1673,7,-2,-61,64
1,1741,1540,201,-6,65,133
-1,1036,1595,-559,-5,-625,112
0,1781,1809,-28,0,-10,83
-1,1355,1575,-220,-1,-226,78
1,1571,1486,85,-3,-18,83
-1,1780,1837,-57,0,-17,44
-1,1872,1741,131,-1,-58,58
1,1584,1359,225,10,513,65
-1,0,1097,-1097,0,-83,52
-1,1655,1736,-81,0,-33,58
1,1551,1417,134,1,57,55
-1,1545,1776,-231,-1,-321,127
0,1481,1744,-263,-8,-194,64
1,1668,1307,361,8,255,53
1,1846,1938,-92,3,386,105
-1,1436,1554,-118,-3,-304,96
-1,1282,1579,-297,2,69,88
1,1687,1574,113,0,13,63
1,1518,1519,-1,0,29,72
1,1441,1641,-200,-11,73,97
1,1976,1899,77,0,-26,93
-1,1564,1628,-64,-4,-134,64
-1,1772,1866,-94,-2,-252,108
1,1744,1806,-62,9,386,86
-1,1463,1489,-26,1,-413,138
-1,1592,1761,-169,-7,-31,42
-1,1405,1527,-122,-3,-122,60
1,1656,1685,-29,2,162,79
1,1669,1755,-86,-2,67,75
1,1196,1232,-36,-1,-61,47
-1,1411,1747,-336,0,-45,76
1,1691,1322,369,0,6,71
1,1558,1500,58,5,135,57
1,1537,1509,28,8,120,41
-1,1633,1698,-65,-1,-156,120
1,1890,1985,-95,-3,225,103
1,1637,1301,336,1,148,127
1,1588,1504,84,1,19,49
1,1529,1515,14,-10,27,81
1,1845,1573,272,0,2,51
1,1673,1680,-7,1,43,109
-1,1303,1403,-100,-12,-625,184
0,1473,1488,-15,-4,-277,63
1,2104,1846,258,6,485,89
-1,1839,2108,-269,0,-172,82
1,1671,1238,433,5,100,47
1,1724,1492,232,1,-301,93
1,1398,1222,176,11,717,87
1,1278,1034,244,15,179,40
1,1659,1157,502,-4,34,53
1,2113,1833,280,2,575,125
-1,1874,1791,83,0,-35,86
1,1444,1510,-66,5,381,67
1,1425,1098,327,2,133,59
1,1530,1542,-12,-9,-271,83
-1,1805,1624,181,0,-132,70
-1,1450,1749,-299,0,-2,42
1,1684,1851,-167,0,149,113
1,1487,1474,13,-2,-4,45
1,1971,1905,66,0,123,101
-1,1827,2117,-290,3,103,96
1,1283,1429,-146,1,143,115
-1,1296,1694,-398,-1,-3,76
1,1415,1423,-8,2,436,93
-1,1277,1507,-230,3,85,66
-1,1378,1407,-29,-3,-31,42
-1,2121,1821,300,-4,-52,62
1,1750,1741,9,2,126,81
-1,1565,1744,-179,-1,-245,80
1,1463,1498,-35,3,377,97
1,1758,1659,99,-3,-124,115
-1,1409,1346,63,-4,-65,54
-1,1586,1557,29,0,-57,84
-1,1861,1895,-34,0,7,86
1,1624,1457,167,3,191,59
-1,1639,1764,-125,-2,-31,44
1,1426,1460,-34,0,365,145
1,1794,1302,492,1,237,87
0,1651,1596,55,1,514,104
1,1833,1644,189,0,1223,157
1,1433,1500,-67,-1,218,69
1,1759,1504,255,0,12,57
-1,1552,1736,-184,-2,-276,100
1,1731,1761,-30,0,4,75
1,1775,1825,-50,-1,-47,77
1,1631,1403,228,1,122,65
-1,1701,1781,-80,4,163,74
1,1094,1220,-126,-7,-272,121
1,1736,1750,-14,1,-29,87
1,1839,1753,86,-2,179,57
-1,1605,1570,35,-5,-94,52
1,1848,1637,211,3,73,47
1,1629,1493,136,4,135,53
-1,1559,1272,287,-1,-27,56
1,1439,1355,84,-1,5,69
1,1854,1631,223,9,277,62
1,1500,1764,-264,0,5,71
1,2097,1906,191,0,-139,99
-1,1398,1637,-239,-7,-98,40
1,1742,1547,195,1,-41,119
1,1626,1859,-233,4,89,45
-1,1750,1980,-230,0,-47,82
-1,1446,1768,-322,-2,-111,68
0,1852,1806,46,2,330,95
-1,1496,1470,26,0,-328,82
-1,1840,1646,194,0,178,84
1,1300,1320,-20,5,46,49
-1,1588,1772,-184,-4,-203,70
-1,1748,1742,6,-3,-238,96
-1,1325,1475,-150,-7,-44,44
-1,1388,1648,-260,-1,-77,52
1,1586,1590,-4,0,69,85
1,1790,1692,98,-6,112,93
1,1644,1421,223,3,150,73
-1,1787,1767,20,-1,-184,100
1,1842,1620,222,-1,-50,65
-1,1448,1450,-2,0,-22,44
-1,1649,1744,-95,0,73,50
-1,1900,2114,-214,-1,-151,84
1,1769,1694,75,0,23,57
1,1482,1484,-2,4,353,83
1,1518,1665,-147,-1,31,71
-1,1300,1572,-272,-6,-355,108
-1,1600,1499,101,1,25,45
1,1805,1395,410,7,263,61
1,1898,1623,275,5,148,53
-1,1737,1771,-34,-7,-94,52
-1,1289,1451,-162,-3,-363,130
1,1500,1500,0,5,97,47
1,1472,1494,-22,0,-5,67
-1,1586,1695,-109,-10,-811,170
-1,1679,1778,-99,-1,0,60
1,2128,1895,233,1,297,111
-1,1753,1235,518,-1,-129,72
1,1745,1870,-125,0,0,41
-1,1378,1658,-280,4,218,62
1,1467,1500,-33,-5,-14,109
1,1425,1556,-131,3,737,127
-1,1183,1223,-40,2,-134,68
-1,1481,1485,-4,-2,-210,74
-1,1781,1726,55,-3,-92,66
-1,1732,1808,-76,0,-321,202
1,1813,1772,41,4,181,69
-1,1703,1577,126,0,5,76
-1,1806,1721,85,-2,-266,91
0,1384,1137,247,5,825,110
-1,1414,1499,-85,-6,-431,70
-1,1757,1539,218,0,-327,151
-1,1515,1585,-70,0,-1,62
-1,1598,1707,-109,-7,-198,88
1,1547,1739,-192,0,0,79
-1,1683,1653,30,0,-18,88
-1,1500,1293,207,3,137,76
1,1559,1820,-261,1,97,67
-1,1291,1722,-431,2,17,40
-1,1871,1890,-19,-1,-134,90
-1,1331,1374,-43,-5,-161,54
-1,1496,1470,26,-2,81,74
1,1655,1538,117,-3,-27,49
1,1593,1544,49,11,113,41
-1,1739,1768,-29,0,-33,74
-1,1500,1569,-69,7,318,70
1,1534,1628,-94,2,40,51
-1,1663,1666,-3,-9,-524,70
1,1507,1403,104,8,285,51
-1,1649,1730,-81,-5,-472,74
-1,1476,1484,-8,-5,-260,94
1,1448,1385,63,3,113,61
1,1598,1671,-73,3,126,57
1,1321,1297,24,2,40,77
-1,1848,1901,-53,-3,36,102
-1,1345,1541,-196,0,-25,58
-1,1861,1791,70,-3,7,52
-1,1475,1724,-249,-1,-23,52
1,1674,1671,3,1,38,81
0,1154,1443,-289,3,-33,99
-1,1649,1748,-99,0,-662,108
1,1822,1785,37,5,225,59
1,1597,1548,49,0,13,85
-1,1505,1773,-268,-3,-137,70
1,1500,1021,479,14,331,47
-1,1560,1510,50,-3,-75,50
-1,1337,1137,200,-1,65,100
-1,1303,1567,-264,-1,-306,122
-1,1500,1411,89,5,170,54
1,1702,1490,212,6,106,49
-1,1566,1640,-74,1,-21,58
-1,1476,1594,-118,-10,-126,42
-1,1878,1906,-28,-1,-71,52
-1,1538,1634,-96,-2,-13,44
0,1640,1764,-124,0,-24,141
1,1938,1868,70,2,84,73
1,1547,1516,31,14,340,49
-1,1332,1500,-168,-6,-122,45
1,1729,1471,258,3,181,71
1,1677,1703,-26,0,83,103
1,1401,1671,-270,1,68,83
1,1500,1533,-33,1,16,45
-1,1370,1546,-176,2,74,112
-1,1549,1397,152,1,42,74
1,1626,1434,192,-7,-300,67
1,1659,1607,52,3,257,83
1,1429,1487,-58,-2,59,57
-1,1558,1505,53,-2,-181,100
1,1632,1534,98,5,147,57
-1,1357,1428,-71,-4,-820,102
1,1913,1770,143,0,14,67
1,1326,1467,-141,7,306,51
-1,1435,1164,271,-5,-516,102
1,1477,1470,7,0,181,89
-1,1411,1602,-191,-1,27,52
-1,1420,1296,124,-2,-1,64
1,2033,1576,457,6,974,109
1,1427,1500,-73,2,469,103
1,1445,1547,-102,1,30,51
-1,1487,1706,-219,-7,-738,112
1,1158,1364,-206,5,390,87
-1,1516,1783,-267,-4,-325,72
0,1323,1807,-484,-7,-265,112
1,1333,1331,2,0,-39,45
-1,1574,2035,-461,0,-483,108
-1,1299,1412,-113,0,-72,72
1,1451,1342,109,4,41,43
-1,1603,1688,-85,-2,-54,42
-1,1680,1617,63,-2,-110,78
-1,1832,1776,56,0,-99,96
1,1735,1757,-22,0,2,61
-1,1859,1964,-105,0,-90,74
-1,1711,1482,229,-3,-223,142
1,1544,1519,25,3,148,65
-1,1677,2037,-360,-2,-131,66
-1,1594,1788,-194,-2,-114,56
1,1731,1432,299,-2,252,107
-1,1742,1688,54,-4,-209,58
1,1793,1546,247,1,313,87
1,1461,1533,-72,1,33,47
-1,1334,1459,-125,-5,-293,72
1,2040,1671,369,2,6,41
1,1179,1346,-167,3,61,47
-1,1187,1417,-230,-9,-140,42
-1,1500,1692,-192,0,-219,110
-1,1317,1554,-237,0,44,84
1,1555,1607,-52,-2,28,111
-1,1428,1542,-114,-7,-66,44
1,1453,1395,58,0,13,45
1,1956,1782,174,0,-23,57
-1,1725,1747,-22,-3,-139,56
1,1531,1490,41,2,23,91
-1,1576,1631,-55,-1,-62,79
-1,1667,1945,-278,0,11,60
1,1598,1396,202,8,585,73
1,1291,1316,-25,-3,-104,101
-1,1696,1589,107,1,-17,92
1,1518,1458,60,-3,315,121
-1,1319,1516,-197,3,96,58
-1,1606,1390,216,-4,-163,110
-1,1949,1657,292,-1,103,80
-1,1305,1639,-334,-2,-213,90
-1,1535,1629,-94,0,-114,128
-1,1248,1568,-320,-5,-807,100
1,1735,1563,172,-7,180,107
1,1522,1313,209,0,-24,59
1,1588,1549,39,-3,345,107
-1,1580,1410,170,0,-151,54
1,1705,1930,-225,2,-147,65
1,1480,1540,-60,-2,-8,47
1,1475,1199,276,0,271,79
-1,1307,1527,-220,-8,-234,56
-1,1557,1429,128,-11,-367,64
1,1826,1702,124,-2,75,75
1,2037,2212,-175,0,371,161
-1,1747,1536,211,0,-566,104
1,1533,1302,231,2,49,69
1,1913,1840,73,0,1,57
-1,1447,1523,-76,4,46,64
-1,1776,1977,-201,-3,-622,170
1,1394,1539,-145,-3,-167,69
1,1440,1463,-23,-3,31,53
1,1771,1493,278,1,24,49
-1,1699,1500,199,-2,-67,52
-1,1436,1532,-96,0,-6,62
1,1707,1704,3,0,26,61
1,1623,1860,-237,3,157,74
0,1539,1597,-58,0,171,121
0,1452,1592,-140,-2,478,104
1,1292,1271,21,1,-117,51
-1,1427,1540,-113,0,-146,62
1,1693,1732,-39,0,81,57
-1,1179,1506,-327,-3,-328,76
1,1706,1705,1,-7,107,81
-1,1803,1688,115,-1,-43,70
-1,1303,1548,-245,-1,-21,56
-1,1303,1321,-18,-4,-58,68
1,1527,1506,21,0,317,129
-1,1303,1402,-99,-2,-62,41
1,1520,1673,-153,-2,181,123
-1,1630,1715,-85,-1,-191,110
-1,1694,1728,-34,0,-96,88
-1,1446,1452,-6,0,4,48
-1,1422,1553,-131,-5,-52,46
1,1891,1922,-31,0,-39,91
-1,1422,1553,-131,-1,-20,50
1,1560,1298,262,-1,25,61
1,1264,1500,-236,1,342,85
1,1747,1684,63,1,69,62
1,1414,1560,-146,-10,-42,47
-1,1910,1903,7,-1,-149,68
-1,1538,1519,19,1,-207,124
1,1641,1507,134,1,457,153
-1,1293,1564,-271,0,-242,80
-1,1596,1541,55,-1,1,40
-1,1521,1529,-8,-1,-89,56
1,1400,1360,40,-1,6,55
1,1675,1544,131,8,305,49
1,1583,1491,92,3,175,71
0,1777,1764,13,-1,-666,110
-1,1637,1431,206,2,189,48
1,1914,1898,16,-1,82,61
-1,1165,1124,41,-5,4,44
-1,1576,1612,-36,-1,-14,52
1,1568,1289,279,0,10,51
1,1619,1537,82,-2,-85,81
1,1557,1522,35,-1,52,75
-1,1643,1782,-139,-3,-302,98
1,1699,1628,71,-1,72,73
1,1764,1777,-13,0,89,117
-1,1887,1925,-38,8,207,90
-1,1285,1572,-287,-2,-140,80
-1,1873,1775,98,-2,-7,40
1,1443,1254,189,4,148,51
1,1583,1463,120,5,54,41
-1,1451,1525,-74,0,75,100
1,1724,1621,103,0,187,89
1,1536,1655,-119,1,332,115
1,1935,1877,58,0,-9,71
1,1302,1217,85,5,305,65
-1,1765,1784,-19,6,284,72
1,1576,1281,295,0,21,53
0,1593,1674,-81,-5,-285,133
1,1636,1440,196,1,105,127
1,1867,1944,-77,0,-13,107
-1,1277,1579,-302,-1,3,70
-1,1787,1797,-10,0,-24,108
1,1801,1754,47,14,464,53
1,2145,1960,185,-3,-28,101
1,1815,1242,573,0,301,65
-1,1343,1656,-313,-5,-528,70
-1,1383,1528,-145,1,16,48
-1,1745,1816,-71,-2,-148,76
-1,1455,1590,-135,0,4,60
-1,1567,2037,-470,1,-15,68
-1,1209,1310,-101,0,-212,120
1,1716,1489,227,3,21,41
1,1931,1881,50,-2,74,119
1,1829,1736,93,-2,41,63
1,1276,1168,108,21,424,43
-1,1727,1842,-115,1,71,92
-1,1871,1940,-69,-4,-11,64
-1,1318,1201,117,-8,-649,90
0,1089,1249,-160,-5,-199,64
-1,1954,2154,-200,-3,-66,50
1,1949,1862,87,0,-2,48
-1,1736,1853,-117,0,-47,78
1,1456,1520,-64,3,7,41
1,1484,1605,-121,4,209,67
1,1720,1637,83,12,370,51
1,1854,1958,-104,0,-18,65
1,1215,1304,-89,3,313,75
-1,1440,1657,-217,-3,-36,67
0,1642,1714,-72,-5,-409,105
-1,1551,1421,130,-5,-397,72
1,1550,1592,-42,1,178,79
1,1597,1448,149,3,152,69
1,1847,1728,119,-11,-111,67
1,1863,1586,277,6,349,61
-1,1628,1728,-100,0,-24,48
1,1457,1421,36,-2,455,117
-1,1589,1639,-50,-2,-314,120
-1,1612,1732,-120,0,-48,96
-1,1943,1868,75,0,39,80
-1,1768,1821,-53,0,-25,74
-1,1483,1568,-85,-4,-24,40
-1,1303,1400,-97,-7,-70,46
-1,1736,1620,116,-13,-314,54
-1,1582,1869,-287,-1,-269,104
1,1470,1240,230,3,136,63
1,1291,1228,63,-4,-55,57
-1,1529,1492,37,-4,-277,116
-1,1536,1613,-77,0,-113,100
-1,1882,1930,-48,-1,-118,68
-1,1635,1722,-87,1,-113,74
-1,1442,1728,-286,-4,-5,48
1,1732,1437,295,0,-4,41
-1,1594,1816,-222,-8,-171,50
-1,1940,1872,68,-1,-193,116
-1,1220,1300,-80,-2,17,60
-1,1227,1103,124,-5,-291,78
1,1730,1626,104,-1,-95,137
-1,1426,1743,-317,6,477,112
-1,1284,1421,-137,-12,-192,42
1,1626,1548,78,6,222,53
1,1442,1604,-162,4,746,105
-1,1343,1367,-24,-7,-103,50
-1,1644,1777,-133,0,-570,138
1,1885,1927,-42,-3,1611,163
1,1648,1752,-104,0,-28,67
-1,1308,1212,96,-6,-142,54
-1,1612,1548,64,-11,-861,82
-1,1419,1750,-331,-2,-106,52
1,1498,1522,-24,-2,-97,83
1,1435,1540,-105,2,123,60
1,1527,1646,-119,0,231,123
1,1618,1738,-120,4,88,55
-1,1399,1520,-121,1,-47,58
-1,1415,1753,-338,-10,-198,50
-1,1887,1925,-38,-8,-152,112
-1,1672,1949,-277,-1,-5,40
1,1761,1712,49,1,320,105
1,1225,1295,-70,-3,270,63
1,1757,1412,345,-3,-91,57
1,1578,1448,130,4,241,73
1,1597,1403,194,0,129,65
1,1723,1633,90,1,234,141
-1,1408,1760,-352,2,-563,144
-1,1604,1576,28,0,3,54
-1,1695,1633,62,0,-25,66
-1,1935,1877,58,0,-1,98
-1,1282,1238,44,0,-54,42
1,1588,1458,130,0,308,125
1,1580,1326,254,1,45,61
-1,1890,1922,-32,4,352,132
-1,1402,1766,-364,3,81,44
-1,1249,1270,-21,-12,-169,50
1,1637,1507,130,-1,23,65
-1,1624,1535,89,-5,-66,40
1,1526,1449,77,3,253,85
-1,1396,1772,-376,-1,-36,58
-1,1395,1641,-246,-1,-15,128
-1,1148,1510,-362,-6,-1002,112
1,1732,1809,-77,0,65,115
-1,1353,1648,-295,0,-7,46
-1,1280,1239,41,-7,-132,52
-1,1476,1412,64,2,65,66
-1,1586,1668,-82,-2,-34,54
1,1679,1657,22,3,341,137
1,1604,1560,44,-4,15,137
0,1610,1740,-130,2,112,122
1,1390,1538,-148,0,39,43
1,1251,1268,-17,3,935,91
1,1650,1554,96,3,596,121
1,1589,1591,-2,1,52,53
1,1785,1382,403,1,112,61
-1,1410,1432,-22,0,-6,48
-1,1719,1612,107,1,17,50
1,1644,1566,78,0,192,67
-1,1232,1475,-243,0,-75,58
1,1450,1595,-145,0,527,115
0,1257,1262,-5,-5,-396,145
0,1585,1711,-126,-3,159,152
1,1140,1410,-270,6,145,79
1,1661,1505,156,-2,-136,79
0,1500,1398,102,-4,-117,62
-1,1262,1258,4,1,61,66
-1,1684,1315,369,-1,-485,122
-1,1254,1403,-149,0,-8,42
1,1430,1314,116,6,143,49
-1,1557,1399,158,-3,-70,56
1,1924,1847,77,0,511,119
1,1441,1499,-58,1,100,79
-1,1577,1390,187,0,-74,80
-1,1600,1464,136,-3,6,50
1,1268,1251,17,-1,-128,59
1,1736,1614,122,3,78,65
1,1407,1428,-21,3,929,83
-1,1442,1649,-207,-1,-132,98
-1,1339,1481,-142,-2,-79,52
-1,1416,1542,-126,2,-2,53
1,1581,1466,115,1,38,79
0,1241,1278,-37,11,773,101
1,1733,1722,11,1,33,63
-1,1668,1801,-133,-3,-141,70
1,1579,1414,165,-3,221,117
-1,1651,1694,-43,0,-9,58
1,1277,1243,34,-5,-214,63
1,1935,1549,386,0,602,115
-1,1579,1503,76,0,-112,133
-1,1433,1631,-198,-2,-59,48
-1,1441,1521,-80,-2,-300,94
1,1322,1500,-178,-1,114,83
1,1808,1660,148,2,517,115
-1,1821,1712,109,0,1,68
1,1458,1588,-130,-2,375,99
-1,1607,1743,-136,1,64,60
1,1606,1683,-77,0,3,43
1,1233,1286,-53,5,314,109
1,1454,1487,-33,7,395,167
1,1333,1492,-159,4,106,65
1,1659,1611,48,8,106,41
1,1555,1409,146,-4,-40,67
-1,1736,1500,236,0,-48,104
1,1274,1245,29,6,600,93
1,1705,1512,193,9,624,83
-1,1470,1273,197,1,16,42
1,1350,1601,-251,0,-15,61
1,1236,1284,-48,18,367,47
1,1669,1578,91,3,51,49
1,1650,1532,118,3,55,46
-1,1255,1291,-36,-3,-85,44
-1,1758,1726,32,-2,-54,48
1,1606,1369,237,4,463,91
-1,1272,1247,25,-16,-429,60
1,1301,1153,148,13,295,49
1,1574,1547,27,-1,-32,65
-1,1425,1401,24,-1,155,92
1,1653,1199,454,12,156,41
1,1432,1453,-21,3,99,63
-1,1678,1519,159,-1,29,56
1,1364,1610,-246,1,69,65
1,1655,1018,637,6,137,41
1,1738,1746,-8,1,60,85
1,1563,1308,255,2,40,49
-1,1197,1357,-160,-3,-281,86
-1,1592,1383,209,-4,-266,72
1,1344,1320,24,0,-22,47
-1,1194,1388,-194,-8,-117,44
-1,1459,1550,-91,-5,-100,48
1,1669,1513,156,7,241,57
-1,1571,1428,143,0,-229,116
1,1734,1749,-15,1,219,85
-1,1560,1412,148,-10,-180,58
-1,1560,1605,-45,-3,-481,110
-1,1507,1711,-204,0,-105,98
-1,1565,1702,-137,0,-164,81
-1,1402,1575,-173,0,-253,114
-1,1572,1586,-14,-10,-287,68
-1,1738,1746,-8,-1,-245,114
1,1395,1178,217,-3,-77,51
-1,1941,1581,360,1,-28,103
1,1601,1545,56,6,68,45
1,1657,1117,540,0,24,49
1,1529,1444,85,-2,12,57
1,1757,1727,30,9,306,59
-1,1613,1532,81,0,4,92
1,1534,1443,91,1,113,78
-1,1016,1500,-484,-3,-92,44
1,1736,1421,315,0,21,49
-1,1610,1815,-205,0,-17,64
-1,1564,1823,-259,-7,-454,76
-1,1805,1452,353,-6,-214,66
1,1620,1540,80,-3,618,139
1,1406,1397,9,5,535,101
1,1297,1341,-44,-3,-63,55
1,1338,1573,-235,0,-9,65
-1,1630,1515,115,-1,-44,66
-1,1804,1884,-80,0,-97,98
1,1668,1527,141,0,84,71
1,1829,1559,270,-3,363,79
-1,1738,1839,-101,-1,-200,108
-1,1517,1559,-42,-3,-835,138
-1,1787,1555,232,3,17,46
1,1502,1558,-56,4,155,91
1,1737,1500,237,0,7,47
-1,1810,1835,-25,0,-39,62
1,1648,1704,-56,2,55,43
-1,1612,1770,-158,-4,-467,112
1,1641,1072,569,4,106,45
-1,1553,1546,7,0,-28,64
1,1634,1798,-164,-4,-17,87
-1,1769,1520,249,1,-437,130
-1,1487,1660,-173,1,-106,90
1,1555,1358,197,0,39,59
1,1401,1380,21,7,165,51
1,1850,1800,50,0,0,57
-1,1398,1800,-402,-3,-324,92
-1,1676,1502,174,-5,-243,102
1,1776,1605,171,4,104,57
1,1233,1375,-142,-1,16,57
-1,1790,1863,-73,-1,-41,48
-1,1578,1628,-50,-1,-387,144
-1,1411,1797,-386,0,31,42
-1,1618,1581,37,2,139,84
1,1875,1782,93,7,263,59
1,1803,1782,21,-3,-115,75
-1,1697,1328,369,2,-129,102
1,1892,1795,97,1,17,47
1,1620,1624,-4,-4,-13,45
1,1438,1208,230,11,223,47
-1,1396,1800,-404,1,48,54
-1,1931,1876,55,0,-8,58
-1,1582,1793,-211,-2,-38,114
1,1458,1376,82,0,71,65
-1,1471,1740,-269,2,21,46
-1,1438,1592,-154,1,59,64
1,1802,1415,387,0,13,51
-1,1500,1875,-375,-2,-147,93
-1,1500,1631,-131,-1,114,79
-1,1542,1520,22,0,-3,51
1,1507,1360,147,3,132,59
-1,1502,1384,118,-5,-41,56
1,1858,1658,200,0,369,107
-1,1422,1695,-273,-6,-117,40
-1,1564,1515,49,2,161,118
1,1675,1552,123,1,18,41
1,1554,1390,164,1,531,107
-1,1409,1807,-398,-2,-22,40
-1,1481,1807,-326,0,4,46
-1,1530,1628,-98,-3,-76,60
1,1634,1310,324,0,2,55
1,1905,1877,28,0,23,45
1,1771,1804,-33,2,105,57
1,1752,1467,285,5,274,85
-1,1790,1691,99,0,7,56
-1,1241,1349,-108,-10,-104,52
1,1683,1535,148,0,111,124
-1,1532,1530,2,-15,-168,48
-1,1462,1240,222,0,-11,46
1,1840,1907,-67,1,34,61
0,1659,1375,284,0,11,60
1,1622,1645,-23,9,465,65
-1,1867,1916,-49,-2,-116,78
1,1462,1500,-38,4,226,63
-1,1345,1483,-138,-3,-151,54
1,1677,1727,-50,-3,-11,61
1,1541,1520,21,13,711,71
-1,1217,1699,-482,-9,-169,54
-1,1623,1710,-87,-4,-108,86
-1,1646,1868,-222,-3,-69,64
1,1552,1399,153,0,29,59
1,1637,1604,33,0,23,61
-1,1535,1758,-223,-1,5,48
1,1891,1855,36,-1,-140,87
-1,1595,1974,-379,-2,-17,42
-1,1211,1599,-388,0,-459,110
-1,1663,1753,-90,2,-287,80
1,1215,1356,-141,-5,-238,71
-1,1655,1808,-153,-1,-136,78
-1,1456,1594,-138,4,290,84
-1,1336,1794,-458,-6,-69,58
1,1690,1632,58,-3,17,61
-1,1601,1797,-196,0,5,46
-1,1353,1554,-201,-8,-441,72
-1,1741,1560,181,0,-19,62
-1,1873,1910,-37,2,97,54
1,1509,1551,-42,4,172,53
-1,1511,1661,-150,-9,-10,46
-1,1715,1690,25,0,-55,70
0,1636,1521,115,2,609,121
1,1494,1377,117,0,32,67
1,1811,1678,133,14,512,55
1,1808,1814,-6,-1,91,65
-1,1335,1646,-311,-6,-172,82
-1,1732,1570,162,-4,-79,52
1,1470,1272,198,3,24,41
1,1521,1647,-126,-1,-17,59
-1,1649,1161,488,0,-470,96
1,1500,1544,-44,0,15,53
-1,2044,1828,216,-2,-135,72
-1,1346,1586,-240,9,352,62
1,1670,1437,233,-5,-81,67
-1,1340,1377,-37,-2,-250,120
-1,1337,1467,-130,2,-432,92
-1,1094,1132,-38,-3,-24,64
1,1539,1522,17,7,137,51
1,1857,2025,-168,0,59,89
1,1609,1365,244,-2,171,55
1,1550,1605,-55,2,254,74
-1,1476,1518,-42,1,2,40
1,1591,1206,385,0,301,115
-1,1538,1317,221,-1,-364,128
1,1675,1432,243,-1,9,67
-1,1314,1633,-319,-1,-75,78
1,1769,1698,71,0,12,57
-1,1079,1543,-464,2,-233,160
-1,1505,1752,-247,2,87,150
1,1511,1549,-38,-3,-112,69
1,1177,1241,-64,-3,-90,69
1,1926,2164,-238,1,20,45
-1,1762,1705,57,-1,-86,126
0,1562,1594,-32,0,89,126
-1,2008,1884,124,-2,-134,86
1,1680,1426,254,-1,-75,71
0,1420,1416,4,0,62,92
1,1678,1576,102,1,360,101
-1,1949,1963,-14,0,-191,132
0,1837,1649,188,0,209,87
1,1636,1621,15,1,35,55
-1,1466,1636,-170,-2,-177,78
1,1909,1991,-82,-5,28,69
-1,1474,1500,-26,-1,-112,68
1,1719,1528,191,4,69,45
-1,1422,1684,-262,1,-28,80
1,1819,1542,277,0,349,117
-1,1316,1633,-317,-6,-61,44
0,1464,1443,21,0,635,127
1,1538,1524,14,1,155,75
-1,1602,1777,-175,0,-27,84
1,1974,1563,411,-9,-17,57
1,1568,1338,230,2,113,51
-1,1511,1612,-101,0,4,50
-1,1524,1823,-299,3,175,124
-1,1593,1800,-207,-3,-107,56
1,1761,1588,173,-4,-98,55
-1,1701,1613,88,-1,-8,51
1,1483,1347,136,0,-11,43
1,1417,1689,-272,0,-51,59
-1,1484,1686,-202,-1,10,44
-1,1561,1976,-415,-7,-105,40
-1,1522,1410,112,-1,-245,152
1,1636,1276,360,1,32,55
-1,1574,1768,-194,1,57,48
-1,1559,1979,-420,-3,-63,62
1,1608,1749,-141,1,226,75
-1,1513,1548,-35,-2,-64,154
-1,1621,1652,-31,-1,64,96
1,1598,1578,20,-1,-51,47
-1,1669,1438,231,0,-1,48
0,1562,1600,-38,1,24,147
-1,1808,1944,-136,-8,-6,44
1,1643,1628,15,1,141,75
1,1226,1193,33,2,160,61
-1,962,0,962,-5,-320,66
-1,1645,1544,101,0,-9,52
1,1698,1500,198,-1,16,46
-1,1379,1426,-47,-4,-189,71
-1,1248,1639,-391,-1,-79,58
-1,1407,1225,182,2,-6,50
1,1544,1273,271,-8,-234,129
1,1470,1347,123,-5,-11,47
1,1719,1520,199,1,149,71
-1,1490,1510,-20,3,-35,48
-1,1135,1645,-510,-9,-284,56
-1,1509,1988,-479,-2,-738,110
1,1558,1503,55,-4,-232,73
1,1783,1525,258,1,68,79
1,1477,1509,-32,0,71,117
1,1700,1583,117,-2,-83,119
1,1497,1395,102,-7,-291,67
-1,1567,1631,-64,-3,-15,48
-1,1586,1463,123,-7,-128,52
1,1557,1587,-30,2,279,107
1,1268,1445,-177,4,88,51
-1,1327,1668,-341,0,-417,106
1,1633,1584,49,3,199,83
1,1960,1855,105,6,45,43
1,1654,1353,301,-1,-48,43
-1,1820,1990,-170,0,4,80
-1,1463,1694,-231,1,-33,68
0,1683,1815,-132,2,108,118
-1,1570,1997,-427,-5,-224,62
1,1703,1541,162,-7,17,55
1,0,1118,-1118,4,93,47
-1,1493,1567,-74,0,-22,64
-1,1568,1566,2,-2,-116,52
-1,1714,1835,-121,-4,-111,60
-1,1431,1699,-268,0,36,106
-1,1574,1504,70,-4,-198,64
-1,1439,1608,-169,-8,-276,60
-1,1347,1555,-208,-3,-94,58
1,1787,1568,219,4,399,93
1,1640,1553,87,1,38,61
-1,1847,1968,-121,0,7,60
-1,1517,1548,-31,-1,-12,48
1,1999,2019,-20,-1,-31,75
1,1815,1547,268,3,160,73
1,1313,1657,-344,-1,-30,79
1,1383,1456,-73,1,4,67
1,1717,1791,-74,5,107,56
-1,1401,1647,-246,-1,-552,98
-1,1500,1657,-157,-6,-102,48
-1,1321,1575,-254,4,38,58
1,1647,1194,453,-1,-27,43
-1,1440,1793,-353,-4,-6,40
-1,1683,1612,71,-1,-28,59
-1,1533,1733,-200,2,43,44
-1,1578,1556,22,0,-65,74
1,1796,1772,24,0,-9,45
-1,1500,1562,-62,0,-1104,112
-1,1624,1727,-103,-2,-189,70
1,1570,1353,217,-2,-10,53
-1,1307,1668,-361,-15,-62,40
1,1280,1516,-236,6,272,67
1,1822,1585,237,-7,-228,105
-1,1540,1623,-83,0,-25,80
1,1567,1409,158,13,241,47
1,1502,1418,84,2,515,147
1,1743,1597,146,2,99,57
-1,1641,1507,134,-2,-220,84
0,1368,1574,-206,3,11,161
-1,1521,1559,-38,3,66,68
-1,1712,2363,-651,0,35,86
1,1840,1703,137,-6,-84,67
-1,1485,1232,253,0,-204,98
-1,1479,1783,-304,-4,-395,92
1,1417,1342,75,2,41,79
1,1667,1387,280,3,212,77
1,1576,1583,-7,-5,73,77
1,1509,1738,-229,-7,251,151
-1,1673,1782,-109,1,70,126
-1,1761,1724,37,-1,-18,54
1,2364,1716,648,1,-29,63
-1,1590,1778,-188,-3,-59,68
1,1539,1537,2,1,-264,101
-1,1652,1711,-59,-6,-357,88
1,1735,1749,-14,-1,-63,77
1,1495,1550,-55,6,155,55
-1,1812,2368,-556,-1,21,144
1,1581,1481,100,-2,39,62
1,1846,1581,265,0,1,50
1,1527,1575,-48,2,121,63
1,1537,1539,-2,7,1162,125
1,1568,1292,276,0,20,65
1,2370,1768,602,14,300,45
1,1504,1548,-44,-1,94,65
1,1571,1494,77,0,4,71
-1,1674,1569,105,0,-84,74
1,1504,1617,-113,-2,524,105
1,1826,1850,-24,-1,-137,89
1,1545,1563,-18,-3,44,58
-1,1801,1628,173,0,-151,92
1,2372,1115,1257,5,202,59
-1,1115,2372,-1257,-1,-42,54
1,1552,1551,1,-2,-70,53
1,1535,1520,15,0,0,53
-1,1660,1734,-74,-6,-237,100
1,1696,1877,-181,1,68,109
-1,1529,1882,-353,-4,-92,100
1,1886,1811,75,-4,-57,97
1,1649,1797,-148,0,168,113
1,1318,1269,49,1,59,55
1,1871,1582,289,5,171,52
1,1662,1633,29,1,74,63
-1,1608,1577,31,-8,-213,76
1,1360,1798,-438,-1,88,77
-1,1546,1586,-40,-1,-446,116
-1,1227,1519,-292,2,-11,94
1,1577,1585,-8,0,81,75
-1,1623,1672,-49,-1,46,104
0,1575,1422,153,-9,-557,82
-1,1736,1429,307,-3,-197,92
-1,1744,1651,93,-3,-22,60
-1,1560,1336,224,0,-137,74
-1,1171,1535,-364,0,-238,82
1,1613,1682,-69,-2,-103,71
0,1843,1723,120,0,-35,98
1,1500,1642,-142,3,135,69
1,1536,1713,-177,0,10,59
1,2372,1662,710,1,24,67
1,1484,1257,227,2,86,41
-1,1930,1898,32,-8,22,78
1,1663,1567,96,-1,145,107
1,1332,1252,80,-4,-94,103
1,1489,1693,-204,1,37,71
-1,1348,1811,-463,-10,-155,47
-1,1321,1402,-81,-11,-161,58
1,1645,1730,-85,0,-8,67
-1,1912,1919,-7,0,-11,74
-1,1570,1792,-222,0,21,80
-1,1473,1617,-144,1,-11,64
1,1506,1471,35,-3,-217,149
-1,1617,1558,59,-7,-215,58
-1,1846,1943,-97,-2,-125,76
1,1518,1230,288,2,211,67
-1,1479,1400,79,8,81,68
-1,1651,1756,-105,-1,-211,104
1,1659,1715,-56,1,65,71
1,1493,1549,-56,7,272,59
1,1244,1355,-111,19,583,57
1,1592,1477,115,1,22,53
1,1322,1201,121,4,-86,65
1,1538,1503,35,7,413,83
1,1230,1521,-291,-1,24,47
1,1766,1643,123,-5,-42,71
-1,1624,1466,158,4,41,85
1,1388,1761,-373,1,153,85
1,1500,1541,-41,-1,-33,72
-1,1444,1413,31,0,-66,94
-1,1532,1696,-164,-4,38,84
1,1508,1336,172,0,80,87
1,1832,1958,-126,-2,-123,81
-1,1774,1635,139,0,-27,77
-1,1929,1899,30,1,78,108
-1,1346,1542,-196,-2,-111,64
-1,1370,1574,-204,0,-85,145
-1,1694,1683,11,0,-58,66
1,1959,1831,128,0,-6,55
-1,1571,1666,-95,0,6,66
-1,1469,1765,-296,0,27,126
0,1258,1298,-40,-9,-120,68
1,1571,1604,-33,2,266,65
-1,1496,1546,-50,-7,-567,128
1,1438,1428,10,4,489,145
1,1565,1544,21,0,8,61
1,1675,1698,-23,-1,-63,77
-1,1523,1513,10,-4,-96,58
1,1441,1505,-64,1,21,51
1,1556,1487,69,5,211,79
1,1351,1461,-110,0,56,81
-1,1279,1724,-445,-4,-122,90
0,1736,1261,475,3,288,136
-1,1553,1780,-227,-1,-26,50
-1,1512,1614,-102,0,-116,70
-1,1421,1320,101,-2,9,42
-1,1763,1694,69,-2,-49,68
1,1951,1838,113,0,-37,43
1,1535,1505,30,4,63,41
-1,1768,1527,241,-1,-226,97
-1,1914,1917,-3,-4,-257,72
1,1927,1902,25,0,2,47
1,1500,1452,48,4,329,77
1,1467,1561,-94,5,650,75
-1,1548,1237,311,-3,-232,86
1,1748,1272,476,0,577,145
1,1417,1503,-86,0,-27,69
-1,1338,1879,-541,-1,-162,82
1,1547,1336,211,1,84,43
-1,1317,1729,-412,-4,-82,42
-1,1501,1370,131,-2,-238,66
-1,1545,1989,-444,-4,-139,56
-1,1527,1622,-95,-2,5,82
-1,1311,1704,-393,6,225,66
1,1736,1559,177,-1,32,62
1,1486,1539,-53,0,455,163
-1,1500,1693,-193,-1,-84,46
1,1734,1328,406,7,76,41
-1,1520,1465,55,2,-88,94
-1,1707,1737,-30,0,16,66
-1,1913,1918,-5,0,-156,110
-1,1928,1901,27,4,80,74
-1,1237,1883,-646,-7,-241,50
-1,1505,1801,-296,-4,-240,62
0,1600,1812,-212,0,16,91
-1,1608,1672,-64,-8,-333,74
1,1723,1780,-57,-3,-55,63
1,1748,1562,186,2,169,67
1,1797,1884,-87,0,11,95
-1,1536,1327,209,-4,-335,84
1,1699,1493,206,0,58,55
1,1576,1612,-36,1,24,41
-1,1334,1293,41,-3,31,42
-1,1348,1518,-170,-11,-254,63
1,1687,1490,197,2,64,47
-1,1737,1570,167,-5,-58,60
1,1500,1405,95,-1,-175,77
1,1706,1203,503,6,151,43
1,1700,1744,-44,0,5,75
-1,1750,1659,91,-3,-67,48
-1,1481,1520,-39,-4,-82,54
-1,1750,1748,2,0,0,42
-1,1755,1542,213,-1,-138,60
1,1759,1739,20,0,66,77
1,1499,1418,81,-3,-4,53
1,1742,1408,334,0,276,79
1,1618,1712,-94,0,-42,93
1,1737,1379,358,0,-1,47
-1,1729,1770,-41,-3,-51,48
-1,1259,1527,-268,-4,-33,40
1,1482,1268,214,9,471,85
-1,1780,1720,60,-1,240,104
-1,1533,1440,93,-6,-141,60
0,1740,1784,-44,0,-26,130
-1,1674,1489,185,1,-9,66
-1,1729,1722,7,1,29,80
1,1824,1397,427,1,-14,43
-1,1771,1973,-202,-2,-49,40
-1,1332,1709,-377,-1,-52,58
1,1752,1754,-2,0,-104,89
1,1967,1790,177,1,-6,75
-1,1520,1569,-49,-1,-535,132
-1,1492,1413,79,-1,-14,70
-1,1449,1590,-141,-9,-445,67
1,1744,1755,-11,-2,-48,49
-1,1725,1621,104,-4,-58,50
-1,1500,1815,-315,-14,-178,40
1,1783,1742,41,0,19,63
1,1852,1388,464,2,84,79
-1,1532,1254,278,-1,20,68
-1,1172,1526,-354,-3,-83,82
-1,1392,1849,-457,0,0,80
1,1743,1754,-11,1,175,91
-1,1357,1409,-52,-10,-284,50
-1,1744,1755,-11,0,-14,50
-1,1471,1522,-51,-1,-537,108
-1,1394,1829,-435,-3,-146,62
1,1637,1707,-70,0,82,61
-1,1500,1854,-354,-1,-30,90
-1,1442,1484,-42,-6,-200,68
1,1513,1466,47,0,-3,41
1,1510,1395,115,1,115,97
-1,1421,1337,84,12,279,46
-1,1529,1493,36,0,3,50
1,1467,1442,25,7,887,107
-1,1450,1429,21,1,102,114
-1,1397,1418,-21,1,-8,44
1,1656,1427,229,1,11,51
1,1365,1404,-39,-1,-25,69
-1,1712,1625,87,-6,-78,44
-1,1492,1441,51,3,230,82
-1,1251,1506,-255,-1,-150,86
1,1690,1219,471,0,60,53
-1,1501,1748,-247,-2,-82,49
1,1713,1913,-200,-4,-70,73
-1,1692,1599,93,0,23,120
1,1389,1389,0,1,-172,73
-1,1396,1501,-105,-7,-93,58
-1,1207,1386,-179,-13,-361,52
-1,1896,1777,119,0,22,80
1,1869,1494,375,6,252,57
1,1818,1733,85,3,151,71
1,1478,1455,23,1,84,63
-1,1406,1810,-404,0,-37,50
-1,1500,1192,308,5,492,78
1,1131,1203,-72,-3,-99,81
1,1810,1406,404,1,53,53
1,1629,1581,48,3,129,62
-1,1368,1402,-34,1,62,56
1,1715,1676,39,-2,30,67
-1,1796,1765,31,0,4,54
1,1704,1505,199,1,146,77
1,1447,1259,188,1,113,59
-1,1365,1488,-123,1,19,46
1,1301,1429,-128,0,68,61
1,1507,1503,4,2,174,81
-1,1611,1444,167,-1,126,106
-1,1634,1580,54,0,-3,43
-1,1478,1477,1,7,159,44
1,1525,1253,272,1,93,63
1,1409,1358,51,-2,415,83
1,1419,1548,-129,1,156,123
1,1886,1857,29,1,128,65
1,1499,1733,-234,-3,-215,77
1,1571,1524,47,4,56,42
-1,1846,1896,-50,-1,0,44
1,1496,1332,164,5,881,139
-1,1494,1516,-22,-2,-48,58
1,1819,1752,67,0,9,71
0,1905,1836,69,1,293,121
1,1342,1420,-78,4,432,81
1,1838,1441,397,8,252,65
-1,1503,1580,-77,-11,-136,46
1,1600,1650,-50,0,-4,47
1,1248,1249,-1,-1,69,53
1,1488,1495,-7,1,224,91
1,1731,1469,262,-4,-54,97
1,1388,1317,71,3,362,63
1,1405,1363,42,-4,-158,55
1,1350,1522,-172,0,61,50
1,1497,1537,-40,1,105,73
1,1527,1400,127,2,-23,47
-1,1743,1827,-84,0,10,64
1,1841,1903,-62,9,198,41
-1,1419,1518,-99,-13,-168,41
-1,1526,1410,116,0,-108,89
-1,1500,1465,35,-12,-47,40
1,1695,1506,189,5,73,41
-1,1704,1784,-80,0,30,48
-1,1305,1399,-94,-7,-102,44
1,1348,1416,-68,-6,-190,87
-1,1238,1380,-142,0,-6,58
1,1571,1669,-98,0,1,45
1,2131,1038,1093,1,30,49
1,1418,1620,-202,-2,-40,53
-1,1484,1568,-84,-3,-37,54
1,1594,1722,-128,14,362,51
1,1486,1422,64,2,179,63
-1,1416,1916,-500,-13,-147,58
-1,1611,1595,16,1,13,50
-1,1681,1681,0,-5,-217,70
-1,1434,1566,-132,1,-37,70
-1,1500,1489,11,-3,-146,112
1,1392,1231,161,1,11,41
-1,1841,1638,203,-10,-358,58
-1,1534,1396,138,0,127,86
1,2131,1038,1093,4,46,45
1,1401,1368,33,-4,-33,65
1,1661,1774,-113,4,99,53
1,1534,1402,132,7,202,53
-1,1510,1722,-212,0,-73,80
1,1589,1499,90,-1,3,43
1,1701,1530,171,1,31,61
1,1860,1415,445,-1,-25,109
-1,1723,1680,43,-3,-378,70
-1,1680,1723,-43,5,283,56
-1,1476,1566,-90,0,61,98
-1,1413,2044,-631,0,-8,50
1,1556,1520,36,0,22,49
-1,1782,1714,68,-12,-163,50
-1,1835,1811,24,-1,-15,64
-1,1409,1260,149,-4,-82,48
1,1353,1412,-59,7,293,59
-1,1435,1798,-363,1,15,48
1,1746,1412,334,-15,-709,57
-1,1534,1394,140,-5,-121,48
1,1505,1612,-107,1,-2,49
-1,1505,1600,-95,0,-4,68
-1,1408,1754,-346,1,281,94
-1,1697,1754,-57,-5,-73,52
-1,1730,1505,225,2,88,52
1,1705,1526,179,-2,-114,81
1,1824,1822,2,0,12,57
1,1761,1405,356,-13,-518,75
1,1801,1818,-17,2,20,45
-1,1154,1217,-63,-8,-349,92
1,1562,1682,-120,2,102,57
1,1594,1234,360,-3,-25,43
1,1807,1813,-6,-3,-79,62
1,1372,1398,-26,4,300,63
1,1774,1410,364,-4,-135,47
-1,1599,1592,7,-1,21,58
-1,1602,1349,253,2,-2,50
-1,1609,1397,212,-4,-60,50
1,1498,1713,-215,4,228,65
-1,1804,1707,97,-2,128,148
1,1366,1566,-200,0,96,63
-1,1231,1596,-365,-3,21,69
0,1690,1801,-111,-1,-41,100
1,1565,1411,154,11,334,58
-1,1403,1731,-328,-7,-192,50
0,1565,1598,-33,-2,-216,89
-1,1740,1786,-46,-6,-633,104
-1,1520,1507,13,-5,-60,44
-1,1603,1588,15,-1,-16,80
0,1088,1237,-149,-2,83,117
1,1599,1228,371,4,89,41
1,1351,1192,159,7,265,55
1,1501,1487,14,-2,-35,49
-1,1687,1763,-76,-3,-65,54
1,1763,1687,76,-3,-62,65
1,1793,1741,52,-1,-112,87
-1,1373,1397,-24,-24,-391,44
-1,1678,1782,-104,-2,-71,62
-1,1241,1225,16,-5,-118,44
-1,1468,1337,131,6,9,42
1,1782,1678,104,0,324,89
1,1670,1798,-128,-4,-80,61
1,1223,1238,-15,0,154,73
-1,1835,1812,23,0,-123,106
1,1722,1424,298,2,58,67
-1,1360,1557,-197,-1,-243,72
1,1829,1685,144,-1,-4,63
1,1512,1516,-4,2,95,67
1,1769,1685,84,-1,-32,85
-1,1453,1569,-116,-15,-752,74
1,1524,1502,22,5,135,65
1,1676,1785,-109,8,373,51
1,1713,1614,99,5,74,43
1,1352,1562,-210,0,53,79
-1,1759,1691,68,-1,-47,62
1,1691,1759,-68,2,188,53
-1,1725,1588,137,-1,-4,40
1,1736,1704,32,3,332,87
1,1545,1377,168,1,193,81
1,1685,1803,-118,0,42,47
-1,1753,1694,59,1,60,54
-1,1606,1446,160,-1,-33,50
1,1710,1722,-12,-2,0,69
1,1729,1732,-3,10,489,63
-1,1368,1552,-184,0,67,48
-1,1730,1714,16,-9,-490,68
1,1227,1315,-88,3,43,51
-1,1718,1732,-14,-2,-204,82
1,1557,1360,197,0,29,63
-1,1699,1875,-176,-1,-87,86
-1,1692,1670,22,-1,-1,41
1,1713,1694,19,-3,-6,49
-1,1352,1563,-211,0,-172,128
-1,1556,1836,-280,-2,-6,46
1,1556,1562,-6,1,11,71
1,1881,1705,176,0,46,53
1,1491,1616,-125,-1,-6,46
1,1562,1730,-168,3,88,45
-1,1697,1738,-41,0,39,72
-1,1607,1452,155,0,17,53
1,1747,1687,60,-2,-34,43
1,1671,1727,-56,-2,-73,57
-1,1600,1556,44,2,48,70
1,1450,1284,166,-1,64,49
-1,1291,1491,-200,-8,-439,78
1,1103,1050,53,-1,-33,57
-1,1587,1569,18,0,167,78
1,1879,1232,647,2,211,101
1,1440,1296,144,6,58,40
-1,1276,1284,-8,0,-22,62
-1,1590,1553,37,2,40,42
1,1611,1539,72,-7,-185,57
1,1691,1650,41,7,198,55
-1,1830,1571,259,0,-210,118
1,1621,1452,169,3,176,59
1,1311,1297,14,9,436,67
1,1655,1529,126,6,122,49
1,1244,1587,-343,2,52,49
-1,1431,1424,7,-3,-1,80
1,1608,1115,493,1,235,89
1,1427,1145,282,13,391,53
-1,1745,1433,312,0,-81,56
1,1265,1146,119,-1,-3,47
-1,1456,1277,179,1,-41,60
1,1610,1581,29,0,23,67
-1,1711,1767,-56,0,-342,86
1,1575,1288,287,0,404,93
1,1570,1506,64,3,34,51
1,1661,1497,164,0,31,71
-1,1567,1432,135,-6,-182,50
1,1532,1375,157,0,5,59
-1,1447,1113,334,-1,-19,54
-1,867,0,867,-14,-689,66
-1,1266,1448,-182,0,-52,48
1,1892,1755,137,2,309,95
-1,1390,1552,-162,-1,-20,46
1,1701,1711,-10,-1,146,103
-1,1524,1636,-112,-8,-324,56
1,1713,1628,85,-1,-13,61
0,2064,1887,177,0,3,130
-1,1816,1974,-158,0,-195,158
1,1585,1662,-77,-3,18,53
1,1441,1209,232,5,486,101
1,1686,1387,299,0,138,75
1,1345,1453,-108,-11,-667,87
-1,1524,1543,-19,-11,-61,58
-1,1553,1735,-182,1,-445,102
1,1734,1840,-106,0,118,71
-1,1560,1727,-167,-1,-34,48
1,2068,1309,759,1,64,61
1,1728,1500,228,17,517,55
1,1383,1234,149,-2,7,43
1,1721,1743,-22,4,54,49
-1,1748,1826,-78,-1,-6,72
1,1546,1416,130,1,183,65
-1,1738,1980,-242,-8,-322,58
-1,1619,2068,-449,-1,27,64
1,1984,1732,252,4,775,89
1,1739,1834,-95,-1,5,59
-1,1802,1700,102,0,-10,94
-1,1381,1490,-109,0,-86,80
1,1698,1364,334,7,263,71
-1,1431,1497,-66,2,-61,64
-1,1562,1400,162,0,87,52
1,2071,1617,454,0,58,53
-1,1500,1566,-66,-1,-435,124
-1,1418,1544,-126,0,-23,50
-1,1767,1808,-41,-1,-185,74
1,1649,1506,143,8,386,67
0,1731,1607,124,-1,43,106
-1,1297,1525,-228,0,-120,124
-1,1324,1285,39,-3,-357,96
1,1470,1259,211,5,140,65
-1,1390,1319,71,-5,-103,56
-1,1718,1527,191,-4,-812,110
-1,1560,1402,158,-2,-2,54
-1,1726,1615,111,2,4,58
1,1652,1602,50,4,444,81
-1,1748,1826,-78,0,93,86
-1,1261,1327,-66,-1,-40,40
1,1584,1451,133,0,146,67
-1,1371,1262,109,0,41,80
1,1817,1757,60,1,192,97
-1,1717,1365,352,3,270,116
1,1584,1718,-134,2,100,63
1,1718,1584,134,-1,-186,97
0,1881,1899,-18,-5,-28,69
1,1389,1310,79,2,92,87
-1,1576,1699,-123,0,103,84
-1,1377,1351,26,-3,-142,76
1,1681,1278,403,-1,36,59
-1,1569,1708,-139,0,-10,84
1,1409,1363,46,0,205,67
1,1401,1329,72,1,29,47
-1,1298,1500,-202,1,373,116
-1,1310,1657,-347,-11,-542,66
1,1525,1460,65,-5,-38,89
-1,1700,1413,287,0,-331,152
1,1708,1592,116,-2,-22,77
-1,1699,1576,123,-1,-696,106
-1,1408,1554,-146,0,44,62
-1,1307,1288,19,0,-296,90
-1,1716,1562,154,-1,-59,68
1,1671,1276,395,0,79,63
-1,1409,1552,-143,0,6,42
-1,1567,1511,56,0,-635,188
-1,1411,1551,-140,2,-70,48
1,1558,1404,154,6,106,53
-1,1366,1241,125,-5,-211,60
-1,1578,1698,-120,3,-102,66
1,1566,1396,170,2,35,49
1,1545,1399,146,1,149,111
1,1846,1882,-36,1,50,71
1,1678,1734,-56,-1,-29,69
-1,1635,1714,-79,-3,-75,44
1,1538,1583,-45,7,70,44
-1,1384,1345,39,-5,-115,55
-1,1500,1583,-83,1,-29,58
-1,1560,1702,-142,1,-596,110
1,1697,1202,495,1,67,57
-1,1715,1366,349,0,-71,106
-1,1350,1370,-20,-5,-639,84
1,1663,1555,108,-3,74,141
1,1553,1307,246,-1,-32,51
-1,1655,1556,99,-4,-140,77
1,1593,1491,102,1,28,49
1,1401,1367,34,0,86,77
1,1294,1130,164,0,243,91
-1,1558,1739,-181,0,-81,58
1,1653,1662,-9,0,76,87
0,1569,1666,-97,-2,-161,82
-1,1698,1572,126,0,-195,94
1,1384,1579,-195,-3,21,61
-1,1547,1720,-173,0,-29,170
1,1420,1379,41,3,141,53
1,1340,1265,75,1,497,97
-1,1483,1603,-120,-7,-489,66
-1,1705,1835,-130,0,-232,116
1,1551,1673,-122,5,845,89
-1,1382,1368,14,-1,-88,60
1,1709,1401,308,-1,-136,67
-1,1401,1649,-248,1,58,84
-1,1567,1262,305,4,152,58
1,1649,1745,-96,-3,-38,69
1,1754,1722,32,9,41,43
-1,1490,1807,-317,-3,-101,50
-1,1916,1733,183,0,14,52
1,1891,1752,139,0,39,47
-1,1333,1215,118,-7,-353,68
-1,1726,1862,-136,0,-117,90
-1,1372,1500,-128,-4,-79,50
1,1793,1781,12,-1,48,90
-1,1406,1752,-346,0,-208,104
1,1487,1538,-51,16,1199,83
1,1454,1446,8,0,12,50
-1,1395,1593,-198,-5,-233,66
-1,1174,1501,-327,-2,-78,66
-1,1592,1512,80,-5,-127,92
-1,1615,1574,41,-2,-387,96
-1,2119,1899,220,0,24,72
-1,1692,1600,92,-2,-65,56
1,1718,1937,-219,0,89,101
-1,1446,1545,-99,-2,-128,65
-1,1588,1582,6,-2,-36,42
1,1869,1718,151,0,71,65
-1,1611,1499,112,-5,266,88
1,1735,1660,75,1,159,67
-1,1745,1754,-9,-4,-21,58
1,1317,1225,92,4,173,55
1,1756,1397,359,3,192,76
-1,1415,1668,-253,-2,-443,108
0,1513,1651,-138,-10,-300,56
1,1438,1490,-52,0,178,87
-1,1712,1875,-163,-2,-33,52
1,1748,1783,-35,1,28,51
0,1646,1517,129,17,1183,79
-1,1440,1577,-137,-1,-607,96
1,1512,1410,102,-3,-59,47
-1,1898,1771,127,1,224,122
-1,1521,1642,-121,-8,-551,82
1,1583,1362,221,2,298,99
0,1732,1972,-240,0,66,128
1,1882,1705,177,0,101,75
1,1465,1329,136,6,384,63
-1,1577,1690,-113,3,75,52
0,1366,1667,-301,3,219,107
1,1496,1552,-56,2,10,51
1,1503,1577,-74,2,34,49
1,1739,1742,-3,0,430,89
1,1652,1588,64,2,295,139
1,1919,1760,159,1,63,63
-1,1500,1445,55,-2,-18,41
0,2047,1810,237,0,529,126
1,1444,1500,-56,0,4,53
-1,1761,1808,-47,0,-40,100
-1,1579,1661,-82,-1,-24,40
-1,1326,1212,114,6,315,76
1,1751,1963,-212,4,256,65
1,1757,1660,97,-1,18,59
-1,1595,1539,56,0,-207,119
-1,1214,1876,-662,-1,-226,100
0,1817,2040,-223,-1,-97,98
1,1458,1579,-121,-1,3,53
1,1734,1794,-60,-2,-52,95
0,2034,1824,210,1,192,132
1,1769,1663,106,0,17,53
-1,1374,1222,152,-3,-44,46
-1,1545,1613,-68,-1,-32,48
1,1893,1693,200,0,-5,95
1,1338,1060,278,-1,-76,51
1,1927,1659,268,3,132,65
1,1450,1603,-153,3,51,41
1,1650,1626,24,7,344,71
-1,1654,1777,-123,-3,-36,120
-1,1831,2027,-196,-1,-133,88
-1,1483,1463,20,-3,-55,54
1,1783,1699,84,0,4,47
-1,1311,1548,-237,6,183,58
1,1520,1582,-62,1,131,85
1,1655,1931,-276,0,59,75
0,2033,1825,208,0,138,112
1,1691,1792,-101,-3,211,87
1,1882,1559,323,5,116,51
1,1552,1268,284,1,45,59
-1,1498,1665,-167,2,137,102
1,1587,1563,24,-10,-23,43
1,1831,1941,-110,1,219,73
-1,1755,1760,-5,-2,-39,42
1,1500,1398,102,11,648,89
-1,1571,1536,35,0,-87,76
1,1777,1705,72,-3,-26,55
1,1922,1847,75,-5,338,79
1,1453,1428,25,-3,-9,61
-1,1561,1623,-62,0,5,70
-1,1898,1873,25,0,-8,94
1,1847,1672,175,-1,920,97
-1,1471,1734,-263,-2,-44,60
1,1275,1329,-54,-3,-49,51
-1,1666,1853,-187,-8,-484,78
-1,1332,1500,-168,-5,130,54
1,1371,1450,-79,6,208,57
1,1910,1474,436,1,254,85
1,1860,1660,200,-1,53,73
1,1895,1887,8,-4,-461,97
1,1506,1293,213,1,-39,99
1,1485,1567,-82,0,1,55
-1,1415,1485,-70,0,-190,120
-1,1654,1866,-212,0,-255,74
1,1809,1732,77,-3,215,131
-1,1467,1568,-101,-1,6,52
-1,1871,1648,223,-1,321,106
-1,1743,1725,18,-3,-107,60
-1,2027,1731,296,-6,-278,70
-1,1265,1511,-246,-9,-66,54
1,1499,1500,-1,0,0,47
1,1549,1241,308,-6,-17,75
-1,1341,1669,-328,-5,-146,50
-1,1342,1312,30,-4,-274,68
1,1933,1852,81,6,67,43
1,1912,1885,27,0,39,91
-1,1473,1623,-150,-3,-64,48
1,1843,1944,-101,0,-54,77
1,1324,1378,-54,-7,104,71
1,1565,1609,-44,1,33,44
1,1819,1578,241,2,63,59
1,1459,1652,-193,-1,116,101
-1,1239,1426,-187,-5,-227,58
1,1568,1578,-10,1,43,55
-1,1787,2007,-220,-6,-286,54
1,1891,1639,252,0,25,75
1,2192,1720,472,1,29,47
0,1234,1552,-318,-1,-89,78
-1,2012,1781,231,-1,16,68
1,1924,1834,90,9,205,59
-1,1245,1338,-93,-8,-213,52
1,1750,1577,173,2,101,41
-1,1395,1686,-291,-2,-45,52
-1,1717,2194,-477,0,-140,76
1,1497,1500,-3,2,306,67
-1,1823,1672,151,0,-21,54
1,1883,1345,538,3,448,95
1,1796,1933,-137,1,70,55
1,2196,1714,482,2,515,79
-1,1189,1338,-149,-7,-160,60
1,1800,1571,229,-1,70,47
-1,1544,1250,294,-1,-10,58
-1,1505,1417,88,0,-201,62
1,1807,1590,217,-1,-49,55
-1,1336,1750,-414,0,-26,72
1,1742,1428,314,1,73,59
-1,1631,1404,227,2,164,68
0,1420,1355,65,0,-109,118
1,1810,1784,26,1,4,61
1,2199,1048,1151,10,633,65
-1,1432,1491,-59,3,300,120
-1,1452,1587,-135,0,-48,64
1,1584,1812,-228,-3,71,99
1,1896,1556,340,0,67,79
-1,1528,1128,400,-10,-767,80
-1,1345,1466,-121,-3,-705,96
1,1424,1747,-323,-1,-15,45
-1,1395,1822,-427,0,-19,42
1,1748,1574,174,2,50,54
1,1525,1588,-63,0,83,75
-1,1124,1479,-355,-5,-188,56
1,1575,1233,342,3,372,81
1,1793,1702,91,0,13,61
0,1748,1730,18,0,14,97
1,1756,1821,-65,3,264,76
-1,1508,1432,76,2,147,80
1,1770,1807,-37,4,574,105
1,1330,1405,-75,-4,-98,69
-1,1413,1509,-96,0,149,109
-1,1626,1500,126,0,-11,50
-1,1447,1720,-273,-2,-75,44
-1,1382,1362,20,-6,-221,68
1,1553,1337,216,4,565,95
1,1473,1484,-11,0,-31,67
-1,1542,1376,166,-3,-37,46
1,1481,1594,-113,0,30,41
1,1694,1604,90,-2,147,135
-1,1205,1326,-121,0,-35,80
-1,1331,1558,-227,-10,-388,60
-1,1395,1524,-129,0,-4,42
-1,1485,1461,24,-9,-644,78
-1,1369,1712,-343,0,-145,128
-1,1606,1672,-66,-3,-179,60
-1,1423,1719,-296,0,-21,59
-1,1392,1449,-57,0,-36,54
-1,1459,1495,-36,-9,-134,44
1,1458,1381,77,2,34,53
-1,1429,1740,-311,-2,-55,64
1,1173,1182,-9,0,308,93
-1,1487,1588,-101,-7,-211,56
1,1159,1508,-349,0,354,103
-1,1782,1710,72,-1,-38,60
-1,1455,1464,-9,0,-66,66
0,1196,0,1196,0,14,65
1,1334,1484,-150,2,102,75
1,1718,1779,-61,0,-13,71
1,1406,1500,-94,6,207,53
-1,1397,1935,-538,1,-29,56
1,1936,1395,541,-2,29,47
1,1993,1323,670,14,337,45
-1,1474,1473,1,4,52,54
-1,1742,1766,-24,-2,-127,86
1,1701,1765,-64,1,1,45
1,1753,1551,202,4,195,69
-1,1394,1937,-543,-9,-90,47
-1,1687,1776,-89,0,3,46
1,2199,1666,533,-1,-14,65
1,1763,1701,62,0,81,71
1,1939,1717,222,3,39,45
-1,1998,1795,203,-3,141,74
-1,1484,1464,20,-2,-70,62
-1,1814,1980,-166,-8,-255,74
1,1569,1305,264,0,14,43
1,1717,1772,-55,-2,0,109
1,1759,1739,20,0,37,67
1,1987,1807,180,9,264,59
-1,1721,1770,-49,-1,195,104
-1,1164,1199,-35,-1,-8,110
-1,1494,1582,-88,-6,-851,106
-1,1433,1746,-313,-6,-244,58
1,1473,1529,-56,-1,4,53
-1,1771,1765,6,-5,-242,74
-1,1727,1766,-39,0,-391,82
1,1766,1727,39,0,105,75
1,1776,1814,-38,0,-24,77
1,1771,1251,520,9,169,45
1,1573,1457,116,-3,233,133
1,1517,1359,158,0,363,115
1,1712,1776,-64,0,-11,105
-1,1789,1664,125,-2,-701,148
1,1675,1481,194,2,85,49
-1,1763,1731,32,-2,-26,40
1,1803,1788,15,-6,-3,131
1,1900,1134,766,4,330,87
0,1500,1486,14,1,105,94
-1,1359,1177,182,1,57,66
-1,1748,1751,-3,1,-404,96
1,1686,1767,-81,0,238,110
-1,1322,1406,-84,-4,-177,54
1,1858,1762,96,3,186,79
1,1840,1739,101,1,37,51
1,1563,1582,-19,0,250,91
-1,1450,1581,-131,-2,-302,129
1,1733,1993,-260,0,-59,65
-1,1700,1753,-53,-1,-15,52
1,1366,1243,123,1,294,117
-1,1754,1867,-113,5,91,48
-1,1763,1690,73,0,-36,76
1,1973,1758,215,-1,-21,57
1,1899,1484,415,0,-2,95
-1,1867,1754,113,6,-137,118
1,1351,1523,-172,4,236,57
1,1704,1749,-45,0,197,69
1,1768,1875,-107,5,114,55
1,1476,1336,140,-2,-16,111
1,1782,1860,-78,0,3,61
0,1736,1716,20,0,75,116
1,1425,1575,-150,-1,-22,73
1,1795,1846,-51,0,-16,47
-1,1795,1717,78,1,8,44
-1,1370,1438,-68,1,32,64
-1,1735,1833,-98,-11,-593,100
1,1731,1807,-76,0,206,98
1,1833,1735,98,6,220,67
1,1507,1571,-64,7,467,101
-1,1797,1715,82,0,16,66
1,1503,1427,76,2,39,43
1,1302,1517,-215,4,47,45
1,1727,1841,-114,-2,-88,57
1,1766,1453,313,0,12,62
-1,1485,1684,-199,0,-34,54
-1,1635,1827,-192,0,-120,132
1,1826,1742,84,4,361,91
-1,1277,1455,-178,-1,-175,66
-1,1500,1322,178,-1,-273,102
1,1559,1444,115,-2,17,117
1,1733,1526,207,-2,-75,65
-1,1412,1565,-153,-2,-120,66
0,1835,1744,91,0,-383,129
1,1341,1483,-142,0,25,43
1,1721,1515,206,-1,-82,51
1,1515,1721,-206,9,424,69
1,1467,1359,108,-5,-106,41
1,1747,1832,-85,3,182,69
-1,1818,1761,57,-1,-141,108
1,1769,1500,269,-1,40,63
-1,1694,1543,151,0,-75,82
-1,1435,1567,-132,-9,-321,60
-1,1261,1801,-540,1,23,56
1,1605,1401,204,0,101,69
1,1793,1785,8,-5,51,141
1,1552,1664,-112,-1,-78,63
1,1664,1552,112,-4,-192,59
1,1746,1728,18,0,-40,77
-1,1775,1728,47,-1,-71,67
1,1539,1359,180,-2,-69,53
-1,1804,1972,-168,-5,-519,90
-1,1500,1630,-130,-4,-427,100
1,1972,1804,168,3,805,137
1,1562,1379,183,0,-5,43
1,1635,1582,53,0,17,75
1,1833,1736,97,1,69,99
-1,1505,1800,-295,-1,-97,58
-1,1641,1519,122,-1,-34,58
-1,1959,1766,193,-4,-34,42
-1,1166,1765,-599,-15,-176,41
1,1660,1616,44,0,-11,49
1,1614,1609,5,-1,-34,93
1,1915,1912,3,0,-26,131
1,1648,1598,50,0,-6,51
1,1529,1590,-61,5,242,117
-1,1340,1242,98,-9,-300,56
-1,1502,1592,-90,3,35,64
-1,1434,1497,-63,1,54,63
0,1500,1707,-207,0,-198,129
1,1612,1565,47,0,583,107
1,1882,1831,51,0,-8,67
-1,1482,1787,-305,-6,-75,54
1,1520,1666,-146,0,-54,77
-1,1097,1564,-467,-19,-238,48
-1,1668,1736,-68,0,-100,84
-1,1710,2015,-305,0,-4,66
1,1788,1798,-10,3,152,69
-1,1556,1634,-78,0,-92,96
0,1333,1214,119,-4,-81,64
-1,1682,1572,110,-1,-76,54
-1,1376,1697,-321,-4,-145,58
1,1863,1707,156,2,49,113
-1,1450,1618,-168,-1,-11,40
1,1580,1430,150,1,275,103
1,1891,1807,84,-3,297,117
1,1764,1791,-27,0,-24,69
1,1547,1297,250,9,242,45
-1,1652,1932,-280,0,-65,82
1,1821,1447,374,-1,-272,155
-1,1450,1625,-175,0,-190,92
-1,1669,1942,-273,0,-77,78
-1,1474,1406,68,-1,22,75
1,1534,1344,190,0,-14,59
-1,1649,1927,-278,0,-32,82
1,1523,1455,68,-1,60,57
-1,1545,1573,-28,0,-76,66
-1,1936,1690,246,0,-106,94
1,1700,1606,94,-2,-46,61
-1,1626,1985,-359,0,-321,110
-1,1326,1540,-214,7,138,52
-1,1373,1254,119,-3,-108,80
1,1637,1668,-31,1,27,61
-1,1448,1332,116,-4,-135,74
1,1500,1525,-25,-1,64,91
1,1341,1320,21,8,364,73
1,1926,1793,133,0,34,99
-1,1326,1548,-222,-7,-73,44
1,1783,1938,-155,0,19,45
1,1297,1550,-253,-3,47,53
-1,1336,1444,-108,0,-307,136
-1,1423,1586,-163,-3,-690,106
-1,1576,1522,54,-1,-28,56
1,1300,1481,-181,-1,16,93
-1,1532,1346,186,-1,23,64
-1,1859,1769,90,1,105,130
-1,1246,1565,-319,1,-57,118
-1,1381,1605,-224,0,-42,74
-1,1447,1615,-168,-1,-147,114
1,1611,1534,77,1,210,77
-1,1657,1747,-90,0,-492,100
1,1770,1761,9,0,308,85
-1,1701,1872,-171,2,-171,148
1,1351,1514,-163,1,35,53
-1,1386,1766,-380,-1,-44,62
-1,1389,1516,-127,1,68,72
1,1797,1623,174,6,517,97
1,1511,1479,32,7,815,95
1,1486,1470,16,0,127,69
-1,1508,1756,-248,-3,-78,50
1,1523,1371,152,-1,-81,51
-1,1579,1826,-247,-1,-80,64
1,1665,1682,-17,-1,-22,61
-1,1749,1781,-32,-4,-489,84
-1,1679,1939,-260,0,-181,80
-1,1280,1534,-254,-1,-32,47
-1,1331,1528,-197,-3,-25,46
1,1779,1729,50,-1,-20,41
1,1799,1803,-4,0,37,155
1,1528,1571,-43,0,-4,69
1,1356,1530,-174,13,383,53
1,1900,1923,-23,0,22,67
-1,1442,1622,-180,1,-204,80
-1,1677,1934,-257,-2,-402,78
1,1792,1738,54,0,79,79
-1,1291,1535,-244,6,32,68
-1,1375,1533,-158,-5,-645,104
0,1417,1760,-343,1,20,124
-1,1218,1127,91,-6,-140,66
1,1782,1518,264,7,257,51
-1,1890,1911,-21,0,-59,73
-1,1675,1752,-77,0,82,94
-1,1418,1765,-347,-7,-112,48
1,1499,1423,76,-3,-41,57
-1,1367,1458,-91,-1,-122,78
-1,1492,1481,11,-3,-62,46
-1,1644,1754,-110,2,-177,122
-1,1727,1802,-75,-5,-89,52
1,1405,1508,-103,5,43,45
-1,1539,1533,6,2,-48,62
1,1494,1433,61,-1,-98,67
1,1286,1072,214,3,235,115
-1,1718,1948,-230,0,23,130
1,1921,1863,58,0,-24,81
-1,1672,1944,-272,-3,-64,52
-1,1585,1787,-202,-2,-110,66
-1,1217,1394,-177,-4,-187,52
1,1756,1666,90,-3,-88,63
-1,1444,1464,-20,-1,-133,78
-1,1384,1587,-203,-2,-171,78
-1,1416,1503,-87,-1,116,62
-1,1343,1194,149,-4,-108,56
-1,1503,1477,26,-2,46,78
-1,1521,1450,71,0,136,76
-1,1725,1672,53,0,-141,80
1,1782,1713,69,-1,-22,71
1,1511,1401,110,-1,-80,61
-1,1677,1720,-43,-3,-26,48
1,1799,1804,-5,4,182,65
1,1487,1625,-138,13,344,48
1,1953,1762,191,-3,-187,99
1,1540,1427,113,0,-71,75
1,1549,1548,1,-1,-69,89
1,1387,1519,-132,-1,54,61
-1,1498,1534,-36,0,36,68
1,1670,1569,101,2,704,85
1,1648,1741,-93,0,131,67
-1,1496,1615,-119,-3,-92,46
-1,1840,1788,52,0,-23,64
-1,1438,1601,-163,3,195,78
-1,1756,1960,-204,0,-27,92
-1,1603,1504,99,1,-637,146
1,1247,1345,-98,2,139,107
-1,1359,1596,-237,0,-43,68
1,1504,1412,92,-5,-145,67
-1,1629,1703,-74,-1,-24,48
-1,1213,1326,-113,-1,-298,84
-1,1457,1400,57,0,-4,58
0,1422,1427,-5,0,-85,92
-1,1771,1798,-27,1,-30,58
1,1653,1666,-13,4,60,45
1,1966,1683,283,1,19,47
1,1661,1541,120,0,-91,89
1,1399,1512,-113,7,106,53
1,1712,1612,100,5,81,43
1,1545,1527,18,-1,-56,43
-1,1584,1315,269,0,-106,108
1,1628,1325,303,0,109,76
0,1970,1668,302,-1,-99,122
-1,1447,1595,-148,0,3,46
1,1498,1422,76,-1,73,59
-1,1597,1721,-124,-1,-24,86
1,1793,1809,-16,0,46,95
1,1811,1682,129,0,-23,83
1,1500,1556,-56,7,255,55
-1,1696,1962,-266,0,30,68
-1,1408,1507,-99,-2,-15,48
-1,1631,1432,199,-4,-200,98
-1,1682,1967,-285,-5,-14,50
1,1879,1694,185,3,191,75
1,2075,1901,174,0,377,101
-1,1514,1609,-95,-2,-304,88
-1,1378,1481,-103,-5,-28,40
1,1801,1655,146,3,30,45
1,1584,1477,107,1,33,51
1,1515,1396,119,2,70,57
-1,1670,1971,-301,0,-7,64
1,1548,1398,150,-1,53,57
-1,1831,1997,-166,-2,-43,60
-1,1894,2082,-188,-3,-715,112
-1,1659,1975,-316,2,46,48
0,1519,1584,-65,3,191,83
-1,1386,1522,-136,-2,15,52
1,1486,1546,-60,-1,292,81
1,1932,1598,334,-3,346,105
0,1581,1602,-21,2,83,120
-1,1565,1612,-47,2,-64,80
1,2089,1889,200,2,43,49
-1,1665,1804,-139,1,128,96
1,1797,1542,255,-3,-102,73
1,1337,1247,90,1,-16,51
1,1529,1376,153,-4,20,65
-1,1674,1827,-153,0,-16,50
1,1335,1203,132,1,5,59
-1,1667,1730,-63,0,-96,82
-1,1679,1979,-300,0,-84,70
-1,1634,1414,220,2,17,114
-1,1593,1935,-342,0,-184,78
-1,1448,1559,-111,3,349,84
1,1743,1322,421,-3,-53,59
-1,1366,1536,-170,4,38,50
1,1322,1419,-97,3,139,91
1,2003,1824,179,0,118,87
1,1648,1505,143,4,84,48
1,1983,1675,308,0,-120,89
1,1447,1288,159,-3,14,85
-1,1542,1358,184,-6,-152,56
-1,1938,1684,254,0,-135,138
1,1812,1840,-28,1,20,55
-1,1581,1521,60,-4,-302,100
1,1946,1774,172,0,77,81
-1,1380,1526,-146,2,-47,78
1,1525,1433,92,1,505,93
1,1515,1447,68,0,34,69
1,1373,1286,87,1,571,153
1,1817,2009,-192,0,101,69
1,1588,1918,-330,0,48,57
-1,1498,1554,-56,-1,-635,140
1,1447,1381,66,3,289,91
1,1366,1315,51,3,292,81
1,1649,1344,305,2,503,91
1,1904,1811,93,-2,133,81
-1,1886,1970,-84,-3,-368,114
-1,1532,1371,161,0,9,52
1,1195,1342,-147,-5,-140,51
-1,1392,1517,-125,0,1,56
1,916,1451,-535,2,40,49
1,1786,1895,-109,1,187,107
-1,1205,1813,-608,-6,-336,70
1,1817,1823,-6,0,-73,69
1,1658,1763,-105,1,73,51
1,1354,1320,34,2,46,45
-1,1880,1800,80,-1,-331,150
-1,1597,1467,130,0,-6,58
-1,1201,1385,-184,-13,-150,48
-1,1548,1627,-79,-3,-133,64
1,1715,1682,33,-1,677,119
1,1620,1524,96,-1,27,53
1,1326,1213,113,-5,359,101
1,1537,1365,172,-1,-9,53
1,1772,1854,-82,-4,16,57
1,1577,1544,33,2,571,137
1,1435,1527,-92,0,-4,54
-1,1653,1671,-18,0,7,42
-1,1671,1725,-54,2,-531,114
-1,1489,1506,-17,-1,-64,70
-1,1358,1544,-186,-3,-7,48
1,1739,1658,81,0,26,85
-1,1633,1785,-152,-1,-124,108
-1,1372,1516,-144,-1,-174,68
-1,1563,1488,75,-1,-104,92
1,1549,1351,198,-2,-81,69
1,1735,1661,74,6,380,71
-1,1700,1838,-138,1,-158,88
-1,1334,1678,-344,-3,-405,116
1,1813,1792,21,1,35,89
0,1651,1744,-93,-2,52,117
-1,1344,1555,-211,0,47,54
0,1756,1767,-11,0,-26,102
1,1681,1295,386,3,178,67
1,1816,1623,193,-4,-182,85
-1,1500,1768,-268,-4,-75,53
-1,1337,1537,-200,-4,-92,50
1,1560,1338,222,0,-100,53
1,1741,1654,87,-7,-289,95
1,1511,1462,49,4,63,45
-1,1555,1657,-102,1,7,96
-1,1332,1565,-233,2,112,60
-1,1646,1750,-104,-1,-169,68
1,1840,1545,295,0,382,95
-1,1538,1589,-51,-2,-131,63
1,1656,1514,142,0,387,109
1,1502,1550,-48,0,312,81
-1,1542,1420,122,-4,-73,70
1,1667,1851,-184,-1,766,165
1,1570,1326,244,-3,-119,59
-1,1541,1855,-314,-14,-760,70
1,1782,1822,-40,0,1,53
-1,1527,1475,52,-3,-439,80
-1,1321,1575,-254,1,69,76
1,1867,1538,329,14,350,53
1,1598,1347,251,0,8,53
-1,1309,1448,-139,-3,-983,110
1,1291,1359,-68,7,211,63
-1,1670,1650,20,-3,-235,116
1,1539,1652,-113,-1,45,82
-1,1641,1840,-199,0,-51,96
-1,1599,1993,-394,0,-258,72
-1,1154,1683,-529,-5,-340,68
1,1884,1878,6,0,105,89
1,1227,1517,-290,0,789,85
-1,1246,1319,-73,0,-6,50
-1,1534,1590,-56,-18,-313,54
-1,1614,1758,-144,-10,-227,66
1,1842,1895,-53,3,178,53
1,1342,1340,2,0,517,105
1,1523,1364,159,1,473,85
1,1789,1723,66,0,-1,64
1,1811,1794,17,3,389,96
1,1995,1597,398,3,299,81
-1,1727,1553,174,0,6,47
1,1204,1432,-228,-2,-50,109
1,1882,1764,118,-2,-96,93
1,1583,1334,249,4,208,77
-1,1749,1772,-23,2,253,104
-1,1344,1313,31,-2,-997,142
-1,1500,1835,-335,-5,-255,94
-1,1684,1710,-26,-10,-149,110
1,1664,1343,321,2,6,47
1,1410,1094,316,4,659,93
1,1337,1476,-139,0,-76,131
-1,1598,1502,96,-1,72,66
0,1340,1667,-327,-6,-2,109
-1,1584,1516,68,-6,-432,76
1,1511,1380,131,4,194,61
1,1570,1530,40,-9,-212,45
-1,1831,1842,-11,0,-41,82
1,1310,1660,-350,0,40,67
-1,1580,1520,60,-14,-147,50
-1,1523,1487,36,0,-181,106
1,1860,1841,19,3,99,49
-1,1447,1575,-128,-6,-142,44
-1,1674,1557,117,-9,-513,70
-1,1447,1575,-128,-11,-266,54
1,1707,1579,128,3,107,87
-1,1455,1348,107,-2,-38,100
-1,1553,1520,33,-2,-77,42
1,1582,1439,143,1,63,53
-1,1349,1658,-309,1,-79,94
-1,1871,1846,25,0,-253,96
0,1502,1506,-4,2,-8,100
-1,1347,1645,-298,-11,-368,54
1,2027,1854,173,1,353,115
-1,1069,1272,-203,-5,-95,48
1,1602,1509,93,-6,-273,69
-1,1686,1847,-161,7,189,52
1,1372,1706,-334,0,-5,63
-1,1258,1958,-700,-4,-252,72
-1,1752,1684,68,-2,-70,70
1,1854,1679,175,0,-55,105
1,1610,1501,109,-5,-191,65
1,1662,1345,317,1,47,73
1,1570,1467,103,0,225,111
-1,1673,1860,-187,3,128,100
-1,1493,1618,-125,-2,11,82
-1,1554,1471,83,-2,-157,90
1,1867,1668,199,-1,0,125
-1,1625,1485,140,-7,-813,108
0,1614,1602,12,-2,-571,133
1,1377,1279,98,3,114,63
1,1500,1476,24,-1,115,91
0,1621,1576,45,0,22,92
-1,1610,1501,109,-14,-377,46
1,1858,1647,211,3,107,53
1,1501,1610,-109,-3,-125,107
-1,1341,1315,26,-10,-287,47
-1,1834,1813,21,-5,-115,42
-1,1521,1453,68,1,-7,50
1,1660,1695,-35,9,549,75
-1,1847,2033,-186,0,12,68
1,1595,1515,80,2,110,53
-1,1500,1449,51,0,-114,68
1,1888,1750,138,0,-2,117
-1,1641,1864,-223,0,-3,64
1,1434,1578,-144,-5,14,57
-1,1673,1823,-150,-1,-131,92
-1,1507,1604,-97,0,8,74
0,2039,1841,198,-5,72,118
-1,1439,1712,-273,-4,-104,58
1,1684,1394,290,2,388,85
-1,1697,1748,-51,-5,-602,97
-1,1327,1413,-86,-12,-357,54
1,1457,1297,160,0,230,99
1,1869,1635,234,0,47,59
-1,1590,1830,-240,-7,-572,98
1,1470,1518,-48,0,-3,115
1,1577,1620,-43,-3,30,103
1,1422,1468,-46,4,161,51
-1,1418,1500,-82,2,67,76
-1,1477,1769,-292,-1,-74,61
1,1630,1874,-244,1,3,41
1,1585,1523,62,6,1161,121
0,1225,1463,-238,2,-231,108
1,1622,1172,450,12,343,53
-1,1855,1650,205,-8,-26,56
1,1595,1514,81,7,299,49
1,1537,1644,-107,9,106,49
-1,1604,1505,99,6,-1,56
1,1759,1688,71,-1,233,141
-1,1170,1625,-455,2,59,56
1,1728,1775,-47,1,59,105
1,1589,1519,70,-2,-45,61
0,2039,1841,198,-4,551,156
1,1599,1510,89,0,30,53
-1,1896,1802,94,-2,-114,80
-1,1458,1285,173,7,107,46
1,1531,1435,96,0,847,153
-1,1630,1551,79,0,-11,50
1,1608,1502,106,0,75,175
1,1627,1207,420,0,7,43
-1,1317,1284,33,0,-473,134
-1,1716,1435,281,-2,-6,54
1,1837,1669,168,-2,-43,47
1,1872,1835,37,-2,-59,53
1,1616,1494,122,1,174,61
1,1883,1500,383,2,137,55
1,1624,1487,137,-2,-40,59
-1,1370,1614,-244,-16,-221,40
1,1721,1577,144,-1,-75,121
1,1632,1480,152,-2,-111,57
1,1844,1558,286,0,269,101
-1,1303,1190,113,-4,-108,46
1,1619,1671,-52,-7,-425,95
1,1886,1826,60,-1,-71,87
-1,1815,1880,-65,0,-49,64
1,1847,1540,307,-9,5,59
-1,1558,1474,84,-13,-220,54
1,1427,1299,128,-2,-161,41
-1,1619,1653,-34,-7,-83,48
1,1896,1487,409,10,1153,133
-1,1287,1500,-213,-4,-365,88
1,1644,1611,33,0,-101,145
0,1348,1565,-217,-3,-17,61
1,1609,1708,-99,2,497,135
-1,1554,1848,-294,-13,-427,54
-1,1679,1769,-90,-4,-277,78
-1,1455,1608,-153,-6,-335,83
-1,1521,1273,248,-5,-236,64
0,0,1200,-1200,-5,-37,114
1,1622,1641,-19,-1,-29,49
1,1470,1223,247,1,127,59
1,1622,1638,-16,-7,-78,43
1,1536,1399,137,6,189,49
-1,1852,1550,302,3,134,100
1,1898,1485,413,6,436,63
0,1736,1566,170,2,164,136
1,1505,1281,224,-1,238,85
-1,1730,1773,-43,-1,-66,51
-1,1635,1619,16,-2,-441,76
1,1794,1481,313,5,100,43
-1,1624,1653,-29,-14,-337,52
-1,1374,1681,-307,2,-593,132
-1,1500,1725,-225,-14,-230,46
0,1666,1804,-138,0,2,108
1,1298,1543,-245,-1,-33,79
-1,1500,1478,22,-2,-82,44
-1,1448,1831,-383,-7,-202,82
1,1503,1500,3,0,-8,55
-1,1455,1696,-241,-3,-190,79
1,1642,1577,65,1,79,95
-1,1496,1690,-194,3,175,52
-1,1472,1473,-1,-10,-183,50
-1,1605,1703,-98,0,-4,46
-1,1631,1473,158,10,141,46
-1,1592,1489,103,-8,-140,52
-1,1555,1519,36,-7,-48,40
-1,938,1158,-220,-6,-103,46
-1,1500,1510,-10,-1,-53,66
1,1355,1500,-145,3,86,51
-1,1592,1489,103,12,373,70
-1,1797,1901,-104,0,-121,140
-1,929,1478,-549,-11,-453,62
1,1834,1479,355,1,101,89
-1,1279,1179,100,0,14,52
1,1524,1773,-249,1,70,77
1,1570,1504,66,6,509,83
0,1452,1614,-162,1,-707,189
1,1518,1330,188,-1,999,101
-1,1517,1661,-144,-2,-15,44
1,1595,1800,-205,0,35,63
-1,1668,1783,-115,1,5,82
-1,1584,1495,89,1,100,62
-1,1408,1386,22,-3,-199,52
1,1735,1643,92,5,359,69
1,1612,1783,-171,0,8,55
-1,1670,1509,161,9,593,66
-1,1519,1570,-51,-3,-349,70
-1,1379,1320,59,-5,-295,72
1,1480,928,552,2,98,65
1,1789,1522,267,2,248,93
-1,1332,1753,-421,-1,29,45
1,1773,1522,251,4,245,109
-1,1543,1580,-37,2,-56,70
1,1515,1484,31,7,400,69
-1,1541,1639,-98,-3,-12,68
-1,1751,1635,116,-2,-63,44
-1,1396,1790,-394,-6,-142,54
1,1517,1490,27,0,-40,67
-1,1429,1460,-31,-5,-109,56
1,1661,1771,-110,-1,-43,127
1,1269,1254,15,-1,11,45
-1,1264,1481,-217,-1,-362,140
1,1701,1450,251,0,14,43
1,1385,1243,142,7,186,45
-1,1684,1572,112,0,19,54
-1,1591,1680,-89,-4,-319,124
1,2094,1775,319,-2,-44,55
-1,1569,1510,59,-3,-42,54
0,1515,1593,-78,-1,-88,131
-1,1418,1471,-53,-9,-166,50
-1,885,1532,-647,-9,-333,56
-1,1509,1662,-153,4,144,64
-1,1576,1518,58,-2,-172,86
1,1500,1418,82,-3,56,71
-1,1647,1495,152,1,2,56
-1,1476,1730,-254,0,69,60
0,1483,1406,77,-6,-379,86
-1,1654,1793,-139,-1,-36,51
-1,1523,1352,171,-3,-184,88
1,1601,1422,179,2,143,57
-1,1675,1853,-178,-6,-192,52
-1,1480,1408,72,-10,-332,48
1,1736,1471,265,-1,-35,69
1,1654,1519,135,3,1007,149
1,1426,1689,-263,9,68,44
-1,1511,1388,123,2,69,52
1,1800,1728,72,3,257,71
1,1624,1233,391,9,171,41
1,1710,1441,269,6,236,67
0,1368,1391,-23,2,436,154
-1,1422,1467,-45,-4,-347,104
1,1536,1563,-27,-4,-96,111
-1,1755,1415,340,-10,-448,70
-1,1386,1490,-104,-3,-321,86
1,1603,1467,136,4,103,61
-1,1221,1539,-318,-14,-342,54
1,1724,1673,51,0,35,125
-1,1649,1671,-22,-7,-689,140
1,1759,1460,299,-1,14,55
-1,1509,1669,-160,-6,-69,66
-1,1353,1542,-189,-2,-1,40
1,1202,1162,40,-3,269,115
-1,1293,1185,108,1,-1,48
1,1309,884,425,4,317,67
1,1746,1130,616,3,142,65
-1,1386,1548,-162,-4,-94,52
1,1446,1553,-107,-3,-93,53
-1,1536,1503,33,0,-7,58
1,1489,1470,19,0,168,135
-1,1311,1468,-157,-10,-445,56
1,2140,1809,331,0,234,89
-1,1716,1691,25,-3,-129,66
-1,1393,1506,-113,6,146,58
-1,1378,1264,114,-2,-103,54
-1,1476,1304,172,3,142,60
1,1352,1571,-219,-7,-641,90
1,1519,925,594,-3,-91,55
1,1766,924,842,-2,392,83
-1,1477,1520,-43,-4,-126,54
1,1436,1339,97,8,249,50
-1,1585,1456,129,-4,-170,54
-1,1407,1446,-39,-1,-85,44
-1,1779,1319,460,-1,-36,62
0,1639,1500,139,1,30,115
-1,1502,1784,-282,1,-493,130
1,1330,1447,-117,0,14,55
-1,1128,1746,-618,-1,-30,82
1,1322,1456,-134,0,81,93
-1,1688,1582,106,-3,-76,60
1,1514,1385,129,0,25,65
-1,1614,1611,3,-1,1,50
1,1500,1480,20,-1,6,55
1,1138,1261,-123,6,1197,109
-1,1550,1761,-211,-9,-88,44
1,1807,1797,10,2,21,65
0,1297,1274,23,-7,-397,148
1,1536,1500,36,2,32,41
1,1873,1457,416,-4,-144,57
-1,1439,1480,-41,-2,-73,62
1,1871,1459,412,-1,201,83
1,1536,1536,0,0,236,79
-1,1788,1498,290,0,-99,116
1,1873,1457,416,0,-21,59
-1,1570,1637,-67,-6,-461,120
1,1481,1052,429,0,72,109
1,1781,1500,281,6,451,69
1,1449,1450,-1,4,206,69
-1,1341,1547,-206,-11,-697,72
1,1878,1453,425,0,5,57
1,1358,1608,-250,-1,-39,73
1,1483,1500,-17,1,1,49
0,1622,1603,19,0,-44,116
1,1857,1474,383,-1,-7,41
1,1451,1880,-429,0,681,115
-1,1522,1439,83,-1,-573,130
1,1505,1494,11,0,72,75
1,1547,1338,209,11,476,64
1,1590,1412,178,3,156,61
1,1554,1500,54,1,547,127
1,1536,1408,128,11,190,45
1,1460,1486,-26,1,27,61
1,1421,1471,-50,6,80,43
1,1766,1845,-79,0,176,110
1,1857,1459,398,8,261,47
-1,1508,1867,-359,-2,-35,44
-1,1395,1596,-201,-8,-319,66
1,1542,1452,90,2,341,74
1,1530,1552,-22,0,22,47
1,1352,1461,-109,2,8,47
1,1587,1778,-191,-3,12,41
1,1641,1268,373,5,288,57
-1,1261,1443,-182,2,21,40
1,1551,1127,424,-4,-179,71
-1,1267,1296,-29,-1,90,42
1,1631,1374,257,0,15,43
1,1873,1503,370,-1,243,157
-1,1724,1500,224,-1,-88,64
-1,1822,1781,41,-2,-100,74
1,1253,1450,-197,-1,-35,55
-1,1714,1823,-109,-5,-27,60
1,1617,1369,248,2,34,43
-1,1124,1553,-429,1,13,100
1,1586,1538,48,1,19,48
1,1558,1274,284,10,380,57
1,1239,1270,-31,0,596,119
-1,1338,1523,-185,-6,-196,54
1,1419,1526,-107,-2,-13,49
-1,1349,1565,-216,-5,-191,68
1,1604,1296,308,0,3,71
-1,1513,1526,-13,-9,-870,110
1,1528,1620,-92,1,17,47
1,1500,1291,209,9,320,55
1,1595,1286,309,0,-147,75
1,1618,1529,89,1,483,123
-1,1675,1471,204,0,-74,64
-1,1629,1462,167,-13,-1557,108
1,1317,1184,133,-2,59,81
1,1578,1456,122,11,184,49
0,1794,1802,-8,-2,108,126
1,1434,1298,136,2,57,49
1,1575,1542,33,0,21,89
1,1722,1584,138,-2,-113,83
1,1655,1613,42,-1,-18,89
0,1585,1869,-284,-1,-493,78
-1,1683,1342,341,0,646,122
-1,1707,1762,-55,-1,-108,92
-1,1662,1480,182,-1,-62,54
-1,1865,1589,276,-1,54,102
1,1612,1498,114,8,457,63
1,1520,1629,-109,-3,-71,113
1,1667,1502,165,1,150,133
-1,1609,1845,-236,2,63,74
1,1850,1604,246,2,69,65
-1,1605,1552,53,1,-67,180
1,1857,1538,319,8,336,71
-1,1768,2065,-297,0,7,68
1,1558,1605,-47,0,9,43
1,1615,1122,493,2,108,61
1,1518,1362,156,3,232,95
0,1860,1594,266,-5,424,79
-1,1802,1795,7,-1,-303,130
-1,1574,1446,128,-2,-33,48
1,1617,1556,61,2,9,61
-1,1602,1852,-250,-7,-191,46
-1,1500,1500,0,-1,-377,88
-1,1572,1629,-57,2,81,76
1,1611,1535,76,1,159,73
1,1651,1558,93,-4,-34,47
-1,1662,1582,80,0,3,58
1,1857,1597,260,7,256,65
1,1674,1500,174,11,367,55
1,2034,1677,357,1,98,65
-1,1264,1463,-199,2,77,58
1,1593,1862,-269,4,175,59
-1,1659,1550,109,0,-20,74
-1,1265,1586,-321,0,42,54
1,1841,1613,228,-3,-74,41
1,1644,1564,80,5,139,61
1,1630,1578,52,8,191,51
0,1627,1454,173,3,323,149
1,1680,1460,220,-1,-20,56
0,1535,1628,-93,-1,-181,94
-1,1608,1847,-239,-11,-1251,108
1,1640,1569,71,0,0,59
-1,1500,1485,15,0,-46,76
-1,1649,1560,89,-1,-173,54
-1,1329,1532,-203,-5,-396,87
-1,1598,1857,-259,-4,-527,86
1,1642,1541,101,0,197,97
-1,1526,1622,-96,-2,-138,52
1,1635,1574,61,-6,392,127
1,1686,1261,425,-1,-186,95
-1,1720,1664,56,-2,-85,52
1,1861,1593,268,10,256,49
1,1639,1562,77,-4,32,121
-1,1684,1729,-45,-1,-16,50
-1,2015,1734,281,-1,-33,68
1,1600,1564,36,0,14,43
1,1588,1554,34,-5,-520,81
-1,1366,1076,290,-2,-358,72
1,1631,1518,113,1,134,77
1,2039,1671,368,0,60,71
-1,1451,1654,-203,0,-227,88
-1,1600,1604,-4,-1,-280,70
1,1633,1544,89,-6,-217,73
-1,1708,1542,166,-3,-113,76
1,1688,1259,429,0,31,79
1,1588,1444,144,-2,13,55
-1,1538,1539,-1,0,23,70
-1,1630,1512,118,0,-10,68
-1,1717,1446,271,-12,-338,58
-1,1252,1578,-326,-5,-566,108
1,1437,1595,-158,0,-4,57
-1,1462,992,470,0,-13,54
-1,1279,1317,-38,-14,-212,42
1,1578,1453,125,-2,-24,43
1,1610,1547,63,4,160,71
1,1892,2037,-145,-1,107,57
1,2042,1597,445,0,10,75
-1,1317,1299,18,-1,-14,66
-1,1657,1521,136,-7,-172,58
-1,1445,1586,-141,7,571,74
1,1640,1536,104,1,94,67
1,1689,1255,434,-1,24,67
-1,1631,1524,107,1,-69,67
-1,1056,1510,-454,-5,-107,50
-1,1705,2017,-312,2,198,96
1,1104,1132,-28,0,5,49
-1,1528,1648,-120,-3,-2,52
-1,1337,1822,-485,-3,-105,74
-1,1593,1616,-23,-1,80,72
-1,1527,1614,-87,1,-82,52
1,1657,1520,137,1,114,66
-1,1582,1910,-328,-5,-167,72
1,1471,1618,-147,0,-31,67
1,1699,1253,446,-3,15,61
1,1663,1692,-29,3,83,63
1,1251,1352,-101,11,112,43
1,1693,1598,95,2,82,57
-1,1247,1385,-138,1,6,68
-1,1391,1355,36,1,45,94
-1,1443,1648,-205,-5,-58,42
1,1595,1495,100,0,-8,55
1,1579,1733,-154,1,879,137
-1,1327,1193,134,6,-41,100
-1,1293,1518,-225,-1,-39,56
1,1593,1373,220,-2,-116,55
0,1647,1529,118,-7,-102,50
1,1513,1664,-151,3,185,71
1,2021,1753,268,0,272,171
1,1353,1500,-147,-4,-104,45
1,1532,1644,-112,2,22,46
1,1702,1746,-44,1,33,63
-1,1715,1914,-199,-8,-34,60
-1,1349,1598,-249,-11,-374,56
-1,1708,1516,192,-5,-162,50
-1,1628,1547,81,4,83,44
1,1578,1490,88,0,21,67
1,1599,1535,64,1,16,45
-1,1710,1611,99,0,-7,48
1,1603,1329,274,13,744,69
-1,1623,1551,72,3,171,58
1,1628,1579,49,0,119,113
1,1437,1123,314,2,193,65
-1,1313,1607,-294,-19,-453,48
1,1644,1390,254,1,15,53
1,1695,1626,69,-1,-35,121
-1,1102,1490,-388,-18,-420,56
-1,1748,1629,119,-2,-15,80
-1,1433,1566,-133,-4,-349,70
1,1474,1599,-125,9,579,81
-1,1714,1740,-26,-5,-176,132
1,1668,1292,376,0,44,73
1,1496,1588,-92,2,119,89
1,1663,1692,-29,0,16,47
1,1777,1576,201,13,777,89
1,1709,1416,293,-2,-187,99
1,1745,1544,201,2,149,131
1,1373,1299,74,0,-12,43
1,1721,1753,-32,1,30,43
1,1546,1686,-140,5,43,41
-1,1644,1734,-90,-2,-631,122
1,1533,1242,291,-1,-81,69
-1,1570,1782,-212,-8,-357,64
1,1575,1511,64,1,93,65
1,1788,1565,223,-3,751,167
-1,1792,1870,-78,0,-64,78
1,1412,1744,-332,-2,-94,101
-1,1429,1570,-141,0,-60,136
1,1670,1625,45,2,125,131
1,1493,1094,399,4,437,75
1,1742,1636,106,4,153,97
1,1434,1308,126,2,50,61
1,1715,1473,242,0,143,99
1,1501,1584,-83,-3,-115,65
1,1403,1609,-206,-2,3,57
1,1633,1218,415,1,-34,79
1,1675,1462,213,0,91,79
-1,1560,1793,-233,-6,-276,82
-1,1594,1740,-146,-3,-121,76
1,1537,1424,113,5,257,75
-1,1509,1582,-73,-2,-26,70
-1,1357,1236,121,3,-84,108
1,1673,1725,-52,8,270,57
1,1798,1555,243,7,265,59
1,1343,1295,48,3,274,89
-1,1628,1750,-122,0,-100,118
1,1308,1430,-122,3,225,117
-1,1538,1751,-213,0,188,70
-1,1638,1696,-58,-5,-33,68
1,1570,1516,54,3,77,49
-1,1628,1546,82,-5,-207,80
1,1550,1803,-253,2,579,121
-1,1593,1730,-137,1,-136,78
1,1596,1523,73,-1,349,97
1,1506,1580,-74,1,47,89
-1,1745,1880,-135,-8,-247,52
1,1784,1569,215,9,699,73
1,1598,1708,-110,0,134,91
1,1517,1509,8,-1,172,83
1,1706,1629,77,0,-19,55
-1,1340,1738,-398,-3,-277,134
-1,1757,1620,137,-1,8,68
-1,1680,1777,-97,-9,-13,42
-1,1496,1660,-164,-3,-40,48
1,1414,1284,130,-1,12,43
-1,1564,1789,-225,0,-73,54
1,1686,1685,1,0,109,109
-1,1442,1578,-136,1,7,44
0,1794,1559,235,-16,-439,131
-1,1567,1520,47,-1,-35,92
-1,1003,1451,-448,-4,-328,74
1,1566,1242,324,0,6,61
0,1303,1422,-119,0,355,115
-1,1611,1704,-93,0,-945,152
1,1725,1465,260,1,19,47
-1,1879,1773,106,-1,-56,88
0,1533,1554,-21,0,60,145
1,1672,1740,-68,-1,4,101
1,1631,1707,-76,1,75,64
1,1712,1204,508,7,167,45
1,1687,1533,154,0,-53,41
1,1649,1350,299,2,622,150
1,1846,1887,-41,0,6,69
-1,1744,1586,158,0,-30,60
1,1560,1567,-7,6,130,57
1,1783,1617,166,1,24,107
1,1498,1439,59,0,36,51
-1,1460,1729,-269,0,-22,46
-1,1569,1584,-15,-1,-4,40
0,1418,1569,-151,-2,-152,74
1,1932,1691,241,0,-61,61
-1,1515,1657,-142,1,-401,142
1,1528,1612,-84,5,55,101
1,1422,1456,-34,-4,-408,87
1,1554,1533,21,-1,-14,47
-1,1189,1398,-209,-2,-1,40
0,1595,1473,122,1,847,109
1,1553,1694,-141,3,112,67
1,1733,1456,277,0,124,95
1,1680,1496,184,-2,48,73
1,1658,1660,-2,-4,-42,69
1,1602,1713,-111,8,83,41
-1,1621,1714,-93,-1,-300,84
-1,1547,1644,-97,-8,-123,54
1,1568,1584,-16,-2,-49,97
-1,1535,1552,-17,-5,-351,100
1,1332,1439,-107,5,118,55
1,1586,1727,-141,-9,-29,53
1,1500,1329,171,3,49,69
0,1864,1803,61,0,-19,77
1,1629,1202,427,2,263,125
1,1463,1414,49,5,742,124
1,1713,1495,218,20,504,49
1,1713,1596,117,0,8,55
1,1542,1598,-56,-1,-299,117
-1,1414,1740,-326,-10,-469,72
-1,1562,1525,37,0,-50,100
1,1678,1568,110,5,194,67
1,1452,1737,-285,-3,132,95
1,1630,1508,122,1,-40,71
1,1712,1603,109,0,65,73
1,1818,1760,58,0,26,49
1,1616,1654,-38,0,131,82
1,1723,1982,-259,1,192,93
-1,1564,1772,-208,-1,-382,68
1,1539,1549,-10,0,81,63
-1,1875,1786,89,-1,-172,72
1,1443,1343,100,0,264,111
-1,1337,1614,-277,1,15,42
-1,1712,1603,109,0,24,72
-1,1506,1537,-31,-2,-109,78
1,1829,1732,97,3,163,69
-1,1500,1404,96,-5,-148,52
1,1961,1741,220,0,104,125
1,1685,1635,50,2,53,69
-1,1537,1550,-13,-4,-324,86
1,1559,1677,-118,-8,293,121
1,1560,1686,-126,2,-54,83
1,1763,1797,-34,0,48,61
-1,1256,1450,-194,-5,-123,76
-1,1544,1556,-12,-3,-158,64
1,1683,1721,-38,0,36,57
1,1641,1628,13,5,45,41
1,1837,1698,139,3,59,57
1,1732,1967,-235,0,9,45
-1,1749,1946,-197,3,58,56
0,1621,1416,205,2,270,103
-1,1473,1650,-177,-1,52,70
1,1400,1200,200,0,135,85
-1,1662,1574,88,-10,-448,112
0,1566,1534,32,1,49,108
-1,1953,1744,209,-9,-223,108
1,1500,1500,0,0,-35,57
1,1743,1649,94,1,36,53
0,1609,1578,31,-1,94,158
-1,1672,1845,-173,-5,-180,52
1,1543,1602,-59,0,104,81
1,1761,1933,-172,-1,-23,49
1,1915,1778,137,3,77,79
1,1862,1730,132,0,41,75
1,1771,1923,-152,-4,-82,49
-1,1423,1611,-188,0,-166,124
1,1535,1565,-30,0,-46,111
-1,1705,1834,-129,-2,-88,46
-1,1577,1772,-195,0,-6,54
-1,1905,1787,118,-1,-473,112
1,1297,1350,-53,3,33,45
1,1575,1418,157,0,40,61
1,1713,1465,248,4,41,41
1,1842,1683,159,5,287,73
0,1430,1046,384,-2,-421,115
1,1500,1425,75,-1,69,101
1,1588,1549,39,1,29,51
-1,1187,1619,-432,-7,-250,72
-1,1801,1889,-88,-1,-96,90
-1,1604,1520,84,-1,-56,52
1,1784,1709,75,1,-46,42
-1,1898,1793,105,-1,-46,48
-1,1793,1898,-105,-1,182,82
-1,1705,1869,-164,2,62,62
-1,1337,1597,-260,2,285,76
-1,1621,1416,205,2,-105,130
-1,1582,1623,-41,-4,-124,50
1,1597,1544,53,3,50,43
1,1855,1650,205,7,114,45
-1,1822,1891,-69,0,-43,122
1,1671,1411,260,6,189,54
1,1543,1437,106,10,372,63
-1,1554,1547,7,0,-164,86
1,1607,1535,72,0,311,157
1,1133,1107,26,4,775,99
-1,1500,1778,-278,0,-8,50
-1,1636,1860,-224,-1,-233,104
1,1621,1452,169,-1,-19,77
1,1901,1813,88,0,-44,153
-1,1397,1883,-486,-1,-249,96
1,1505,1752,-247,-1,-29,83
-1,1875,1685,190,-2,-92,110
-1,1268,1755,-487,-1,-1,64
-1,1804,1910,-106,-4,-528,116
-1,1635,1572,63,1,36,82
-1,1406,1675,-269,-1,37,56
1,1552,1717,-165,9,779,91
-1,1408,1521,-113,-7,-313,82
-1,1616,1532,84,0,-202,108
-1,1193,1455,-262,-2,-109,104
-1,1526,1500,26,-3,-201,72
-1,1378,1495,-117,0,-6,44
1,1899,1706,193,2,-18,57
-1,1871,1918,-47,-1,-312,86
-1,1493,1415,78,-9,-89,40
-1,1559,1485,74,-3,-83,71
-1,1509,1782,-273,0,-15,68
1,1928,1602,326,-5,1,61
1,1397,1542,-145,2,165,63
-1,1602,1928,-326,6,306,86
-1,1446,1628,-182,-2,-77,78
-1,1518,1835,-317,1,20,84
1,1463,1272,191,8,692,95
-1,1558,1377,181,0,-35,58
-1,1640,1629,11,-1,-50,46
1,1402,1615,-213,-4,10,49
-1,1398,1684,-286,-1,-28,50
-1,1331,1840,-509,-1,-268,70
-1,1932,1599,333,-2,7,86
-1,1585,1620,-35,0,-2,56
1,1911,1695,216,3,51,41
-1,1488,1370,118,5,91,54
-1,1778,1911,-133,0,80,58
1,1424,1370,54,5,378,61
1,1785,1524,261,-2,236,91
1,1656,1641,15,4,26,45
1,1489,1503,-14,2,82,85
1,1918,1771,147,-1,-26,49
1,1688,1584,104,0,113,93
-1,1752,1839,-87,0,-42,62
-1,1568,1711,-143,1,19,52
-1,1345,1587,-242,-5,-229,60
1,1764,1926,-162,4,35,51
1,1699,1539,160,0,163,87
-1,1632,1575,57,1,64,78
-1,1591,1340,251,4,-405,160
0,1389,1291,98,2,491,115
-1,1690,1916,-226,0,-324,132
-1,1505,1687,-182,-2,-69,62
-1,1780,1909,-129,2,-445,158
-1,1453,1541,-88,0,-96,122
-1,1745,1676,69,-6,-684,88
1,1634,1440,194,2,79,45
1,1542,1577,-35,-5,-106,51
-1,1527,1555,-28,-1,-338,102
-1,1255,1470,-215,-8,-194,80
1,1393,1809,-416,7,194,55
-1,1464,1481,-17,-2,-31,47
1,1916,1773,143,2,67,71
-1,1519,1790,-271,2,8,50
1,1601,1529,72,-1,-23,67
1,1675,1583,92,0,-14,85
-1,1766,1924,-158,-6,-42,40
0,1360,1573,-213,-1,-15,113
1,1515,1350,165,-1,238,85
-1,1500,1569,-69,-6,-286,67
1,1930,1759,171,1,298,81
-1,1499,1735,-236,1,20,66
-1,1748,1835,-87,0,-330,114
1,1588,1617,-29,-1,-225,111
-1,1753,1937,-184,-2,72,60
-1,1264,1434,-170,2,52,66
1,1775,1569,206,9,231,61
-1,1400,1451,-51,-7,-319,74
0,1524,1551,-27,1,20,104
1,1522,1341,181,12,505,57
0,1943,1748,195,-5,27,148
-1,1385,1549,-164,-8,-272,64
1,1492,1500,-8,0,-1,45
-1,1690,1640,50,1,20,82
-1,1414,1789,-375,-2,-17,56
1,1528,1555,-27,0,42,69
-1,1748,1794,-46,0,27,114
-1,1607,1631,-24,0,-85,83
1,1555,1378,177,5,152,49
1,1374,1855,-481,0,199,107
1,1279,1062,217,8,305,57
-1,1372,1562,-190,0,-16,62
-1,1558,1940,-382,-7,-153,86
-1,1490,1646,-156,-2,-48,40
1,1792,1411,381,2,-24,49
1,1418,1440,-22,4,438,81
1,1942,1556,386,14,914,85
-1,1574,1695,-121,3,224,110
-1,1878,1576,302,-3,-2,62
1,1568,1365,203,1,272,88
-1,1567,1610,-43,-2,-144,42
-1,1644,1874,-230,0,-57,92
1,1194,1500,-306,0,63,43
-1,1554,1945,-391,-7,-287,56
1,1579,1491,88,7,118,43
1,1652,1367,285,2,164,51
1,1688,1685,3,0,95,87
1,1947,1552,395,2,30,55
1,1570,1675,-105,0,2,71
-1,1294,1257,37,0,-57,62
-1,1359,1573,-214,0,11,46
1,1286,1435,-149,3,505,121
-1,1549,1950,-401,-8,-387,72
1,1742,1595,147,-3,523,85
-1,1441,1361,80,-3,-142,76
1,1494,1437,57,2,533,169
1,1515,1643,-128,-1,79,67
-1,0,968,-968,-1,-565,128
1,1458,1615,-157,1,444,107
1,1746,1933,-187,-4,-184,67
1,1635,1522,113,0,14,57
-1,1389,1668,-279,1,4,52
1,1740,1510,230,-4,-35,75
0,1915,1745,170,2,207,129
-1,1437,1570,-133,-2,-98,96
1,1472,1241,231,2,33,113
-1,1909,1767,142,0,-1,46
1,1443,1794,-351,-2,455,123
1,1330,1168,162,5,194,103
1,1623,1631,-8,0,9,49
-1,1910,1881,29,-5,-205,98
-1,1881,1910,-29,-3,-196,72
-1,1260,1467,-207,0,-27,64
-1,1519,1423,96,-1,-22,56
1,1933,1746,187,2,6,51
-1,1921,1892,29,3,91,90
1,1209,1371,-162,-4,84,55
1,1797,1717,80,1,165,117
-1,1470,1473,-3,1,47,89
-1,1696,1806,-110,0,1,52
-1,1908,2011,-103,-1,-135,86
1,1741,1515,226,5,319,79
-1,1802,1709,93,-1,-177,108
1,1813,1495,318,2,87,83
1,1892,1650,242,7,136,47
1,1393,1448,-55,0,-27,45
1,1469,1506,-37,0,29,51
-1,2019,1899,120,-3,6,86
-1,974,1355,-381,-3,-13,42
-1,1393,1778,-385,-7,-222,62
-1,2004,1915,89,0,-145,126
-1,1494,1505,-11,0,24,88
1,1634,1396,238,7,262,65
1,1724,1666,58,0,2,63
1,1780,1390,390,-1,-237,79
-1,1642,1354,288,-4,-182,90
-1,1929,1989,-60,-7,-156,64
-1,1650,1470,180,1,134,110
-1,1500,1388,112,-5,-34,48
1,1999,1920,79,1,148,95
1,1494,965,529,6,73,47
-1,1500,1422,78,-4,-60,50
1,1730,1127,603,5,427,67
-1,1406,1735,-329,-5,-8,40
-1,1457,1399,58,3,27,40
-1,1817,1911,-94,0,-89,60
-1,1459,1652,-193,-3,-137,70
-1,1421,1414,7,7,25,40
1,1787,1803,-16,2,96,55
1,1927,1750,177,0,-3,69
1,1800,1503,297,3,31,53
-1,1545,1488,57,0,-190,100
-1,1503,1800,-297,0,277,104
1,1221,1158,63,9,243,53
-1,1744,1933,-189,-4,-614,104
1,1804,1499,305,-1,3,101
-1,1800,1792,8,2,38,72
1,1939,1738,201,-1,-14,61
-1,1390,1639,-249,-7,-62,44
-1,1624,1714,-90,-5,-87,42
1,1437,1143,294,11,64,45
-1,1484,1578,-94,-2,-136,76
-1,1733,1945,-212,-1,-28,46
-1,1897,1718,179,0,89,92
1,1950,1727,223,4,56,47
1,1486,1633,-147,2,59,59
-1,1441,1495,-54,-3,251,116
-1,1403,1816,-413,-11,-260,58
1,1955,1722,233,0,-31,101
1,1755,1615,140,3,131,49
1,1610,1811,-201,-15,-337,63
1,1339,961,378,0,69,45
1,1807,1491,316,0,56,57
1,1643,1383,260,-1,67,59
-1,1230,1146,84,1,-736,94
1,1765,1487,278,-2,53,45
-1,1496,1463,33,1,-485,100
1,1628,1470,158,0,73,69
1,1811,1483,328,0,33,89
1,1500,1500,0,1,50,55
1,1476,1531,-55,0,18,75
-1,1904,2008,-104,-1,-68,86
1,2016,1896,120,-3,70,55
-1,1832,1618,214,0,32,58
-1,1722,1955,-233,-3,-66,44
0,1814,1699,115,-2,-371,148
-1,1889,2024,-135,0,-604,122
1,1662,1742,-80,-2,-57,51
-1,1608,1781,-173,1,-260,126
1,1660,1703,-43,-3,-102,67
-1,2031,1882,149,2,234,86
-1,1450,1634,-184,0,-169,110
-1,1897,2015,-118,0,-152,94
1,1573,1475,98,-2,-7,41
-1,1796,1732,64,-3,-704,122
1,1400,1556,-156,-7,45,71
-1,2023,1890,133,-1,35,80
-1,1292,1500,-208,-7,-262,68
1,1681,1686,-5,0,4,59
1,1581,1199,382,2,41,49
1,1805,1747,58,0,-51,115
-1,1346,1544,-198,-4,-260,77
-1,1514,1465,49,-2,134,86
1,1966,1745,221,-1,379,133
-1,1904,2007,-103,-3,-357,94
-1,1732,1796,-64,1,60,70
-1,1366,1557,-191,0,-27,55
1,1488,1566,-78,3,257,61
-1,1640,1432,208,-1,-162,106
0,1738,1815,-77,3,919,139
-1,1740,1971,-231,-6,-80,46
-1,1378,1700,-322,-1,-75,92
-1,1499,1718,-219,0,-6,44
-1,1484,1458,26,2,-59,54
1,1840,1907,-67,0,10,59
1,1812,1740,72,-5,-122,131
-1,1584,1799,-215,-6,-87,40
-1,1731,1980,-249,1,528,76
-1,1664,1726,-62,-4,-77,58
-1,1786,1483,303,0,-105,60
-1,1731,1821,-90,-3,-134,142
1,1985,1726,259,0,114,67
1,1724,1621,103,-1,-15,45
-1,1470,1472,-2,-2,28,76
1,1484,1480,4,-1,20,69
-1,1550,1374,176,0,-291,118
-1,1722,1989,-267,-3,-91,62
-1,1632,1628,4,-14,-85,40
1,1478,1436,42,3,97,47
-1,1339,1349,-10,0,-81,64
-1,1723,2016,-293,-1,-363,74
1,1994,1717,277,-8,-32,41
1,1802,1602,200,0,-2,49
1,1514,1504,10,7,194,49
1,1976,1735,241,-1,-41,77
-1,1579,1431,148,0,-62,72
1,1451,1494,-43,4,162,91
-1,1085,1733,-648,-1,-382,116
1,1639,1621,18,-1,34,79
-1,2019,2002,17,0,52,86
-1,1799,1756,43,-2,-21,58
1,1490,1524,-34,1,45,49
1,1855,1958,-103,-1,137,59
1,1483,1391,92,2,319,93
-1,2014,2007,7,-2,-125,64
-1,1328,1530,-202,3,22,50
1,2007,2014,-7,3,204,71
1,1340,1403,-63,-5,66,98
1,1659,1373,286,0,79,59
1,1777,1392,385,-1,1,41
1,2002,2019,-17,-6,-228,93
1,1819,1586,233,0,361,131
1,1782,1446,336,-9,-534,69
-1,2014,1830,184,1,113,108
1,1681,1732,-51,0,5,89
-1,1625,1386,239,-4,-248,75
1,1443,1362,81,19,301,43
1,1491,1535,-44,2,320,91
1,1359,1431,-72,6,174,60
-1,1476,1442,34,-1,-54,56
1,1855,1908,-53,1,101,65
-1,1897,1997,-100,1,-227,100
1,1610,1650,-40,2,76,47
-1,1506,1794,-288,2,40,44
1,1456,1464,-8,0,3,83
-1,1229,1500,-271,0,-93,60
-1,1527,1339,188,0,-33,58
1,1846,1479,367,0,-24,67
-1,2006,1889,117,-7,-343,64
-1,1479,1846,-367,-4,-83,44
1,1452,1469,-17,4,135,61
-1,1334,1452,-118,-9,-53,48
1,1337,1486,-149,2,-30,45
1,1903,1991,-88,0,45,61
1,1774,1766,8,3,286,81
-1,1597,1710,-113,-5,-525,158
1,1456,1464,-8,5,222,51
1,1503,1500,3,0,94,109
-1,2007,1849,158,1,46,60
-1,1976,1916,60,-6,-289,66
-1,1663,1623,40,0,33,70
1,1481,1442,39,2,89,65
-1,1865,1991,-126,0,-213,76
-1,1963,1929,34,-7,-566,82
1,1368,1697,-329,1,391,81
-1,1999,1858,141,0,68,96
1,1940,1951,-11,0,14,77
-1,1459,1312,147,-1,-174,72
-1,1477,1445,32,-3,-62,58
1,1534,1285,249,-5,569,161
-1,1834,1863,-29,2,-48,76
1,1873,1983,-110,1,-45,91
-1,1223,1801,-578,-7,-26,40
1,1724,1604,120,1,18,43
1,1983,1873,110,3,231,63
1,1326,1511,-185,2,216,73
1,1597,1525,72,12,143,41
1,1865,1991,-126,-1,-246,101
-1,1088,1241,-153,-2,-61,40
-1,1464,1939,-475,3,84,54
-1,1498,1514,-16,-9,-357,84
-1,1218,1807,-589,0,-46,77
1,1941,1463,478,0,30,49
1,1329,1493,-164,-1,362,87
1,1240,1145,95,2,87,51
-1,1992,1864,128,-1,-213,96
-1,1461,1942,-481,0,-71,68
-1,1899,1806,93,0,-118,104
-1,1646,1805,-159,0,-122,64
-1,1473,1596,-123,-4,-235,77
-1,1785,1650,135,3,112,65
-1,1879,1977,-98,0,13,56
1,1944,1460,484,5,128,53
-1,1538,1544,-6,0,-41,84
1,1603,1489,114,7,99,61
1,1560,1391,169,9,187,43
1,1734,1372,362,4,81,51
-1,1871,1985,-114,-3,-176,75
1,1443,1512,-69,-3,-94,61
1,1993,1864,129,5,619,111
-1,1746,1738,8,0,8,62
-1,1864,1993,-129,0,-47,50
1,1808,1213,595,7,162,43
-1,1482,1656,-174,-12,-311,46
1,1133,1256,-123,6,1055,107
1,2000,1856,144,1,459,113
1,1813,1566,247,12,943,91
1,1850,2007,-157,0,-107,99
-1,1601,1781,-180,-1,-38,90
-1,1809,1807,2,-5,-117,48
1,1691,1476,215,5,165,59
-1,1463,1362,101,-8,-98,40
-1,1527,1384,143,-3,-594,116
1,1991,1865,126,1,216,71
1,1215,1355,-140,2,41,51
1,1681,1718,-37,-4,-16,87
-1,1865,1991,-126,1,-435,100
-1,1239,1945,-706,1,42,58
-1,1471,1602,-131,-3,-45,54
-1,1376,1449,-73,-2,-213,66
1,1718,1630,88,1,147,81
1,1539,1576,-37,-1,-9,43
1,1998,1858,140,0,445,129
1,1946,1235,711,2,35,49
-1,1235,1946,-711,-1,-20,64
-1,1851,2005,-154,0,-407,94
-1,1406,1512,-106,0,129,168
-1,1735,1603,132,-2,-21,42
1,1465,1604,-139,2,181,79
-1,1946,1232,714,0,30,52
-1,1838,1924,-86,4,129,60
1,1458,1367,91,-7,70,105
1,2018,1691,327,2,49,59
1,1987,1476,511,1,207,73
-1,1934,1830,104,1,171,104
-1,1203,1253,-50,-2,-18,84
-1,1596,1698,-102,-7,-41,45
-1,1688,1844,-156,0,-25,54
1,1844,1688,156,-13,-293,57
1,1844,1688,156,-1,2,61
1,1755,1700,55,0,58,79
-1,1681,1850,-169,-9,-139,44
-1,1500,1475,25,0,-229,106
-1,1756,1218,538,-1,-36,72
1,1473,1555,-82,1,138,87
1,1857,1674,183,0,10,44
1,1730,1810,-80,1,205,119
-1,1385,1454,-69,5,206,96
1,1585,1741,-156,-2,224,119
1,1383,1675,-292,0,21,59
-1,1399,1458,-59,3,51,44
1,1360,1222,138,6,297,65
-1,1444,1777,-333,0,-71,66
0,1285,1139,146,6,361,123
-1,1608,1510,98,0,8,68
-1,1482,2111,-629,-1,-53,58
1,1572,1685,-113,-8,-142,49
1,1622,1500,122,3,441,99
-1,1477,1781,-304,-3,-257,68
1,1312,1482,-170,1,171,71
-1,1466,1577,-111,-4,-29,41
1,2112,1918,194,6,227,61
-1,1918,2112,-194,-3,-139,68
1,1466,1587,-121,-3,110,117
-1,1308,1477,-169,0,5,46
-1,1600,1783,-183,-1,-39,48
1,1458,1464,-6,-9,124,77
-1,1484,1238,246,-17,-254,48
1,2118,1865,253,-5,-100,75
1,1238,1484,-246,2,76,47
1,1298,1602,-304,4,24,40
-1,1467,1402,65,-2,-77,48
1,1474,1487,-13,0,285,111
1,1722,1767,-45,-3,-86,77
1,1497,1454,43,3,48,43
1,1594,1534,60,-2,-40,71
1,1454,1497,-43,-2,-82,51
1,1280,1146,134,-1,-110,77
1,1703,1464,239,-4,24,85
1,2125,1958,167,5,817,135
1,1820,1483,337,-2,13,55
-1,1784,1706,78,1,-120,127
1,1667,1753,-86,-6,-7,51
1,1564,1629,-65,6,153,51
1,1634,1818,-184,0,-177,81
1,1475,1532,-57,0,-9,67
1,1578,1487,91,2,90,61
-1,1368,1884,-516,0,3,72
1,1934,1462,472,5,87,47
-1,1951,2133,-182,-4,-347,69
-1,1469,1509,-40,-8,-291,118
-1,1329,1710,-381,0,-16,62
-1,1475,2026,-551,-4,-204,66
-1,1500,1983,-483,-1,-244,90
-1,1614,1465,149,-1,-269,158
1,1734,1337,397,5,622,103
1,1876,1507,369,8,160,45
-1,2139,1944,195,1,-267,120
-1,1411,1622,-211,1,24,40
-1,1478,1823,-345,0,-14,52
1,1936,1405,531,2,76,53
-1,1767,1755,12,0,-33,92
1,1739,1681,58,-3,-175,59
1,1885,1367,518,0,87,69
-1,1405,1613,-208,-11,-73,40
-1,1963,2120,-157,-3,-394,70
1,1466,1623,-157,-9,-140,45
-1,1672,1749,-77,-3,-46,52
1,1513,1650,-137,7,747,139
1,1939,1409,530,3,125,69
1,1648,1608,40,-4,-150,87
-1,1448,1911,-463,-3,-225,108
-1,1355,1500,-145,-5,-317,66
1,1594,1393,201,-2,-85,65
-1,1940,1705,235,-1,-219,66
-1,1393,1374,19,1,-34,150
1,1500,1999,-499,0,0,124
-1,1488,1473,15,-1,-125,102
-1,1500,1609,-109,-6,-94,44
1,1736,1335,401,1,315,113
1,1559,1204,355,1,38,55
1,1681,1353,328,-4,621,135
-1,1630,1642,-12,-1,-227,118
-1,1470,1829,-359,-3,-49,54
-1,1520,1597,-77,0,52,70
-1,1757,1663,94,-3,-84,56
1,1518,1429,89,3,609,105
1,1748,1904,-156,-3,-6,77
-1,1686,1615,71,-3,-170,52
1,1766,1756,10,-2,-436,159
1,1956,1600,356,0,18,101
1,1785,1774,11,0,397,143
0,1337,1662,-325,2,197,135
-1,1461,1518,-57,-4,-11,44
-1,1500,1371,129,-11,-469,88
1,1658,1528,130,-1,22,50
-1,1615,1721,-106,0,-31,120
1,1480,1599,-119,0,437,171
-1,1425,1457,-32,-3,-230,84
-1,1661,1971,-310,-1,-145,70
1,1739,1212,527,3,592,91
1,1475,1320,155,-1,-142,87
1,1832,1466,366,1,40,47
-1,1887,1745,142,-1,51,114
-1,1543,1691,-148,-2,-21,56
1,1766,1332,434,5,49,41
1,1354,1657,-303,5,61,45
-1,1562,1515,47,-6,-342,98
-1,1324,1658,-334,6,224,62
1,1445,1415,30,-1,200,81
-1,1465,1554,-89,-3,-125,64
-1,1680,1752,-72,0,-75,82
-1,1165,1657,-492,-3,-313,68
1,1545,1479,66,0,-24,59
1,1912,1820,92,1,23,53
1,2065,1638,427,-1,-36,73
1,1745,1777,-32,2,145,79
-1,1666,1521,145,-9,-334,58
-1,1824,1835,-11,1,44,68
1,1482,1555,-73,5,605,117
-1,1498,1429,69,-4,-115,44
-1,1718,1650,68,-4,-286,94
1,1635,1496,139,3,157,63
-1,1500,1542,-42,-1,-25,50
1,1809,1440,369,1,23,57
-1,1620,1500,120,0,-3,42
1,1449,1491,-42,6,237,57
-1,1692,1519,173,0,-195,86
-1,1793,1689,104,0,6,62
-1,1648,1437,211,10,94,44
0,1330,1768,-438,2,254,84
-1,1751,1583,168,0,16,72
1,1772,1489,283,2,313,129
-1,1584,1495,89,0,-159,136
-1,1634,2064,-430,-2,-524,112
-1,1541,1496,45,-1,29,90
-1,1497,1538,-41,-3,51,40
1,1658,1163,495,-3,-169,61
1,1629,1416,213,-1,-45,77
1,1695,1788,-93,-2,-34,79
-1,1610,1745,-135,0,-7,64
-1,1458,1500,-42,0,-143,100
-1,1447,1765,-318,0,-36,66
-1,1765,1757,8,0,111,102
1,1460,1240,220,3,254,117
-1,1387,1674,-287,2,0,56
1,1913,1446,467,-2,257,85
-1,1478,1375,103,1,8,68
1,1440,1371,69,4,117,57
1,1549,1557,-8,0,131,99
-1,1466,1879,-413,-1,273,158
-1,1619,1693,-74,1,16,60
-1,1461,1535,-74,-2,-122,86
1,1678,1606,72,0,-3,45
1,1597,1342,255,1,53,129
1,1509,1529,-20,-8,67,79
1,1846,1662,184,0,205,59
1,1700,1535,165,3,95,47
-1,1780,1869,-89,-3,2,72
0,1647,1500,147,0,-16,107
-1,1500,1684,-184,-2,-104,148
1,1620,1563,57,-1,-5,61
1,1840,1475,365,6,182,55
-1,1729,1607,122,-1,-56,88
1,1414,1655,-241,-6,553,105
1,2067,1812,255,0,96,59
-1,1429,1850,-421,-2,-179,80
-1,1521,1517,4,0,-105,86
-1,1509,1570,-61,0,-45,55
1,1349,1164,185,-5,-6,63
-1,1768,1807,-39,0,-192,70
-1,1344,1558,-214,2,51,46
1,1750,1528,222,-1,35,79
1,1477,1420,57,-1,19,61
1,1768,1754,14,0,-2,65
-1,1703,1611,92,0,-437,142
-1,1464,1532,-68,2,50,71
0,1601,1336,265,1,75,125
1,1856,1758,98,0,2,43
-1,1540,1544,-4,3,35,84
-1,1808,2075,-267,0,-35,100
1,1528,1510,18,4,50,43
-1,1452,1500,-48,1,36,52
-1,1576,1423,153,-17,-421,82
1,1449,1418,31,11,384,55
1,1748,1882,-134,0,1,49
-1,1431,1412,19,-3,-50,70
1,1500,1536,-36,2,250,89
-1,1284,1305,-21,-3,-545,106
1,1757,1188,569,0,-5,77
1,1539,1713,-174,-9,-195,97
-1,1743,1779,-36,0,-31,76
-1,1579,1499,80,-1,-358,112
1,1769,1594,175,1,204,106
1,1837,1766,71,0,2,43
-1,1345,1606,-261,0,14,46
-1,1618,1454,164,1,26,72
-1,1607,1696,-89,-10,-171,40
-1,1800,1693,107,0,-37,88
1,1573,1309,264,-2,-24,73
-1,1558,1523,35,-2,-76,44
1,1755,1862,-107,-1,7,65
-1,1355,1402,-47,-6,-235,60
0,1766,1856,-90,0,229,144
1,1695,1555,140,2,92,51
-1,1351,1812,-461,-9,-400,82
-1,1613,1586,27,-7,-466,88
1,1541,1712,-171,-5,-179,71
0,1777,1596,181,-5,29,73
-1,1628,1705,-77,-1,-142,94
1,1825,1772,53,0,1,47
-1,1406,1460,-54,-7,-183,54
0,1499,1419,80,1,393,125
1,1788,1733,55,1,276,91
-1,1535,1546,-11,0,-35,67
-1,1588,1378,210,-1,-147,78
1,1548,1378,170,4,175,54
-1,1330,1424,-94,-6,37,46
1,1561,1515,46,1,581,141
1,1603,1771,-168,1,18,49
-1,1761,1848,-87,0,-11,86
1,1754,1622,132,2,74,59
-1,1847,1822,25,-3,-122,118
0,1509,1705,-196,-3,-43,85
1,1768,1242,526,1,143,65
1,1597,1693,-96,2,22,43
1,1556,1513,43,1,18,117
1,1614,1762,-148,0,101,65
1,1691,1586,105,-1,-43,69
-1,1648,1958,-310,0,194,102
-1,1344,1554,-210,-8,-117,44
1,1867,1751,116,0,354,127
-1,1601,1421,180,0,-65,62
-1,1577,1183,394,0,-234,134
1,1724,1797,-73,-1,-38,77
1,1962,1645,317,0,-33,95
1,1622,1645,-23,1,84,75
-1,1465,1497,-32,0,-37,74
1,1749,1500,249,0,-64,113
-1,1554,1683,-129,-3,-60,47
1,1647,1470,177,1,58,74
-1,1139,1270,-131,1,-34,68
1,1662,1824,-162,0,1,49
-1,1339,1744,-405,0,-130,91
-1,1743,1884,-141,-5,-90,44
-1,1578,1559,19,-9,-29,40
1,1641,1966,-325,-1,175,109
1,1699,1514,185,-6,-64,57
1,1438,1766,-328,0,90,101
1,1624,1768,-144,0,253,105
-1,1241,1672,-431,-2,-62,43
1,1769,1611,158,0,-54,75
1,1898,1735,163,2,62,61
1,1956,1747,209,0,36,79
-1,1336,1418,-82,-3,-100,60
-1,1410,1441,-31,0,87,138
1,1614,1596,18,-1,341,107
1,1646,1687,-41,-5,-13,63
0,1762,1715,47,-1,-38,121
1,1507,1593,-86,-3,-60,107
1,1537,1461,76,3,73,43
-1,1503,1566,-63,1,19,70
-1,1571,1567,4,-2,-115,74
1,1750,1661,89,1,316,77
1,1674,1658,16,-3,-59,47
-1,1728,1911,-183,-5,-147,82
1,1547,1553,-6,-4,-77,47
-1,1421,1533,-112,-1,-12,44
1,2098,1415,683,4,272,57
-1,1349,1821,-472,-1,-235,88
1,1731,1722,9,-1,4,55
1,1402,1685,-283,-1,73,85
1,1982,1804,178,5,282,99
1,1653,1758,-105,-1,7,107
1,1582,1463,119,8,38,43
1,1485,1198,287,-1,73,67
1,1922,1657,265,0,278,95
-1,1575,1494,81,-2,-146,82
1,1578,1560,18,3,60,47
-1,1558,1605,-47,0,-13,46
-1,1426,1415,11,-5,-33,44
1,2109,1721,388,0,-495,99
0,1781,1679,102,-2,-401,125
0,1452,1546,-94,-1,-118,144
1,1566,1589,-23,-1,2,45
0,1572,1520,52,-1,-112,89
-1,1744,1668,76,4,59,56
1,1565,1546,19,1,30,47
-1,1798,2010,-212,-1,-139,134
0,1574,1634,-60,1,-125,153
1,1828,1989,-161,0,111,99
1,1330,1353,-23,-1,20,42
1,1372,1577,-205,0,16,49
1,1902,1581,321,4,57,41
1,2133,1670,463,0,420,93
-1,1489,1705,-216,-1,-133,62
-1,1631,1665,-34,-5,-32,42
1,1731,1682,49,1,62,65
1,1560,1390,170,4,79,55
1,1879,1761,118,4,213,65
1,1777,1401,376,1,3,93
-1,1130,1341,-211,-6,-271,79
-1,1672,1740,-68,-6,-235,76
-1,2031,2134,-103,0,-19,94
1,1555,1313,242,1,81,69
-1,1383,1566,-183,-4,-193,70
1,1225,1557,-332,0,132,87
-1,1729,1642,87,-3,-785,126
1,2148,1718,430,1,5,63
1,1549,1710,-161,-2,173,103
1,1497,1674,-177,-3,9,57
1,1572,1377,195,11,350,55
-1,1484,1501,-17,-1,-220,124
1,1753,1554,199,-4,-56,51
1,1629,1633,-4,0,388,123
-1,1499,1716,-217,-1,-76,66
1,1542,1852,-310,1,20,61
1,1575,1629,-54,-5,168,83
-1,1366,1416,-50,2,80,46
-1,1558,1508,50,0,-21,76
1,1715,1684,31,0,13,59
-1,1779,1618,161,-4,-198,56
-1,1759,1887,-128,-2,-297,94
-1,1413,1877,-464,0,-244,138
1,1527,1575,-48,0,44,64
1,1930,1944,-14,1,195,87
-1,1784,1714,70,-3,-309,76
1,1772,1742,30,1,48,67
-1,1466,1659,-193,-1,-330,96
-1,1565,1352,213,-7,-225,62
-1,1693,1779,-86,0,-40,50
1,1931,1942,-11,-9,-72,79
1,1895,1752,143,0,100,80
1,1725,1500,225,0,17,65
1,1931,1944,-13,4,386,131
-1,1500,1363,137,-1,-200,106
1,1647,1577,70,-4,-29,45
1,1733,1462,271,-3,273,131
1,1525,1593,-68,0,32,103
1,1307,1641,-334,15,335,45
-1,1472,1806,-334,-2,-7,44
1,1244,1333,-89,1,69,66
1,1428,1366,62,5,266,67
1,1668,1626,42,-8,-195,81
-1,1550,1573,-23,-10,-17,42
1,1161,1538,-377,0,107,109
1,1523,1215,308,3,147,61
-1,1290,1482,-192,-1,54,76
1,1803,1950,-147,-2,785,171
-1,1838,1798,40,-2,-15,66
-1,1782,1672,110,0,-33,120
1,1748,1647,101,14,445,57
-1,1336,1244,92,0,111,60
-1,1426,1557,-131,0,5,64
1,1817,1496,321,9,263,47
-1,1278,1573,-295,-7,-527,74
-1,1258,1645,-387,-1,-26,44
-1,1493,1820,-327,-15,-307,46
-1,1493,1517,-24,-1,-16,42
0,1750,1834,-84,0,37,125
-1,1489,1529,-40,-2,-214,86
1,1743,1884,-141,1,71,67
-1,1326,1540,-214,-3,-59,44
1,1247,1453,-206,3,189,61
1,1054,1299,-245,11,341,57
1,1479,1540,-61,2,2,47
-1,1526,1584,-58,-3,-257,76
1,1525,1493,32,-1,32,57
-1,1572,1885,-313,-1,-8,44
-1,1562,1549,13,0,-118,68
-1,1631,1760,-129,-3,-61,66
-1,1632,1824,-192,0,4,60
-1,1319,1652,-333,-2,-199,86
-1,1471,1790,-319,-6,-304,54
1,1444,1322,122,0,33,47
-1,1528,1489,39,8,41,42
1,1727,1839,-112,3,95,69
1,1502,1515,-13,-6,-158,45
-1,1210,1696,-486,-3,-105,58
-1,1192,1073,119,2,-124,100
1,1829,1626,203,1,87,89
-1,1504,1514,-10,-4,-66,50
-1,1518,1528,-10,-3,-116,110
-1,1419,1834,-415,-3,0,56
-1,1500,1582,-82,-2,-55,56
-1,1621,1835,-214,0,-168,68
1,1505,1513,-8,3,765,159
1,1593,1559,34,0,-119,107
-1,1634,1813,-179,0,-106,84
1,1356,1453,-97,-2,-31,43
1,1840,1616,224,1,54,53
-1,1402,1577,-175,0,-195,107
-1,1500,1479,21,-9,-350,62
1,1516,1494,22,0,-235,85
-1,1441,1588,-147,5,220,102
1,1612,1438,174,5,293,77
-1,1611,1845,-234,-1,-649,108
1,1872,1830,42,1,93,85
1,1850,1606,244,0,779,115
-1,1393,1485,-92,-3,-112,59
-1,1539,1507,32,-5,-167,58
1,1527,1535,-8,-3,-269,115
-1,1425,1537,-112,2,262,68
1,1601,1855,-254,1,162,99
1,1603,1268,335,0,80,91
1,1698,1929,-231,0,7,75
1,1455,1695,-240,0,-9,51
-1,1604,1360,244,0,-694,132
1,1490,1426,64,7,492,83
1,1836,1620,216,10,275,55
1,1519,1527,-8,1,280,75
-1,1116,1384,-268,7,267,78
-1,1416,1500,-84,0,-295,86
1,1583,1327,256,8,274,55
1,1662,1396,266,3,156,89
1,1841,1615,226,9,343,55
1,1408,1385,23,13,145,41
-1,1823,1745,78,0,26,118
-1,1406,1508,-102,-1,-152,80
-1,1819,1882,-63,0,-16,52
-1,1597,1624,-27,1,63,108
1,1500,1472,28,0,-8,41
1,1828,1628,200,-1,-62,65
1,1583,1557,26,5,140,57
1,1523,1539,-16,0,74,69
-1,1516,1531,-15,-2,-354,132
-1,1622,1834,-212,-3,-122,74
1,1469,1500,-31,1,243,91
1,1541,1387,154,0,32,41
1,1606,1550,56,-3,20,45
-1,1793,1731,62,1,32,70
1,1839,1617,222,3,59,59
1,1388,1097,291,5,128,43
1,1675,1258,417,-2,-73,58
1,1945,1851,94,2,156,87
-1,1753,2176,-423,-1,-26,54
-1,1612,1844,-232,4,404,112
1,1587,1306,281,1,622,94
1,1574,1464,110,-1,-14,61
1,1849,1607,242,8,201,51
-1,1540,1615,-75,-15,-228,42
-1,1485,1598,-113,-3,-202,88
-1,1808,1793,15,0,-16,92
1,1420,1387,33,4,154,76
-1,1602,1854,-252,-3,-398,140
1,1625,1532,93,4,138,49
1,1497,1819,-322,5,1297,189
1,1664,1436,228,5,498,95
1,1993,1810,183,1,41,93
1,1859,1597,262,1,-62,145
0,1392,1487,-95,-2,-425,112
-1,1893,1682,211,0,-353,124
1,1880,1472,408,6,149,55
-1,1477,1551,-74,-1,-24,48
-1,1662,1844,-182,1,-2,53
-1,1505,1677,-172,-3,-208,74
-1,1750,1791,-41,-2,-19,40
1,1746,1768,-22,0,120,99
-1,1515,1592,-77,1,4,42
1,1750,1863,-113,0,149,99
-1,1635,1572,63,0,-7,90
-1,1848,1765,83,-5,-749,122
1,1400,1407,-7,-7,-76,49
1,1629,1593,36,0,5,47
1,1760,1861,-101,-3,-5,41
1,1833,1779,54,-6,-60,48
-1,1546,1591,-45,-1,-14,68
-1,1237,1397,-160,3,91,54
-1,1811,1876,-65,0,-277,102
1,1573,1253,320,0,2,41
1,1804,1796,8,-2,-55,59
-1,1843,1769,74,-3,-303,96
-1,1290,1489,-199,-3,-363,88
1,1574,1640,-66,0,51,67
1,1480,1404,76,3,192,83
1,1687,1668,19,0,-17,75
0,1615,1723,-108,0,-21,77
1,1883,1749,134,-8,345,155
-1,1633,1758,-125,0,-31,86
1,1368,1486,-118,-9,-122,41
1,1910,1829,81,0,399,137
-1,1562,1684,-122,-1,-293,114
-1,1820,1918,-98,0,-431,132
-1,1580,1523,57,-2,-214,94
-1,1238,1652,-414,-1,-38,48
-1,1396,1602,-206,0,-85,70
-1,1621,1495,126,0,-24,94
1,1900,1897,3,1,67,55
1,1784,1814,-30,0,327,101
1,1783,1659,124,0,28,103
-1,1500,1445,55,-1,-608,108
1,1585,1430,155,-2,-37,87
1,1592,1820,-228,-1,54,81
-1,1582,1619,-37,-1,-86,72
0,1220,1214,6,0,387,138
-1,1500,1573,-73,7,244,86
1,1767,1626,141,3,192,83
-1,1543,1439,104,-2,-219,84
-1,1378,1376,2,0,18,42
-1,1613,1796,-183,-1,-18,42
1,1423,1145,278,0,68,55
1,1582,1796,-214,-1,-12,53
1,1702,1632,70,-4,-80,81
1,1803,1797,6,-2,-17,43
1,1459,1614,-155,-2,232,101
1,1600,1607,-7,-3,-237,65
1,1409,1411,-2,3,83,105
1,1472,1271,201,-1,7,57
1,1626,1500,126,-1,62,83
1,1314,1653,-339,4,115,47
-1,1733,1436,297,-2,-14,40
-1,1123,1428,-305,-3,-68,52
-1,1605,1710,-105,0,8,66
-1,1596,1612,-16,0,52,64
-1,1655,1735,-80,4,191,84
1,1748,1732,16,-2,-99,75
-1,1386,1546,-160,1,19,42
1,1573,1219,354,8,151,49
1,1544,1701,-157,-2,107,143
1,1749,1500,249,0,66,72
-1,1624,1586,38,1,19,58
1,1721,1758,-37,-1,229,65
1,1592,1456,136,-2,10,79
1,1598,1611,-13,-2,-31,61
1,1746,1733,13,-1,-14,53
1,1482,1191,291,-5,-91,49
-1,1114,1452,-338,-6,-181,50
-1,1401,1658,-257,-3,-253,80
1,1464,1202,262,0,11,45
1,1824,1624,200,-4,193,131
-1,1470,1565,-95,0,-29,62
-1,1544,1446,98,0,-57,98
1,1469,1379,90,-3,-50,43
-1,1758,1756,2,0,-11,64
1,1637,1564,73,1,36,43
-1,1599,1609,-10,-2,-46,74
-1,1619,1588,31,0,13,108
-1,1788,1822,-34,0,108,68
1,1663,1376,287,0,44,69
1,1600,1607,-7,0,-5,49
1,1712,1766,-54,-4,611,149
1,1597,1612,-15,0,12,85
1,1518,1486,32,12,324,47
-1,1357,1667,-310,-6,-274,64
1,1523,1490,33,-2,56,113
-1,1500,1287,213,0,-404,104
-1,1576,1460,116,-3,-172,82
-1,1600,1608,-8,-6,-187,68
-1,1319,1497,-178,-1,10,66
1,1469,1370,99,1,30,49
1,1671,1341,330,-1,103,133
-1,1618,1589,29,2,21,66
-1,1725,1486,239,-1,-703,136
1,1511,1354,157,-3,138,93
1,1601,1607,-6,-3,-52,55
1,1574,1753,-179,-6,46,59
1,2012,1527,485,4,71,47
1,1747,1455,292,1,71,55
1,1596,1612,-16,-5,-1,47
1,1327,1675,-348,10,735,145
-1,1528,1599,-71,-3,-77,52
-1,1475,1480,-5,1,70,62
1,1556,1738,-182,-4,21,48
1,1601,1607,-6,-1,-23,45
1,1752,2244,-492,0,23,79
1,1765,1357,408,19,318,45
-1,1361,1477,-116,-9,-30,50
1,1394,1434,-40,0,-89,51
1,1451,1751,-300,0,-14,41
-1,1355,1767,-412,-16,-608,58
-1,1295,1483,-188,-9,-18,40
-1,1347,1478,-131,-8,-58,44
-1,1923,2220,-297,-13,-606,68
1,1340,1202,138,8,86,42
0,1648,1526,122,-7,-351,127
1,1596,1453,143,5,148,49
-1,1350,1772,-422,-12,-257,54
-1,1468,1736,-268,0,-160,110
1,1266,1418,-152,-11,-495,69
1,1898,1508,390,-1,-9,41
-1,1391,1270,121,0,-20,68
1,1774,1348,426,2,507,87
-1,1205,1538,-333,-1,-235,116
0,1529,1627,-98,0,105,170
0,1627,1447,180,-1,-34,69
1,1458,1145,313,0,-18,51
1,1554,1498,56,0,23,59
-1,1280,1500,-220,-2,-499,102
-1,1502,1727,-225,-1,19,62
1,1583,1633,-50,-10,-92,79
0,1371,1404,-33,-3,174,102
-1,1358,1580,-222,-11,-407,50
-1,1404,1633,-229,-4,-29,42
0,1613,1532,81,-8,-139,136
-1,1620,1595,25,-2,-349,94
-1,1585,1352,233,-1,-68,72
1,1422,1201,221,0,83,55
1,1741,1575,166,0,87,61
-1,1413,1706,-293,0,1,92
1,1542,1488,54,3,426,79
1,1610,1506,104,-1,-117,79
-1,1599,1685,-86,-2,-19,48
-1,1193,1428,-235,-13,-806,100
-1,1482,1553,-71,2,33,53
-1,1328,1596,-268,-8,-126,42
1,1534,1603,-69,-5,255,129
-1,1740,1463,277,-7,-333,66
1,1726,1366,360,2,21,93
-1,1337,1362,-25,-4,-509,98
1,1448,1232,216,-5,58,95
-1,1590,1112,478,-5,-22,50
-1,1635,1427,208,0,13,79
-1,1363,1738,-375,-5,-674,126
1,1200,1226,-26,3,10,49
-1,1360,1757,-397,0,-15,68
1,1353,1372,-19,-3,-13,53
1,1497,1500,-3,14,412,53
1,1574,1380,194,0,27,87
1,1428,1467,-39,0,705,115
1,1527,1787,-260,0,525,141
1,1559,1553,6,-9,95,83
1,1505,1211,294,1,13,45
-1,1479,1447,32,0,8,46
0,1497,1621,-124,3,41,139
-1,1443,1505,-62,-1,36,46
-1,1316,1378,-62,-9,-283,60
1,1515,1433,82,0,-9,59
1,1455,1389,66,0,-2,77
-1,1553,1491,62,0,-87,92
-1,1388,1289,99,-4,-6,40
-1,1603,1760,-157,-1,-24,82
-1,1295,1473,-178,-3,-95,48
-1,1710,1635,75,-8,-216,56
1,1253,1531,-278,1,6,47
1,1388,1499,-111,-2,13,53
1,1764,1545,219,4,194,65
-1,1327,1373,-46,-1,-498,118
1,1729,1674,55,1,33,41
-1,1374,1587,-213,-2,-351,96
1,1484,1409,75,3,192,67
1,2177,1795,382,0,7,57
-1,1348,1633,-285,-5,-40,48
0,1412,1463,-51,3,663,101
-1,1945,1857,88,-6,-61,44
1,1580,1483,97,-2,350,137
1,1912,1716,196,-1,-62,59
-1,1488,1505,-17,-8,-567,92
-1,2180,1792,388,-1,-267,96
1,1623,1365,258,-1,16,51
-1,1665,1693,-28,0,-12,58
-1,1788,1727,61,3,350,70
1,1524,1323,201,3,813,121
1,1749,1557,192,-2,-26,41
-1,1504,1596,-92,0,-2,60
-1,1812,2150,-338,0,19,94
1,1637,1329,308,5,267,65
1,2154,1809,345,0,7,49
1,1360,1357,3,2,558,107
-1,1454,1528,-74,0,50,134
-1,1532,1619,-87,2,16,48
0,1124,1430,-306,11,1537,116
1,1361,1629,-268,-2,38,45
-1,1400,1494,-94,-6,-161,52
-1,1806,2158,-352,-5,2,48
-1,1598,1665,-67,-2,-69,58
1,2162,1804,358,1,123,139
1,1556,1345,211,13,161,41
1,1669,1570,99,3,98,55
1,1461,1079,382,2,361,111
-1,1742,1754,-12,-4,-93,58
1,1628,1524,104,0,34,55
-1,1500,1734,-234,-9,-28,42
-1,1616,1501,115,0,-297,204
-1,1113,1436,-323,0,-52,78
-1,1366,1742,-376,1,43,42
-1,1655,1475,180,-4,-101,50
-1,1407,1537,-130,-1,-76,114
-1,1764,1730,34,5,140,54
-1,1314,1700,-386,-4,-145,58
1,1682,1552,130,0,18,49
1,1425,1413,12,0,1,43
-1,1743,1752,-9,-2,-92,46
-1,1456,1604,-148,-4,-93,52
-1,1636,1752,-116,-4,-316,80
1,1827,1729,98,0,34,89
1,1185,1171,14,3,35,59
1,1290,1394,-104,9,724,73
1,1628,1762,-134,-1,-3,49
-1,1427,1734,-307,-6,-302,74
-1,1617,1515,102,0,-7,55
-1,1748,2063,-315,0,-33,92
-1,1488,1304,184,-10,-554,72
1,1588,1875,-287,0,-1,51
1,1737,1643,94,2,47,51
1,1745,1551,194,2,95,65
1,1678,1302,376,4,364,73
1,1491,1440,51,2,164,70
0,1885,1801,84,-1,-1,41
-1,1609,1745,-136,0,13,42
1,1545,1750,-205,-1,-14,41
1,1348,1335,13,7,444,65
0,1872,1815,57,0,0,62
-1,1569,1753,-184,0,37,104
-1,1449,1705,-256,-3,-37,68
1,1556,1312,244,7,117,41
1,1470,1604,-134,0,1,75
-1,1817,1870,-53,0,-119,94
1,1505,1794,-289,0,-74,81
1,1720,1500,220,6,398,65
-1,1517,1597,-80,-8,-637,98
-1,1368,1602,-234,0,-14,73
1,1565,1263,302,0,83,59
0,1328,1468,-140,0,-12,74
0,1776,1525,251,1,45,129
1,1521,1605,-84,2,-359,113
1,1336,1447,-111,1,25,53
-1,1407,1451,-44,-16,-620,60
-1,1562,1500,62,0,14,52
1,1812,1536,276,1,47,89
-1,1362,1362,0,-2,-19,128
1,1256,1307,-51,-5,-87,103
1,1879,1807,72,2,62,59
-1,1708,1500,208,-2,-708,92
1,1635,1816,-181,2,44,65
-1,1553,1607,-54,-2,-83,50
1,1799,1652,147,0,137,113
1,1377,1351,26,-3,-75,59
1,1459,1292,167,1,449,103
0,1799,1652,147,-1,-104,94
-1,1275,1366,-91,-2,20,48
-1,1798,1888,-90,-4,6,44
1,1532,1770,-238,0,70,73
-1,1741,1544,197,0,-11,53
-1,1656,1794,-138,0,-168,98
1,1607,1514,93,1,264,85
-1,1233,1148,85,1,-47,52
0,1432,1551,-119,-1,58,71
0,1801,1649,152,1,-444,113
-1,1649,1801,-152,-1,-75,60
-1,1568,1397,171,1,-90,88
1,1700,1749,-49,0,-4,101
1,1808,1653,155,-5,-98,69
-1,1603,1543,60,-3,-51,80
-1,1399,1432,-33,-1,-452,108
-1,1359,1388,-29,-5,-8,110
1,1647,1815,-168,3,305,99
1,1736,1713,23,-1,179,137
-1,1397,1746,-349,-2,-33,44
1,1798,1663,135,-11,-460,69
1,1442,1379,63,2,84,55
-1,1663,1798,-135,-2,-100,74
-1,1362,1451,-89,-18,-535,48
1,1492,1455,37,9,299,63
-1,1284,1374,-90,-15,-470,58
1,1806,1656,150,-2,165,69
-1,1459,1347,112,1,86,74
1,1649,1813,-164,14,278,49
1,1737,1613,124,2,338,91
-1,1813,1649,164,-6,-136,42
1,1861,1268,593,24,579,47
1,1755,1512,243,-1,74,133
-1,1665,1796,-131,-1,-61,84
1,1372,1445,-73,1,-20,85
1,1862,1267,595,-2,348,75
1,1804,1658,146,-3,50,93
-1,1749,1291,458,3,29,50
1,1863,1532,331,1,73,55
1,1385,1328,57,13,587,59
-1,1651,1811,-160,1,117,108
1,1510,1470,40,-1,313,137
1,2052,1867,185,1,53,61
-1,1702,1612,90,0,56,72
1,1544,1046,498,9,235,55
1,2052,1817,235,5,134,61
1,1688,1626,62,2,99,57
-1,1621,1318,303,-1,-103,65
-1,1676,1658,18,-2,-35,50
-1,1812,2056,-244,-5,-273,66
-1,1697,1645,52,-4,-120,88
1,2056,1812,244,2,364,105
1,1264,1213,51,6,415,67
1,1657,1685,-28,-1,-67,67
1,1808,2061,-253,0,126,99
1,1528,1617,-89,9,203,55
-1,1300,1520,-220,-14,-954,84
-1,1436,1638,-202,-3,-14,56
1,1672,1669,3,1,29,73
1,1561,1338,223,14,324,53
-1,1669,1665,4,0,-65,62
-1,1658,1684,-26,1,12,60
1,1826,1745,81,1,69,99
1,1432,1595,-163,3,799,151
1,1694,1648,46,-1,-29,61
1,1500,1261,239,2,99,51
-1,1736,1835,-99,-3,47,76
1,1589,1639,-50,3,334,91
1,1675,1544,131,0,24,109
1,1843,1728,115,1,117,93
-1,1587,1357,230,-8,-654,78
0,1579,1448,131,-4,6,95
-1,1694,1801,-107,8,128,42
-1,1278,1666,-388,-4,-45,54
-1,1801,1694,107,0,107,40
1,1721,1543,178,0,4,77
1,1685,1706,-21,0,571,119
-1,1676,1836,-160,-8,-25,40
1,1571,1036,535,11,343,51
1,1376,1547,-171,3,378,127
1,1696,1761,-65,-7,-45,139
-1,1290,1333,-43,-8,-34,42
1,1475,1622,-147,-1,22,65
-1,1466,1585,-119,-10,-84,54
-1,1767,1700,67,0,7,54
-1,1746,1896,-150,-3,-11,60
1,1597,1581,16,0,2,61
1,1304,1357,-53,-4,-184,67
1,1659,1106,553,-2,-144,88
-1,1165,1401,-236,-17,-388,52
1,1364,1456,-92,8,307,61
-1,1609,1570,39,-9,-663,220
1,1579,1398,181,4,149,57
-1,1558,1652,-94,-2,-291,82
-1,1592,1459,133,-1,-210,114
1,1475,956,519,7,73,47
-1,1738,1855,-117,-3,-250,66
-1,1558,1832,-274,1,-146,97
1,1863,1730,133,-3,-33,109
1,1407,1153,254,14,162,43
1,1655,1600,55,0,11,41
1,1473,1182,291,5,119,57
-1,1918,1837,81,0,-61,103
-1,1722,1870,-148,-1,158,90
1,1315,1583,-268,0,-6,60
1,1714,1335,379,0,-6,51
1,1442,1378,64,0,266,115
1,1660,1097,563,2,74,55
-1,1877,1754,123,-3,-281,78
0,1538,1676,-138,-2,-269,105
-1,1332,1717,-385,-3,-88,58
-1,1142,1412,-270,-1,186,152
-1,1610,1794,-184,0,-245,77
-1,1656,1876,-220,-1,-8,49
1,1703,1826,-123,2,111,99
1,1341,1419,-78,-3,214,81
-1,950,1496,-546,-10,-250,46
-1,1635,1862,-227,-3,39,64
1,1719,1330,389,-3,-84,53
-1,1603,1800,-197,-6,-46,40
-1,1603,1360,243,0,-175,114
1,1477,1199,278,2,126,110
1,1716,1501,215,10,533,69
-1,1603,1800,-197,-6,-509,76
-1,1733,1536,197,-4,-553,140
-1,1675,1582,93,0,-436,104
-1,1327,1722,-395,-6,-476,90
1,1457,1542,-85,-3,-191,87
-1,1422,1474,-52,1,-61,100
1,1559,1336,223,-4,-28,49
-1,1662,1806,-144,-2,-232,78
1,1901,1598,303,1,209,127
-1,1089,1292,-203,0,25,70
-1,1451,1597,-146,-1,-27,64
-1,1729,1320,409,2,71,68
-1,1655,1943,-288,0,-21,68
1,1722,1370,352,4,358,99
1,1668,1254,414,4,239,57
-1,1803,1471,332,-2,-193,62
-1,1344,1705,-361,5,154,68
1,1478,1391,87,7,260,71
1,1651,1867,-216,-1,-22,45
-1,1313,1511,-198,1,72,48
-1,1370,1504,-134,-5,-143,50
1,1708,1341,367,-3,-3,59
1,1528,1439,89,1,199,111
1,1589,1409,180,0,92,89
-1,1405,1358,47,8,256,66
-1,1538,1500,38,-1,6,42
1,1849,1669,180,-1,-156,73
-1,1623,1444,179,0,289,74
-1,1338,1711,-373,-1,10,44
1,1569,1500,69,8,298,65
-1,1250,1671,-421,-15,-622,54
-1,1447,1483,-36,-5,-184,106
-1,1596,1660,-64,9,253,120
1,1766,1523,243,0,-208,81
1,1470,1722,-252,8,298,58
-1,1662,1855,-193,0,-10,56
1,1714,1335,379,0,23,57
-1,1485,1163,322,-7,-229,102
-1,1657,1861,-204,0,85,82
-1,1332,1717,-385,1,6,54
-1,1905,1586,319,0,-16,64
1,1673,1246,427,1,227,61
1,1575,1553,22,0,112,71
-1,1858,1510,348,3,-745,132
1,1720,1329,391,-3,32,55
1,1866,1651,215,0,25,77
1,1530,1472,58,0,197,125
1,1458,1500,-42,6,223,59
-1,1486,1550,-64,-3,-29,42
-1,1646,1872,-226,9,468,70
-1,1731,1529,202,-1,-38,46
1,1441,1558,-117,4,27,41
1,1566,1550,16,-2,-37,51
1,1635,1546,89,-2,50,61
1,1595,1428,167,14,632,77
1,1876,1641,235,0,1,83
1,1712,1713,-1,0,-15,51
1,1641,1876,-235,7,197,61
-1,1309,1533,-224,-5,-269,66
1,1373,1392,-19,0,71,67
0,1883,2004,-121,0,64,137
-1,1459,1528,-69,1,23,68
1,1486,1216,270,1,545,123
-1,1677,1841,-164,-3,-73,66
1,1848,1670,178,-1,-49,67
1,1670,1587,83,1,95,83
1,1631,1529,102,-1,276,85
1,1364,1450,-86,5,157,63
1,1854,1814,40,-4,-423,91
-1,1803,1864,-61,-1,-34,48
1,1457,1584,-127,0,730,119
-1,1380,1387,-7,-7,-850,116
1,1873,1793,80,4,218,67
1,1729,1426,303,-3,-34,72
-1,1537,1567,-30,-3,-97,62
1,1493,1537,-44,-1,-42,101
1,1578,1679,-101,-1,385,133
1,1477,1522,-45,-1,624,79
1,1684,1628,56,2,49,49
-1,1809,1882,-73,-5,-33,94
-1,1454,1542,-88,0,44,98
0,1451,1457,-6,-8,256,126
-1,1891,1799,92,0,-308,142
-1,1580,1694,-114,4,-195,104
1,1438,1318,120,15,389,45
1,1617,1571,46,-1,-3,77
1,1361,1511,-150,-8,-302,107
1,1437,1440,-3,5,164,53
-1,1687,1660,27,-4,-255,75
-1,1399,1505,-106,1,182,126
1,1877,1814,63,0,21,89
-1,1542,1765,-223,0,-146,133
-1,1422,1732,-310,-14,-132,40
1,1397,1490,-93,8,343,67
-1,1187,1546,-359,-7,-371,91
1,1388,1436,-48,3,37,47
-1,1755,1664,91,0,0,50
1,1321,1281,40,-3,277,75
0,1400,1369,31,2,304,131
-1,1664,1592,72,-1,-50,52
-1,1886,1804,82,-8,-2,90
-1,1618,1829,-211,-9,-124,50
-1,1401,1419,-18,-10,-227,51
1,1410,1453,-43,-7,-204,67
1,1736,1419,317,-2,-97,113
1,1626,1316,310,2,164,64
1,1476,1413,63,1,138,65
-1,1537,1508,29,1,-335,108
0,1605,1650,-45,0,53,118
1,1873,1819,54,2,67,45
-1,1390,1943,-553,-12,-154,52
1,1428,1557,-129,-2,-42,41
-1,1526,1434,92,-8,-274,52
1,1330,1573,-243,-2,2,49
-1,1494,1688,-194,-2,-99,70
-1,1760,1390,370,0,-2,40
-1,1478,1385,93,-1,-250,118
1,1331,1358,-27,1,449,127
-1,1538,1642,-104,-3,-438,76
1,1404,1431,-27,5,280,75
1,1513,1391,122,4,137,59
1,1451,1464,-13,-5,-349,71
1,1648,1606,42,-3,116,77
-1,1402,1458,-56,0,-11,56
1,1403,1485,-82,10,547,95
1,1680,1672,8,0,37,59
1,1469,1197,272,-6,67,57
1,1512,1292,220,0,24,58
1,1649,1702,-53,0,115,79
1,1326,1469,-143,-1,-4,43
1,1657,1512,145,6,54,45
0,1448,1701,-253,1,-171,114
-1,1639,1399,240,-2,-39,62
-1,1314,1294,20,-1,-92,69
0,1189,1345,-156,0,65,104
-1,1517,1658,-141,0,-233,72
1,1629,1636,-7,0,4,45
-1,1342,1982,-640,-2,-159,64
-1,1461,1538,-77,-4,-414,128
1,1472,1419,53,1,49,87
1,1957,1341,616,4,64,47
1,1510,1520,-10,-2,301,113
-1,1340,1958,-618,-13,-240,44
1,1494,1452,42,10,352,61
1,1663,1576,87,-4,-91,73
-1,1415,1739,-324,2,-93,80
-1,1584,1412,172,-3,92,94
1,1640,1384,256,1,51,47
1,1571,1426,145,7,307,59
-1,1689,1768,-79,-2,-63,54
-1,1338,1960,-622,-6,-191,76
-1,1697,1694,3,-2,-27,46
-1,1665,1780,-115,-2,-8,46
1,1960,1337,623,3,33,45
1,1565,1408,157,2,191,95
-1,1471,1509,-38,0,85,56
-1,1662,1885,-223,-1,-5,42
1,1521,1515,6,-2,-204,105
-1,1336,1961,-625,0,-41,48
1,1962,1335,627,-1,61,43
-1,1309,1218,91,-13,-230,50
0,1882,1963,-81,-2,-365,131
-1,1550,1379,171,2,101,78
-1,1335,1564,-229,1,36,56
0,1516,1261,255,-1,168,156
1,1529,1605,-76,2,77,101
-1,1690,1730,-40,1,-9,50
-1,1115,1541,-426,-8,-178,52
1,1481,1519,-38,2,109,97
1,1683,1630,53,1,169,93
1,1532,1439,93,9,403,72
-1,1500,1709,-209,-4,-112,48
1,1649,1500,149,8,597,69
1,1713,1506,207,-1,36,57
-1,1328,1239,89,8,127,54
-1,1693,1620,73,0,4,46
-1,1256,1309,-53,-7,-102,46
-1,1540,1643,-103,0,-192,82
1,1496,1501,-5,1,65,77
-1,1564,1335,229,-7,-281,80
-1,1571,1277,294,0,-231,142
-1,1306,1246,60,-2,-348,106
1,1606,1410,196,-6,-59,55
1,1612,1404,208,4,40,43
-1,1505,1808,-303,-4,-172,70
1,1747,1703,44,6,86,43
-1,1299,1588,-289,-1,-178,100
1,1507,1493,14,0,296,111
1,1973,1790,183,1,92,65
-1,1535,1431,104,-5,-196,68
-1,1322,1644,-322,0,15,44
1,1533,1363,170,3,594,99
1,1299,1552,-253,0,71,61
-1,1782,1981,-199,-1,37,68
-1,1578,1421,157,0,-345,78
1,1534,1320,214,1,139,69
1,1652,1775,-123,0,70,93
-1,1423,1444,-21,2,47,60
1,1988,1998,-10,0,-120,103
-1,1693,1758,-65,-8,-191,48
1,2003,1986,17,0,28,75
1,1539,1314,225,0,155,77
-1,1585,1588,-3,-1,-12,90
1,1139,1162,-23,13,480,55
1,1689,1398,291,-2,247,85
1,2061,1978,83,-2,2,73
1,1602,1531,71,-1,3,49
-1,1451,1527,-76,-5,-131,52
-1,2017,1975,42,-2,-345,124
-1,1699,1777,-78,-3,-56,52
-1,1039,1277,-238,8,353,60
-1,1544,1769,-225,-2,-482,114
-1,1187,1494,-307,3,17,78
1,1490,1193,297,1,10,53
0,1442,1511,-69,1,-88,137
1,1576,1324,252,2,613,79
1,1618,1394,224,3,28,97
1,1632,1529,103,0,133,89
1,1754,1715,39,-1,-58,69
1,1536,1538,-2,1,216,81
-1,1172,1280,-108,-3,-174,64
-1,1309,1527,-218,-12,-347,46
-1,1547,1506,41,-1,-27,78
-1,1498,1454,44,-1,-168,72
-1,1697,1756,-59,-3,-240,88
1,1429,1248,181,1,-62,53
-1,1535,1369,166,0,-54,56
-1,1623,1515,108,12,401,62
1,1534,1532,2,1,167,107
1,1463,1413,50,-1,-5,50
1,1645,1484,161,8,351,59
1,1616,1453,163,6,254,61
-1,1518,1660,-142,-3,-626,124
1,1616,1453,163,-1,0,45
-1,1541,1546,-5,-9,-306,56
1,1690,1696,-6,-2,72,59
1,1658,1597,61,2,1222,109
1,1417,1521,-104,0,6,43
-1,1459,1557,-98,1,17,60
-1,1873,1930,-57,-2,-218,74
1,1512,1402,110,4,286,77
-1,1812,1684,128,3,82,60
-1,1249,1184,65,4,99,54
1,1908,1786,122,0,3,67
1,1667,1511,156,-3,-131,85
1,1588,1615,-27,-8,-389,99
-1,1475,1574,-99,0,-182,118
-1,1603,1600,3,-7,-115,64
-1,1742,1921,-179,-2,-73,50
-1,1591,1611,-20,2,47,46
-1,1463,1455,8,-1,-83,74
1,1863,1699,164,0,34,85
-1,1161,1451,-290,-3,-47,50
-1,1611,1591,20,1,41,56
-1,1621,1603,18,-19,-618,64
1,1557,1465,92,3,121,59
-1,1692,1870,-178,0,20,52
1,1664,1499,165,5,169,51
1,1501,1638,-137,-3,-158,61
1,1455,1123,332,4,104,51
1,2069,1970,99,0,-1,51
1,1643,1628,15,3,90,45
-1,1599,1510,89,5,332,76
-1,1586,1626,-40,1,13,42
1,1876,1686,190,0,-1,61
-1,1636,1524,112,-1,-23,40
1,1576,1311,265,3,276,69
1,1668,1555,113,-1,-16,60
1,1458,1330,128,13,363,51
0,1476,1645,-169,-2,-156,98
-1,1683,1807,-124,-3,-309,82
-1,1059,1417,-358,-11,-704,74
1,1505,1547,-42,4,249,105
-1,1505,1796,-291,2,-73,64
-1,1580,1570,10,-7,-136,54
-1,1970,1908,62,0,-5,50
-1,1782,1798,-16,0,-265,136
-1,1516,1517,-1,-1,-87,128
-1,1539,1621,-82,-2,-93,60
-1,1934,1729,205,-2,-27,52
1,1960,1950,10,0,-151,105
1,1549,1603,-54,-1,-16,63
1,1345,1292,53,-5,37,111
1,1569,1582,-13,-1,237,83
1,1634,1800,-166,6,269,71
1,1662,1467,195,5,394,67
-1,1471,1340,131,-3,-23,44
1,1940,1788,152,-3,47,73
1,1593,1558,35,2,314,77
-1,1940,1974,-34,1,-42,94
-1,1322,1385,-63,-5,-27,42
1,1590,1561,29,-7,-53,77
-1,1947,1771,176,0,-29,68
1,1988,1929,59,-9,-209,85
1,1551,1496,55,0,12,55
-1,1929,1988,-59,-3,-8,78
1,1617,1534,83,0,-7,73
1,1669,1459,210,0,257,81
1,1518,1300,218,-2,-95,57
-1,1446,1560,-114,-3,-50,48
0,1822,1940,-118,0,9,111
1,1920,2000,-80,1,207,67
1,1414,1520,-106,2,11,101
-1,1650,1702,-52,1,-19,74
1,1675,1451,224,10,626,79
1,1523,1521,2,0,12,53
-1,1710,1782,-72,0,-121,80
-1,1405,1510,-105,2,-9,77
-1,1625,1526,99,0,37,96
1,1681,1444,237,0,25,61
1,1355,1426,-71,10,198,43
1,1573,1570,3,-3,-19,63
1,1597,1581,16,2,315,122
1,1686,1438,248,6,525,97
-1,1368,1518,-150,1,-53,48
-1,1401,1581,-180,0,-14,64
1,1578,1630,-52,6,139,63
-1,1540,1500,40,0,33,96
1,1714,1641,73,-9,236,101
-1,1534,1429,105,0,-2,52
1,1692,1432,260,4,307,71
1,1540,1696,-156,0,266,89
-1,1617,1590,27,5,300,70
1,1590,1617,-27,-6,-140,67
1,1696,1426,270,11,148,43
-1,1882,1681,201,1,92,114
-1,1627,1602,25,9,472,84
0,1520,1834,-314,0,-3,66
-1,1696,1426,270,1,163,84
1,1614,1616,-2,1,173,89
1,1641,1589,52,-1,129,139
1,1605,1624,-19,-1,-4,47
-1,1404,1484,-80,0,1,66
1,1624,1605,19,0,-7,53
1,1373,1464,-91,2,436,105
-1,1461,1395,66,-8,-5,72
1,1594,1635,-41,0,-103,85
1,1608,1587,21,7,651,103
-1,1500,1394,106,-2,-137,66
-1,1623,1606,17,-4,-100,54
-1,1618,1611,7,-1,23,40
0,1533,1446,87,-5,-71,88
-1,1611,1618,-7,-5,-454,84
-1,1628,1601,27,6,246,58
1,1493,1411,82,-4,-116,55
-1,1381,1537,-156,-1,-109,55
1,1930,1870,60,-1,28,63
-1,1500,1679,-179,0,-215,84
1,1530,1484,46,0,-61,69
0,1120,1110,10,6,694,107
1,1618,1576,42,0,323,145
-1,1154,1983,-829,-12,-202,50
-1,1621,1840,-219,-6,-106,56
1,1559,1519,40,0,-3,59
1,1983,1154,829,1,10,47
-1,1760,1522,238,-2,-152,62
1,1540,1474,66,0,-2,63
-1,1401,1709,-308,2,56,46
1,1867,1691,176,0,67,89
-1,1408,1549,-141,-1,-58,82
-1,1724,1672,52,-4,-44,67
-1,1262,1325,-63,1,160,112
0,1451,1500,-49,1,67,64
1,2024,1625,399,1,26,79
1,1549,1744,-195,0,258,165
1,1684,1395,289,15,284,51
1,1704,1452,252,3,120,53
-1,1500,1517,-17,-1,12,54
1,1295,1650,-355,0,-1,45
-1,1476,1465,11,-11,-291,52
-1,1500,1500,0,-2,-1,74
1,1636,1422,214,6,195,59
-1,1446,1708,-262,-7,-585,102
1,1675,1442,233,3,275,83
-1,1628,1884,-256,0,130,78
-1,1151,1413,-262,-4,-188,62
1,1623,1500,123,6,149,52
1,1712,1687,25,-3,1,93
1,1727,1566,161,18,548,59
1,1401,1480,-79,10,369,71
1,1501,1544,-43,0,131,63
-1,1725,1646,79,-1,-14,96
-1,1353,1507,-154,-5,-132,68
-1,1559,1734,-175,1,-578,108
1,1681,1438,243,4,692,107
1,1827,1874,-47,1,202,83
1,1550,1391,159,-2,149,125
-1,1640,1793,-153,-1,-430,80
1,1659,1712,-53,-2,-99,81
1,1433,1026,407,10,234,53
0,1612,1438,174,-1,-140,85
1,1686,1287,399,1,115,65
1,1608,1444,164,2,17,43
-1,1016,1435,-419,-7,-79,49
1,1700,1671,29,-3,-233,93
1,1642,1590,52,1,642,159
-1,1417,1864,-447,-6,-160,54
-1,1422,1513,-91,-2,-255,148
-1,1897,1873,24,-1,-288,84
-1,1543,1362,181,-1,-130,86
1,1675,1494,181,6,301,71
1,1693,1638,55,1,42,44
-1,1437,1358,79,0,-12,56
-1,1440,1348,92,-18,-705,56
-1,1685,1709,-24,-1,-142,106
-1,1617,1778,-161,-7,-700,84
1,1634,1354,280,3,167,65
-1,1284,1416,-132,4,64,84
1,1285,1139,146,2,166,59
1,1411,1428,-17,-4,-120,55
1,1628,1710,-82,-1,57,81
1,1785,1721,64,3,95,59
1,1623,1650,-27,-1,11,119
-1,1500,1516,-16,-5,-443,102
1,1861,1826,35,-4,-128,57
1,1525,1293,232,-9,-172,73
1,2126,1826,300,0,54,65
1,1681,1466,215,3,405,95
1,1594,1522,72,-2,-89,161
-1,1709,1869,-160,2,43,50
1,1822,2131,-309,0,295,117
-1,1425,1432,-7,-3,-122,56
-1,1622,1623,-1,0,51,64
-1,1675,1869,-194,1,-325,148
-1,1794,1816,-22,0,-267,78
-1,1415,1491,-76,-6,-254,78
1,1635,1601,34,-3,-35,161
1,1444,1412,32,-1,6,49
-1,1764,2104,-340,-1,-12,54
1,1976,1710,266,3,193,64
1,1420,1665,-245,1,340,79
-1,1688,1612,76,-1,-3,58
-1,1382,1306,76,-7,-176,54
-1,1399,1454,-55,-3,-4,72
1,1626,1258,368,4,155,85
1,1673,1510,163,-3,-60,51
-1,1701,1591,110,0,-42,59
-1,1532,1645,-113,-4,-107,50
-1,1500,1976,-476,0,-225,102
0,1875,1669,206,-2,-123,97
-1,1700,1869,-169,0,2,42
-1,1613,1288,325,-5,-442,110
1,1634,1638,-4,3,66,51
1,1464,1388,76,1,259,83
1,1823,1887,-64,-1,-23,51
1,2108,1389,719,-1,46,81
-1,2057,2059,-2,-3,-299,116
1,1524,1418,106,1,33,47
0,1644,1531,113,-4,185,164
-1,1377,1472,-95,0,-38,50
1,1940,2023,-83,-2,-121,73
1,1500,1396,104,3,92,53
1,1886,1694,192,1,170,95
1,1664,1675,-11,-1,1,49
1,1485,1463,22,-7,-123,43
-1,1680,1500,180,-10,-87,42
-1,1651,1566,85,0,8,58
-1,1254,1638,-384,-5,-237,64
1,1634,1649,-15,15,414,47
1,1459,1788,-329,-1,45,60
-1,1602,1639,-37,0,-137,102
-1,1465,1475,-10,-3,-144,56
1,1445,1265,180,0,3,41
-1,1326,1520,-194,2,-42,92
0,1725,1500,225,-5,-102,55
-1,1534,1488,46,0,23,72
1,1798,1719,79,-3,-46,49
0,1199,1198,1,1,-778,134
-1,1276,1359,-83,6,99,46
1,1920,1796,124,0,22,65
1,1421,1181,240,6,301,65
1,1904,1806,98,1,88,59
1,1387,1458,-71,-2,155,77
-1,1696,1698,-2,2,68,86
1,1524,1620,-96,0,-4,43
1,1344,1379,-35,-3,-14,53
-1,1592,1658,-66,0,-13,64
1,1368,1266,102,2,44,77
-1,1500,1650,-150,-5,-265,64
-1,1728,1748,-20,0,-67,90
0,1054,1336,-282,-11,-4,77
-1,1583,1710,-127,1,3,56
1,2141,1735,406,0,85,75
1,1257,1377,-120,7,134,51
-1,1173,1394,-221,-8,-257,56
-1,1568,1525,43,-6,-141,56
1,1730,1594,136,0,18,61
1,1266,1380,-114,0,-8,67
0,1367,1557,-190,2,59,102
-1,1322,1462,-140,-8,115,112
1,1751,1565,186,-3,115,59
1,1616,1722,-106,-2,-53,45
-1,1797,1913,-116,0,-155,58
-1,1675,1729,-54,0,-115,92
-1,1199,1608,-409,-3,-346,88
-1,1336,1704,-368,4,24,70
1,1562,1484,78,12,181,45
-1,1764,1928,-164,0,5,114
1,1813,1541,272,-1,251,165
1,1628,1512,116,1,71,63
-1,1811,1607,204,2,130,81
1,1313,1580,-267,1,42,45
-1,1739,1678,61,1,-170,62
1,2146,1731,415,0,1,43
-1,1165,1296,-131,-10,-346,56
-1,1475,1571,-96,-4,-118,74
1,1746,1625,121,1,139,141
-1,1359,1372,-13,-1,-115,116
-1,1718,1759,-41,0,-27,60
0,1725,1666,59,4,76,141
-1,1400,1455,-55,-2,-91,50
0,1315,1241,74,0,-72,87
1,1555,1538,17,4,113,115
-1,1525,1660,-135,-2,-13,40
1,1728,1737,-9,0,-1,55
0,1196,1255,-59,0,-9,129
-1,1497,1312,185,-11,-771,114
-1,1636,1503,133,-2,-67,64
1,1310,1202,108,13,372,57
1,1527,1658,-131,4,69,59
-1,1440,1500,-60,0,7,80
-1,1155,1584,-429,3,-203,74
1,1668,1723,-55,0,25,111
1,1574,1335,239,4,153,53
1,1806,1535,271,-4,-483,91
-1,1579,1467,112,-1,-359,92
-1,1840,1713,127,-1,-63,60
1,1101,1230,-129,1,109,101
1,1621,1558,63,3,63,48
-1,1393,1576,-183,1,-43,94
-1,1472,1508,-36,-9,3,40
-1,1652,1641,11,0,35,60
-1,1551,1373,178,1,86,66
1,1768,1658,110,3,510,93
-1,1593,1652,-59,-7,-441,80
1,1512,1549,-37,-1,-15,41
-1,1992,1653,339,0,-72,112
-1,1578,1662,-84,-2,-164,62
1,1707,1665,42,1,256,111
-1,1521,1390,131,-3,-173,65
1,1462,1198,264,4,190,63
-1,1726,1748,-22,-6,-130,44
1,1480,1418,62,3,283,77
1,1586,1656,-70,-3,-71,63
1,1606,1643,-37,-7,-36,51
1,1537,1630,-93,4,317,77
-1,1680,1572,108,1,-282,108
-1,1606,1643,-37,5,148,64
1,1481,1565,-84,0,297,93
-1,1921,1527,394,7,251,58
1,1592,1653,-61,-7,-93,53
1,1586,1152,434,8,911,90
-1,1523,1818,-295,1,-14,54
-1,1609,1776,-167,-3,-72,42
1,1610,1640,-30,-1,-137,71
-1,1551,1616,-65,0,13,54
-1,1488,1305,183,-1,-39,62
1,1493,1439,54,-5,-70,77
1,1464,1504,-40,1,27,53
-1,1175,1329,-154,-3,67,62
-1,1627,1628,-1,-11,-73,44
-1,1547,1899,-352,0,-63,122
1,1625,1485,140,3,435,83
1,1612,1639,-27,3,1517,121
1,1324,1566,-242,-1,153,101
-1,1460,1474,-14,0,-21,100
1,1324,1500,-176,10,961,99
1,1783,1576,207,0,79,69
-1,1149,1588,-439,-19,-377,47
1,1628,1627,1,4,33,43
1,1582,1546,36,4,653,107
1,1477,1632,-155,1,209,103
1,1460,1508,-48,-4,-3,97
1,1519,1464,55,3,91,65
-1,1376,1710,-334,-13,-328,50
1,1692,1616,76,-1,186,83
-1,1484,1382,102,-2,-151,64
1,1443,1068,375,1,37,75
-1,1634,1575,59,-6,-181,56
-1,1292,1556,-264,-7,-467,74
-1,1713,1373,340,0,-196,88
-1,1319,1357,-38,0,23,60
1,1777,1664,113,2,80,69
-1,1548,1789,-241,0,-1,66
-1,1395,1693,-298,0,-17,78
1,1560,1256,304,8,791,85
-1,1641,1754,-113,-1,-145,78
1,1468,1470,-2,-1,-48,51
-1,1610,1738,-128,-1,-99,144
-1,1597,1500,97,1,20,40
-1,1500,1484,16,-1,-87,54
-1,1369,1536,-167,-1,-27,40
-1,1712,1748,-36,0,-110,100
1,1718,1655,63,-2,247,103
-1,1460,1525,-65,1,-282,132
-1,1625,1511,114,-7,-207,54
1,1843,1676,167,0,-15,85
1,1543,1534,9,0,54,67
-1,1455,1529,-74,0,-69,70
1,1405,1500,-95,3,205,79
-1,1363,1500,-137,5,-195,106
-1,1506,1593,-87,4,125,66
0,1577,1583,-6,0,31,132
1,1449,1289,160,2,-74,108
-1,1795,1436,359,-5,-154,78
-1,1669,1850,-181,0,58,92
-1,1170,1147,23,6,88,90
1,1566,1450,116,-8,39,117
-1,1634,1510,124,-3,-135,66
-1,1662,1337,325,-4,-531,104
-1,1555,1710,-155,2,72,72
-1,1644,1764,-120,2,-3,46
-1,1690,1870,-180,0,-26,84
0,1421,1507,-86,0,185,142
-1,1309,1406,-97,-1,-125,134
1,1636,1725,-89,-4,-143,75
-1,1495,1443,52,2,68,70
-1,1556,1457,99,-6,-50,48
-1,1729,1690,39,0,-111,146
-1,1258,1163,95,19,531,46
-1,1633,1793,-160,0,-46,80
1,1538,1773,-235,-3,190,81
-1,1656,1785,-129,-1,-138,86
1,1357,1471,-114,4,51,53
-1,1456,1482,-26,-3,-226,64
0,1731,1487,244,1,-236,135
0,1446,1338,108,1,-49,86
-1,1483,1790,-307,0,-52,56
-1,1542,1588,-46,-1,-21,64
-1,1452,1549,-97,-2,-67,62
-1,1412,1399,13,0,-19,44
1,1445,1492,-47,3,284,67
-1,1442,1385,57,-1,-20,48
0,1537,1413,124,0,6,136
1,1837,1267,570,2,52,47
-1,1493,1717,-224,0,-52,70
-1,1397,1429,-32,-5,-364,66
-1,1343,1516,-173,3,17,76
1,1480,1458,22,1,100,57
0,1401,1255,146,-1,11,98
-1,1410,1558,-148,-4,-91,56
-1,1369,1561,-192,0,-22,54
1,1604,1793,-189,0,-5,58
-1,1474,1489,-15,-3,-456,109
-1,1448,1490,-42,-9,152,108
1,1813,1565,248,-1,-24,59
1,1634,1727,-93,1,29,63
1,1554,1355,199,6,233,49
-1,1388,1439,-51,-2,-78,66
-1,1331,1554,-223,-8,-462,70
0,1744,1775,-31,0,17,110
-1,1533,1571,-38,-2,-123,72
-1,1500,1438,62,1,-94,80
-1,1594,1603,-9,-8,-263,114
0,1499,1456,43,3,273,108
1,1577,1496,81,0,333,91
1,1818,1560,258,2,38,61
-1,1514,1643,-129,-1,-99,110
-1,1487,1586,-99,0,-97,160
1,1368,1508,-140,7,424,93
-1,1541,1670,-129,4,19,42
1,1581,1523,58,-2,122,81
-1,1300,1528,-228,-1,-111,60
1,1475,1463,12,0,120,77
1,1210,1079,131,-4,-190,91
-1,1556,1663,-107,-4,-186,56
-1,1335,1677,-342,-5,-58,46
1,1822,1548,274,1,212,87
-1,1613,1481,132,-5,-234,70
-1,1459,1498,-39,1,24,80
-1,1530,1477,53,-6,-200,70
-1,1346,1362,-16,-3,-66,54
1,1489,1227,262,23,972,59
1,1594,1478,116,4,268,85
-1,1518,1500,18,1,-189,74
1,1452,1486,-34,0,-116,75
-1,1827,1793,34,0,-362,72
-1,1470,1602,-132,-1,-230,110
-1,1474,1465,9,-7,-162,46
1,1509,1381,128,0,168,57
1,1394,1684,-290,0,17,71
1,1500,1237,263,-3,63,73
1,1813,1806,7,3,112,71
-1,1348,1208,140,-9,-210,48
1,1249,1241,8,5,315,81
-1,1476,1463,13,-2,-95,72
-1,1624,1794,-170,-7,59,40
-1,1794,1624,170,-2,-55,56
-1,1100,1485,-385,-2,-89,54
-1,1598,1520,78,-2,-141,80
1,1500,1336,164,18,497,49
-1,1801,1640,161,-3,-81,56
1,1602,1622,-20,-2,210,63
1,1295,1619,-324,-3,123,91
-1,1691,1500,191,-3,-139,67
-1,1584,1445,139,-3,-168,76
1,1330,1609,-279,-18,-141,43
-1,1622,1610,12,0,-53,108
1,1474,1465,9,5,335,57
1,1676,1502,174,-1,78,119
1,1797,1769,28,4,30,43
1,1710,1560,150,0,12,71
1,1666,1604,62,2,160,87
1,1500,1421,79,-3,339,113
1,1657,1436,221,3,148,94
-1,1454,1484,-30,3,290,90
1,1681,1506,175,0,-16,55
-1,1675,1590,85,-10,-371,58
1,1915,1761,154,2,45,41
1,1661,1610,51,0,247,101
-1,1384,1748,-364,-3,-345,104
1,1584,1524,60,6,603,99
-1,1494,1444,50,0,-400,88
1,1500,1543,-43,0,93,69
-1,1157,1476,-319,-7,-398,56
1,1698,1825,-127,-3,229,127
-1,1717,1754,-37,-4,14,46
1,1363,1513,-150,0,172,91
-1,1509,1800,-291,0,-93,86
1,1813,1863,-50,-2,341,161
-1,1515,1594,-79,-9,-121,82
1,1456,1482,-26,-4,-141,63
-1,1499,1687,-188,-2,-34,64
1,1752,1378,374,0,122,63
-1,1609,1778,-169,-2,-248,64
-1,1544,1480,64,-7,-142,52
1,1839,1569,270,-1,39,71
1,1395,1641,-246,-5,-111,51
-1,1829,1844,-15,0,-76,148
-1,1496,1685,-189,0,-157,138
1,1790,1603,187,-3,167,87
1,1471,1468,3,1,66,59
1,1376,1250,126,3,132,49
1,1765,1529,236,5,27,41
-1,1507,1789,-282,0,-67,114
1,1743,1377,366,-1,-9,65
1,1734,1634,100,-3,-72,45
1,1496,1769,-273,0,-17,45
1,1715,1596,119,-2,78,75
1,1457,1481,-24,0,23,57
1,1709,1380,329,-3,181,57
-1,1523,1494,29,5,165,62
-1,1533,1611,-78,0,-51,66
1,1605,1500,105,6,302,57
-1,1819,1856,-37,0,13,68
1,1723,1345,378,11,426,85
-1,1614,1861,-247,-1,-203,96
-1,1591,1752,-161,-2,-53,52
-1,1354,1712,-358,-2,-136,62
1,1427,1446,-19,14,616,57
1,1725,1343,382,9,513,67
1,1470,1469,1,1,65,77
1,1746,1408,338,4,413,95
-1,1496,1524,-28,-1,-34,44
-1,1809,1867,-58,0,-42,80
-1,1399,1650,-251,-1,-116,72
1,1609,1390,219,-3,159,114
1,1504,1334,170,-4,-166,62
1,1518,1443,75,2,339,117
-1,1578,1766,-188,0,7,54
1,1477,1493,-16,0,198,89
-1,1614,1462,152,0,-82,70
-1,1584,1433,151,-3,-429,118
-1,1598,1824,-226,-2,-166,72
1,1804,1772,32,1,38,67
-1,1662,1711,-49,1,2,62
1,1806,1866,-60,-2,-487,79
-1,1565,1654,-89,-1,92,116
1,1614,1510,104,0,5,73
1,1593,1535,58,-1,-53,55
1,1516,1503,13,3,316,77
-1,1294,1611,-317,-5,-141,54
-1,1843,1698,145,-5,-41,56
1,1118,1500,-382,-1,190,89
-1,1715,1770,-55,-6,-236,58
-1,1543,1313,230,-1,-179,146
-1,1778,1747,31,4,58,44
1,1518,1530,-12,0,43,73
1,1502,1622,-120,-1,55,73
-1,1486,1443,43,0,-44,92
-1,1714,1827,-113,2,39,46
-1,1615,1666,-51,-1,32,70
-1,1493,1531,-38,-3,-26,55
1,1754,1335,419,4,616,113
1,1403,1462,-59,8,261,67
-1,1486,1678,-192,0,-58,82
1,1656,1535,121,0,21,43
1,1835,1706,129,1,32,55
1,1193,1549,-356,-2,206,111
-1,1607,1516,91,1,-42,106
-1,1775,1760,15,-2,-28,70
1,1357,1386,-29,11,283,49
-1,1417,1545,-128,-1,-24,54
1,1296,1403,-107,3,239,71
-1,1379,1217,162,-5,-148,60
-1,1676,1604,72,-2,-113,66
1,1393,1185,208,0,11,41
1,1593,1430,163,-1,-6,83
-1,1238,1160,78,4,94,48
1,1361,1267,94,8,356,69
1,1757,1308,449,8,276,51
0,1682,1732,-50,2,84,197
1,1362,1631,-269,5,43,57
-1,1331,1435,-104,-4,-37,58
-1,1390,1667,-277,-6,-26,60
-1,1229,1351,-122,-3,-385,110
-1,1745,1738,7,3,-66,80
-1,1652,1883,-231,-1,-89,84
1,1857,1899,-42,0,10,59
-1,1327,1545,-218,-3,-36,94
1,1500,1527,-27,2,-31,69
1,1363,1520,-157,4,116,65
1,1835,1409,426,0,33,69
-1,1424,1600,-176,-2,10,86
1,1382,1189,193,16,611,59
1,1689,1518,171,-3,-93,67
-1,1530,1545,-15,-1,-113,60
1,1608,1622,-14,4,77,41
1,1758,1512,246,0,42,75
-1,1778,1772,6,0,17,90
1,1399,1443,-44,0,281,79
1,1610,1619,-9,-1,-25,101
1,1613,1408,205,5,343,78
-1,1862,1529,333,1,13,54
1,1732,1692,40,1,61,73
1,1212,1552,-340,5,171,43
1,1799,1507,292,1,128,87
1,1759,1472,287,-1,161,71
-1,1322,1658,-336,-3,-291,72
-1,1606,1632,-26,1,182,86
1,1945,1523,422,-8,113,83
-1,1828,1608,220,0,-290,64
1,1619,1663,-44,0,-14,59
1,1548,1520,28,0,-37,83
1,1623,1710,-87,-3,-4,63
-1,1480,1649,-169,-1,-219,88
-1,1640,1503,137,-4,-232,66
-1,1631,1635,-4,-4,-34,52
1,1661,1224,437,1,146,55
1,1584,1529,55,0,-20,41
-1,1435,1384,51,-5,-224,70
1,1236,1426,-190,-2,281,115
-1,1684,1480,204,-1,-48,128
1,1633,1511,122,0,43,45
1,1467,1386,81,4,414,88
-1,1226,1636,-410,-2,-18,44
1,1539,1311,228,6,341,63
1,1595,1047,548,2,128,73
-1,1559,1500,59,-3,-335,88
-1,1558,1503,55,-4,-124,56
1,1237,1228,9,-1,540,135
-1,1521,1784,-263,-4,-405,124
-1,1742,1615,127,-8,-26,84
-1,1516,1512,4,1,-303,114
1,1328,1191,137,-14,-236,45
-1,1641,1727,-86,0,0,50
1,1664,1319,345,-4,191,105
-1,1593,1655,-62,-1,-150,96
1,1873,1837,36,-5,-45,45
1,1517,1511,6,8,1898,129
1,1706,1550,156,6,909,119
1,1183,1372,-189,1,353,93
1,1558,1473,85,5,193,54
1,1423,1471,-48,7,351,89
1,1497,1483,14,-5,-95,51
-1,1481,1529,-48,-8,-331,76
-1,1630,1573,57,1,24,50
1,1538,1457,81,4,252,49
1,1281,1200,81,1,9,43
1,1597,1300,297,0,0,45
-1,1617,1735,-118,-3,-361,130
-1,1191,1322,-131,2,38,102
1,1672,1544,128,2,123,65
1,1641,1547,94,0,51,103
-1,1460,1617,-157,-3,-178,72
1,1436,1480,-44,1,6,67
-1,1183,1660,-477,-3,-132,74
0,1743,1610,133,4,492,83
-1,1218,1273,-55,0,-525,134
1,1445,1353,92,-2,201,77
-1,1547,1549,-2,3,99,64
1,1664,1181,483,1,-63,75
1,1766,1372,394,2,218,79
-1,1649,1677,-28,-1,57,90
1,1601,1290,311,-2,49,107
-1,1294,1780,-486,0,-92,74
-1,1376,1453,-77,-6,-88,42
1,1851,1667,184,2,202,93
1,1462,1322,140,2,341,87
-1,1322,1462,-140,-5,-543,88
-1,1667,1851,-184,-1,-1005,146
1,1443,1224,219,2,68,51
1,1664,1540,124,6,342,65
1,1857,1654,203,-2,92,101
0,1604,1271,333,-1,-101,138
1,1476,1443,33,-5,-259,84
1,1728,1756,-28,3,11,75
-1,1398,1582,-184,-1,-149,72
-1,1638,1639,-1,-1,-70,44
-1,1510,1367,143,3,147,44
0,1642,1862,-220,-1,-441,106
1,1488,1379,109,-4,81,75
1,1433,1495,-62,7,429,75
-1,1856,1655,201,-8,-385,64
1,1495,1433,62,1,179,117
-1,1536,1505,31,-8,-462,72
0,1538,1490,48,0,-46,135
-1,1512,1424,88,3,61,42
1,1597,1315,282,0,10,63
1,1412,1390,22,-7,7,77
-1,1438,1527,-89,4,143,62
1,1481,1382,99,1,70,57
-1,1269,1285,-16,-3,-81,46
-1,1369,1703,-334,-7,-269,72
1,1542,1430,112,7,64,43
1,1689,1840,-151,0,-32,95
-1,1650,1539,111,-8,-258,58
1,1690,1773,-83,3,232,81
-1,1418,1517,-99,-6,-286,68
1,2032,1983,49,0,11,67
-1,1554,1635,-81,0,113,122
1,1601,1218,383,5,80,45
1,2373,1218,1155,3,79,51
-1,1780,1893,-113,-11,-45,40
-1,1554,1545,9,-4,-338,84
1,2041,1824,217,-3,-134,81
1,1526,1410,116,2,69,63
-1,1211,1603,-392,-1,-707,176
0,1644,1740,-96,1,-342,103
-1,1556,1536,20,5,276,92
1,1475,1289,186,9,236,77
1,1819,2046,-227,-2,-149,73
-1,1415,1523,-108,-1,-137,92
-1,1494,2374,-880,-10,-182,48
-1,1554,1545,9,-5,-362,70
-1,1269,1373,-104,-10,-597,78
1,1837,1737,100,0,-41,67
-1,1489,1647,-158,2,48,46
-1,1491,1500,-9,-7,-164,58
1,1653,1381,272,0,22,55
-1,1500,2373,-873,-13,-493,54
1,1533,1551,-18,0,133,133
-1,1729,1845,-116,-1,-139,68
1,1537,1556,-19,-8,-155,49
-1,1500,1598,-98,0,-202,71
1,1853,1722,131,-1,-49,69
-1,1544,1554,-10,2,-357,94
-1,1722,1853,-131,0,37,74
1,1601,1529,72,1,146,79
1,1657,1544,113,-1,-113,85
1,1606,1205,401,10,370,55
1,1860,1715,145,1,74,79
0,1407,1531,-124,3,321,79
1,1570,1386,184,6,191,49
-1,1708,1867,-159,-1,-254,94
1,1512,1496,16,-1,-53,53
1,1570,1665,-95,1,-5,79
1,1874,1702,172,0,66,71
1,1537,1280,257,8,623,81
1,1608,1139,469,-1,-43,50
1,1534,1423,111,0,99,67
-1,1651,1589,62,3,136,114
-1,1696,1880,-184,4,117,58
-1,1526,1614,-88,1,54,78
-1,1886,1690,196,-5,-467,124
-1,1486,1523,-37,-1,-59,110
-1,1707,1869,-162,-3,-202,84
1,1869,1707,162,1,105,69
1,1637,1500,137,7,184,45
-1,1610,1500,110,0,-279,76
-1,1643,1381,262,6,110,48
-1,1381,1537,-156,-11,-201,50
1,1860,1628,232,0,-111,151
-1,1700,1875,-175,-2,-162,78
1,1875,1700,175,-4,-187,81
1,1500,1517,-17,1,48,47
1,1901,1717,184,-4,-11,47
-1,1613,1629,-16,0,-25,52
1,1534,1449,85,21,304,41
-1,1694,1881,-187,0,-215,122
1,1600,1291,309,1,287,179
-1,1500,1599,-99,-7,-56,46
1,1601,1535,66,1,14,49
1,1887,1689,198,0,123,107
-1,1408,1656,-248,3,26,54
-1,1351,1472,-121,-14,-558,66
1,1952,1547,405,6,465,83
1,1641,1497,144,-4,-50,51
-1,1547,1952,-405,0,37,102
1,1480,1342,138,6,112,85
-1,1657,1648,9,-4,-163,54
1,1483,1587,-104,3,75,51
-1,1803,1722,81,0,0,92
1,1500,1590,-90,1,96,79
1,1413,1475,-62,6,361,81
1,1686,1588,98,5,418,91
1,1623,1390,233,-2,114,55
-1,1653,1483,170,6,135,52
1,1661,1403,258,1,259,91
1,1543,1957,-414,-1,-17,45
-1,1750,1787,-37,0,-12,54
-1,1428,1429,-1,1,118,68
1,1933,1565,368,1,327,79
-1,1582,1645,-63,0,-384,106
-1,1210,1490,-280,0,-564,104
-1,1251,1648,-397,0,-48,60
-1,1557,1620,-63,4,98,64
1,1819,1397,422,0,19,51
1,1581,1725,-144,-1,6,59
-1,1379,1479,-100,-4,-326,70
0,1798,1581,217,-11,8,112
-1,1444,1674,-230,0,-185,86
1,1912,1584,328,2,20,41
-1,1882,1710,172,0,-39,76
-1,1581,1916,-335,0,4,74
-1,1551,1572,-21,-2,5,40
1,1427,1462,-35,2,27,81
1,1463,1581,-118,-2,-79,51
1,1314,1477,-163,16,592,63
1,1919,1577,342,3,158,64
-1,1756,1790,-34,0,27,92
-1,1398,1666,-268,-2,-112,80
-1,1385,1671,-286,-5,-404,83
-1,1562,1563,-1,-2,-48,100
-1,1606,1607,-1,-4,-299,110
-1,1587,1569,18,-6,-221,56
-1,1736,1728,8,-1,-605,106
1,1653,1739,-86,0,-69,77
1,1427,1463,-36,3,105,58
1,1679,1439,240,-1,-22,57
1,1367,1330,37,-6,-28,53
0,1640,1698,-58,-2,-373,106
1,1650,1313,337,0,1,47
-1,1573,1636,-63,-2,-69,78
-1,1625,1551,74,0,-27,54
1,1929,1580,349,-1,-29,47
1,1651,1584,67,2,98,61
-1,1724,1739,-15,-2,-14,66
-1,1205,1439,-234,-1,-579,114
-1,1578,1798,-220,-8,-300,62
-1,1650,1658,-8,1,19,70
1,1440,1417,23,1,106,89
-1,1266,1723,-457,-7,-362,68
1,1564,1561,3,-1,9,57
1,1319,1424,-105,4,120,55
1,1933,1725,208,0,-7,101
1,1714,1669,45,0,-10,49
-1,1573,1803,-230,1,52,54
-1,1144,1247,-103,2,122,54
-1,1525,1718,-193,0,10,56
1,1683,1683,0,1,82,81
-1,1566,1630,-64,-6,-203,60
1,1514,1574,-60,-2,53,61
1,1808,1568,240,7,621,79
-1,1720,1939,-219,0,31,66
1,1434,1383,51,0,-2,43
1,1829,1544,285,-3,14,63
-1,1332,1654,-322,0,-45,64
-1,1519,1418,101,-3,-273,114
-1,1563,1813,-250,-2,-64,54
1,1323,1398,-75,-10,-170,53
-1,1945,1715,230,-2,-413,106
-1,1710,1642,68,-3,-111,52
-1,1310,1245,65,-1,-126,66
1,1818,1558,260,0,47,53
-1,1526,1580,-54,-2,-83,80
1,1696,1592,104,1,19,48
-1,1924,1730,194,-11,-277,60
-1,1487,1425,62,3,99,47
1,1337,1347,-10,0,160,83
1,1671,1668,3,3,136,59
1,1827,1550,277,0,105,93
-1,1275,1631,-356,-17,-83,40
-1,1499,1494,5,0,24,44
1,1590,1497,93,-1,74,71
-1,1554,1822,-268,-7,-334,58
0,1646,1780,-134,2,2,91
-1,1373,1444,-71,0,-101,64
-1,1546,1831,-285,-3,-202,84
-1,1377,1489,-112,-8,-134,44
1,1911,1924,-13,0,-40,145
-1,1692,1655,37,0,11,90
1,1652,1397,255,1,184,97
1,1307,1325,-18,1,455,85
1,1473,1599,-126,1,170,55
-1,1500,1310,190,-2,-4,48
-1,1406,1450,-44,-1,448,142
1,1835,1542,293,1,87,55
-1,1538,1839,-301,1,74,62
1,1583,1513,70,3,409,103
-1,1507,1152,355,-2,-375,174
1,1571,1646,-75,0,-30,99
-1,1913,1924,-11,-1,-439,156
-1,1472,1483,-11,-5,-161,44
-1,1313,1344,-31,-3,-308,78
-1,1575,1725,-150,0,-90,70
-1,1429,1639,-210,2,18,78
1,1937,1902,35,0,90,103
-1,1540,1835,-295,-2,-100,64
1,1843,1534,309,2,418,99
1,1491,1593,-102,0,304,103
1,1732,1599,133,1,21,45
-1,1337,1541,-204,-3,-461,146
-1,1316,1534,-218,-7,-177,48
1,1843,1820,23,2,73,63
1,1329,1582,-253,3,117,61
-1,1578,1524,54,-2,-332,92
-1,1310,1540,-230,4,78,40
-1,1500,1770,-270,-4,-236,124
-1,1351,1540,-189,0,4,56
1,1553,1564,-11,6,128,45
1,1595,1788,-193,-1,111,109
1,1273,1489,-216,0,220,89
1,1497,1551,-54,-2,437,155
1,1796,1546,250,0,-87,81
1,1344,1239,105,0,31,49
1,1796,1721,75,-1,-11,49
1,1810,1870,-60,-2,-28,47
1,1433,1564,-131,0,136,77
1,1801,1541,260,5,105,49
-1,1242,1597,-355,0,-83,94
-1,1590,1732,-142,0,177,106
1,1474,1367,107,-1,71,101
-1,1541,1537,4,1,27,58
1,1846,1738,108,3,-93,99
1,1841,1536,305,-2,-44,61
1,1733,1642,91,-3,-229,73
-1,1352,1697,-345,3,266,76
1,1672,1731,-59,-1,14,59
-1,1729,1855,-126,-2,-87,52
-1,1529,1549,-20,0,-8,40
-1,1500,1349,151,-2,-7,42
1,1838,1822,16,0,349,139
-1,1700,1733,-33,-7,-209,58
1,1863,1560,303,-1,8,65
1,1579,1518,61,2,148,59
-1,1686,1805,-119,-1,-257,158
1,1690,1557,133,9,246,77
-1,1712,1813,-101,0,-6,100
1,1867,1549,318,-2,-18,49
-1,1508,1588,-80,-1,-46,56
-1,1762,1680,82,0,-76,134
1,1697,1549,148,2,316,65
1,1188,1644,-456,2,507,105
-1,1597,1499,98,-1,-13,76
1,1329,1481,-152,5,399,107
-1,1361,1870,-509,0,-57,92
1,1530,1415,115,8,252,47
1,1925,1535,390,0,36,71
1,1821,1704,117,-1,-3,77
1,1623,1560,63,0,266,117
1,1743,1532,211,6,269,63
-1,1549,1514,35,0,-71,68
-1,1369,1206,163,-13,-412,46
1,1813,1671,142,1,80,75
1,1871,1527,344,8,195,53
-1,1639,1352,287,-3,-41,42
-1,1208,1359,-151,1,33,54
-1,1533,1846,-313,0,-11,56
1,1499,1548,-49,2,126,87
1,1528,1441,87,3,45,41
-1,1526,1536,-10,1,67,72
-1,1367,1158,209,-1,-13,42
-1,0,1121,-1121,-10,-74,44
1,1812,1862,-50,0,41,59
1,1267,1349,-82,4,151,59
-1,1748,1875,-127,0,0,54
1,1284,1826,-542,-4,-313,75
-1,1581,1644,-63,2,-18,60
1,1710,1524,186,7,207,43
-1,1334,1341,-7,0,-268,74
1,1739,1686,53,-1,-13,59
1,1548,1515,33,3,180,53
1,1741,1517,224,5,174,41
1,1439,1396,43,1,88,55
1,1392,1322,70,0,13,53
1,1883,1536,347,-4,-5,41
-1,1505,1558,-53,-1,112,58
1,1835,1824,11,-4,63,81
-1,1700,1821,-121,-3,-2,46
-1,1182,1500,-318,-13,-304,128
1,1721,1886,-165,0,294,141
-1,1312,1428,-116,-1,-16,44
1,1587,1535,52,2,314,67
-1,1716,1541,175,0,-497,88
-1,1551,1633,-82,-2,-40,58
-1,1623,1213,410,-3,-447,114
1,1829,1692,137,-1,-2,47
1,1456,1303,153,6,101,47
1,1868,1739,129,2,38,45
1,1700,1559,141,5,247,55
-1,1731,1876,-145,-5,-63,43
-1,1706,1552,154,1,76,66
-1,1296,1479,-183,-5,-79,46
-1,1685,1836,-151,2,45,42
-1,1500,1569,-69,9,190,44
-1,1653,1540,113,-5,-212,58
-1,1691,1579,112,6,241,74
1,1746,1495,251,0,275,93
1,1225,1372,-147,4,242,73
1,1852,1529,323,0,22,51
1,1691,1579,112,0,35,51
-1,1580,1548,32,-3,-154,68
1,1289,1491,-202,-3,-19,41
1,1699,1570,129,1,22,47
-1,1355,1617,-262,-5,-91,46
0,1678,1843,-165,0,7,101
-1,1002,1271,-269,8,134,46
1,1559,1498,61,-3,204,101
1,1313,1387,-74,-2,-227,73
1,1473,1308,165,6,152,53
1,1709,1553,156,-2,-35,41
1,1884,1547,337,8,243,61
-1,1301,1479,-178,-5,-100,48
1,1782,1544,238,6,218,51
1,1446,1568,-122,0,107,79
1,1887,1504,383,-2,64,63
1,1486,1294,192,0,68,65
1,1714,1321,393,-3,-28,67
1,1677,1556,121,12,447,53
-1,1859,1838,21,-5,-233,54
-1,1825,1539,286,0,-182,64
-1,1780,1554,226,-3,-75,56
1,1622,1351,271,5,143,53
1,1892,1499,393,-4,-144,65
1,1633,1343,290,-4,-138,70
1,1288,1492,-204,-4,-86,55
-1,1760,1542,218,-2,-75,56
-1,1462,1411,51,-5,-394,74
0,1716,1568,148,-6,-169,113
-1,1497,1559,-62,0,-167,78
0,1743,1848,-105,1,158,151
1,1712,1487,225,2,24,59
-1,1536,1777,-241,-5,-638,142
1,1785,1569,216,-6,-95,43
-1,1936,1895,41,-1,-264,56
1,1909,1918,-9,8,229,85
1,1757,1573,184,3,119,67
1,1275,1224,51,2,26,45
1,1473,1621,-148,0,135,73
-1,1717,1564,153,0,-17,48
1,1482,1312,170,12,445,61
1,1808,1564,244,2,190,47
1,1346,1493,-147,5,104,57
-1,1701,1567,134,1,1,118
1,1933,1763,170,0,-68,41
-1,1598,1639,-41,-2,-26,64
1,1827,1581,246,1,86,69
-1,1489,1757,-268,-3,-16,50
1,1286,1302,-16,0,13,105
-1,1583,1940,-357,-3,-67,42
1,1723,1582,141,3,13,41
-1,1570,1163,407,5,129,52
1,1175,1179,-4,15,314,61
-1,1685,1576,109,-8,-535,78
-1,1731,1943,-212,5,280,90
1,1844,1592,252,1,127,41
-1,1746,1845,-99,-1,-96,134
1,1839,1804,35,-1,11,53
1,1765,1531,234,-1,-118,73
-1,1449,1424,25,-1,-431,98
-1,1860,1587,273,-9,-562,78
-1,1500,1374,126,-4,-40,54
1,1749,1448,301,2,86,55
1,1478,1363,115,-3,-46,65
1,1383,1250,133,8,851,105
1,1671,1606,65,3,103,53
-1,1774,1521,253,0,-3,48
1,1797,1596,201,11,284,59
1,1540,1596,-56,1,13,43
1,1948,1474,474,3,293,95
1,1685,1553,132,-1,-17,67
1,1753,1836,-83,-1,-53,83
-1,1663,1636,27,-2,-13,40
-1,1473,1950,-477,2,-8,52
1,1952,1471,481,2,139,71
1,1933,1948,-15,1,20,41
1,1687,1589,98,1,59,53
-1,1469,1953,-484,-1,-67,76
1,1158,1209,-51,2,699,121
1,1695,1580,115,-1,-12,59
1,1695,1580,115,-1,21,45
-1,1354,1794,-440,-11,-398,58
1,1485,1355,130,-2,-26,47
1,1389,1331,58,-7,-66,49
1,1958,1465,493,0,130,71
1,1764,1572,192,3,63,41
-1,1626,1727,-101,-1,-183,94
1,2048,1658,390,4,584,79
1,1752,1582,170,-3,-3,47
-1,1463,1960,-497,-4,-97,54
-1,1634,1683,-49,0,4,54
1,1665,1298,367,-1,47,55
1,1961,1462,499,-4,-29,55
1,1710,1576,134,-7,-152,49
1,1759,1576,183,7,196,43
1,1387,1340,47,2,41,69
1,1740,1593,147,8,281,45
1,1478,1506,-28,-1,-21,63
1,1964,1458,506,6,375,73
1,1717,1586,131,8,142,55
-1,1347,1492,-145,-4,-16,40
-1,1693,1622,71,0,-21,74
1,1748,2058,-310,0,-1,42
-1,1585,1661,-76,-6,-978,114
-1,1945,1934,11,0,-451,176
1,2058,1748,310,3,223,61
-1,1457,1966,-509,-2,-54,46
1,1724,1578,146,5,128,49
1,1744,2062,-318,-4,-30,41
1,1968,1455,513,-4,-77,51
-1,1829,1571,258,4,230,67
1,1518,1575,-57,-7,-402,79
-1,0,1121,-1121,-8,-288,52
1,1297,1524,-227,3,313,79
1,1969,1454,515,5,149,49
1,1792,1583,209,-7,-89,51
-1,1822,1679,143,-1,12,52
-1,1472,1771,-299,-1,-12,40
-1,1452,1971,-519,0,-2,54
1,1806,1578,228,-2,6,41
1,1806,1578,228,-2,-193,63
1,1786,1465,321,5,314,89
-1,1632,1520,112,-9,-118,112
1,1695,1807,-112,0,-41,53
-1,1429,1494,-65,3,-17,68
1,1828,1568,260,7,258,57
-1,1459,1778,-319,-8,-299,60
1,1731,1451,280,-2,-13,43
1,1450,1759,-309,-1,3,127
1,1847,1559,288,1,-7,63
1,1847,1559,288,4,213,65
1,1459,1799,-340,6,719,136
-1,1490,1397,93,-7,-176,58
-1,1710,1692,18,-3,11,50
1,1855,1555,300,4,858,111
1,1642,1517,125,3,66,45
-1,1654,1768,-114,-7,-214,70
1,1862,1551,311,2,88,109
0,1539,1503,36,0,23,112
-1,1780,1693,87,-5,-80,46
1,1869,1548,321,-10,-123,43
-1,1596,1631,-35,0,-357,144
-1,1419,1344,75,2,5,57
1,1875,1544,331,1,69,65
-1,1649,1500,149,0,-67,52
-1,1704,1698,6,0,-34,68
-1,1454,1510,-56,-5,-225,96
-1,1526,1654,-128,-3,-356,124
-1,1562,1541,21,-2,-36,66
0,1616,1579,37,4,11,120
1,1056,1516,-460,11,393,51
1,1726,1494,232,2,259,107
1,1608,1554,54,-4,126,77
1,1547,1316,231,9,195,51
-1,1525,1666,-141,-4,-303,118
1,1617,1707,-90,1,49,69
1,1766,1544,222,1,148,57
-1,1500,1556,-56,-6,-57,72
1,1339,1140,199,1,-2,41
-1,1709,1693,16,0,19,66
1,1771,1538,233,-1,151,105
-1,1416,1806,-390,-1,-30,42
1,1640,1517,123,2,70,73
-1,1467,1776,-309,-6,-63,70
1,1693,1631,62,-1,203,133
1,1652,1572,80,1,528,105
1,1776,1533,243,0,170,51
-1,1776,1533,243,4,36,98
-1,1552,1311,241,0,-31,52
-1,1307,1528,-221,-1,-62,66
1,1781,1972,-191,0,345,127
1,1689,1635,54,0,373,97
-1,1337,1662,-325,-4,-428,110
-1,1485,1743,-258,1,7,71
-1,1809,1510,299,0,57,94
-1,1573,1534,39,1,41,76
1,1862,1793,69,2,60,61
1,1800,1546,254,-1,132,97
-1,1947,1561,386,2,-26,58
0,1626,1698,-72,1,115,89
1,1953,1623,330,1,25,43
1,1780,1653,127,-1,-19,51
-1,1321,1531,-210,-2,-76,58
1,1805,1541,264,2,284,65
-1,1765,1580,185,0,11,80
-1,1620,1957,-337,-6,-92,52
-1,1406,1577,-171,-4,-94,50
-1,1784,1872,-88,-1,-31,66
1,1350,1536,-186,-6,-26,71
1,1809,1617,192,-14,-534,65
-1,1696,1628,68,0,-6,64
1,1961,1881,80,10,346,59
-1,1793,1725,68,0,-259,144
1,1335,1529,-194,1,662,117
1,1757,1477,280,2,86,65
-1,1524,1535,-11,-4,-198,74
1,1880,1776,104,0,-9,63
-1,1641,1683,-42,-3,-56,76
-1,1556,1795,-239,-7,-606,68
1,1692,1632,60,-1,184,105
-1,1684,1765,-81,-1,-139,102
-1,1399,1476,-77,-8,-173,42
-1,1889,1753,136,0,-41,74
1,1747,1541,206,-5,-125,51
1,1720,1687,33,0,-70,97
1,1623,1702,-79,4,20,41
1,1295,1587,-292,5,70,49
1,1972,1893,79,-2,56,57
1,1815,1865,-50,7,831,107
1,1752,1535,217,0,-15,55
1,1688,1636,52,7,319,65
1,1711,1563,148,2,81,51
1,1841,1534,307,-3,-55,57
-1,1627,1697,-70,-2,-215,76
-1,1757,1614,143,-6,-386,70
1,1848,1530,318,0,-124,45
1,1500,1568,-68,3,142,65
1,1778,1458,320,1,155,93
1,1853,1526,327,0,4,41
1,1807,1776,31,2,697,157
1,1853,1526,327,0,-9,47
0,1609,1575,34,0,341,173
-1,1626,1726,-100,2,-167,140
-1,1677,1863,-186,0,-13,62
-1,1875,1817,58,0,229,90
1,1734,1618,116,1,303,71
-1,1487,1554,-67,-4,-491,122
-1,1837,1536,301,5,287,82
1,1742,1610,132,7,27,41
1,1767,1553,214,0,27,147
-1,1829,1885,-56,-4,-63,62
-1,1766,1817,-51,0,-92,94
1,1806,1557,249,1,3,47
-1,1326,1454,-128,-11,-412,74
0,1813,1552,261,-8,-1265,226
0,1598,1824,-226,9,521,77
-1,1914,1671,243,0,-259,150
1,1827,1756,71,0,1,93
1,1756,1560,196,0,-144,83
-1,1782,1799,-17,-1,-217,130
1,1535,1710,-175,-1,-3,42
1,1808,1890,-82,-1,196,117
1,1673,1676,-3,-2,-33,69
1,1802,1554,248,-2,-99,41
1,1787,1637,150,-3,16,81
1,1767,1549,218,3,237,77
1,1759,1629,130,-1,-31,59
-1,1552,1748,-196,-1,-42,54
1,1794,1268,526,10,949,89
0,1874,1783,91,3,191,151
1,1809,1543,266,3,65,51
0,1366,1532,-166,2,122,137
1,1673,1631,42,0,393,145
1,1500,1389,111,-2,279,99
1,1382,1367,15,0,227,73
1,1815,1538,277,10,229,45
1,1821,1534,287,6,192,49
1,1821,1534,287,2,15,41
-1,1754,1641,113,-4,-83,132
1,1765,1795,-30,1,-30,69
-1,1827,1530,297,-3,-227,62
-1,1607,1544,63,0,-212,86
1,1798,1551,247,-4,-45,49
1,1811,1769,42,-4,-221,119
-1,1641,1686,-45,-2,-89,66
1,1772,1672,100,10,395,59
1,1805,1546,259,5,110,53
-1,1355,1570,-215,-3,-91,58
1,1665,1537,128,0,4,69
1,1811,1541,270,7,248,47
-1,1704,1533,171,-2,-207,78
1,1773,1805,-32,3,282,84
-1,1321,1490,-169,-10,-510,58
-1,1574,1427,147,-1,-100,58
1,1572,1645,-73,8,166,53
-1,1121,1319,-198,-1,-109,84
-1,1798,1980,-182,-4,-563,126
1,1631,1587,44,0,-116,81
1,1523,1644,-121,0,7,69
1,1568,1649,-81,0,95,100
-1,1589,1272,317,-1,-56,64
0,1527,1699,-172,0,78,164
1,1480,1534,-54,0,170,89
-1,1576,1641,-65,-5,-23,50
1,1987,1792,195,-2,-18,57
-1,1526,1443,83,-3,-148,62
1,1650,1567,83,12,383,47
-1,1786,1994,-208,-5,-396,78
1,1567,1650,-83,6,631,115
-1,1715,1586,129,1,-40,74
-1,1417,1457,-40,-3,-100,56
-1,1523,1490,33,-3,-259,70
1,1645,1549,96,-4,-74,47
-1,1467,1686,-219,0,172,102
1,1549,1645,-96,1,-7,49
1,1631,1563,68,0,8,87
-1,1603,1392,211,1,-41,52
-1,1794,1781,13,0,-73,110
1,1694,1789,-95,3,173,87
1,1554,1640,-86,1,26,53
-1,1506,1905,-399,-2,-142,116
-1,1728,1748,-20,0,-46,102
1,1626,1568,58,-2,-20,49
-1,1793,1797,-4,1,-153,100
1,1568,1626,-58,2,160,57
1,1636,1559,77,-2,-18,45
-1,1511,1468,43,1,-191,94
-1,1815,1782,33,-2,-227,72
1,1765,1718,47,-2,-42,41
1,1559,1636,-77,1,7,45
-1,1401,1518,-117,0,-122,78
1,1679,1741,-62,2,10,71
-1,1572,1644,-72,2,10,52
1,1794,1795,-1,-2,-7,125
1,1653,1563,90,-4,-219,57
1,1707,1516,191,0,23,65
-1,1541,1694,-153,-1,-32,46
-1,1805,1770,35,0,-331,124
0,1784,1793,-9,-2,-67,96
1,1482,1489,-7,0,21,59
1,1499,1396,103,3,431,75
1,1653,1778,-125,4,244,75
1,1956,1700,256,0,0,55
1,1421,1586,-165,-2,-112,73
1,1772,1803,-31,0,2,43
-1,1646,1769,-123,0,-339,140
1,1627,1388,239,-1,-60,71
1,1791,1785,6,0,17,77
-1,1229,1161,68,-5,-70,40
-1,1500,1577,-77,-9,-303,56
1,1792,1784,8,4,95,43
1,1478,1524,-46,6,218,53
1,1632,1783,-151,0,-11,49
1,1685,1415,270,-2,-39,41
1,1632,1783,-151,-4,-60,61
1,1773,1802,-29,4,545,115
1,1790,1786,4,-1,-83,69
1,1768,1690,78,0,5,45
1,1690,1768,-78,0,-7,63
-1,1775,1801,-26,-3,86,98
1,1307,1289,18,0,8,45
-1,1494,1490,4,0,-273,70
-1,1647,1811,-164,0,-522,88
1,1570,1433,137,1,9,40
-1,1641,1817,-176,-7,-443,106
1,1811,1647,164,5,255,67
1,1679,1530,149,0,-2,49
-1,1477,1421,56,-2,-94,54
-1,1523,1688,-165,-1,-14,46
-1,1500,1731,-231,0,-267,166
-1,1377,1512,-135,3,122,72
1,1822,1635,187,5,193,69
1,1984,1731,253,-6,-69,51
-1,1635,1822,-187,-2,-405,224
-1,1504,1841,-337,-1,-343,90
1,1710,1803,-93,1,20,41
1,1695,1517,178,3,74,41
1,1896,1358,538,8,194,49
1,1539,1381,158,-4,132,65
-1,1507,1825,-318,0,-171,134
-1,1692,1630,62,-7,-184,86
-1,1404,1246,158,-9,-292,80
-1,1462,1598,-136,-5,-537,72
1,1777,1844,-67,-2,-23,49
-1,1655,1724,-69,-1,129,77
-1,968,0,968,2,-154,98
-1,1747,1765,-18,-1,35,56
-1,1735,1979,-244,0,-30,88
1,1484,1500,-16,0,113,83
-1,1545,1371,174,-10,-100,80
1,2000,1643,357,1,302,105
-1,1875,1690,185,0,-21,64
1,1779,1736,43,4,64,45
-1,1703,2004,-301,-4,-829,132
1,1511,1681,-170,0,11,73
1,1664,1527,137,2,205,67
1,2016,1690,326,-1,109,71
-1,1694,2012,-318,-7,-310,66
1,2008,1698,310,5,613,89
1,1950,1751,199,-5,-61,67
1,1517,1339,178,12,529,53
1,1737,1609,128,3,73,61
1,1619,1451,168,2,148,83
1,1396,1164,232,2,59,47
1,1838,1689,149,0,-17,51
-1,1687,2020,-333,-3,-253,76
-1,1746,1806,-60,-5,-209,61
-1,1471,1577,-106,-11,-56,40
-1,1765,1462,303,0,1,56
1,1776,1389,387,1,12,45
1,1418,1569,-151,0,153,151
-1,1386,1779,-393,0,-486,110
-1,1883,1855,28,-3,-89,52
1,1537,1091,446,8,294,59
-1,0,1196,-1196,-2,-188,74
1,2062,1955,107,-1,-9,41
-1,1687,1779,-92,-1,-197,84
-1,1384,1781,-397,-4,-22,92
1,1787,1696,91,9,652,103
1,1678,1679,-1,0,9,49
-1,1583,1713,-130,-1,-101,108
1,1679,1678,1,4,48,47
1,1795,1688,107,1,421,91
1,1783,1381,402,0,13,45
-1,1415,1555,-140,-1,-57,78
-1,1556,1563,-7,0,-52,72
1,1785,1803,-18,2,463,135
-1,1540,1947,-407,-1,-229,78
-1,1680,1690,-10,-2,-162,120
1,1815,1738,77,0,6,61
0,1792,1797,-5,-3,-177,112
1,1797,1792,5,4,191,93
1,1209,1333,-124,-3,6,51
-1,1700,1670,30,-2,-131,78
1,1809,1781,28,2,217,111
1,1950,1526,424,1,125,67
-1,1512,1394,118,2,44,56
-1,1682,1689,-7,2,-571,104
0,1729,1824,-95,0,-57,130
-1,1337,1662,-325,-7,-466,74
-1,1771,1819,-48,0,24,52
1,1629,1494,135,-1,172,73
1,1411,1496,-85,-6,-166,67
1,1829,1762,67,5,-54,131
-1,1699,1671,28,-2,-113,76
1,1316,1229,87,10,119,46
1,1754,1640,114,9,807,93
1,1481,1427,54,2,58,53
-1,1845,1682,163,0,-15,56
1,1391,1586,-195,0,-23,87
-1,1114,1371,-257,-4,-135,52
-1,1683,1688,-5,2,71,120
-1,1480,1406,74,2,50,56
1,1768,1625,143,10,499,65
1,1416,1491,-75,-4,-89,63
-1,1618,1774,-156,-6,-453,88
1,1926,1524,402,1,82,85
-1,1612,1666,-54,-1,-45,54
-1,1698,1672,26,-1,135,80
-1,1679,1612,67,-3,-39,42
1,1517,1218,299,9,213,49
-1,1683,1687,-4,-6,-139,44
-1,1554,1449,105,1,-336,92
1,1421,1487,-66,0,18,53
1,1697,1673,24,4,375,133
1,1572,1673,-101,1,34,57
1,1652,1492,160,3,101,53
1,1602,1675,-73,1,23,51
1,1773,1618,155,-2,-91,47
1,1663,1707,-44,-6,-270,75
0,1500,1471,29,-2,-317,82
-1,1681,1780,-99,-3,-36,66
1,1448,1461,-13,0,17,65
-1,1485,1660,-175,-8,-39,40
-1,1787,1673,114,-7,-391,58
-1,1508,1406,102,3,160,98
1,1695,1675,20,2,225,71
-1,1929,2023,-94,0,-51,86
-1,1644,1573,71,-3,-297,116
1,1291,1212,79,2,66,59
-1,1665,1705,-40,-2,-183,84
-1,1687,1773,-86,-2,-214,78
1,1667,1479,188,-7,515,89
-1,1421,1352,69,3,41,62
-1,1919,2034,-115,-1,-211,84
1,1449,1460,-11,-2,-53,43
1,1781,1679,102,0,-5,43
-1,1679,1781,-102,0,-69,56
1,1715,1910,-195,8,341,71
1,1789,1671,118,3,228,117
-1,1671,1789,-118,-4,-352,78
-1,1448,1461,-13,-1,-14,60
-1,1493,1407,86,0,-91,104
1,1316,1500,-184,1,245,69
1,2043,1664,379,0,2,59
-1,1585,1621,-36,-1,-82,80
1,1472,1437,35,-3,-114,52
-1,2046,1661,385,-3,-98,56
-1,1673,1660,13,1,77,84
1,1407,1339,68,-7,-93,45
-1,1806,1952,-146,-5,-166,66
-1,1721,1852,-131,0,-69,40
1,1427,1483,-56,10,126,43
-1,1327,1924,-597,0,33,60
1,1631,1737,-106,3,38,57
1,1576,1504,72,3,58,51
-1,1469,1440,29,-5,-80,50
-1,1500,1802,-302,-8,-478,74
1,1645,1597,48,0,-18,75
-1,1890,2021,-131,-5,-212,60
-1,1489,1531,-42,-7,-164,56
-1,1723,1646,77,0,-70,88
1,1192,1674,-482,1,68,75
1,1488,1335,153,1,371,93
-1,1666,1569,97,-3,-336,106
-1,2030,1881,149,0,178,94
1,1906,1884,22,1,259,132
-1,1899,2011,-112,0,-71,72
-1,1584,1495,89,-3,-273,76
1,1655,1581,74,-1,573,197
1,1659,1710,-51,-1,108,77
1,1731,1927,-196,9,182,47
1,1629,1140,489,6,196,51
-1,1600,1611,-11,5,-214,76
1,2141,2020,121,0,43,57
-1,1422,1902,-480,-4,-143,55
1,1541,1467,74,-2,-92,47
1,1622,1589,33,-6,-338,73
-1,1218,1649,-431,0,-318,94
-1,1747,2011,-264,0,-11,68
-1,1681,1655,26,-8,-193,44
1,1926,1466,460,-2,-347,115
1,1665,1472,193,-5,-511,121
1,2016,1743,273,1,25,97
1,1592,1619,-27,-6,921,125
1,1495,1204,291,9,295,61
1,1631,1470,161,1,-109,75
1,1630,1581,49,0,16,85
1,1550,1404,146,-1,-5,41
1,1416,1448,-32,6,178,55
-1,2150,2021,129,0,-108,84
-1,1351,1420,-69,1,50,71
-1,1369,1555,-186,0,-59,100
-1,1643,1910,-267,0,14,46
0,1571,1639,-68,-1,-31,123
-1,1904,1690,214,0,129,94
1,1669,1456,213,1,126,65
1,1959,2099,-140,-3,-88,47
1,1637,1573,64,8,1125,131
1,1696,1456,240,1,92,55
-1,2038,2132,-94,0,-125,80
-1,1564,1667,-103,-4,-567,86
-1,1677,1778,-101,0,-615,142
1,2142,2029,113,-4,-102,73
1,1799,1930,-131,-2,35,49
1,1537,1273,264,3,159,75
-1,1317,1561,-244,-1,-175,98
1,1646,1556,90,-1,-53,79
1,1669,1439,230,20,697,59
1,1424,1428,-4,-1,-8,51
0,2020,2151,-131,-1,-107,104
1,1640,1562,78,0,260,97
1,1651,1215,436,0,260,101
-1,1473,2025,-552,-2,-23,45
-1,1539,1671,-132,1,0,50
1,2146,2026,120,-1,45,55
1,1478,1305,173,-2,-88,79
1,1553,1143,410,2,125,61
1,1143,1553,-410,5,125,51
-1,1329,1450,-121,-6,-598,90
1,1499,1400,99,-2,202,95
-1,1722,1739,-17,-2,18,46
1,2017,1674,343,4,25,47
-1,1793,1624,169,-1,-11,48
-1,1422,1687,-265,-16,-527,56
1,1321,1060,261,-4,-185,51
1,1540,1648,-108,0,42,99
-1,1749,1711,38,1,11,54
1,1462,1273,189,12,338,53
-1,1273,1656,-383,-3,-88,62
-1,1703,1542,161,-2,-46,56
1,1679,1446,233,8,127,41
1,2023,1669,354,-1,-65,63
-1,1634,1555,79,-2,-191,60
1,1566,1312,254,3,366,83
-1,1687,1698,-11,-1,-49,72
-1,1504,1885,-381,-5,-199,64
1,1714,1531,183,2,47,41
1,1500,1522,-22,-2,-27,57
-1,1701,2027,-326,0,-25,70
-1,1569,1621,-52,-3,-53,52
0,1724,1751,-27,-1,-67,114
1,1484,1224,260,2,-3,43
1,1686,1513,173,2,45,51
1,1630,1559,71,13,956,103
-1,1417,1481,-64,10,333,66
1,1948,1993,-45,4,75,83
-1,1698,2030,-332,0,-13,42
-1,1557,1388,169,-4,-234,60
1,1890,1507,383,-9,-409,79
-1,1437,1683,-246,-5,-161,48
1,2226,2155,71,0,9,67
-1,1550,1639,-89,-13,-1002,90
1,1750,1725,25,-1,-25,61
-1,1695,2034,-339,-2,-66,62
-1,1223,1323,-100,-3,-194,64
1,2094,1659,435,0,0,45
-1,1507,1417,90,2,53,120
1,1542,1647,-105,5,574,129
1,2037,1755,282,-1,-136,79
1,1734,1571,163,-1,111,107
1,1763,1505,258,0,2,61
-1,1326,1437,-111,-7,-400,70
1,1584,1429,155,3,197,71
1,1887,1587,300,-1,251,123
-1,1657,2096,-439,0,-54,102
-1,2145,2240,-95,0,-180,102
-1,1688,1570,118,-2,-161,62
1,1777,1723,54,5,825,77
1,1620,1570,50,-4,-317,103
1,1458,1500,-42,-4,-40,71
1,1318,1450,-132,-3,-64,55
-1,1714,1769,-55,-2,-90,80
-1,1560,1629,-69,-1,-9,62
1,2042,1612,430,7,256,55
1,1719,1699,20,7,126,53
-1,1610,2044,-434,-2,-51,52
-1,1629,1560,69,-4,-577,96
-1,1482,1481,1,-7,-488,138
-1,1710,1786,-76,-2,115,126
0,1432,1493,-61,0,-1,143
-1,1781,1705,76,-9,-331,116
1,2046,1608,438,2,118,65
-1,1423,1655,-232,1,7,56
-1,1471,1487,-16,-2,-119,62
1,1787,2048,-261,-1,4,79
-1,1585,1673,-88,-4,-304,78
-1,1525,1388,137,0,-217,90
-1,1565,1742,-177,-3,-167,74
1,1617,1498,119,-7,-73,71
1,1653,1541,112,-4,89,83
-1,1718,1606,112,2,49,78
1,2029,1790,239,6,403,67
-1,1329,1227,102,-1,-507,114
1,1516,1661,-145,3,73,65
1,1624,1490,134,0,91,53
-1,1783,2035,-252,-2,-47,50
-1,1961,1980,-19,-5,-88,58
-1,1520,1500,20,0,-47,74
1,1795,1800,-5,6,424,71
-1,1681,1577,104,-2,-180,64
1,2136,1893,243,3,127,53
1,1631,1483,148,-1,179,79
-1,1314,1571,-257,-9,-1168,126
-1,1672,1675,-3,-1,-143,112
-1,1417,1448,-31,-2,-128,94
1,1888,2141,-253,-2,6,93
1,1591,1367,224,7,879,99
1,1926,1776,150,1,65,57
-1,1444,1643,-199,0,32,56
1,2135,1805,330,0,-6,53
1,1435,1330,105,2,79,51
-1,1749,1559,190,0,24,106
-1,1909,1704,205,0,-483,104
-1,1591,1667,-76,-3,-139,126
-1,1685,1477,208,-6,-221,78
1,2040,1615,425,5,111,53
1,2121,1889,232,1,243,71
-1,1305,1580,-275,-3,-812,106
1,1404,1491,-87,8,165,51
-1,1613,2042,-429,-1,-15,48
0,2126,2121,5,0,71,119
-1,1655,1510,145,-4,-229,108
-1,1567,1729,-162,0,5,98
1,1883,1475,408,-5,79,81
-1,1649,1439,210,2,43,42
-1,1385,2253,-868,-1,-53,56
1,1459,1400,59,-2,-33,43
-1,2045,2109,-64,0,36,70
-1,1585,1533,52,0,-66,74
-1,1301,1144,157,-4,-268,70
-1,2126,2122,4,-3,-155,138
1,2120,2033,87,0,-87,91
-1,1762,1802,-40,-4,-12,58
-1,1584,1454,130,0,-41,66
1,1888,1471,417,-2,-22,47
0,1491,1389,102,-2,-115,87
-1,1650,1692,-42,1,10,62
1,1890,1469,421,0,-35,61
1,1886,1473,413,2,90,61
1,2023,1894,129,1,-5,47
-1,1469,1452,17,2,28,70
-1,2135,2114,21,0,209,88
1,1991,2184,-193,0,-5,65
-1,1752,2130,-378,-1,-514,102
-1,1545,1596,-51,-2,-8,50
1,1425,1489,-64,-3,677,95
1,1887,2032,-145,0,133,79
1,2013,1901,112,-1,46,71
0,2126,2121,5,0,28,112
-1,1242,1535,-293,-4,-605,96
1,1628,1405,223,3,66,45
-1,1894,2022,-128,2,23,46
1,1422,1465,-43,1,66,55
1,1607,1407,200,7,517,79
1,1579,1513,66,4,127,51
-1,2008,2165,-157,-5,-97,62
-1,2031,1887,144,-1,-54,84
-1,2121,2126,-5,0,-3,42
-1,1750,1666,84,-1,-607,146
1,1582,1613,-31,3,21,43
-1,2138,2109,29,-5,-87,104
-1,1902,2013,-111,0,-21,102
1,1489,1652,-163,1,92,61
1,1275,1396,-121,6,194,101
0,1474,1457,17,0,-139,148
1,1477,1537,-60,5,50,43
0,1591,1213,378,0,-88,232
-1,1680,1735,-55,-3,-105,56
1,2022,1894,128,0,-1,69
-1,1238,1539,-301,-3,-417,74
-1,1448,1489,-41,0,-37,52
-1,1887,2030,-143,0,-32,60
-1,1745,1671,74,-1,-783,126
1,1593,1595,-2,-5,8,49
-1,2038,2122,-84,0,39,90
-1,1777,1636,141,-6,-220,60
-1,1684,1731,-47,5,-16,80
1,1475,1652,-177,-2,-65,59
1,1390,1166,224,9,389,61
-1,2132,2028,104,5,264,74
-1,1424,1448,-24,1,0,104
1,1499,1329,170,0,6,75
1,1234,1500,-266,8,221,53
-1,1741,1674,67,-6,-342,70
0,1583,1611,-28,-1,-546,110
1,1687,1728,-41,-3,125,99
1,1550,1400,150,0,4,41
-1,1488,1500,-12,-3,-47,54
1,1554,1553,1,2,140,57
1,1579,1546,33,0,143,104
-1,1402,1500,-98,1,-259,82
1,2117,1301,816,1,20,51
1,1619,1505,114,6,270,77
-1,1349,1565,-216,-8,-631,100
1,1749,1702,47,0,-60,43
1,1715,1967,-252,-1,-65,153
-1,1143,1247,-104,-4,-631,94
1,1566,1467,99,0,7,53
0,1476,1612,-136,-1,-246,131
1,1337,1528,-191,0,457,113
-1,1393,1645,-252,-3,-97,62
0,1635,1492,143,0,-305,186
1,2117,1947,170,2,188,91
-1,1928,1821,107,0,-81,124
1,1560,1220,340,-1,38,63
-1,1500,1451,49,2,-90,64
-1,1667,1610,57,0,100,122
-1,1940,2124,-184,-3,-127,51
1,1609,1584,25,0,170,85
-1,1354,1492,-138,-12,-160,44
1,1593,1280,313,0,-38,75
-1,1370,1447,-77,-6,-195,64
1,2131,1933,198,1,70,87
1,1733,1461,272,-5,218,91
-1,1500,1465,35,-1,76,76
-1,1423,1372,51,-1,-57,94
1,1563,1216,347,0,379,119
1,1499,1347,152,0,71,53
0,1500,1497,3,-1,-274,126
1,1737,1813,-76,0,12,63
0,1927,2138,-211,-1,-313,111
-1,1354,1562,-208,-6,-217,64
1,1307,1556,-249,1,18,55
1,1574,1624,-50,2,198,114
1,1593,1349,244,0,15,51
-1,1340,1506,-166,0,-12,56
-1,1255,1500,-245,0,6,58
1,1510,1301,209,-1,-41,59
1,1344,1617,-273,2,525,111
1,1658,1415,243,3,528,93
1,1598,1394,204,4,158,51
-1,1100,1486,-386,-1,-987,136
1,1835,1912,-77,0,-26,61
-1,1513,1605,-92,-7,-605,154
1,1560,1293,267,-1,-119,75
1,1631,1657,-26,2,64,51
1,1500,1488,12,0,-35,89
-1,1213,1566,-353,-1,-211,74
-1,1994,1897,97,2,126,84
1,1512,1334,178,0,-6,65
1,1784,1575,209,0,92,43
1,1466,1317,149,3,114,53
1,1556,1652,-96,6,132,47
1,1588,1214,374,2,1167,135
-1,1572,1488,84,-11,-507,90
1,1423,1467,-44,1,45,49
1,1610,1569,41,1,40,49
1,1559,1637,-78,1,42,53
1,1607,1407,200,1,46,53
-1,1525,1780,-255,-7,-46,50
-1,1740,1988,-248,-2,-215,64
1,1470,1435,35,-2,-123,85
-1,1820,1578,242,-2,-19,44
-1,1309,1507,-198,-4,-76,62
1,1695,1613,82,1,73,47
-1,1481,1418,63,-2,-529,124
-1,1563,1572,-9,2,14,42
-1,1572,1563,9,-1,-15,46
1,1356,1614,-258,3,112,91
-1,1583,1603,-20,-13,-300,58
-1,1473,1452,21,-5,-547,102
-1,1951,1993,-42,0,-41,52
1,2004,1942,62,1,47,61
1,1536,1303,233,0,-4,49
1,1680,1564,116,9,550,65
-1,1383,1604,-221,-3,-67,56
1,1618,1726,-108,0,-18,59
1,2014,1488,526,0,1,59
1,1500,1061,439,8,282,55
1,1542,1057,485,2,38,53
1,1468,1714,-246,0,1,41
1,1670,1501,169,0,106,61
1,2022,2016,6,-3,-74,95
-1,1478,1591,-113,-1,-63,56
-1,2003,2033,-30,-3,28,80
-1,1549,1665,-116,-3,-224,66
1,1494,1464,30,9,671,99
1,1287,1604,-317,10,126,51
-1,1719,1727,-8,1,-112,68
1,1614,1484,130,-2,-63,53
-1,1719,1727,-8,-2,72,118
-1,1495,1677,-182,-1,-180,104
1,1481,1634,-153,1,-97,67
-1,1709,1738,-29,-4,-196,72
1,1748,1699,49,0,202,79
1,1687,1734,-47,-3,70,71
1,1672,1367,305,6,137,45
1,1758,1689,69,2,11,41
-1,1375,1458,-83,-11,-128,40
-1,1599,1454,145,6,105,52
-1,1681,1767,-86,-5,-303,68
-1,1308,1638,-330,0,3,42
1,1767,1681,86,1,68,53
-1,1681,1767,-86,-2,-5,54
1,1497,1495,2,-1,17,93
1,1467,1224,243,4,223,73
1,1665,1783,-118,1,151,63
1,1775,1672,103,0,-10,59
1,1678,1687,-9,-1,-46,113
-1,1476,1753,-277,-4,-145,72
-1,1691,1480,211,-3,-201,76
1,1762,1679,83,0,46,61
-1,1547,1489,58,0,1,66
1,1306,1485,-179,1,66,57
1,1450,1363,87,0,18,65
1,1783,1671,112,-1,134,111
-1,1469,1582,-113,-7,-191,66
1,1643,1689,-46,1,-5,55
1,1710,1750,-40,0,-7,45
1,1801,1678,123,-1,-2,63
1,1347,1376,-29,-3,-53,69
-1,1556,1801,-245,-9,-282,72
1,1811,1663,148,3,110,55
1,1505,1471,34,2,111,61
-1,1960,1738,222,-7,23,52
-1,1324,1385,-61,-6,-579,74
-1,1560,1460,100,0,-68,58
-1,1593,1918,-325,5,92,52
-1,1642,1532,110,12,297,58
1,1838,2045,-207,-3,-483,83
-1,1532,1642,-110,-9,-280,50
1,1744,1504,240,-2,-57,59
1,1664,1798,-134,3,53,51
1,1552,1484,68,11,849,69
-1,1871,1663,208,0,-14,40
1,1628,1548,80,-9,-321,71
-1,1539,1636,-97,0,0,44
1,1840,2028,-188,-5,-6,77
1,1778,1679,99,-2,-27,75
1,1475,1561,-86,-1,22,63
1,1738,1677,61,0,36,65
-1,1530,1644,-114,-5,-121,50
-1,1871,2011,-140,-1,-225,98
-1,1547,1489,58,0,-194,88
1,1514,1659,-145,4,221,65
1,1940,1762,178,4,358,99
-1,1514,1659,-145,-21,-440,52
1,1502,1535,-33,10,196,53
1,1665,1530,135,0,111,77
-1,1359,1354,5,-1,-214,66
-1,1868,2019,-151,-1,-64,86
1,1523,1515,8,5,448,77
1,1588,1545,43,0,197,73
0,1663,1527,136,3,-163,126
-1,1665,1709,-44,-4,-390,80
-1,1672,1523,149,5,-291,100
1,1857,2025,-168,-2,-39,61
-1,1543,1638,-95,0,19,56
-1,1535,1599,-64,-1,-385,80
1,1883,2009,-126,0,92,97
1,1608,1526,82,-2,-38,43
-1,1883,2009,-126,-2,-185,58
1,1669,1702,-33,0,-2,47
-1,1366,1348,18,5,208,74
-1,1617,1517,100,0,41,80
1,1872,2017,-145,-1,-64,99
1,1704,1659,45,-1,-9,51
1,1896,2001,-105,-5,-66,55
-1,1681,1674,7,-2,-128,74
1,1539,1484,55,2,136,63
-1,1917,1986,-69,-1,-753,136
1,1698,1476,222,1,121,57
1,1734,1720,14,1,73,63
1,1473,1549,-76,1,86,61
-1,1708,1995,-287,0,37,58
-1,1549,1473,76,-3,-105,54
1,1796,1636,160,1,172,125
1,1746,1587,159,-3,172,91
0,1587,1646,-59,0,63,108
1,1500,1508,-8,0,564,115
-1,1489,1535,-46,-3,-112,72
1,1720,1533,187,4,321,67
1,1080,1383,-303,3,126,99
1,1642,1491,151,-1,-3,53
1,1679,1475,204,-1,-91,97
1,1670,1701,-31,0,-12,55
-1,1478,1498,-20,-6,-557,86
1,1545,1470,75,-3,73,79
1,1360,1469,-109,0,1,51
1,1947,1739,208,2,60,49
-1,1554,1460,94,-1,-2,46
-1,1619,1803,-184,-3,-184,80
1,1348,1630,-282,-2,-37,55
1,1758,1739,19,0,150,59
-1,1398,1363,35,-1,-11,60
-1,1500,1441,59,-4,-483,84
0,1953,1854,99,1,-83,111
-1,1570,1644,-74,-1,-22,64
-1,1581,1613,-32,0,2,44
1,1657,1534,123,1,59,67
-1,1584,1367,217,0,-62,84
-1,1658,1730,-72,-3,-29,42
1,1810,1605,205,1,59,71
1,1454,1487,-33,-5,39,59
-1,1531,1476,55,-2,-42,48
-1,1671,1551,120,-1,-41,60
1,1487,1454,33,-1,82,71
1,1949,1857,92,0,26,79
0,1708,1816,-108,1,84,100
1,1762,1648,114,4,42,41
1,1444,1497,-53,1,33,93
1,1653,1603,50,3,274,103
-1,1667,1439,228,-8,-98,54
-1,1761,1877,-116,0,10,54
-1,1543,1550,-7,-1,-108,106
-1,1598,1483,115,0,-44,52
-1,1550,1458,92,-1,-352,88
-1,1792,1751,41,0,31,114
-1,1456,1457,-1,-2,-111,148
-1,1650,1563,87,0,14,44
1,843,1304,-461,-13,-287,45
1,1812,1711,101,0,88,101
1,1645,1540,105,0,247,133
1,1174,1374,-200,4,30,68
-1,1636,1594,42,-2,-27,48
0,1473,1524,-51,0,-427,152
-1,1653,1500,153,0,-16,52
-1,1624,2001,-377,-1,-64,54
1,1700,1486,214,15,457,49
-1,1521,1475,46,0,-115,114
-1,1484,1526,-42,-3,-160,78
1,1622,1574,48,2,93,55
-1,1405,1462,-57,-2,-174,54
1,1779,1374,405,3,180,71
1,2003,1628,375,2,35,59
1,1954,1682,272,0,6,53
-1,1625,2006,-381,0,-79,56
1,1560,1501,59,4,75,58
1,2008,1623,385,1,124,59
1,1666,1653,13,1,368,161
-1,1620,2011,-391,0,80,70
1,1784,1678,106,0,-11,40
1,1967,1958,9,5,350,93
1,1755,1500,255,8,275,47
-1,1488,1502,-14,0,-443,86
1,1649,1527,122,-2,279,99
1,1793,1669,124,1,72,65
-1,1848,2013,-165,0,36,84
1,1445,1557,-112,-4,-12,45
-1,1842,2020,-178,-3,-90,56
-1,2020,1842,178,-1,101,114
1,1500,1662,-162,0,56,59
1,1631,1511,120,0,13,49
-1,1858,2027,-169,-1,75,116
-1,1460,1570,-110,1,-71,58
-1,1663,1503,160,-3,-180,56
0,2034,1852,182,1,215,121
1,1667,1639,28,1,139,101
-1,1491,1639,-148,-2,-97,69
-1,1648,1520,128,0,-113,112
1,1598,1153,445,-1,344,71
1,2081,1960,121,0,116,117
-1,1962,1955,7,-1,-81,58
-1,1857,2028,-171,0,-9,56
-1,1536,1633,-97,0,-231,108
-1,1516,1502,14,-8,-4,40
1,1646,1500,146,-3,137,128
-1,2035,1851,184,1,90,86
1,1269,1494,-225,1,244,109
1,1641,1630,11,0,-22,43
-1,1868,2017,-149,-1,-63,98
-1,1483,1950,-467,1,42,70
-1,1524,1520,4,-5,-344,86
-1,1648,1520,128,-2,-271,146
1,2024,1861,163,0,90,59
1,1577,1453,124,8,395,73
1,1952,1876,76,0,-6,117
-1,1535,1634,-99,-6,-223,64
-1,1855,2031,-176,-7,-661,112
1,2038,1848,190,4,211,55
1,1678,1479,199,-3,535,141
1,1776,1480,296,0,33,55
-1,1867,1963,-96,-2,-197,132
-1,1599,1663,-64,0,-29,84
-1,1151,1359,-208,-13,-865,72
-1,1476,1780,-304,0,-96,88
1,1500,1527,-27,0,57,75
1,1364,1353,11,6,288,69
-1,1542,1774,-232,-1,-38,52
1,1383,1556,-173,0,403,119
-1,1703,1735,-32,-3,-79,58
1,1500,1426,74,0,-208,63
-1,1716,1578,138,-2,-70,64
1,1474,1546,-72,-1,-39,95
1,1685,1538,147,0,216,89
1,1641,1411,230,0,1,67
-1,1481,1520,-39,-10,-574,90
-1,1536,1552,-16,0,-116,74
1,1597,1615,-18,0,108,69
1,1701,1612,89,1,15,63
1,1684,1590,94,1,339,73
1,1642,1515,127,-1,-37,45
1,1417,1621,-204,1,25,49
1,1629,1939,-310,-6,-46,41
1,1309,1416,-107,-1,-84,57
1,1523,1634,-111,-1,42,87
-1,1386,1512,-126,-3,-769,106
1,1619,1538,81,0,151,151
-1,1692,1513,179,-2,-364,110
0,1622,1973,-351,0,53,90
1,1785,1372,413,4,669,91
1,1428,1480,-52,14,157,43
1,1278,1279,-1,12,499,55
1,1699,1606,93,-2,-88,63
-1,1693,1546,147,-3,-89,40
-1,1325,1298,27,-13,-571,98
1,1608,1663,-55,-4,38,51
0,1370,1787,-417,-1,-16,124
-1,1677,1561,116,5,19,42
-1,1592,1597,-5,0,-64,76
-1,1433,1539,-106,-4,-81,50
-1,1576,1662,-86,-2,-229,120
1,1582,1432,150,3,296,95
1,1674,1531,143,0,2,73
1,1927,1641,286,-1,-2,43
-1,1773,1461,312,5,210,50
-1,1530,1721,-191,-1,-321,146
-1,1372,1753,-381,-2,-63,52
-1,1643,1594,49,-3,-88,122
1,1650,1650,0,2,24,41
1,1588,1512,76,-3,167,113
-1,1304,1621,-317,-1,3,60
-1,1620,1773,-153,-2,-54,56
1,1637,1661,-24,-1,11,87
1,1612,1581,31,2,109,67
1,1810,1677,133,1,238,97
1,1595,1724,-129,0,95,89
-1,1529,1775,-246,0,103,106
1,1589,1392,197,4,516,89
1,1614,1603,11,-2,-3,53
-1,1595,1526,69,0,-18,85
1,1650,1407,243,2,74,59
-1,1727,1525,202,-6,-23,42
-1,1620,1532,88,0,72,72
1,1682,1693,-11,1,28,44
1,1708,1610,98,2,36,53
-1,1500,1470,30,1,-19,88
1,1589,1816,-227,0,7,55
-1,1547,1593,-46,-3,-113,50
1,1726,1638,88,-5,-124,85
1,1638,1660,-22,0,366,139
1,1448,1381,67,0,284,103
1,1700,1621,79,2,54,45
1,1611,1536,75,2,419,83
1,1624,1651,-27,4,236,88
1,1669,1758,-89,-5,-24,97
-1,1398,1446,-48,1,57,56
-1,1694,1529,165,0,57,94
-1,1494,1587,-93,0,-34,52
-1,1103,1419,-316,-7,-304,80
-1,1249,1293,-44,4,76,84
1,1734,1517,217,-3,-64,45
1,1787,1810,-23,2,157,123
1,1668,1478,190,0,6,51
1,1648,1651,-3,0,22,57
-1,1938,1881,57,4,-10,76
1,1639,1372,267,10,374,61
1,1430,1426,4,6,572,101
-1,1495,1500,-5,-1,7,46
-1,1538,1512,26,-1,-29,48
1,1638,1659,-21,-1,-68,42
-1,1682,1677,5,-3,-109,54
1,1635,1703,-68,0,261,139
1,1580,1670,-90,1,83,45
1,1439,1468,-29,0,19,41
-1,1275,1630,-355,-3,-266,64
0,1942,1649,293,-1,-33,126
-1,1672,1487,185,-1,-94,100
1,1655,1594,61,3,328,87
-1,1524,1525,-1,0,-3,44
1,1674,1682,-8,0,19,51
1,1748,1631,117,6,282,73
1,2081,1910,171,3,102,65
1,1579,1475,104,6,295,91
1,1623,1756,-133,-1,-49,61
-1,1410,1776,-366,-3,-191,66
1,1497,1384,113,1,16,49
1,1473,1498,-25,3,253,85
-1,1671,1685,-14,-3,-33,58
-1,1585,1665,-80,-2,-31,46
1,1551,1623,-72,2,95,45
1,1740,1639,101,2,141,87
-1,1798,1822,-24,-4,-277,78
1,1586,1441,145,1,121,171
-1,1904,2088,-184,0,10,50
-1,1657,1934,-277,1,28,48
-1,1452,1701,-249,-8,-61,40
1,1740,1298,442,3,123,65
0,1630,1748,-118,-1,-16,135
1,1540,1356,184,5,74,49
-1,1701,1670,31,-2,-91,80
-1,1660,1696,-36,-3,-495,172
1,1378,1144,234,13,521,61
1,1779,1407,372,0,80,53
1,1488,1337,151,5,101,47
1,1227,1314,-87,3,87,53
-1,1816,1578,238,-1,-173,112
-1,1627,2248,-621,-9,-480,66
1,1938,1653,285,3,46,49
1,1524,1487,37,-5,219,151
-1,1625,2249,-624,-1,-269,100
-1,1421,1986,-565,-4,-23,40
-1,1475,1548,-73,-1,-24,52
1,1963,1673,290,1,73,71
1,1851,1788,63,-3,23,89
1,1326,1496,-170,-7,-267,61
-1,1583,1693,-110,-11,-215,78
1,1485,1242,243,-2,-14,69
1,1644,1494,150,0,65,73
1,1649,1612,37,0,-1,47
-1,1299,1243,56,0,54,64
-1,1750,1632,118,0,55,84
0,1650,1797,-147,0,-14,85
1,1543,1500,43,4,394,127
-1,1779,1874,-95,-7,-28,42
1,2000,1981,19,2,100,85
1,1587,1137,450,12,983,99
1,1482,1578,-96,-1,551,99
1,1518,1651,-133,0,152,95
-1,1701,1575,126,-3,-246,90
-1,1466,1562,-96,-5,-440,84
-1,1477,1317,160,-4,-287,78
1,1699,1404,295,-3,267,121
1,1599,1659,-60,0,32,57
0,1647,1736,-89,-1,11,143
1,1804,1498,306,7,383,83
-1,1536,1437,99,0,-27,60
1,1477,1352,125,3,451,79
1,1434,1594,-160,3,146,50
-1,1508,1724,-216,1,-101,108
1,1894,1987,-93,1,108,71
1,1590,1686,-96,0,-19,93
1,1733,1650,83,0,161,103
0,1624,1571,53,0,7,109
-1,1719,1496,223,2,31,46
1,1621,1531,90,0,36,51
1,1420,1415,5,1,103,87
-1,1468,1519,-51,0,-17,62
1,1785,1747,38,-2,223,85
1,1793,1666,127,-1,50,79
1,1258,1285,-27,2,70,69
-1,1922,1762,160,-3,-2,62
1,1361,1130,231,2,88,53
1,1500,1651,-151,1,58,83
1,1630,1362,268,1,43,59
1,1341,1486,-145,-9,491,115
-1,1689,1662,27,-15,-247,40
1,1512,1564,-52,-5,-7,63
-1,1641,1741,-100,-1,23,46
1,1636,1449,187,-1,-11,55
1,1872,1557,315,4,158,49
-1,1672,1604,68,-1,-38,70
-1,1521,1675,-154,-6,-232,74
1,1530,1641,-111,3,119,69
1,1612,1554,58,0,-38,45
-1,1682,1765,-83,1,25,79
1,1887,1352,535,6,182,61
1,1926,1970,-44,0,80,75
-1,1665,1947,-282,-5,-186,58
1,1979,1767,212,6,62,45
-1,1500,1544,-44,0,13,80
1,1547,1625,-78,2,109,75
-1,1553,1726,-173,0,-13,88
1,2081,1892,189,0,-1,41
1,1653,1473,180,3,465,99
-1,1195,1565,-370,0,-92,78
1,1500,1237,263,2,240,77
-1,1596,1617,-21,-4,-160,70
-1,1445,1676,-231,-1,-60,78
-1,1006,1783,-777,-8,-428,66
1,1984,1573,411,0,-11,77
1,1749,1709,40,-1,140,73
1,1733,1545,188,3,164,73
-1,1275,1335,-60,-10,-230,46
1,1520,1269,251,0,-10,79
-1,1669,1956,-287,2,81,70
1,1563,1465,98,4,635,115
1,1500,1563,-63,0,352,129
-1,1537,1740,-203,-1,-131,82
1,1445,1404,41,3,105,57
-1,1700,1759,-59,0,47,58
1,1560,1627,-67,0,23,71
1,1459,1341,118,-5,-396,81
-1,1230,1524,-294,2,42,58
-1,1500,1578,-78,1,-9,82
-1,1330,1570,-240,-2,-1,54
1,1517,1480,37,-1,42,59
-1,1135,1571,-436,-15,-858,68
1,1440,1630,-190,0,355,107
-1,1368,1444,-76,-4,-297,128
-1,1784,1592,192,0,-107,78
1,1521,1479,42,1,136,109
1,1575,1592,-17,4,69,55
-1,1289,1746,-457,1,349,108
1,1598,1500,98,-3,-67,43
1,1768,1691,77,2,183,59
1,1529,1570,-41,0,-24,81
-1,1514,1608,-94,-7,-62,46
1,1433,1367,66,0,9,53
-1,1571,1624,-53,-2,-57,52
1,1561,1614,-53,0,19,83
1,1467,1456,11,1,157,113
1,1457,1572,-115,0,81,57
1,1643,1641,2,3,135,53
0,1558,1542,16,1,-68,63
-1,1398,1492,-94,-6,-276,66
1,1333,1419,-86,-3,-76,69
1,1574,1652,-78,0,78,86
1,1616,1505,111,3,603,141
1,1766,1472,294,1,200,63
-1,1517,1388,129,-3,-32,48
-1,1445,1487,-42,-3,-444,138
-1,1649,1568,81,-1,-72,90
-1,1418,1969,-551,-19,-719,92
1,1543,1557,-14,-1,-143,79
-1,1573,1748,-175,0,-146,84
-1,1653,1967,-314,-10,-18,40
1,1541,1762,-221,-1,-49,103
-1,1466,1610,-144,-2,-216,72
1,1719,1500,219,3,91,63
1,1600,1506,94,7,167,41
1,1978,1416,562,10,709,81
-1,1755,1567,188,-3,-70,46
-1,1562,1968,-406,-1,-68,76
0,1445,1624,-179,-5,-51,118
-1,1468,1770,-302,0,-182,118
1,1667,1729,-62,3,32,43
-1,2118,1787,331,0,-42,90
1,1646,1776,-130,-8,-48,61
1,1524,1566,-42,-2,-198,71
1,1556,1633,-77,0,70,69
1,1598,1633,-35,-1,65,79
1,1614,1460,154,-1,214,85
1,1452,1582,-130,2,385,153
-1,1508,1821,-313,0,-12,58
-1,1456,1670,-214,-2,-435,141
-1,1536,1407,129,3,7,66
-1,1619,1622,-3,0,-74,86
-1,1622,1539,83,-1,-228,90
-1,1604,1880,-276,-4,-132,82
-1,1511,1602,-91,4,110,46
-1,1538,1829,-291,0,-12,82
1,1814,1491,323,0,121,105
1,1891,1890,1,0,-29,85
1,1661,1668,-7,0,8,65
1,1997,1595,402,-2,55,53
1,1879,1921,-42,-1,56,55
1,1759,1786,-27,0,-80,85
-1,1592,1999,-407,-4,-158,74
1,1454,1287,167,1,404,85
1,1525,1354,171,-1,78,62
-1,1329,1591,-262,1,68,82
1,1324,1349,-25,1,50,68
0,1890,1758,132,-7,-344,147
-1,1413,1315,98,-3,-122,66
1,1381,1429,-48,12,176,48
1,1534,1400,134,9,127,41
-1,1892,1881,11,0,-115,114
-1,1493,1514,-21,-2,-51,98
-1,1333,1330,3,-3,-64,80
-1,1783,1738,45,0,-1,48
1,1846,1635,211,-3,325,81
-1,1579,1316,263,1,55,66
-1,1554,1570,-16,-1,-57,78
1,1821,1842,-21,0,6,43
-1,1693,1540,153,-2,-595,104
1,1550,1488,62,-1,160,161
1,1383,1331,52,2,166,61
1,1326,1500,-174,10,640,72
1,1547,1347,200,0,16,61
-1,1569,1666,-97,-2,-87,56
1,1531,1287,244,11,185,41
1,1598,1795,-197,0,7,49
-1,1394,1418,-24,0,-90,95
-1,1831,2001,-170,-3,-147,92
1,1637,1417,220,0,19,61
-1,1528,1599,-71,-2,-403,176
-1,1429,1542,-113,-1,-6,86
-1,1480,1294,186,2,-37,76
-1,1260,1562,-302,-4,-164,70
1,1500,1665,-165,2,84,103
-1,1345,1405,-60,0,32,70
-1,1500,1490,10,2,-201,72
-1,1491,1721,-230,-2,-161,64
-1,1518,1553,-35,0,9,58
1,1906,1794,112,1,38,55
-1,1469,1148,321,-1,-8,46
1,2008,1826,182,2,26,41
-1,1776,1922,-146,-2,-327,72
1,1667,1507,160,4,230,59
1,1679,1753,-74,2,55,43
1,1549,1416,133,-1,-57,97
1,1562,1343,219,1,158,81
-1,1936,1760,176,4,76,42
-1,1554,1666,-112,0,-29,42
1,1412,1376,36,3,436,99
1,1642,1195,447,1,387,85
1,1803,1751,52,3,79,51
1,1795,1905,-110,-2,-4,45
-1,1820,2014,-194,1,81,78
1,1518,1300,218,0,209,121
1,1878,1950,-72,0,199,149
-1,1675,1543,132,3,57,79
1,1757,1340,417,0,217,116
1,1559,1292,267,7,78,43
-1,1937,1903,34,-1,-1,86
0,1337,1420,-83,1,-268,115
-1,1315,1566,-251,-3,-715,118
-1,1830,1924,-94,-1,-18,73
-1,1757,2090,-333,0,-25,52
1,1662,1605,57,0,32,71
1,2020,1815,205,-1,-40,113
-1,1640,1821,-181,-2,-25,40
1,1762,1634,128,5,220,55
-1,1483,1726,-243,-1,-38,56
1,1365,1430,-65,-4,-199,130
-1,1656,1802,-146,1,-49,64
1,1500,1799,-299,1,826,137
-1,1563,1549,14,-3,15,68
-1,1623,1827,-204,0,3,48
-1,1644,1858,-214,-3,-283,102
-1,1354,1500,-146,-5,-188,64
-1,1567,1564,3,-3,-43,48
-1,1810,2026,-216,-3,68,128
1,1565,1500,65,-4,-71,43
1,1396,1238,158,5,180,51
1,1798,1251,547,5,624,87
1,1658,1806,-148,-8,-292,91
1,1571,1534,37,2,569,129
1,1337,1167,170,-8,-443,81
1,1661,1705,-44,3,139,73
1,1556,1255,301,7,280,65
-1,1459,1794,-335,-4,-66,40
1,1675,1651,24,-2,-72,49
-1,1336,1354,-18,1,13,42
1,1407,1379,28,12,488,67
1,1799,1698,101,-4,-275,75
0,1615,1349,266,3,-695,200
1,1685,1613,72,3,94,58
-1,1703,1754,-51,-7,-175,50
1,1567,1308,259,7,600,105
1,1615,1446,169,1,199,75
-1,1453,1822,-369,0,-389,111
-1,1422,1500,-78,1,152,54
1,1506,1583,-77,-1,10,71
-1,1440,1624,-184,-3,-8,84
-1,2053,1763,290,0,-180,142
-1,1559,1404,155,0,5,78
1,1475,1589,-114,-1,-32,119
1,1465,2031,-566,-1,-66,123
-1,1639,1563,76,-4,-74,50
1,1632,1414,218,0,144,69
1,1551,1462,89,-4,20,41
-1,1521,1648,-127,-3,-410,102
1,1845,1210,635,9,358,75
1,1867,1750,117,-4,-163,65
1,1567,1519,48,1,226,81
0,1742,1874,-132,1,125,122
1,1470,1302,168,4,55,45
-1,1588,1839,-251,0,3,44
1,1815,1424,391,4,253,63
1,1691,1639,52,1,188,105
1,1421,1572,-151,1,47,57
-1,1320,1400,-80,-1,13,40
1,1639,1771,-132,0,177,83
-1,1870,1747,123,-1,-639,154
1,1368,1331,37,4,287,75
1,1747,1870,-123,1,273,108
-1,1543,1339,204,2,159,82
1,1856,1762,94,-1,-78,67
0,1731,1865,-134,0,-47,95
1,1476,1392,84,2,331,84
-1,1500,1687,-187,-2,-806,134
-1,1683,1817,-134,0,-31,52
1,1482,1409,73,0,28,57
1,1500,1583,-83,-1,-42,43
-1,1500,1500,0,-4,-221,80
1,1500,1593,-93,9,571,109
1,1500,1754,-254,1,1,53
0,1552,1555,-3,2,38,89
-1,1449,1290,159,-4,-13,40
1,1825,1675,150,0,10,71
-1,1451,1454,-3,2,78,56
1,1662,1207,455,0,6,49
1,1742,1337,405,7,699,95
1,1693,1199,494,2,101,67
-1,1737,1629,108,-1,-100,90
1,1400,1491,-91,7,177,57
1,1749,1568,181,13,1061,85
1,1555,1552,3,-1,-100,75
-1,1525,1527,-2,-11,-238,44
1,1674,1840,-166,0,5,69
1,1563,1613,-50,-1,-11,79
-1,1500,1378,122,-21,-547,58
-1,1453,1759,-306,-1,-102,78
1,1553,1492,61,3,350,89
1,1244,1307,-63,2,250,86
-1,1377,1832,-455,-4,-260,64
1,1706,1602,104,1,27,51
1,1795,1524,271,1,335,75
-1,1472,1479,-7,-4,-519,96
1,1477,1414,63,3,7,41
1,1674,1612,62,2,153,63
-1,1571,1575,-4,-5,-77,120
1,1574,1701,-127,-4,487,123
1,1864,1669,195,0,0,47
-1,1714,1913,-199,-9,-110,44
1,1864,1814,50,1,257,113
1,1663,1682,-19,0,22,63
-1,1804,1873,-69,-3,1,46
-1,1500,1540,-40,-9,-374,78
1,1600,1683,-83,0,-94,55
-1,1733,1930,-197,0,-411,150
0,1537,1626,-89,3,42,50
1,1457,1382,75,2,272,83
-1,1500,1694,-194,4,-269,146
1,1882,1796,86,-1,609,135
-1,1708,1684,24,1,-25,66
-1,1641,1593,48,-1,-61,84
-1,1572,1670,-98,0,-164,106
-1,1863,1699,164,0,4,60
1,1616,1537,79,6,32,41
1,1466,1326,140,9,295,45
1,1500,1402,98,4,83,41
1,1678,1563,115,4,47,45
-1,1563,1678,-115,0,-99,110
0,1833,1890,-57,3,741,120
-1,1696,1696,0,-10,-457,60
-1,1569,1547,22,-3,-92,48
-1,1133,1493,-360,-5,-270,68
-1,1686,1555,131,-11,-94,66
-1,1582,1482,100,0,-107,80
1,1559,1554,5,2,13,53
1,1571,1671,-100,-3,-163,79
1,1889,1675,214,0,-47,71
-1,1633,1776,-143,-1,-32,48
-1,1579,1691,-112,-2,-110,68
-1,1611,1669,-58,-6,-215,80
1,1783,1626,157,7,767,91
1,1258,1293,-35,13,476,65
-1,1388,1541,-153,-4,-306,76
-1,1656,1586,70,-7,-458,84
-1,1670,1894,-224,0,-6,64
1,1664,1533,131,-3,-105,59
-1,1600,1643,-43,0,-33,62
-1,1314,1161,153,-3,-233,69
1,1643,1600,43,0,-50,79
-1,1472,1292,180,-1,-468,100
-1,1365,1596,-231,-1,-43,68
0,1898,1693,205,0,115,136
-1,1665,1590,75,-8,-358,90
-1,1673,1777,-104,-2,-41,50
0,1647,1678,-31,-2,128,135
-1,1604,1893,-289,-7,-157,58
1,1321,1253,68,-1,-80,93
1,1896,1600,296,0,7,53
-1,1651,2034,-383,-1,-111,86
1,1286,1595,-309,7,239,59
1,1629,1360,269,4,142,53
-1,1649,1900,-251,-1,-5,48
-1,1644,1904,-260,0,20,72
1,1904,1644,260,0,161,67
1,1572,1406,166,-1,25,87
-1,1417,1550,-133,0,-594,152
-1,928,1180,-252,-15,-502,58
0,1909,2036,-127,0,-192,121
-1,1726,1655,71,-1,-112,62
-1,1356,1654,-298,-4,-284,120
1,1208,1339,-131,2,219,71
1,1189,903,286,2,546,83
1,2032,1912,120,3,592,105
1,1609,1678,-69,0,14,81
-1,1782,1640,142,-1,-1,54
1,1245,1435,-190,-3,-103,79
-1,1905,2040,-135,-1,-355,112
-1,1301,1396,-95,1,-72,72
-1,1578,1656,-78,0,-208,86
-1,1500,1373,127,0,-111,130
-1,1675,1767,-92,0,-47,94
-1,1656,1745,-89,-5,-213,68
-1,1311,1273,38,0,-23,136
1,1526,1541,-15,4,76,51
-1,1627,1733,-106,0,-9,42
1,1319,1117,202,6,707,125
-1,1647,1754,-107,1,46,62
-1,1733,1831,-98,0,171,70
1,1463,1316,147,-4,-146,67
-1,1801,1557,244,0,59,60
1,1839,1715,124,-1,51,63
1,1407,1253,154,8,319,57
-1,1500,1628,-128,-8,-335,66
-1,1130,1500,-370,-4,-157,61
1,1569,1177,392,-6,-119,79
1,1698,1846,-148,1,38,49
-1,1898,2047,-149,-4,-211,69
1,1831,1731,100,0,135,49
1,1831,1731,100,2,36,41
1,1529,1544,-15,-1,-12,67
-1,1891,2054,-163,-5,-135,50
-1,1618,1399,219,-3,-67,52
1,1715,1839,-124,-4,590,139
-1,1743,1825,-82,3,42,42
-1,1885,2061,-176,-3,-83,72
1,1440,1425,15,7,175,57
-1,1517,1664,-147,1,-20,56
-1,1629,1774,-145,1,49,80
-1,1727,1833,-106,1,-25,66
1,1439,1647,-208,-6,-251,73
1,1519,1500,19,4,133,53
1,2044,1901,143,0,174,63
1,1833,1727,106,0,-52,75
0,1666,1762,-96,0,23,83
-1,1174,1571,-397,-1,-9,46
-1,1585,1673,-88,1,53,54
-1,1416,1598,-182,-3,-151,66
1,1841,1713,128,3,115,67
0,2051,1894,157,1,535,116
-1,1840,1740,100,0,-9,76
0,1899,2058,-159,-2,-246,107
-1,1854,1690,164,-1,-279,66
-1,1549,1352,197,-11,-227,42
1,1716,1577,139,0,-9,61
0,1903,1716,187,0,165,145
-1,1815,1671,144,-4,-434,88
1,1485,1499,-14,-1,7,65
1,1640,1380,260,-8,6,45
1,1630,1677,-47,1,120,53
1,1605,1410,195,3,38,43
-1,1146,1793,-647,1,24,60
-1,1898,1727,171,0,-129,96
1,1150,1689,-539,2,129,79
1,1814,1887,-73,1,32,69
-1,1486,1619,-133,1,-28,72
1,1714,1577,137,2,142,79
-1,1752,1882,-130,2,3,50
1,1708,1370,338,2,60,53
1,1705,1685,20,0,-12,51
-1,1410,1451,-41,-4,-263,74
-1,1741,1889,-148,0,-35,74
-1,1470,1398,72,-4,-109,56
-1,1889,1741,148,-2,-559,138
-1,1768,1785,-17,-8,-69,43
-1,1880,1896,-16,0,190,134
1,1664,1328,336,-1,-64,133
1,1907,1868,39,4,29,45
1,1764,1649,115,1,44,51
1,1868,1907,-39,-5,22,51
-1,1775,1641,134,-5,-135,66
-1,1743,1706,37,3,99,58
-1,1367,1712,-345,-7,-91,42
-1,1916,1858,58,0,-265,130
1,1178,1176,2,15,945,81
-1,1871,1904,-33,-5,7,54
1,1574,1753,-179,1,82,61
1,1674,1741,-67,-3,-8,55
1,1285,0,1285,12,281,44
-1,1914,1861,53,4,86,84
1,1717,1692,25,2,54,55
-1,1222,1669,-447,-17,-1179,106
1,1591,1730,-139,-1,15,71
0,1874,1901,-27,1,31,135
-1,1364,1443,-79,0,-13,46
1,1456,1260,196,4,196,65
-1,1629,1711,-82,1,35,48
-1,1541,1581,-40,-1,-152,68
1,1796,1488,308,4,349,81
-1,1672,1375,297,-1,-129,78
1,1730,1354,376,4,445,83
-1,1639,1904,-265,-1,-26,50
1,1606,1419,187,0,237,89
1,1608,1599,9,1,55,71
-1,1643,1323,320,-1,3,60
-1,1635,1630,5,0,94,68
0,1609,1318,291,13,1348,97
1,1617,1670,-53,0,8,41
1,1351,1272,79,-1,-22,71
1,1659,1721,-62,-2,55,53
1,1561,1240,321,5,504,119
-1,1612,1188,424,-9,-399,106
-1,1706,1797,-91,2,-49,58
0,1762,1670,92,1,365,100
-1,1569,1634,-65,1,-56,70
-1,1674,1759,-85,0,8,112
-1,1459,1658,-199,0,-18,88
-1,1617,1908,-291,-5,-233,98
-1,1733,1814,-81,-2,-58,56
1,1500,1571,-71,-2,-246,85
-1,1349,1594,-245,-3,-184,80
1,1768,1663,105,0,354,97
-1,1808,1699,109,-1,-64,86
-1,1055,1411,-356,-12,-440,56
1,1531,1300,231,6,143,53
1,1126,1033,93,4,358,71
-1,1653,1776,-123,-4,-393,84
1,1527,1697,-170,2,318,75
-1,1912,2053,-141,0,-3,58
1,1560,1626,-66,-5,-123,79
-1,2060,1905,155,-3,19,84
-1,1783,1644,139,1,185,68
1,1341,1405,-64,-3,-18,53
-1,1599,1555,44,-1,-62,118
-1,1663,1768,-105,-1,-59,56
-1,1921,2044,-123,-2,-383,126
-1,1506,1537,-31,0,-113,74
1,1776,1653,123,8,363,61
1,1412,1235,177,7,352,63
1,1653,1776,-123,-1,-22,67
1,2051,1913,138,1,80,63
1,1680,1333,347,0,0,55
-1,1761,1671,90,-2,-45,76
1,1462,984,478,4,195,85
1,1854,1485,369,2,31,45
-1,1906,2059,-153,-5,-498,78
1,1792,1683,109,0,387,133
1,1455,1273,182,6,225,65
1,2065,1900,165,-1,-12,45
-1,1805,1727,78,1,14,68
-1,1227,1418,-191,-9,-285,81
-1,1585,1557,28,0,-406,86
1,1893,1610,283,-1,-122,93
1,1451,1509,-58,1,-1,43
0,1739,1792,-53,2,236,126
-1,1606,1897,-291,-3,-142,86
1,1536,1544,-8,3,684,121
-1,1482,1404,78,0,-278,84
-1,1901,1602,299,-14,-870,84
1,1674,1569,105,0,314,85
1,1568,1573,-5,1,497,95
-1,1424,1834,-410,-2,-196,76
1,1790,1741,49,-4,75,85
0,1882,1739,143,-4,-872,110
1,1801,1560,241,3,515,139
1,1732,1799,-67,-5,-64,109
1,1886,1616,270,4,252,59
1,1787,1744,43,0,86,75
-1,1659,1806,-147,-1,-40,46
1,1478,1335,143,0,-2,45
-1,1532,1555,-23,-3,-327,88
-1,1612,1890,-278,0,-53,64
1,1363,1367,-4,8,167,45
1,1890,1612,278,1,40,77
-1,1813,1651,162,0,-38,85
1,1266,1530,-264,3,240,67
1,1156,1425,-269,-4,-132,53
-1,1729,1666,63,0,-34,84
-1,1608,1641,-33,-3,-218,66
1,1765,1575,190,3,600,127
1,1750,1500,250,3,430,113
1,1772,1556,216,2,15,97
-1,1327,1568,-241,0,41,72
1,1779,1743,36,0,44,61
-1,1575,1765,-190,-3,-8,52
1,2229,2065,164,0,11,63
-1,1798,1861,-63,0,-211,106
1,1580,1251,329,3,495,87
1,1286,1219,67,3,17,47
-1,1274,1697,-423,2,-67,60
1,1718,1759,-41,7,126,41
1,1879,1593,286,1,334,95
-1,1500,1654,-154,-2,-486,86
1,1809,1392,417,-3,12,75
-1,1500,1536,-36,-1,-332,86
1,1193,1272,-79,0,156,67
-1,1589,1882,-293,0,-63,84
-1,1728,1646,82,3,85,54
1,1660,1387,273,2,261,79
-1,1839,1687,152,0,-22,68
1,1293,1107,186,-1,-120,119
-1,1586,1886,-300,-1,-54,60
1,1699,1296,403,5,191,49
1,1642,1687,-45,-1,-147,75
-1,2072,2214,-142,0,-1,76
-1,1327,1582,-255,7,500,92
-1,1663,1496,167,-10,-555,68
1,1715,1790,-75,0,142,83
-1,1500,1309,191,-4,-65,50
1,1537,1583,-46,2,73,65
-1,1566,1677,-111,-1,-79,90
1,1537,1583,-46,-2,67,83
-1,1662,1606,56,-3,-89,52
-1,1649,1735,-86,-2,-53,56
1,1566,1571,-5,0,-41,73
1,1203,1405,-202,5,134,41
1,1512,1647,-135,5,396,71
-1,1218,1598,-380,-13,-569,76
1,1776,1728,48,-2,66,139
-1,1560,1591,-31,-3,-67,64
1,1530,1341,189,0,225,128
1,1591,1560,31,-3,-2,71
1,1789,1669,120,-1,-64,57
-1,1500,1003,497,-20,-473,52
1,1453,1438,15,0,43,55
-1,1669,1789,-120,0,-34,56
-1,1322,1550,-228,-6,-103,52
-1,1719,1786,-67,-1,13,56
-1,1558,1685,-127,0,-2,44
1,1791,1641,150,-3,-55,123
-1,1797,1661,136,0,-41,68
1,1780,1632,148,-5,42,93
-1,1136,1500,-364,-3,-723,118
1,1795,1710,85,0,25,57
-1,1648,1579,69,0,133,70
1,1678,1781,-103,0,515,129
1,1608,1587,21,1,158,57
-1,1417,1350,67,1,-89,102
1,1593,1635,-42,-1,-143,113
1,1576,1605,-29,2,22,47
-1,1702,1803,-101,0,-1,64
1,1787,1625,162,7,289,67
-1,1623,1606,17,-1,-2,56
-1,1620,1576,44,-4,-81,42
1,1474,1364,110,-3,32,63
-1,1840,1694,146,0,-124,123
1,1589,1606,-17,3,101,61
-1,1618,1653,-35,-11,-341,70
-1,1187,1490,-303,1,1,52
-1,1619,1794,-175,0,-291,90
1,1663,1607,56,2,304,85
0,1634,1625,9,-1,-1881,268
1,1594,1601,-7,2,374,77
-1,1494,1571,-77,-2,-183,82
1,1805,1972,-167,-1,-63,145
-1,1376,1262,114,-4,-321,98
-1,1677,1811,-134,-3,-10,52
1,1589,1606,-17,3,-35,43
1,1606,1589,17,1,69,57
1,1580,1485,95,1,412,107
-1,1601,1594,7,-7,-394,70
1,1197,1383,-186,9,572,73
1,1800,1612,188,0,360,103
1,1652,1452,200,-1,-13,55
1,1605,1589,16,1,201,77
-1,1605,1714,-109,-2,-143,64
0,1259,1560,-301,0,278,99
1,1693,1776,-83,9,135,45
-1,1482,1511,-29,-4,-277,76
-1,1591,1604,-13,-4,-182,68
-1,1588,1667,-79,1,36,50
1,1806,1702,104,1,127,107
-1,1482,1207,275,0,-7,48
-1,1293,1706,-413,-9,-342,50
-1,1366,1513,-147,0,-105,68
1,1657,1325,332,-10,-165,85
-1,1233,1477,-244,-7,-481,102
-1,1613,1554,59,-1,-29,58
-1,1355,1500,-145,4,195,58
1,1132,1114,18,8,274,53
-1,1676,1568,108,-7,-77,56
1,1597,1619,-22,0,70,95
1,1543,1647,-104,0,287,149
-1,1587,1567,20,-6,-303,128
1,1708,1293,415,3,519,99
1,1660,1971,-311,2,141,101
-1,1693,1815,-122,-5,-156,50
1,1573,943,630,0,245,131
1,1375,1500,-125,-3,187,59
-1,1647,1588,59,0,-77,94
1,1483,1045,438,7,1773,161
-1,1557,1654,-97,-1,-13,54
1,1439,1821,-382,0,226,89
1,1415,1255,160,6,169,53
1,1286,1181,105,6,968,109
1,1920,1877,43,2,51,43
1,1822,1346,476,9,138,41
-1,1710,1830,-120,0,8,52
1,1415,1579,-164,-7,-132,45
1,1601,1431,170,-1,-30,43
-1,1520,1745,-225,-2,-122,112
-1,1781,1903,-122,0,-92,68
-1,1823,1562,261,-3,-108,62
-1,1722,1675,47,1,-46,54
1,1742,1453,289,-5,-230,79
-1,1704,1792,-88,-3,-159,76
-1,1447,1667,-220,-3,-127,60
-1,1518,1392,126,7,178,96
-1,1657,1716,-59,7,195,46
1,1449,1746,-297,-1,-25,61
1,1750,1715,35,0,62,69
-1,1348,1455,-107,-2,-54,50
1,1515,1305,210,-10,-120,51
-1,1330,1154,176,-3,-203,72
1,1843,1728,115,0,29,93
1,1789,1931,-142,0,441,143
1,1685,1477,208,-3,-7,67
-1,1687,1666,21,-3,-137,80
-1,1640,1779,-139,-3,-278,82
-1,1605,1911,-306,-1,-27,48
1,1800,1695,105,-2,-7,53
-1,1258,1339,-81,-3,-3,54
1,1188,0,1188,0,506,101
-1,1807,1726,81,0,-141,96
-1,1292,1520,-228,-3,-35,44
-1,1774,1732,42,2,59,62
1,1343,1435,-92,-1,-13,67
-1,1808,1818,-10,0,-26,56
-1,1703,1721,-18,-2,-225,92
1,1606,1644,-38,0,15,55
-1,1647,1606,41,2,29,90
-1,1622,1577,45,-1,-20,64
1,1526,1470,56,2,39,49
1,1525,1281,244,-1,-38,59
1,1828,1797,31,0,212,131
1,1589,1664,-75,4,39,57
-1,1683,1786,-103,0,-12,70
-1,1094,1327,-233,2,93,52
1,1500,1426,74,0,38,59
-1,1540,1578,-38,-4,-37,66
1,1604,1500,104,1,94,153
1,1723,1669,54,2,3,53
-1,1763,1744,19,0,-35,46
1,1273,1155,118,7,158,49
1,1640,1558,82,1,74,53
-1,1602,1562,40,2,11,64
1,1809,1876,-67,-2,-14,83
1,1631,1522,109,-2,-361,83
-1,1270,1530,-260,4,120,60
-1,1406,1668,-262,-2,3,44
-1,1793,1851,-58,-1,-47,72
1,1375,1320,55,1,105,45
1,1590,1595,-5,1,37,59
1,2167,1472,695,3,133,63
1,1415,1372,43,-1,215,57
1,1693,1673,20,8,1308,111
-1,1472,1559,-87,0,-9,50
1,1544,1354,190,5,348,71
-1,1252,1563,-311,-5,-116,48
1,1752,1756,-4,1,119,79
-1,1662,1703,-41,-6,-106,110
1,1399,1332,67,6,339,117
-1,1826,1800,26,-1,-133,84
-1,1740,1568,172,-3,-62,90
-1,1782,1502,280,-6,-73,64
1,1712,1651,61,1,12,95
-1,1649,1501,148,0,37,106
1,1618,1675,-57,3,99,71
-1,1471,1589,-118,1,83,82
1,2167,1860,307,0,-7,55
1,1740,1550,190,3,412,97
-1,1723,1642,81,-1,-460,100
-1,1408,1639,-231,0,-503,110
1,1656,1708,-52,0,365,91
-1,1373,1795,-422,-2,-40,40
-1,1550,1573,-23,0,12,70
1,1417,1385,32,2,246,67
-1,1811,1815,-4,-1,-81,68
-1,1862,1823,39,1,-19,60
-1,1531,1398,133,0,-74,78
-1,1694,1457,237,-2,-419,122
1,1771,1420,351,-9,-210,63
-1,1762,1745,17,0,-89,58
-1,0,1248,-1248,1,-97,66
-1,1675,1596,79,0,-179,97
1,1359,1245,114,0,69,55
-1,1675,1474,201,2,-70,60
1,1663,1837,-174,0,16,63
1,1440,1364,76,1,388,99
1,1825,1801,24,0,-2,57
1,1570,1569,1,1,151,63
-1,1490,1657,-167,4,138,60
-1,1281,1462,-181,6,149,50
-1,0,981,-981,1,163,80
1,1539,1264,275,4,546,159
-1,1747,1709,38,0,-278,150
-1,1124,1361,-237,-2,-174,52
1,1774,1857,-83,-1,14,45
1,1646,1500,146,11,266,41
-1,1583,1759,-176,0,-53,84
-1,1751,2175,-424,-5,-87,94
1,1500,1500,0,3,171,49
1,1791,1835,-44,0,16,93
-1,1663,1484,179,3,-28,40
1,1819,1679,140,0,-33,73
1,1414,1515,-101,1,-57,83
-1,1489,1487,2,0,-13,70
1,1641,1384,257,3,251,59
1,1765,1578,187,-2,176,67
-1,1422,1560,-138,1,57,88
1,1588,1650,-62,7,339,64
-1,1288,1114,174,-8,102,78
-1,1498,1477,21,-6,-264,70
-1,1843,2179,-336,0,-43,62
-1,1558,1581,-23,3,102,60
1,1823,1803,20,1,57,107
-1,1750,1792,-42,1,5,60
1,1490,1487,3,5,357,59
1,1849,1610,239,2,50,49
1,1502,1517,-15,-1,-29,73
-1,1341,1607,-266,-7,-503,76
-1,1352,1349,3,-3,-625,90
-1,1457,1584,-127,-6,-173,48
-1,1345,1505,-160,-4,-163,56
-1,1611,1536,75,-1,-33,60
-1,1355,1221,134,-4,-259,74
0,1612,1337,275,-12,-628,74
-1,1725,2185,-460,0,145,100
1,1793,1833,-40,1,15,47
1,1500,1436,64,1,12,43
-1,1601,1406,195,-6,-261,66
-1,1507,1760,-253,1,45,52
-1,1220,1300,-80,-11,-311,72
-1,1551,1572,-21,0,-114,88
-1,1826,1840,-14,0,-35,102
-1,1329,1589,-260,-3,-97,54
-1,1429,1518,-89,-3,-35,46
1,1361,1341,20,5,43,57
1,1416,1414,2,5,223,65
1,1765,1503,262,-1,35,59
1,1740,1807,-67,-1,-4,51
-1,1498,1769,-271,-3,-144,64
1,1440,1450,-10,2,41,45
-1,1384,1471,-87,-4,-121,62
-1,1426,1510,-84,-9,-426,88
-1,1331,1372,-41,-2,-239,82
1,1773,1494,279,-3,-65,87
1,1286,1440,-154,-4,-4,55
-1,1469,1466,3,-1,74,84
-1,1733,1668,65,0,-28,92
-1,1490,1777,-287,-2,-69,72
1,1430,1500,-70,-1,2,49
-1,1902,1757,145,1,32,46
-1,1540,1500,40,2,21,44
1,1669,1408,261,4,186,59
1,1781,1486,295,-4,18,83
1,1460,1609,-149,5,198,71
1,1591,1477,114,-5,-241,109
-1,1598,1606,-8,-4,-215,128
1,1482,1785,-303,0,282,75
0,1650,1599,51,-2,-80,132
-1,1146,1272,-126,-6,-175,44
-1,1815,1579,236,2,13,46
-1,1765,1503,262,0,-32,62
-1,1600,1649,-49,0,-4,92
-1,1196,1512,-316,-1,-259,82
1,1767,1425,342,3,172,63
-1,1793,1765,28,-4,-109,60
-1,1514,1605,-91,-9,-110,50
-1,1420,1413,7,-3,-183,60
-1,1579,1519,60,-1,-146,106
-1,1745,1658,87,0,-9,70
1,1770,1577,193,3,67,41
-1,1496,1586,-90,-3,-111,66
-1,1597,1724,-127,-3,-145,62
-1,1485,1723,-238,-2,-287,76
1,1323,1224,99,-1,-82,65
-1,1420,1498,-78,-3,-22,50
1,1363,1443,-80,3,320,75
1,1796,1851,-55,0,12,75
-1,1279,1366,-87,-5,-45,44
-1,1776,1781,-5,0,65,62
1,1786,1427,359,6,248,55
-1,1635,1927,-292,-3,-70,46
1,1375,1486,-111,-4,-87,59
1,1594,1598,-4,0,-204,113
-1,1673,1500,173,-10,-326,60
1,1771,1731,40,2,203,105
1,1545,1406,139,5,228,65
1,1531,1493,38,4,13,41
1,1243,1500,-257,1,463,93
0,1789,1648,141,-2,-89,127
-1,1701,1662,39,1,-85,100
1,1614,1505,109,-3,-243,105
1,1439,1540,-101,-1,114,79
0,1589,1655,-66,-4,-68,108
-1,1721,1780,-59,1,11,56
1,1792,1766,26,-1,-9,91
1,1406,1389,17,3,829,121
-1,1124,1411,-287,2,37,48
1,1785,1797,-12,-1,-61,179
-1,1453,1497,-44,4,34,76
-1,1666,1858,-192,-5,-179,58
1,1552,1396,156,7,777,83
-1,1636,1738,-102,0,-2,44
-1,1631,1514,117,0,-192,108
-1,1746,1753,-7,0,-10,92
-1,1527,1506,21,-6,53,64
-1,1442,1516,-74,-1,-406,99
-1,1587,1616,-29,0,-887,168
1,1797,1568,229,8,325,57
1,1578,1520,58,4,100,95
-1,1756,1801,-45,2,-52,64
1,1315,1194,121,-2,-32,57
-1,1747,1752,-5,1,-181,126
1,1504,1500,4,0,68,57
1,1455,1542,-87,-4,-78,69
1,1559,1387,172,1,277,65
-1,1803,1533,270,-3,-776,132
1,1660,1519,141,1,99,55
-1,1415,1329,86,5,-46,98
1,1555,1515,40,0,6,73
1,1810,1747,63,-1,-7,101
-1,1705,1605,100,-3,11,40
-1,1323,1530,-207,-3,-37,42
-1,1618,1691,-73,0,-20,66
-1,1430,1442,-12,2,36,100
1,1565,1378,187,1,267,85
1,1759,1681,78,9,216,53
1,1332,1500,-168,-4,-100,61
1,1902,1366,536,0,43,65
1,1672,1768,-96,0,-38,73
-1,1317,1474,-157,-11,-135,46
1,1927,1660,267,0,-46,101
-1,1738,1819,-81,0,-17,62
1,1697,1737,-40,0,105,67
-1,1505,1592,-87,-2,-56,58
1,1571,1370,201,-1,33,89
-1,1700,1590,110,-5,-3,78
1,1656,1932,-276,-3,-36,47
-1,1430,1635,-205,-10,-271,54
1,1382,1221,161,1,26,53
1,1674,1911,-237,2,-56,69
1,1951,1544,407,1,639,109
1,1892,1692,200,0,-64,93
-1,1754,1686,68,4,67,50
1,1667,1773,-106,-1,-14,47
1,1620,1497,123,3,33,51
-1,1700,1741,-41,-1,-87,98
-1,1898,1706,192,-1,-146,102
-1,1500,1590,-90,-1,-38,46
1,1786,1482,304,0,-2,71
-1,1410,1678,-268,-5,-166,56
1,1903,1737,166,0,222,169
1,1743,1678,65,-1,54,71
-1,1475,1500,-25,-11,-229,42
1,1723,1880,-157,1,93,97
-1,1249,1525,-276,0,-9,84
1,2168,1312,856,2,71,46
1,1577,1363,214,-7,-96,93
1,1379,1582,-203,3,227,75
0,1863,1738,125,-12,-572,76
-1,1310,1340,-30,-1,115,76
-1,1312,1388,-76,-14,-56,40
-1,1077,1357,-280,-5,-521,104
-1,2168,1661,507,0,-100,70
0,1500,1478,22,-10,-1179,124
-1,1842,1826,16,-2,-181,92
1,1476,1364,112,8,446,63
1,1649,1500,149,0,-28,41
1,1492,1596,-104,-1,147,67
-1,1345,1500,-155,-7,-353,64
-1,1356,1601,-245,-4,-156,58
-1,1731,1910,-179,0,-108,154
1,1340,1612,-272,-18,-438,63
1,1532,1352,180,3,242,64
1,2072,1772,300,4,23,41
-1,1548,1538,10,3,-187,112
-1,1651,1833,-182,0,-75,76
-1,1395,1556,-161,-8,-93,44
1,1503,1407,96,0,20,113
1,1769,1685,84,2,36,45
1,1650,1614,36,0,-1,43
1,1550,1359,191,9,309,71
-1,1681,1345,336,-3,-15,40
-1,1248,1548,-300,-1,22,54
1,1662,1337,325,1,65,45
1,1924,1833,91,1,39,63
1,1783,1605,178,-4,-29,45
-1,1353,1556,-203,-11,-92,40
1,1612,1616,-4,1,133,71
-1,1395,1151,244,-2,-71,66
-1,1660,1677,-17,0,-168,86
-1,1354,1347,7,-13,-283,66
1,1352,1368,-16,0,267,149
-1,1542,1964,-422,-5,-123,52
1,1800,1612,188,-6,272,91
-1,1616,1739,-123,2,65,82
-1,1751,1790,-39,1,52,56
-1,1535,1586,-51,-2,-26,54
-1,1552,1245,307,-2,-242,108
1,1806,1606,200,1,160,87
-1,1548,1538,10,-3,-404,128
1,2144,1777,367,4,362,81
1,2108,1801,307,3,114,65
-1,1244,1374,-130,-1,-46,50
-1,1531,1687,-156,-3,-20,46
-1,1361,1529,-168,0,56,82
-1,1371,1615,-244,-4,-9,40
1,1359,1342,17,14,301,51
1,2148,1775,373,0,34,67
-1,1371,1615,-244,-5,-145,52
-1,1509,1725,-216,2,81,82
1,1618,1340,278,2,179,93
1,1752,1247,505,3,216,69
-1,1350,1385,-35,-10,-118,42
-1,1859,1745,114,2,49,44
1,1848,1625,223,14,363,55
1,1841,1640,201,0,59,65
-1,1812,1637,175,1,40,56
-1,1299,1532,-233,2,51,54
-1,1536,1503,33,0,-137,58
1,1396,1236,160,3,269,101
1,1853,1620,233,0,162,91
1,1843,1366,477,0,14,57
1,1661,1301,360,1,220,71
-1,1919,1916,3,-3,-161,80
1,1656,1742,-86,0,4,55
-1,1761,1845,-84,0,-157,118
1,1615,1364,251,-4,-130,57
-1,1678,1705,-27,-3,-29,44
-1,1854,1752,102,0,-657,134
-1,1360,1620,-260,-5,-318,86
-1,1772,1877,-105,0,-17,76
-1,1485,1729,-244,0,-167,162
1,1583,1537,46,13,1009,75
-1,1668,1744,-76,0,-4,76
1,1767,1624,143,3,273,105
-1,1512,1518,-6,-6,-111,48
-1,1710,1355,355,1,34,54
1,1437,1542,-105,1,59,55
-1,1287,1429,-142,-6,-48,46
-1,1659,1747,-88,-4,-26,42
-1,1808,2137,-329,-1,-12,47
1,1774,1500,274,1,18,65
1,1650,1617,33,0,-7,47
-1,1298,1504,-206,-8,-340,64
-1,1756,1774,-18,0,10,60
-1,1422,1778,-356,2,155,76
1,1650,1617,33,0,-10,49
1,1660,1606,54,0,16,45
-1,1443,1398,45,-4,-191,62
1,1611,1615,-4,-6,-14,105
1,1781,1500,281,1,95,83
-1,1670,1716,-46,-1,-25,52
1,1451,1499,-48,-1,17,67
-1,1500,1891,-391,-10,-251,58
-1,1694,2108,-414,-4,-89,60
1,1502,1592,-90,0,-23,69
-1,1610,1805,-195,1,27,64
-1,1608,1629,-21,-1,-67,52
-1,1266,1657,-391,0,-63,68
-1,1523,1310,213,-4,2,78
-1,1786,1858,-72,3,126,50
-1,1363,1378,-15,0,4,60
-1,1761,2177,-416,-2,-156,92
1,2110,1692,418,5,232,79
1,1729,1334,395,3,808,165
-1,1034,1331,-297,-27,-847,56
1,1976,1447,529,7,178,41
1,1660,1597,63,-8,-38,79
1,1463,1490,-27,-15,-390,71
-1,1669,1594,75,-1,-74,110
1,1578,1900,-322,-1,-42,59
1,1776,1868,-92,1,-1,47
-1,1656,1608,48,-1,-161,74
1,1513,1649,-136,5,239,68
-1,1376,1466,-90,0,-17,46
1,1791,1621,170,2,358,89
1,1643,1511,132,3,456,87
1,2155,2190,-35,0,55,113
1,1798,1614,184,8,411,63
1,1650,1614,36,-6,-378,85
1,1355,1395,-40,3,86,69
-1,1526,1645,-119,-5,-90,62
-1,1473,1491,-18,-5,-384,68
-1,1331,1738,-407,-3,-105,50
1,1560,1604,-44,12,188,43
-1,1660,1591,69,0,-82,60
1,1174,1181,-7,0,-219,83
-1,1749,1718,31,0,77,112
0,1413,1415,-2,-6,-455,164
1,1647,1605,42,-9,-720,99
1,1986,1604,382,1,501,111
1,1745,1573,172,-1,309,169
-1,1704,1656,48,1,-91,102
-1,1614,1643,-29,-2,-311,106
-1,1649,1691,-42,-1,-88,72
0,2045,1983,62,0,56,100
1,1521,1329,192,1,62,63
-1,1366,1557,-191,-1,-72,52
1,1657,1595,62,0,-56,87
1,1839,1567,272,-5,-57,47
-1,1986,2043,-57,-1,-77,64
1,1666,1586,80,0,38,93
-1,1563,1843,-280,-2,-21,50
1,2053,1974,79,1,115,85
-1,1380,1552,-172,3,90,62
1,1652,1688,-36,2,34,53
1,1675,1577,98,0,247,91
1,1964,2062,-98,-2,-34,59
0,1847,1559,288,1,-432,125
1,1683,1569,114,12,307,91
1,1683,1569,114,1,327,77
1,1461,1500,-39,-1,46,65
-1,1643,1705,-62,-2,-75,62
-1,1521,1633,-112,-6,-29,44
1,1690,1561,129,-1,-501,93
-1,1818,1981,-163,3,294,76
1,1432,1554,-122,6,458,89
1,1657,1536,121,0,-40,53
-1,1981,1818,163,0,-875,122
1,1697,1539,158,7,529,75
-1,1654,1686,-32,-1,-38,58
-1,1697,1836,-139,-1,-76,79
1,1415,1413,2,8,225,59
1,1464,1562,-98,3,273,80
-1,1843,1722,121,0,-279,118
1,1675,1665,10,1,58,83
-1,1665,1724,-59,-2,149,136
1,1839,1988,-149,0,201,127
1,1696,1644,52,0,55,107
-1,1500,1714,-214,-5,-78,46
-1,1970,1856,114,6,684,120
-1,1421,1660,-239,-7,-101,50
1,1558,1704,-146,0,261,81
0,1655,1533,122,-1,-503,156
-1,1871,1736,135,-1,-61,82
1,1345,1441,-96,-6,295,95
1,1718,1405,313,1,40,61
1,1729,1879,-150,0,28,69
-1,1623,1656,-33,1,-2,43
1,1537,1651,-114,-6,-117,59
1,2121,1988,133,0,-71,87
1,1602,1706,-104,-1,122,68
1,1161,1203,-42,6,172,55
1,1789,1232,557,-1,57,81
1,1688,1566,122,0,11,83
1,2157,1789,368,-2,-96,73
-1,1237,1340,-103,-7,-593,98
1,1663,1500,163,-1,-30,47
-1,1457,1559,-102,-2,-840,112
1,1660,1355,305,1,358,111
1,1348,1236,112,-9,-175,49
1,1551,1602,-51,0,156,91
-1,1365,1195,170,3,180,64
-1,1444,1662,-218,-1,-54,62
-1,1829,1787,42,1,22,40
1,1683,1763,-80,-1,-72,59
-1,1799,1816,-17,1,62,68
-1,1494,1802,-308,-1,-18,40
-1,1980,2193,-213,-1,-35,48
-1,1577,1549,28,0,-68,68
-1,1827,1789,38,-3,-194,64
1,1775,1500,275,1,276,81
-1,1749,1759,-10,1,-13,57
-1,1759,1749,10,-10,-103,42
1,1801,1815,-14,1,13,95
1,1752,1535,217,0,563,97
1,1761,1771,-10,0,79,113
1,1806,1718,88,1,38,51
1,1803,1812,-9,2,-30,65
0,1683,1692,-9,0,133,166
1,1399,1426,-27,9,460,75
-1,1675,1746,-71,0,-213,162
-1,1500,1527,-27,5,-251,170
-1,1759,1773,-14,1,71,46
-1,1572,1435,137,-1,130,68
0,1801,1814,-13,-1,4,74
1,1549,1206,343,1,488,91
-1,1454,1520,-66,0,10,80
-1,1784,1747,37,-5,-109,48
1,1632,1544,88,-3,-29,47
-1,1414,1821,-407,-6,-175,64
1,1814,1801,13,-1,255,125
-1,1544,1588,-44,-11,-193,48
-1,1760,1771,-11,-4,-162,70
1,1757,1708,49,0,117,131
1,1443,1605,-162,9,353,61
-1,1368,1201,167,0,28,54
-1,1820,1709,111,0,21,40
1,1368,1196,172,4,126,47
-1,1791,1824,-33,-2,-33,54
1,1782,1749,33,0,-71,109
-1,1589,1463,126,0,68,72
-1,1462,1620,-158,-2,-450,104
1,1574,1481,93,3,73,61
1,1540,1652,-112,-1,-23,62
1,1531,1577,-46,-1,231,77
-1,1834,1781,53,0,-81,88
-1,1230,1352,-122,0,6,52
-1,1838,1940,-102,-3,-100,70
-1,1361,1233,128,4,-27,50
-1,1736,1824,-88,0,-122,104
-1,1420,1825,-405,1,48,50
-1,1739,1658,81,2,53,44
-1,1560,1558,2,-3,-163,64
-1,1500,1494,6,-6,-174,66
0,1833,1418,415,-6,41,104
-1,1436,1581,-145,-7,22,52
0,1389,1346,43,-1,-244,164
1,1833,1726,107,1,93,79
-1,1426,1799,-373,-4,-114,50
-1,1777,1645,132,1,29,40
-1,1427,1381,46,0,-457,112
1,1774,1430,344,0,95,91
1,1807,1424,383,1,19,47
-1,1224,1591,-367,-5,-791,138
1,1675,1451,224,0,321,189
-1,1571,1548,23,2,-20,86
-1,1830,1960,-130,-1,-156,102
-1,1661,1762,-101,-1,-42,46
-1,1407,1675,-268,4,286,124
-1,1504,1800,-296,-5,-182,68
-1,1397,1613,-216,-5,-368,156
0,1576,1525,51,-4,-173,121
1,1524,1375,149,2,286,89
-1,1392,1540,-148,3,-2,56
-1,1689,1971,-282,-3,-285,104
1,1620,1446,174,3,248,70
-1,1570,1535,35,1,187,134
1,1394,1339,55,1,406,95
1,1709,1504,205,6,251,53
1,1480,1464,16,3,580,77
-1,1558,1680,-122,-1,-91,78
1,1534,1566,-32,-8,58,63
-1,1554,1557,-3,-1,-34,66
0,1987,1823,164,-2,-39,135
-1,1572,1628,-56,-7,-321,66
-1,1373,1573,-200,-1,6,50
1,1367,1239,128,2,461,85
1,1976,1685,291,2,92,59
1,1705,1435,270,4,241,65
-1,1319,1367,-48,1,-13,64
-1,1623,1714,-91,0,-14,86
1,1642,1893,-251,-3,-38,51
1,1500,1596,-96,0,121,137
-1,1415,1548,-133,0,-154,60
1,1688,1550,138,1,72,103
-1,1431,1731,-300,0,-265,74
-1,1894,1932,-38,0,-41,87
-1,1553,1660,-107,-15,-341,50
1,1325,1403,-78,2,23,45
1,1112,1296,-184,3,838,107
1,1524,1338,186,0,26,45
-1,1751,1427,324,-6,-150,62
1,1354,1724,-370,2,220,103
1,1382,1005,377,16,975,73
1,1977,1962,15,0,-71,111
-1,1542,1695,-153,-3,37,110
0,1493,1531,-38,0,25,128
1,1981,1828,153,-2,234,67
1,1545,1476,69,0,214,93
-1,2024,1953,71,0,-255,174
1,1615,1723,-108,2,254,97
-1,1712,1582,130,0,-2,60
-1,1985,1867,118,0,-11,82
1,1709,1465,244,1,75,101
0,1429,1457,-28,2,267,111
-1,1951,2005,-54,0,-30,66
1,1968,1856,112,1,56,69
-1,1391,1324,67,-2,-7,48
1,1847,1554,293,1,124,73
1,1742,1346,396,0,-123,61
-1,1132,1348,-216,-14,-549,60
-1,1888,1681,207,1,-433,146
1,1535,1332,203,2,224,87
-1,1631,1701,-70,-1,-19,46
1,1669,1653,16,0,73,111
-1,1500,1371,129,-11,-521,74
1,1387,1500,-113,2,324,107
0,2028,1942,86,0,-195,117
-1,1468,1885,-417,3,16,90
1,1500,1278,222,13,499,59
-1,1547,1529,18,0,-208,76
1,1622,1698,-76,1,16,97
1,1530,1444,86,3,62,57
1,1316,1167,149,0,414,85
-1,1615,1466,149,-5,-121,58
1,1656,1344,312,9,194,53
1,1821,1760,61,0,-7,63
1,1466,1631,-165,1,291,105
1,1215,1072,143,4,239,73
-1,1273,1545,-272,-4,-51,48
-1,1944,2022,-78,-2,-25,42
-1,1343,1745,-402,-3,-8,40
-1,1642,1552,90,7,106,48
1,1632,1694,-62,1,357,191
1,1895,1476,419,0,453,135
1,1500,1460,40,6,157,45
1,1699,1871,-172,2,-54,89
-1,1396,1624,-228,1,123,72
0,1539,1612,-73,-1,-37,87
1,1581,1376,205,2,83,73
1,1193,1045,148,-1,-30,49
1,1546,1672,-126,0,-73,79
-1,1430,1376,54,-1,-299,100
1,1576,1268,308,10,250,49
0,1451,1456,-5,-10,-549,134
-1,1636,1529,107,2,74,68
1,1353,1125,228,-3,495,105
-1,1500,1379,121,0,-2,42
0,1830,1658,172,-1,41,113
0,1081,1323,-242,-3,-625,122
-1,1541,1261,280,2,5,62
1,1724,1577,147,-2,98,75
1,1575,1405,170,1,86,91
1,1659,1386,273,5,437,79
-1,1715,1854,-139,1,37,50
-1,1629,1931,-302,0,-14,70
1,1680,1541,139,1,165,119
-1,1374,1252,122,3,128,68
-1,1642,1735,-93,-1,-76,66
-1,1774,1731,43,0,-126,72
1,1544,1622,-78,2,179,67
0,1568,1732,-164,-3,-231,134
1,1365,1288,77,2,128,81
-1,1454,2004,-550,-12,-527,66
-1,1000,1620,-620,-18,-405,46
1,1417,1084,333,-2,273,83
1,1659,1248,411,8,445,73
0,1645,1680,-35,0,-477,197
1,1436,1384,52,-1,-100,73
1,1573,1549,24,1,25,47
1,1948,1500,448,-1,-50,47
1,1323,1360,-37,4,73,47
1,1861,1708,153,0,105,59
1,1561,1500,61,12,280,43
-1,1467,1486,-19,1,-13,58
1,1558,1220,338,1,40,59
-1,1616,1771,-155,-2,-55,54
1,1441,1689,-248,3,406,111
1,1728,1545,183,-6,123,136
0,1453,1339,114,1,-261,162
-1,1625,1718,-93,-6,-177,69
1,1732,1701,31,3,118,97
-1,1550,2008,-458,-5,-422,108
1,1704,1667,37,-1,199,81
1,1608,1557,51,1,103,83
1,1277,999,278,10,565,61
1,1622,1538,84,0,55,89
-1,1702,1868,-166,1,-713,112
1,1452,1663,-211,1,46,99
1,1500,1569,-69,-2,42,69
1,1452,1381,71,-4,-2,57
-1,1356,1106,250,-8,-631,86
1,1812,1570,242,0,335,95
1,1439,1335,104,0,95,67
1,1578,1341,237,2,138,67
1,1483,1280,203,-2,-85,63
1,1704,1550,154,2,51,45
-1,1514,1553,-39,-2,-56,52
-1,1406,1585,-179,0,-44,54
1,1500,1500,0,-2,-13,45
-1,1619,1683,-64,0,-4,56
0,1484,1525,-41,0,54,89
-1,1739,1600,139,-1,-194,114
1,1646,1679,-33,0,21,135
-1,1338,1622,-284,-1,-43,56
1,1589,1450,139,0,285,87
-1,991,2015,-1024,-16,-374,52
-1,1541,1314,227,-1,-422,106
0,1353,1480,-127,4,498,164
-1,1565,1504,61,-13,-125,56
0,1578,1765,-187,0,-119,185
-1,1307,1620,-313,-10,-149,44
-1,1548,1618,-70,-9,-43,46
1,1642,1604,38,4,261,67
-1,1595,1595,0,0,-28,73
1,1370,1602,-232,-2,-5,107
-1,1875,1695,180,1,-135,123
1,1628,1334,294,2,109,71
-1,1198,1646,-448,-15,-237,40
-1,1342,1450,-108,-7,-127,44
1,1518,1550,-32,-2,-24,65
-1,1641,1308,333,-4,-113,54
1,1652,1579,73,0,13,45
-1,1820,1927,-107,-1,-265,132
1,1670,1515,155,7,345,63
-1,1491,1594,-103,0,-158,82
-1,1405,1568,-163,-1,-119,74
-1,1330,1635,-305,-3,-164,67
1,1537,1530,7,-1,318,91
1,1661,1568,93,-1,-9,47
-1,1626,1539,87,2,89,42
1,1455,1274,181,0,158,67
-1,1437,1607,-170,2,40,56
-1,1454,1606,-152,0,150,84
1,1797,1696,101,6,337,60
1,1608,1691,-83,-2,-79,83
1,1655,1530,125,1,120,87
-1,1685,1723,-38,0,35,56
-1,1669,1602,67,2,86,48
1,1403,1514,-111,7,42,43
-1,1640,1327,313,0,-256,96
1,1662,1606,56,0,719,119
1,1615,1656,-41,1,116,107
-1,1658,1734,-76,-1,-123,148
-1,1256,2123,-867,-1,-25,52
-1,1388,1432,-44,-4,-272,80
-1,1500,1350,150,-4,-557,78
-1,2250,2278,-28,-10,-103,130
-1,1676,1584,92,-1,15,82
1,1746,1252,494,7,250,43
-1,1390,1369,21,-2,-417,106
1,1486,1543,-57,0,432,111
0,1935,2028,-93,-1,-158,129
-1,1500,1373,127,1,22,72
-1,1658,1482,176,-4,24,68
-1,1575,1460,115,-4,-183,59
-1,1347,1608,-261,6,103,116
1,1733,1052,681,28,454,43
-1,1989,1981,8,-1,-46,84
1,1781,1552,229,2,329,125
-1,1644,1584,60,-5,-174,52
-1,1243,1477,-234,-13,-562,140
1,1479,1591,-112,-3,-90,71
-1,1477,1560,-83,7,456,84
1,1553,1770,-217,-5,-96,51
-1,1598,1631,-33,-4,-244,68
1,1783,1334,449,5,604,91
-1,1508,1677,-169,-3,-62,52
1,2236,1555,681,0,150,111
1,1780,1618,162,2,137,70
-1,1587,1641,-54,-3,-39,44
-1,1734,1608,126,-4,-116,56
0,1630,1556,74,0,35,76
-1,1951,1812,139,1,30,62
1,1615,1343,272,3,266,69
1,1407,1465,-58,0,-9,49
-1,1569,1467,102,1,68,86
1,1675,1599,76,0,19,53
-1,1577,1650,-73,-10,-67,52
1,1802,1387,415,3,166,57
-1,1488,1163,325,-4,-249,80
-1,1674,1911,-237,0,13,48
-1,1523,1662,-139,1,56,92
1,1598,1116,482,4,34,41
1,1637,1591,46,3,329,67
0,1474,1519,-45,2,168,98
1,1787,1579,208,-1,-19,55
-1,1489,1534,-45,-1,2,72
1,1618,1378,240,1,484,87
-1,1581,1647,-66,-7,-235,96
1,1667,1149,518,5,114,45
1,1706,1568,138,3,189,54
1,1683,1351,332,0,-9,99
1,1823,1452,371,0,0,49
-1,1626,1684,-58,-1,-18,44
1,1518,1555,-37,-4,54,63
1,1244,990,254,9,609,81
-1,1572,1655,-83,-5,-38,46
1,1794,1502,292,2,306,87
-1,1373,1002,371,-10,-260,50
1,2041,1938,103,0,-52,115
-1,1147,1668,-521,-20,-172,40
1,1482,1317,165,2,151,113
0,1590,1523,67,2,36,63
1,2009,1721,288,-1,2,95
-1,1868,1577,291,0,-17,64
-1,1530,1542,-12,-1,-197,120
1,1684,1075,609,15,821,73
1,1431,1573,-142,3,219,83
-1,1649,1897,-248,-2,-42,46
-1,1758,1585,173,4,53,66
1,1500,1543,-43,5,183,73
1,1669,1146,523,1,119,67
-1,1353,1544,-191,-9,-198,48
-1,1403,1459,-56,2,-21,60
1,1637,1613,24,2,87,53
1,1662,1076,586,9,201,45
1,1686,1563,123,0,-146,85
0,1727,1683,44,0,25,127
-1,1493,1798,-305,-2,-641,100
1,1519,1553,-34,-1,-174,91
1,1471,1332,139,0,-22,49
-1,1347,1629,-282,-2,-35,46
1,1669,1516,153,0,76,91
-1,1718,1783,-65,1,47,94
1,2058,1828,230,1,124,89
-1,1645,1669,-24,-1,-92,74
0,1146,1211,-65,2,327,84
-1,1681,1476,205,0,3,56
-1,1898,1970,-72,-1,-94,62
1,1554,1522,32,-2,-23,43
1,2013,1541,472,2,127,67
1,1459,1343,116,2,121,57
-1,1556,1615,-59,-6,-124,46
-1,982,1248,-266,2,-62,60
-1,1500,1555,-55,1,-148,70
1,1525,1500,25,0,31,57
-1,1657,1984,-327,0,-12,48
-1,1691,1814,-123,0,-117,72
1,1809,1557,252,2,52,49
-1,1278,1590,-312,-10,-186,50
1,2048,1719,329,1,113,73
1,1512,1543,-31,2,40,59
-1,1517,1621,-104,0,29,42
-1,1551,1566,-15,-2,-3,78
1,1393,1500,-107,7,111,42
-1,1438,1652,-214,-4,-22,40
1,1610,1500,110,1,182,87
1,1716,1153,563,0,366,87
1,1613,1586,27,-1,-18,45
1,1978,1821,157,-1,-16,54
1,1632,1469,163,-1,-12,75
1,1624,1584,40,1,1,41
-1,1803,1949,-146,0,-35,56
1,1610,1553,57,0,360,125
1,1664,1594,70,-1,440,113
1,1636,1321,315,-4,-42,59
-1,1433,1313,120,0,-15,58
1,1753,1569,184,0,52,133
1,1863,1562,301,1,63,77
1,1795,1693,102,-1,59,123
-1,1422,1500,-78,0,-54,59
-1,1576,1644,-68,3,-56,58
1,1986,1840,146,2,42,53
1,1951,1798,153,5,131,61
1,1664,1206,458,1,173,81
1,1428,1956,-528,0,-1,67
1,1369,1080,289,10,947,93
-1,1791,1969,-178,-1,-433,70
1,1524,1593,-69,10,126,44
-1,998,1700,-702,-5,-163,62
1,1733,1221,512,-5,21,105
1,1826,1784,42,-2,-105,65
1,2052,1983,69,0,411,113
-1,1833,1993,-160,-2,-99,71
-1,1540,1639,-99,-1,-32,72
-1,1640,1413,227,0,45,62
1,1618,1348,270,-1,2,41
-1,1339,1411,-72,-2,-149,98
-1,1962,2061,-99,0,-42,68
1,1463,1638,-175,1,96,71
1,1474,1556,-82,-1,421,161
-1,1813,1903,-90,1,55,82
1,1440,1405,35,2,367,75
-1,1411,1492,-81,0,-90,108
-1,2070,1944,126,-1,116,76
-1,1405,1402,3,0,22,42
-1,1827,1776,51,3,69,66
-1,1976,2054,-78,0,19,104
-1,1393,1535,-142,0,-25,61
1,1622,1204,418,6,160,57
1,1500,1463,37,4,113,71
-1,1760,1431,329,-4,-94,54
-1,1789,1815,-26,-3,-125,90
-1,1409,1684,-275,-1,-334,146
1,2064,1526,538,0,124,67
-1,1628,1741,-113,0,-36,78
-1,1687,1741,-54,-1,-20,56
1,1599,1532,67,-3,373,129
-1,1734,1449,285,0,-98,70
-1,1625,1867,-242,0,17,53
1,1950,2008,-58,-9,65,93
-1,1684,1726,-42,2,172,130
-1,1670,1567,103,0,-55,58
-1,1399,1488,-89,0,-136,76
1,1524,2065,-541,-2,-130,57
1,1452,1376,76,-1,331,103
-1,1542,1586,-44,-9,-306,56
-1,1624,1736,-112,-1,-24,74
-1,1352,1414,-62,9,384,74
1,2041,1548,493,2,118,79
-1,1543,1686,-143,-3,-10,78
1,1750,1563,187,0,218,147
-1,1717,2235,-518,0,17,96
-1,1463,1622,-159,-1,-176,102
1,1714,1318,396,9,162,55
-1,1825,1779,46,-2,-11,106
1,1624,1721,-97,0,-21,101
-1,1581,1542,39,-9,-317,71
1,1522,1383,139,-4,-134,49
1,1537,1606,-69,-5,-93,91
-1,1716,1741,-25,-1,-347,112
-1,1315,1763,-448,0,-24,72
1,1500,1554,-54,-3,-75,59
-1,1377,1495,-118,-1,-14,50
1,1716,1565,151,2,20,41
-1,1823,1911,-88,0,0,70
1,1751,1493,258,3,77,41
-1,1430,1572,-142,1,14,66
-1,1451,1615,-164,-1,-64,70
1,1754,2042,-288,0,34,87
-1,1352,1724,-372,-3,-77,78
0,1693,1647,46,0,111,128
1,1704,1618,86,1,1,43
1,1441,1662,-221,-3,-118,75
-1,1778,2021,-243,-1,-43,78
1,1698,1624,74,2,73,59
1,1791,1813,-22,1,15,55
1,1871,1796,75,0,117,119
-1,2019,2261,-242,0,-234,90
-1,1529,1555,-26,-1,-531,96
1,1688,1322,366,6,197,57
1,1560,1757,-197,0,-36,73
1,1628,1435,193,11,746,81
1,1369,1538,-169,4,575,91
-1,1614,1707,-93,0,-180,76
1,1755,1500,255,3,203,79
1,2026,1772,254,1,47,55
1,2003,1707,296,4,1285,125
-1,1554,1757,-203,0,98,136
1,1466,1130,336,3,312,61
1,1582,1579,3,4,95,71
0,1739,1767,-28,-1,-607,138
1,1320,1263,57,1,24,45
-1,1531,1595,-64,-6,-28,40
1,1727,1802,-75,0,28,65
1,1671,1479,192,4,225,75
1,1694,1656,38,1,288,97
-1,1126,1469,-343,-1,-462,93
-1,1567,1476,91,-2,-381,90
1,1691,1449,242,-2,467,187
-1,1253,1346,-93,0,-7,46
0,1384,1457,-73,-5,-143,105
1,1787,1590,197,0,109,77
-1,1692,1579,113,1,37,48
-1,1706,1777,-71,0,-381,118
1,1568,1555,13,1,36,47
1,1703,2007,-304,-2,0,53
-1,1740,1593,147,-1,-80,80
1,1742,1493,249,1,162,109
-1,1244,1800,-556,-3,-287,68
1,1819,1706,113,-1,5,109
-1,1527,1604,-77,-1,-131,72
1,1622,1579,43,-1,-21,45
1,1602,1458,144,0,135,98
1,1488,1606,-118,-2,-80,63
1,1181,1485,-304,-2,91,95
1,1500,1571,-71,1,162,73
1,1273,1168,105,5,214,103
1,1759,1580,179,0,401,136
1,1639,1500,139,-2,-7,55
-1,1536,1528,8,-3,-76,60
-1,1542,1784,-242,-2,-176,100
-1,1668,1683,-15,0,-20,126
1,1649,1367,282,3,138,63
-1,1474,1676,-202,-2,-258,118
-1,1489,1747,-258,0,-28,86
1,1645,1437,208,3,31,99
-1,1646,1802,-156,-3,-94,80
-1,1243,1269,-26,1,10,48
-1,1616,1444,172,-1,-39,88
-1,1880,1863,17,0,6,100
1,1570,1632,-62,0,-38,73
0,1763,1547,216,-3,-15,87
1,1601,1526,75,1,-52,93
1,1386,1440,-54,2,-9,41
-1,1361,1500,-139,0,-3,70
-1,1744,1346,398,1,0,74
-1,1461,1600,-139,-2,-163,126
1,1519,1727,-208,-8,-199,53
-1,1693,1513,180,-5,-543,108
1,1408,1794,-386,-2,517,95
1,1677,1649,28,1,16,69
1,1577,1317,260,2,62,57
-1,1697,1814,-117,2,75,112
-1,1958,1909,49,1,2,56
0,1500,1500,0,3,995,119
-1,1634,1382,252,-8,-164,40
-1,1285,1512,-227,-3,-279,82
-1,1400,1595,-195,-1,-23,40
1,1607,1453,154,-2,73,87
-1,1421,1593,-172,0,-57,60
-1,1987,1827,160,-3,-89,80
-1,1655,1723,-68,0,-38,70
-1,1696,1629,67,-1,-134,94
-1,1279,1232,47,-3,-391,92
0,1633,1752,-119,-5,63,99
-1,1727,1869,-142,-2,-183,76
-1,1733,1645,88,-1,-169,78
1,1922,1945,-23,0,174,115
1,1764,1310,454,21,966,69
1,1517,1609,-92,-3,-5,45
-1,1500,1597,-97,-2,-545,112
-1,1485,1585,-100,-1,-112,162
-1,1472,1649,-177,-4,-138,70
1,1585,1843,-258,2,76,57
-1,1639,1585,54,0,-22,96
1,1500,1558,-58,1,27,131
1,1828,1688,140,0,47,59
1,1546,1707,-161,0,53,93
1,1595,1531,64,-5,294,135
-1,1534,1660,-126,1,-102,68
1,2237,1454,783,0,23,55
1,1394,1479,-85,-6,-29,52
1,1657,1688,-31,0,-7,55
1,1466,1382,84,-1,213,114
1,1765,1765,0,0,30,93
1,1667,1526,141,0,-25,91
1,1756,1163,593,2,83,57
-1,1656,2238,-582,-3,-7,50
-1,1500,1449,51,-14,-285,42
1,2035,1740,295,-1,-48,75
1,1619,1558,61,2,136,75
1,1319,1447,-128,-2,-247,89
1,1933,1933,0,0,-29,69
1,1888,1583,305,1,94,63
1,1609,1308,301,-1,37,61
1,1543,1617,-74,1,184,97
-1,1408,1512,-104,1,31,54
-1,1584,1714,-130,0,-318,106
-1,1518,1674,-156,-1,-85,90
1,1599,1512,87,0,-107,71
1,2240,1737,503,0,16,51
-1,1372,1432,-60,-1,-166,83
1,1477,1438,39,-5,73,99
1,2193,2039,154,0,25,77
1,1551,1522,29,-7,-135,65
-1,1691,1582,109,1,-154,87
1,1436,1459,-23,-1,379,177
-1,1658,1771,-113,1,12,46
-1,2242,1735,507,0,-89,128
1,1681,1511,170,1,66,85
1,1639,1604,35,4,201,61
0,1475,1493,-18,-1,-49,96
-1,1932,1977,-45,-2,-12,42
1,1737,1617,120,1,7,43
1,1677,1669,8,3,175,91
1,1757,1648,109,-1,0,90
1,1443,1445,-2,-6,-22,43
-1,1923,1944,-21,-9,-23,82
-1,1771,1702,69,-5,-843,100
1,1594,1650,-56,14,234,53
-1,1870,1944,-74,-3,-27,56
1,1598,1626,-28,0,-4,69
-1,1538,1421,117,-4,-9,58
-1,1302,1923,-621,-13,-381,54
1,1388,1335,53,7,154,50
-1,2203,2201,2,-1,-128,86
1,1556,1451,105,0,146,95
-1,1613,1601,12,0,-365,150
1,1804,1643,161,4,267,81
-1,1561,1398,163,-12,-132,40
1,1637,1607,30,-2,-42,41
1,1496,1419,77,0,245,110
-1,1558,1607,-49,0,-123,90
-1,1757,2183,-426,0,-49,80
1,1895,1441,454,2,215,75
-1,1546,1647,-101,-4,-153,54
1,1640,1766,-126,0,34,69
-1,1633,2186,-553,0,-13,49
0,1558,1552,6,1,308,92
1,1596,1641,-45,2,38,77
1,1824,2011,-187,1,32,69
1,1398,1301,97,7,275,79
-1,1512,1829,-317,0,19,60
1,1549,1604,-55,4,398,63
-1,1682,1924,-242,0,-16,66
1,1500,1733,-233,1,52,105
-1,1475,1262,213,-2,-77,54
-1,1843,1992,-149,-2,-66,72
-1,1340,1529,-189,-4,-49,44
-1,1410,1481,-71,-9,-302,174
1,1637,1611,26,-4,-29,115
-1,1616,1500,116,-1,2,74
-1,1642,1650,-8,-1,-24,52
1,1542,1670,-128,15,808,67
1,2000,1835,165,0,36,95
-1,1538,1676,-138,-10,-94,42
-1,1639,1516,123,1,5,44
1,1449,1559,-110,1,186,88
1,1655,1811,-156,1,27,59
-1,1658,1500,158,-1,-25,48
1,1729,1681,48,0,-1,55
-1,1751,1415,336,-1,84,74
1,2007,1828,179,0,11,127
-1,1386,1582,-196,4,62,52
1,1500,1492,8,4,184,73
1,1488,1464,24,4,341,111
-1,1535,1334,201,6,141,54
1,1456,1468,-12,0,-5,59
-1,2004,1857,147,0,-256,138
-1,1555,1607,-52,-3,-277,70
1,1813,1524,289,-4,-308,97
-1,1668,1784,-116,-2,-218,100
1,1748,1655,93,-2,-69,67
1,1500,1496,4,0,101,69
1,1531,1623,-92,3,96,65
-1,1385,1649,-264,0,138,98
-1,1821,2014,-193,0,-22,64
-1,1733,1562,171,0,-370,90
1,1794,1671,123,0,-57,55
1,2014,1821,193,2,213,91
1,1900,1438,462,3,223,70
-1,1463,1544,-81,0,-45,52
-1,1508,1670,-162,-1,-143,111
-1,1663,1500,163,0,0,42
1,1288,1556,-268,3,385,163
-1,1590,1749,-159,1,-77,60
1,1596,1500,96,7,267,51
-1,1549,1594,-45,0,161,98
-1,1671,1616,55,-1,-16,42
1,1561,1380,181,0,128,191
-1,1392,1504,-112,-1,-164,65
1,1789,1425,364,0,3,73
-1,1166,1687,-521,3,20,54
1,2095,1956,139,0,-37,71
1,1760,1858,-98,1,227,95
-1,1529,1564,-35,1,-46,50
-1,1425,1368,57,0,40,60
1,1736,1579,157,0,5,45
1,1449,1601,-152,7,-2,43
1,1830,1164,666,4,455,81
-1,1632,1589,43,0,64,100
1,1844,1701,143,0,273,73
-1,1633,1650,-17,0,-51,60
0,1584,1500,84,0,47,133
-1,1524,1948,-424,1,-1,42
1,1765,1783,-18,2,31,47
1,1713,1446,267,1,15,45
1,1748,1533,215,-3,61,99
1,1527,1492,35,5,475,69
1,1950,1522,428,0,12,41
-1,1164,1217,-53,-7,17,40
0,1639,1694,-55,-4,-192,113
1,1743,1572,171,-1,11,41
-1,1390,1572,-182,-1,-235,94
-1,1640,1692,-52,0,-2,42
-1,1644,1544,100,3,192,140
-1,1953,1520,433,-2,-76,52
1,1772,1776,-4,-3,212,83
1,1502,1451,51,0,48,55
-1,1647,1636,11,0,-193,90
1,1792,1618,174,1,96,103
-1,1634,1884,-250,1,226,126
-1,1153,1513,-360,0,-170,76
1,1800,1724,76,2,282,135
1,1511,1536,-25,-4,-59,101
-1,1544,1927,-383,-1,-2,44
1,1702,1851,-149,0,8,81
-1,1519,1661,-142,-6,-423,80
1,1510,1471,39,3,111,49
-1,1831,1935,-104,1,-13,98
1,1750,1566,184,0,-7,47
1,1930,1542,388,2,83,61
0,1582,1488,94,-1,-306,96
1,1605,1835,-230,0,-3,43
1,1502,1749,-247,-2,821,137
1,1817,1625,192,-3,0,51
-1,1539,1933,-394,0,2,60
1,1747,1741,6,1,16,49
1,1823,1523,300,3,75,49
-1,1752,1544,208,0,-25,42
1,1578,1384,194,1,53,63
1,1668,1512,156,0,97,121
-1,1469,1417,52,-3,-235,128
-1,1261,1030,231,8,113,50
0,1174,1493,-319,2,53,100
1,1392,1524,-132,-1,769,119
-1,1519,1827,-308,1,35,50
1,1612,1799,-187,0,17,97
1,1635,1500,135,1,13,47
-1,1495,1692,-197,0,341,151
-1,1668,1633,35,0,-71,80
1,1508,1610,-102,2,99,77
1,1734,1711,23,1,51,81
-1,1163,1480,-317,-3,-727,124
-1,1762,1263,499,-1,-24,46
1,1564,1461,103,-1,175,95
-1,1213,1384,-171,-3,-43,60
1,1681,1500,181,4,302,83
1,1415,1889,-474,0,404,117
1,1782,1630,152,0,31,93
-1,1695,1673,22,-1,-2,40
-1,1630,1541,89,-1,-69,66
1,1570,1481,89,0,319,115
-1,1568,1830,-262,-1,-460,106
-1,1430,1730,-300,-1,-46,62
1,1515,1500,15,-2,151,123
-1,1568,1746,-178,3,69,70
1,1494,1687,-193,10,423,58
-1,1287,1739,-452,-8,135,68
1,1834,1563,271,0,-23,65
-1,1465,1365,100,1,9,46
1,1538,1370,168,0,-35,73
1,1522,1795,-273,2,19,47
-1,1477,1422,55,0,-80,60
-1,1551,1752,-201,-1,44,76
-1,1183,1484,-301,-1,-49,94
-1,1558,1839,-281,1,-144,94
-1,1746,1602,144,-4,-370,124
1,1649,1716,-67,5,225,65
1,1755,1427,328,-6,-212,67
1,1718,1321,397,0,6,71
1,1693,1619,74,2,21,67
1,1758,1545,213,-2,10,103
-1,1294,1741,-447,-3,-120,57
-1,1733,1843,-110,0,3,54
-1,1390,1780,-390,-3,-160,80
1,1734,1426,308,7,241,57
-1,1372,1356,16,4,252,72
1,1380,1654,-274,-1,-79,79
1,1763,1540,223,5,105,55
-1,1851,1724,127,0,-68,80
-1,1200,1307,-107,-8,-518,80
-1,1511,1529,-18,-2,-3,42
0,1641,1375,266,0,59,65
-1,1535,1768,-233,1,-1,80
1,1590,1448,142,-5,-17,45
0,1741,1789,-48,0,-6,109
-1,1740,1835,-95,0,8,44
1,1813,1602,211,0,382,105
-1,1327,1379,-52,-5,51,42
1,1844,1732,112,0,-47,87
-1,1722,1860,-138,-1,-137,100
1,1773,1530,243,1,0,65
0,1441,1624,-183,-4,1143,298
-1,1622,1729,-107,1,-6,64
-1,1179,1488,-309,-8,-58,44
1,1782,1436,346,0,39,129
-1,1576,1579,-3,0,97,108
1,1244,1388,-144,0,279,85
1,1423,1737,-314,-1,202,135
-1,1501,1575,-74,5,46,46
-1,1677,1696,-19,-1,4,47
-1,1645,1550,95,2,-241,110
1,1330,1191,139,-1,64,75
-1,1638,1683,-45,1,21,98
1,1047,1292,-245,0,-8,41
-1,1516,1783,-267,-6,-208,50
1,1381,1361,20,6,310,65
1,1175,1033,142,8,211,53
-1,1699,1715,-16,-1,-192,104
1,1543,1204,339,-3,-93,61
-1,1744,1949,-205,0,-62,106
1,1864,1707,157,0,127,83
1,1787,1510,277,0,5,51
-1,1406,1620,-214,-5,-172,62
1,2034,1612,422,-1,7,57
1,1663,1539,124,1,16,45
1,1611,1766,-155,5,274,69
1,1787,1743,44,0,-32,101
1,1791,1505,286,11,252,77
1,1852,1580,272,-10,-59,49
-1,1022,1183,-161,-5,-189,92
-1,1414,1437,-23,-3,-61,50
-1,1809,1702,107,1,41,108
1,1576,1856,-280,-2,-16,49
-1,1979,1692,287,-2,-281,100
1,1260,1658,-398,2,150,63
-1,1499,1795,-296,-3,-252,56
1,1836,1594,242,2,138,77
1,1427,1322,105,1,381,97
1,1673,1563,110,1,189,105
-1,1610,1532,78,2,87,56
-1,1589,1841,-252,-10,-166,44
-1,1485,1448,37,0,-2,40
1,1799,1494,305,0,37,59
-1,1618,1448,170,0,-188,62
1,1846,1585,261,-1,52,71
-1,1512,1443,69,0,-44,56
-1,1623,1743,-120,0,-32,94
-1,1603,1477,126,0,5,60
-1,1581,1850,-269,-4,-152,52
1,1872,1500,372,-5,-33,71
-1,1614,1715,-101,1,42,116
0,1856,2040,-184,1,31,162
1,1787,1660,127,-1,-67,73
-1,1582,1485,97,0,-133,84
1,1854,1577,277,1,546,89
-1,1558,1810,-252,1,43,58
-1,1768,1960,-192,-4,-226,76
1,1625,1602,23,3,133,67
1,1191,1013,178,3,21,41
0,1614,1673,-59,-4,-88,50
1,1444,1225,219,1,19,41
-1,1573,1858,-285,-6,-128,54
-1,1816,1931,-115,0,-68,116
1,1359,1331,28,-2,-117,63
-1,1628,1403,225,0,-138,90
-1,1589,1875,-286,-1,47,74
1,1862,1569,293,5,89,53
1,1277,1198,79,10,306,51
-1,1513,1598,-85,0,-21,92
1,1707,1184,523,3,775,109
-1,1732,1545,187,0,20,70
-1,1565,1866,-301,0,-80,76
1,1382,1633,-251,6,648,109
1,1751,1004,747,9,428,57
-1,1492,1497,-5,3,50,48
1,1217,1471,-254,-4,-123,49
1,1517,1806,-289,4,8,41
1,1363,1218,145,2,288,81
1,1651,1488,163,6,206,55
1,1272,1388,-116,-2,-64,43
1,1870,1562,308,3,744,97
1,1565,1367,198,-1,195,168
1,1875,1386,489,-1,101,79
1,1626,1484,142,-2,-110,81
-1,1781,1614,167,-7,-300,78
-1,1844,1707,137,1,14,42
-1,1564,1624,-60,-1,-233,112
1,1481,1511,-30,0,36,41
1,1791,1549,242,0,362,71
-1,1188,1286,-98,-11,-384,64
-1,1183,1708,-525,0,-26,72
1,1521,1561,-40,0,17,53
-1,1647,1687,-40,0,-26,54
1,1476,1538,-62,3,247,91
1,1554,1544,10,0,8,51
-1,1729,1861,-132,-1,-112,102
1,1369,1460,-91,8,72,59
-1,1493,1606,-113,10,334,78
-1,1717,1652,65,-1,-413,114
1,1615,1448,167,0,103,67
-1,1354,1500,-146,-1,-39,68
-1,1622,1647,-25,-4,-108,56
-1,1385,2025,-640,-7,-146,58
1,1877,1500,377,2,105,69
1,1586,1751,-165,3,82,51
-1,1295,1562,-267,-1,-92,64
1,1863,1690,173,5,218,89
1,1715,1523,192,-1,133,63
-1,1503,1723,-220,0,6,108
-1,1423,1435,-12,1,72,96
-1,1178,1342,-164,-3,-367,76
-1,1485,1534,-49,0,13,68
1,1572,1312,260,2,34,49
1,1526,1390,136,0,119,73
1,1446,1383,63,2,163,85
-1,1804,2027,-223,-1,-52,106
-1,1498,1421,77,-8,-201,56
-1,1533,1567,-34,0,-75,86
-1,1578,1681,-103,-3,-176,70
1,1722,1721,1,0,-4,63
1,1744,1516,228,4,220,73
1,1734,1570,164,2,91,81
-1,1288,1370,-82,-2,-242,68
1,1881,1543,338,-1,177,132
-1,1869,1938,-69,-1,41,54
1,1626,1679,-53,-1,-7,43
1,1563,1770,-207,-9,-186,51
1,1476,1570,-94,-1,35,83
-1,1617,1616,1,0,-33,128
-1,1171,1381,-210,2,101,66
1,1684,1580,104,1,35,73
-1,1436,1520,-84,-3,7,76
1,1480,1558,-78,2,143,95
1,1473,1362,111,2,161,47
-1,1455,1362,93,0,-84,108
-1,1665,1703,-38,1,-19,148
-1,1466,1369,97,0,8,81
-1,1572,1719,-147,-2,-215,124
-1,1544,1874,-330,-6,-753,92
-1,1495,1833,-338,0,-30,50
1,1872,1538,334,3,-1,41
-1,1639,1666,-27,-1,57,97
0,1524,1562,-38,0,1,107
0,1551,1553,-2,-1,-133,100
-1,1456,1400,56,-4,-821,150
-1,1492,1500,-8,4,32,112
-1,1234,1747,-513,-4,-465,84
-1,1492,1541,-49,-4,-299,96
1,1709,1165,544,-3,-4,58
-1,1552,1711,-159,-6,-457,128
-1,1478,1564,-86,1,-58,70
-1,1489,1347,142,-3,-66,76
-1,1462,1887,-425,-3,-255,84
1,1752,1226,526,2,254,67
-1,1481,1551,-70,-1,-62,52
0,1377,1142,235,0,104,115
-1,1320,1452,-132,-1,-73,74
1,1396,1507,-111,6,405,73
1,1614,1445,169,-1,-49,43
-1,1440,1573,-133,0,-180,76
1,1739,1616,123,6,893,115
1,1551,1416,135,0,199,75
-1,1552,1427,125,0,-273,130
1,1796,1702,94,1,105,61
-1,1561,1525,36,-2,-200,70
1,1486,1196,290,-1,-4,60
1,1733,1685,48,-1,56,103
1,1996,1566,430,1,219,96
-1,1582,1726,-144,-8,-139,52
1,1474,1427,47,-3,92,61
1,1634,1366,268,4,237,61
1,1889,1460,429,1,148,63
-1,1384,1247,137,0,-80,76
-1,1491,1453,38,-2,-240,84
1,1270,1387,-117,1,481,139
-1,1652,1426,226,-1,-67,60
1,1695,1804,-109,-2,-156,63
1,1656,1555,101,1,231,65
1,1629,1694,-65,1,71,93
1,1490,1628,-138,1,73,55
1,1484,1249,235,0,0,45
1,1791,1584,207,2,411,89
1,1567,1477,90,0,656,113
1,1961,1753,208,0,-8,41
-1,1522,1757,-235,-3,-257,96
-1,1206,1368,-162,3,-94,90
1,1456,1454,2,5,101,69
-1,1308,1384,-76,8,492,82
-1,1325,1891,-566,-2,-41,53
-1,1374,1477,-103,2,-34,98
1,1525,1588,-63,0,369,159
-1,1513,1523,-10,-1,-56,71
-1,1603,1642,-39,-1,-133,80
-1,1305,1384,-79,-3,-187,54
-1,1414,1310,104,-2,-65,71
1,1512,1564,-52,2,149,71
-1,1540,1476,64,-6,-303,62
-1,1485,1567,-82,-1,-479,162
-1,1671,1735,-64,-1,-36,82
1,1562,1350,212,0,20,47
-1,1709,1696,13,-3,-928,128
-1,2094,1930,164,2,82,66
1,1626,1546,80,1,131,65
1,1536,1490,46,1,39,49
-1,1477,1488,-11,-2,445,120
-1,1507,1590,-83,0,-67,80
1,1980,1890,90,0,9,51
1,1200,1245,-45,4,451,85
1,1348,1408,-60,4,122,47
1,1603,1605,-2,0,48,71
-1,1770,1693,77,-1,-171,127
1,1468,1368,100,-5,153,175
-1,1987,1654,333,0,-133,114
-1,1472,1458,14,4,60,42
-1,1074,1684,-610,-8,-529,72
1,1700,1551,149,0,70,123
-1,1657,1633,24,-1,-169,78
0,1778,1858,-80,0,-113,82
-1,1176,1361,-185,-9,-343,64
1,1674,1416,258,-1,-70,92
0,1677,1495,182,0,7,128
-1,1882,1988,-106,0,-3,54
1,1702,1334,368,-4,-98,67
1,1478,1465,13,-3,-146,91
1,1576,1476,100,3,126,53
1,1696,1712,-16,0,301,161
-1,1538,1637,-99,-2,-89,70
1,1367,1142,225,-2,83,75
-1,1955,2163,-208,-2,-531,164
1,1781,1600,181,1,103,141
1,1855,1781,74,3,66,49
1,1546,1593,-47,1,300,111
-1,1617,1888,-271,-1,-66,100
1,2170,1949,221,0,-130,101
1,1483,1323,160,2,63,46
-1,1324,1500,-176,-16,-216,40
1,1996,1874,122,3,99,65
-1,1300,1466,-166,-2,4,42
-1,1523,1482,41,0,-14,56
0,1740,1482,258,1,-167,150
-1,1631,1678,-47,-5,-355,152
-1,1500,1490,10,0,-276,76
-1,1944,2175,-231,0,-313,150
1,1651,1634,17,-4,248,109
1,1580,1535,45,1,16,53
1,1684,1726,-42,0,71,101
-1,1770,1864,-94,0,-83,102
-1,1229,1644,-415,-1,-13,52
-1,1705,1965,-260,0,-1,84
1,1498,1319,179,-3,-108,53
0,1567,1753,-186,0,14,65
-1,1309,1506,-197,-1,-84,70
-1,2181,1939,242,0,-66,78
-1,1609,1659,-50,-1,-81,124
1,1646,1530,116,1,75,71
1,1585,1378,207,1,30,45
-1,1499,1555,-56,-1,-100,90
-1,1748,1573,175,-1,-52,68
1,1678,1621,57,-2,-37,49
1,1646,1148,498,-1,-21,51
1,1605,1318,287,-1,131,77
1,1708,1696,12,0,-64,75
1,1699,1267,432,-1,61,63
-1,1590,1731,-141,-1,-43,64
-1,1492,1500,-8,0,-467,150
-1,1341,1522,-181,1,-18,112
1,1510,1612,-102,2,66,59
1,1694,1551,143,-1,64,47
-1,1431,1320,111,-5,-1,42
-1,1500,1521,-21,-1,-52,64
-1,1228,1591,-363,-2,-18,46
-1,1303,1591,-288,-3,-183,74
1,1757,1682,75,-2,78,117
1,1613,1668,-55,0,89,62
1,1575,1581,-6,1,154,71
-1,1335,1603,-268,0,-169,70
-1,1598,1541,57,0,-80,123
-1,1980,1761,219,1,47,114
-1,1803,1655,148,-3,-48,62
1,1641,1547,94,8,419,73
1,1535,1701,-166,-1,14,57
1,1558,1492,66,-3,-2,67
1,1842,1607,235,0,0,77
1,1659,1573,86,9,40,43
1,1867,1538,329,-4,-33,43
-1,1681,1608,73,1,42,108
1,1520,1623,-103,3,13,69
1,1488,1131,357,5,109,55
-1,1242,1646,-404,-2,-18,53
0,1568,1585,-17,1,172,132
1,1674,1556,118,0,12,51
-1,1741,1552,189,-7,-83,42
1,1595,1203,392,0,148,85
1,1685,1571,114,2,145,62
-1,1299,1503,-204,-1,-240,92
1,1768,1706,62,1,66,60
-1,1548,1564,-16,1,-33,90
-1,1682,1645,37,-3,-318,100
0,1655,1613,42,1,-165,95
1,1603,1614,-11,-2,40,53
-1,1223,1483,-260,-11,-398,70
1,1623,1662,-39,-1,168,75
-1,1650,1539,111,-1,-56,126
-1,1286,1717,-431,-1,-183,82
1,1608,1552,56,0,10,49
1,1394,1273,121,0,20,53
1,1658,1670,-12,0,1,57
1,1839,1649,190,0,280,115
1,1720,1664,56,-4,-240,107
-1,1626,1919,-293,-1,-61,75
-1,1555,1693,-138,0,-348,110
1,1389,1482,-93,0,19,81
1,1542,1591,-49,1,47,53
1,1961,1781,180,1,112,105
-1,1540,1554,-14,-1,-51,64
1,1567,1566,1,0,-15,43
1,1779,1663,116,-1,-25,47
1,1479,1350,129,3,391,91
-1,1183,1598,-415,-1,-116,112
1,1377,1170,207,0,386,127
-1,1946,2023,-77,-1,-26,62
1,1501,1554,-53,-9,-139,55
1,1567,1311,256,8,124,43
1,2026,1783,243,0,33,61
-1,1343,1638,-295,-2,-78,46
1,1650,1635,15,-4,-127,63
1,1362,1274,88,3,79,48
-1,1487,1529,-42,0,-300,122
-1,1541,1515,26,0,-305,118
-1,1036,1293,-257,-7,-944,84
-1,1687,1773,-86,-1,10,82
-1,1617,1530,87,-3,77,86
1,2077,1935,142,1,29,67
-1,1774,1653,121,-1,-29,56
-1,2031,1937,94,-3,-196,90
-1,1534,1663,-129,-10,-160,49
-1,1519,1571,-52,-3,-59,48
1,1850,1485,365,0,116,77
-1,1526,1635,-109,0,-36,82
-1,1958,2386,-428,0,15,80
1,1528,1529,-1,7,129,47
-1,1569,1643,-74,-5,-102,102
1,1604,1548,56,2,447,81
-1,1518,1539,-21,8,77,42
-1,1487,1503,-16,2,-39,64
1,1421,1308,113,25,592,47
-1,2403,1955,448,-4,-543,122
-1,1586,1642,-56,0,37,110
1,1579,1480,99,0,431,159
1,1600,1167,433,0,25,59
1,1632,1571,61,8,537,75
-1,1429,1755,-326,0,-607,126
-1,1518,1530,-12,0,-27,70
1,1659,1504,155,0,42,61
-1,1133,1079,54,-8,-222,60
-1,1867,1800,67,0,-16,52
-1,1310,1299,11,-10,-214,50
1,1670,1757,-87,2,140,75
0,2237,1974,263,0,-520,106
-1,1527,1609,-82,-7,-159,52
-1,1490,1432,58,0,-156,108
-1,1737,1829,-92,-3,-10,42
-1,1688,1922,-234,0,38,90
1,1364,1265,99,7,259,64
-1,1665,1500,165,-1,-112,70
-1,1497,1982,-485,-4,-657,90
-1,1572,1486,86,0,-6,42
-1,1297,1312,-15,-6,-116,68
1,1622,1865,-243,0,5,53
-1,1845,1650,195,4,70,46
-1,1519,1622,-103,-3,-60,50
-1,1823,1282,541,0,26,58
1,2225,1796,429,0,-7,65
1,1777,1656,121,5,395,63
-1,1453,1545,-92,-11,-282,50
1,1983,1496,487,8,235,91
-1,1622,1710,-88,-1,-5,40
1,1561,1526,35,-5,-170,109
-1,1649,1864,-215,-1,-42,52
1,1700,1540,160,-1,28,65
1,1463,1696,-233,-2,-67,45
1,1557,1304,253,4,507,101
1,1725,1732,-7,-1,-40,61
1,1507,1233,274,0,-3,59
1,2093,1985,108,0,-94,95
-1,1613,1525,88,3,204,68
1,1594,1210,384,3,261,87
-1,1309,1332,-23,-8,-552,92
-1,1742,1629,113,-1,-3,40
-1,1912,2228,-316,0,5,50
1,1759,1801,-42,2,79,95
-1,1756,1622,134,3,-8,94
-1,1256,1226,30,-1,-7,42
-1,1553,2030,-477,-2,6,48
1,1679,1203,476,5,73,43
1,1976,2102,-126,-1,25,71
-1,1503,1554,-51,-3,-390,70
-1,1794,1648,146,-4,-129,52
-1,1644,1726,-82,-1,-103,114
-1,1648,1562,86,-7,-117,54
-1,1285,1323,-38,3,115,96
1,2014,1846,168,-1,-70,61
1,1571,1483,88,0,-24,71
-1,1542,1494,48,0,-38,74
1,1297,1353,-56,-2,60,81
-1,1569,1516,53,-2,-384,98
-1,1951,1928,23,-2,-65,72
-1,1600,1885,-285,1,-118,100
1,2086,1992,94,1,12,71
0,1582,1303,279,-2,81,93
1,1332,1382,-50,1,342,83
1,1788,1771,17,-3,-86,98
1,1569,1970,-401,-3,247,141
-1,1983,2094,-111,-1,-386,105
1,1482,1460,22,0,-312,93
1,1853,1781,72,8,153,53
-1,1561,1576,-15,2,100,66
1,1580,1511,69,0,52,83
-1,1640,1940,-300,-2,-181,128
-1,1445,1449,-4,-3,-33,104
-1,2103,1975,128,-1,-4,82
1,1362,1543,-181,0,215,173
-1,1812,1719,93,2,-79,60
-1,1497,1539,-42,1,200,78
-1,1528,1557,-29,0,-47,66
-1,1548,1476,72,0,-79,76
1,1761,1799,-38,2,74,45
-1,1803,1728,75,-2,-72,58
1,1398,1383,15,21,715,59
1,1643,1497,146,1,488,109
1,1517,1477,40,3,162,65
-1,1862,1772,90,-3,-326,136
1,2087,1991,96,1,178,83
-1,1787,1773,14,-1,-74,96
-1,1583,1585,-2,-4,-541,144
-1,1288,1264,24,-2,-6,72
1,1597,1474,123,-3,255,98
1,1589,1502,87,1,669,177
-1,1337,1651,-314,0,-333,128
-1,1350,1575,-225,0,-102,102
-1,1380,1664,-284,-14,-340,54
1,1669,1575,94,-1,-22,47
1,1982,2095,-113,-1,137,103
-1,1702,1667,35,-13,-480,62
-1,1606,1786,-180,0,-411,158
-1,1477,1562,-85,-3,-115,96
-1,1490,1650,-160,-11,-149,42
-1,1054,1274,-220,-4,12,44
1,1594,1567,27,-6,545,117
1,1873,1681,192,0,6,79
-1,1671,1376,295,-2,-127,46
-1,1785,1775,10,-4,-665,106
1,1786,1848,-62,3,114,75
1,1947,1867,80,1,23,61
1,1750,1467,283,-2,-152,97
1,1642,1564,78,1,-30,41
-1,1682,1998,-316,-1,-41,62
-1,1528,1539,-11,-9,-411,80
-1,1372,1409,-37,-4,-51,60
-1,1302,1684,-382,-2,-110,64
1,1690,1658,32,0,-71,71
1,1656,1725,-69,-4,-68,57
1,1502,1470,32,-1,-17,53
1,2001,1678,323,2,71,57
-1,1396,1638,-242,2,-107,98
-1,1572,1469,103,-1,169,110
-1,1794,1520,274,1,-78,70
-1,1557,1604,-47,1,70,60
1,1608,1500,108,1,78,93
1,1786,1322,464,2,131,61
1,1786,1773,13,0,565,214
-1,1384,1504,-120,1,8,82
1,1644,1700,-56,0,-16,73
-1,1637,1948,-311,0,-33,115
-1,1260,1350,-90,-8,-241,64
-1,2008,1671,337,-11,-504,96
1,1513,1597,-84,3,375,97
-1,1522,1518,4,-2,-125,80
-1,1687,1657,30,-8,-212,54
1,1434,1435,-1,-7,-205,67
-1,1822,1613,209,-1,-77,116
-1,1858,1957,-99,-2,-11,80
-1,1646,1391,255,-5,-143,64
-1,1669,1675,-6,0,-29,46
-1,1463,1548,-85,-9,-154,44
0,1542,1595,-53,1,-112,114
-1,1555,1512,43,0,160,68
1,1501,1361,140,-3,-10,91
1,1468,1280,188,8,276,57
-1,1804,2020,-216,-3,-263,124
0,1608,1670,-62,0,-48,127
1,1686,1647,39,-3,-271,91
1,1494,1212,282,4,955,109
1,1500,1686,-186,3,405,73
-1,1556,1455,101,-6,-192,58
1,1790,1306,484,6,245,65
1,1396,1328,68,1,328,81
1,1579,1601,-22,-1,221,111
-1,1517,1265,252,-1,-47,56
-1,1813,1797,16,-3,-297,90
-1,1630,1805,-175,1,102,156
1,1534,1472,62,-3,-53,85
1,1624,1405,219,4,46,45
1,1735,1648,87,0,-9,85
1,1369,1419,-50,1,42,69
1,1405,1536,-131,0,96,59
1,1675,1668,7,-1,473,109
-1,1554,1650,-96,1,89,90
-1,1399,1632,-233,-7,-101,48
1,1620,1370,250,1,33,47
1,1966,1850,116,0,11,109
1,1469,1542,-73,0,35,111
-1,1668,1630,38,-2,-1,56
-1,1050,1235,-185,-18,-780,64
-1,1431,1759,-328,-9,-279,56
-1,1541,2234,-693,-4,-77,50
1,1523,1265,258,-1,-6,43
-1,1249,1518,-269,-1,-97,58
1,1535,1274,261,8,127,43
1,1658,1640,18,-1,-40,43
1,2235,1397,838,0,44,85
1,1498,1300,198,0,20,65
-1,1809,1811,-2,2,-298,90
-1,1802,1807,-5,-4,-126,58
1,1414,1315,99,-3,-42,51
1,1624,1668,-44,1,15,53
-1,1823,1500,323,-9,6,102
1,1503,1376,127,1,1,61
1,1768,1587,181,0,84,155
1,1660,1583,77,1,18,53
-1,1529,1482,47,-2,-250,90
-1,1410,1658,-248,-1,-110,62
1,1768,1743,25,-3,-33,81
-1,2080,1748,332,-3,-4,48
-1,1591,1467,124,2,199,62
-1,1466,1523,-57,0,-191,108
-1,1733,1734,-1,0,-60,96
1,1912,1712,200,2,91,77
1,1527,1529,-2,0,30,77
-1,1498,1657,-159,-10,-807,92
1,1362,1056,306,1,2,73
-1,1793,1839,-46,-2,7,54
1,1633,1757,-124,0,125,99
-1,1238,1319,-81,-4,-387,96
1,1472,1427,45,-3,221,73
-1,1240,1428,-188,-4,-67,54
0,1744,1733,11,0,-24,94
1,1823,1265,558,5,68,43
1,1763,1596,167,-4,-23,115
-1,1378,1856,-478,-7,-495,92
-1,1512,1662,-150,-3,-38,49
0,1808,1723,85,10,921,99
-1,1504,1628,-124,-1,-4,62
0,1571,1532,39,3,433,131
-1,1711,1824,-113,0,22,53
1,1620,1686,-66,-1,32,55
-1,1648,1521,127,-5,-153,58
-1,1763,1798,-35,1,-33,52
1,1952,2015,-63,0,0,53
1,1811,1822,-11,-2,22,87
1,1438,1417,21,0,140,67
-1,1843,1975,-132,0,-3,76
1,1979,1812,167,1,51,75
1,1847,1681,166,1,-6,43
1,1433,1566,-133,0,328,119
1,1744,1295,449,3,146,67
1,1400,1241,159,4,20,45
1,1793,1778,15,0,50,111
1,1491,1357,134,-1,-24,95
1,1482,1575,-93,2,170,61
1,1583,1327,256,15,750,71
1,1693,1403,290,3,211,85
1,1500,1496,4,-3,-74,131
-1,1813,1835,-22,-3,-283,108
-1,1680,1821,-141,-1,18,63
-1,1570,1642,-72,-4,-192,88
1,1697,1956,-259,1,2,43
-1,1400,1533,-133,-5,-214,70
-1,1452,1683,-231,-2,-87,64
1,1494,1384,110,1,54,75
1,1751,1726,25,-1,-11,59
-1,1963,1887,76,0,-47,86
1,1234,1040,194,7,328,57
-1,1708,1569,139,-1,-58,94
1,1481,1515,-34,-1,166,115
-1,1215,1588,-373,-1,-284,110
1,1987,2060,-73,-4,-230,79
1,1808,1669,139,-1,-33,51
-1,1264,1307,-43,-2,-157,94
1,1568,1356,212,3,492,99
1,1079,1332,-253,12,213,49
1,1775,1447,328,0,103,49
1,1983,1836,147,-1,28,63
-1,1768,1844,-76,-3,-129,84
1,2046,2005,41,-5,-169,123
-1,1746,1369,377,1,14,40
-1,1488,1446,42,-3,-450,92
1,1502,1258,244,0,177,67
1,1799,1752,47,1,44,51
1,1740,1226,514,4,73,47
-1,1313,1351,-38,-5,-253,88
-1,1992,2056,-64,-2,-72,55
0,1399,1696,-297,-2,-16,80
0,1779,1503,276,0,65,99
1,1648,1537,111,1,252,91
-1,1622,1738,-116,-3,-322,92
-1,2066,1980,86,-5,-255,116
-1,1625,1563,62,0,43,82
-1,1718,1694,24,-2,-66,56
1,1590,1541,49,0,56,75
1,1633,1540,93,2,111,55
-1,1493,1457,36,-2,-150,80
1,1560,1496,64,0,219,75
-1,1669,1578,91,0,-12,108
1,1950,1848,102,0,18,67
1,1209,1253,-44,1,22,62
-1,1790,1906,-116,-4,-85,78
-1,1338,1573,-235,-19,-937,66
1,1873,1764,109,-5,-26,119
0,1657,1716,-59,-3,-252,134
1,2052,1922,130,0,39,73
-1,1774,1676,98,0,65,180
1,1673,1671,2,0,81,75
-1,1657,1752,-95,-1,-81,104
-1,1590,1881,-291,-2,35,70
1,1510,1770,-260,-1,106,117
1,1716,1619,97,-1,-2,44
-1,1914,2059,-145,-6,-36,48
-1,1350,1546,-196,0,-143,114
-1,1609,1790,-181,1,20,40
1,1555,1498,57,7,611,93
1,1829,1739,90,-2,-34,59
1,1656,1603,53,-3,-70,49
1,1763,1383,380,16,244,47
-1,1434,1475,-41,1,4,42
1,1724,1569,155,2,66,53
-1,1366,1502,-136,-5,-166,84
-1,1577,1688,-111,0,-18,76
-1,1239,1239,0,2,-19,84
1,2123,2066,57,0,141,73
-1,1610,1599,11,-1,8,70
-1,1957,1895,62,0,-13,150
0,1662,1674,-12,-3,-337,133
-1,1768,1758,10,-3,-213,90
1,1606,1370,236,5,123,49
-1,1445,1600,-155,-5,-76,48
0,1987,1777,210,0,7,103
-1,1904,1483,421,-3,-93,96
0,1590,1535,55,-2,-86,59
1,1747,1528,219,0,9,67
0,1483,1494,-11,0,205,146
1,2134,1696,438,4,224,61
1,1445,1218,227,1,39,47
1,1529,1494,35,1,203,77
-1,1810,1918,-108,-3,-382,122
1,1694,2136,-442,-1,22,55
1,1472,1567,-95,9,307,55
-1,1856,1866,-10,0,-10,86
1,2112,1715,397,2,221,81
-1,1783,1981,-198,-2,-226,92
1,1766,1644,122,0,13,51
-1,1732,1476,256,-7,-309,66
-1,1945,1942,3,-1,-57,82
0,1488,1553,-65,2,559,112
-1,1523,1753,-230,-3,-468,112
-1,1707,1811,-104,0,13,56
1,1477,1251,226,2,123,59
1,1811,1855,-44,0,206,103
1,1936,2070,-134,-9,8,93
1,1283,1379,-96,2,21,43
1,1736,1673,63,-1,21,83
1,1442,1403,39,5,185,69
1,1467,1470,-3,5,130,55
1,1819,1700,119,3,132,73
1,1576,1331,245,1,291,91
1,1842,1823,19,-5,-9,51
1,1721,1780,-59,1,18,87
-1,1664,1745,-81,0,-109,104
-1,1813,1853,-40,1,-31,62
1,1466,1334,132,5,320,97
-1,1573,1767,-194,0,54,68
-1,1523,1559,-36,-4,-118,52
-1,1603,1816,-213,-5,-476,86
1,1524,1481,43,0,20,111
-1,1692,1827,-135,0,-313,158
-1,1341,1379,-38,-1,-74,80
1,1623,1522,101,2,86,53
-1,1664,1608,56,2,-29,68
-1,1409,1718,-309,-11,-240,47
1,1514,1457,57,-3,-47,45
-1,1394,1510,-116,-4,-282,92
1,1681,1599,82,-3,-123,59
1,1709,1788,-79,1,16,45
1,1585,1500,85,0,693,105
-1,1569,1513,56,-8,11,54
1,1772,1129,643,-4,-86,70
1,1654,1527,127,-2,-6,67
1,1834,1686,148,0,186,143
1,1736,1631,105,0,-7,43
1,1724,1596,128,0,2,43
1,1722,1405,317,0,7,45
1,1648,1563,85,1,81,81
-1,1482,1353,129,-2,-54,46
1,1611,1815,-204,0,51,87
1,1744,1472,272,1,56,53
-1,1655,1710,-55,-2,-931,108
-1,1592,1568,24,0,-48,78
-1,1921,2186,-265,0,-72,80
1,1617,1533,84,0,12,73
1,1398,1481,-83,9,316,59
1,1586,1169,417,10,484,61
-1,1623,1745,-122,0,-72,67
-1,1651,1802,-151,-1,-189,114
1,1462,1318,144,6,480,85
1,1916,1656,260,4,268,83
1,1526,1556,-30,-2,141,69
-1,1570,1492,78,1,5,96
-1,1454,1737,-283,1,24,44
1,2193,1846,347,1,102,109
-1,1608,1401,207,-16,-513,56
-1,1565,1431,134,0,-222,80
-1,1603,1769,-166,3,-68,64
-1,1922,1652,270,3,66,76
-1,1741,1450,291,-8,-165,54
-1,1628,1588,40,0,-17,46
-1,1369,1822,-453,-7,-493,66
1,1466,1388,78,3,182,79
-1,1389,1524,-135,0,6,42
1,1588,1656,-68,0,86,100
-1,1679,1754,-75,0,-70,74
-1,1843,2197,-354,-1,-63,66
-1,1544,1538,6,-1,-8,46
1,1468,1467,1,3,108,52
-1,1735,1457,278,1,38,66
0,1796,1652,144,-1,-139,95
1,1718,1789,-71,0,-104,161
1,1553,1473,80,4,873,125
1,1475,1563,-88,-2,337,97
1,1773,1731,42,-2,-21,61
-1,1312,1408,-96,6,96,52
1,1621,1803,-182,0,90,84
1,1671,1373,298,-2,8,45
-1,1749,1641,108,-1,-49,60
-1,1311,1476,-165,9,289,94
-1,1643,1602,41,2,-12,66
1,1326,1479,-153,0,55,61
1,1389,1395,-6,3,211,109
-1,1668,1615,53,-6,-74,42
1,1358,1362,-4,8,406,70
-1,1579,1373,206,2,-96,108
1,1824,1367,457,12,401,51
1,1265,1500,-235,-2,-136,69
1,1697,1497,200,-2,45,67
-1,1737,1303,434,-3,-68,54
1,1754,1579,175,-4,-73,57
1,1587,1740,-153,-1,305,125
-1,1794,1736,58,-10,-38,44
-1,1707,1491,216,0,-39,52
1,1725,1242,483,2,149,57
1,1512,1419,93,0,54,63
-1,1702,1491,211,1,-61,62
-1,1285,1668,-383,-7,-417,80
1,1348,1416,-68,-2,-126,117
-1,1524,1583,-59,-1,-149,76
1,1670,1759,-89,-3,5,67
-1,1713,1479,234,0,16,68
-1,1508,1381,127,0,-72,76
0,1435,1446,-11,1,688,120
1,1727,1862,-135,0,156,71
1,1531,1733,-202,5,327,77
1,1713,1644,69,-1,-40,103
1,1384,1071,313,1,-8,43
1,1521,1792,-271,-2,65,107
-1,1368,1625,-257,-1,-70,76
1,1709,1622,87,-8,-467,59
-1,1721,1693,28,3,-592,120
-1,1493,1847,-354,-3,-110,82
1,1586,1258,328,7,240,51
-1,1742,1637,105,0,-48,74
-1,1341,1464,-123,-1,-144,86
1,1504,1614,-110,0,-7,47
-1,1772,1892,-120,0,-13,72
1,1745,1690,55,0,137,77
-1,1776,1731,45,1,-17,49
-1,1595,1718,-123,-4,-71,52
1,1825,1500,325,5,47,43
1,1674,1655,19,0,45,119
1,1748,1892,-144,2,54,41
-1,1943,1853,90,0,-279,119
1,1374,1365,9,1,113,55
1,1638,1628,10,1,99,73
1,1469,1602,-133,4,159,59
1,1878,1687,191,0,-8,61
1,1725,1483,242,-3,-142,93
-1,1390,1249,141,2,-14,59
1,1867,1930,-63,2,3,41
-1,1912,2077,-165,-1,-163,124
1,1717,1548,169,1,78,65
-1,1587,1728,-141,-4,-94,54
1,1645,1500,145,-5,-123,43
1,2053,1824,229,2,84,85
1,1630,1363,267,0,0,57
-1,1917,1880,37,-1,-31,66
1,1810,1767,43,-3,-27,85
-1,1388,1395,-7,-1,-453,158
-1,1892,1905,-13,0,-85,98
-1,1477,1730,-253,-4,-55,48
1,1792,1467,325,4,138,55
1,1645,1684,-39,0,876,131
1,1822,1829,-7,0,5,41
-1,1646,1442,204,1,58,64
-1,1819,2058,-239,0,25,82
0,1600,1784,-184,-1,-188,112
1,1916,1882,34,0,-9,65
1,1592,1553,39,1,257,89
-1,1251,1381,-130,-3,-90,96
-1,1580,1735,-155,-12,-79,42
1,1765,1629,136,4,88,45
1,1872,1925,-53,2,68,46
-1,1896,1500,396,-2,-193,74
-1,1684,1435,249,-8,-343,62
1,2063,1814,249,0,249,106
1,1471,1652,-181,-2,-45,45
1,1551,1427,124,-10,-106,93
-1,1913,1884,29,0,-174,114
1,1672,1657,15,-1,-37,51
1,1622,1772,-150,8,877,105
-1,1763,1717,46,0,-368,138
-1,1542,1723,-181,-3,-54,88
1,1499,1371,128,7,244,58
1,2084,1906,178,0,30,67
1,1879,1724,155,0,-5,61
-1,1797,1396,401,-1,-645,146
-1,1310,1541,-231,-1,-12,90
1,1896,1902,-6,2,126,91
1,1817,1142,675,4,90,41
1,1647,1683,-36,2,109,83
1,1758,1591,167,0,10,93
1,1884,1578,306,2,286,67
-1,1809,2068,-259,-1,-44,66
1,1891,1907,-16,1,130,75
-1,1888,1972,-84,-1,-123,64
1,1854,1754,100,8,381,77
1,1435,1556,-121,4,80,49
1,1896,1902,-6,1,46,50
-1,1877,1981,-104,0,-2,62
1,1671,1659,12,3,93,71
1,2173,1715,458,1,52,111
1,1744,1823,-79,-3,-197,123
1,1866,1152,714,8,84,65
-1,1364,1506,-142,1,-251,76
1,1619,1457,162,11,270,53
-1,1184,1350,-166,-2,-278,84
-1,1757,1809,-52,-6,-441,132
1,1729,1536,193,1,61,63
-1,1503,1817,-314,0,-30,78
-1,2073,1886,187,0,-13,50
1,1867,1152,715,4,127,51
1,1438,1309,129,1,112,100
-1,1623,1963,-340,-2,-19,44
1,1334,1324,10,-7,-131,55
1,1647,1545,102,-2,-28,55
-1,1618,1677,-59,-1,-133,112
-1,1891,1907,-16,-5,-2,82
1,1584,1403,181,-5,-359,81
-1,1495,1400,95,-1,-141,82
-1,1619,2013,-394,0,-235,74
1,1867,1151,716,1,413,81
-1,1375,1464,-89,-14,-828,72
-1,1568,1500,68,-2,-290,90
-1,1900,1930,-30,-1,87,72
1,1643,1711,-68,0,25,65
-1,1868,1917,-49,0,382,100
-1,1531,1467,64,-1,-229,104
1,1559,1654,-95,-1,47,97
-1,1498,2045,-547,-4,-65,49
1,1819,1538,281,-9,28,55
1,2002,1547,455,-5,-402,107
1,1746,1862,-116,-8,-98,45
-1,1855,2045,-190,-5,-565,124
-1,1468,1583,-115,0,73,84
1,1609,1539,70,4,679,103
-1,1848,2107,-259,0,13,50
1,1651,1307,344,7,100,47
-1,1450,1549,-99,-2,-281,100
-1,1848,2107,-259,-3,-67,66
1,1681,1388,293,1,387,103
1,1618,1283,335,-4,13,123
1,1609,1758,-149,0,5,85
1,1823,1303,520,0,-40,59
-1,1648,1708,-60,1,-83,94
1,1530,1618,-88,0,647,119
-1,1579,1476,103,-3,-160,66
-1,1748,1734,14,-1,-358,94
-1,1500,1480,20,2,-275,94
1,1685,1500,185,0,93,177
1,1613,1358,255,-1,176,78
1,1655,1351,304,2,53,59
1,1760,1749,11,-1,81,97
-1,1620,1805,-185,-2,-60,46
-1,1783,1557,226,4,65,60
-1,1496,1458,38,-3,-118,58
1,1604,1544,60,-6,113,79
1,1650,1491,159,6,48,43
1,1811,1614,197,1,54,63
-1,1588,1734,-146,0,5,42
-1,1483,2145,-662,-3,-119,52
-1,1720,1709,11,-1,30,88
-1,1704,1697,7,-3,-325,78
-1,1690,1588,102,-2,-195,108
-1,1309,1500,-191,1,-773,156
-1,1306,1540,-234,-12,-82,40
-1,1355,1363,-8,0,19,120
1,1790,1484,306,-1,-9,49
1,1657,1403,254,1,41,69
-1,1590,1573,17,0,2,64
-1,1899,1940,-41,-2,-148,74
1,1573,1631,-58,4,280,92
1,1779,1722,57,-4,29,50
1,1693,1500,193,0,14,63
-1,1602,1676,-74,0,-193,72
1,1425,1474,-49,-1,-42,54
1,1365,1372,-7,6,51,43
-1,1283,1501,-218,-3,-16,40
-1,1482,1422,60,-3,-68,44
1,1745,1692,53,0,-15,81
-1,1684,1593,91,-5,-179,90
0,1663,1614,49,-1,-6,79
-1,1890,2091,-201,0,-126,66
1,1724,1500,224,0,-5,69
1,1811,1695,116,0,40,141
-1,1624,1742,-118,0,-7,108
-1,1387,1548,-161,-2,-520,110
1,1500,1559,-59,-1,-119,103
1,1911,1740,171,-2,-47,59
-1,2004,1624,380,1,-174,96
-1,1613,1808,-195,-5,-369,81
1,1508,1609,-101,-3,-33,51
-1,1487,1287,200,-3,-174,68
-1,1557,1626,-69,-1,-321,96
1,1579,1356,223,7,618,81
-1,1607,1671,-64,0,-674,150
-1,1506,1277,229,1,38,46
-1,1551,1454,97,-3,-479,102
1,1344,1337,7,-2,-23,61
1,2054,1881,173,0,0,103
1,1914,1885,29,-2,-16,59
1,1555,1740,-185,1,179,77
-1,1584,1579,5,-2,-89,80
-1,1698,2202,-504,0,-16,76
-1,1586,1608,-22,0,-133,98
-1,1560,1493,67,-2,-148,78
1,1931,1817,114,3,120,77
1,1755,1746,9,4,655,119
1,1441,1805,-364,0,33,117
1,1680,1598,82,0,462,147
1,1500,1593,-93,1,68,63
-1,1305,1326,-21,-2,-64,48
-1,1692,1705,-13,3,70,54
1,1244,1110,134,13,982,89
-1,1989,1949,40,-1,-25,74
1,1809,1941,-132,0,24,73
-1,1467,1415,52,-3,40,50
-1,1506,1546,-40,2,71,64
-1,1875,1924,-49,0,-32,98
1,1982,1662,320,-1,-22,87
1,1681,1868,-187,2,57,49
0,1868,1687,181,0,-215,115
1,1556,1496,60,13,172,43
1,1583,1240,343,6,273,51
1,1786,1632,154,0,-171,99
0,1832,1713,119,-1,-260,117
1,2177,1979,198,0,355,135
-1,1429,1549,-120,-6,-200,62
1,1894,1956,-62,1,544,125
-1,1788,1533,255,-5,-61,48
-1,1657,1824,-167,-3,-133,62
-1,1236,1586,-350,0,-263,86
-1,1709,1689,20,0,-35,80
-1,1974,2184,-210,0,-299,150
-1,1887,1744,143,1,-47,130
1,1500,1409,91,7,194,61
-1,1548,1459,89,0,-360,150
1,1944,1925,19,0,7,91
0,1793,1841,-48,-1,-234,118
-1,1515,1554,-39,-10,-92,56
-1,1292,1492,-200,0,-135,116
-1,1901,1969,-68,-4,-126,48
-1,1739,1785,-46,0,5,72
-1,1763,1948,-185,-2,80,98
1,1389,1182,207,6,242,49
-1,1559,1661,-102,0,-317,164
-1,1485,1740,-255,-1,-46,44
0,1589,1232,357,-6,-833,144
-1,1978,1873,105,0,-26,80
-1,1697,1837,-140,-1,-50,62
1,1444,1473,-29,2,-8,41
-1,1444,1437,7,5,63,46
-1,1291,1324,-33,-7,-100,44
-1,1555,1615,-60,-12,-343,58
-1,1118,1753,-635,1,-43,64
-1,1534,1463,71,1,12,42
1,1698,1611,87,4,541,95
-1,1485,1625,-140,0,-69,54
1,1538,1280,258,2,65,61
-1,1561,1365,196,1,117,60
-1,1887,1964,-77,-1,-37,68
1,1695,1593,102,1,523,133
-1,1493,1660,-167,-2,-76,42
-1,1500,1532,-32,-11,-123,74
-1,1557,1749,-192,-5,-763,112
-1,1701,1667,34,-1,-317,68
1,1595,1360,235,3,138,71
-1,1972,1879,93,0,-320,112
-1,1378,1601,-223,-2,-56,56
-1,1660,1579,81,-5,-187,76
1,2078,1840,238,-1,6,53
-1,1376,1335,41,-1,21,42
1,1790,1700,90,1,10,45
-1,1690,1293,397,-1,-475,118
-1,1376,1334,42,3,57,52
1,1647,1533,114,4,276,83
-1,1539,1120,419,0,112,64
1,1605,1635,-30,-3,-1,131
-1,1892,1958,-66,-4,29,120
1,1585,1704,-119,0,-121,127
1,1623,1372,251,1,113,59
-1,1969,1954,15,-3,-187,82
-1,1594,1646,-52,-2,-13,64
1,1794,1753,41,0,-4,53
1,1967,1883,84,0,37,93
-1,1602,1708,-106,0,-336,100
-1,1603,1691,-88,-2,-229,76
1,1663,1221,442,0,27,53
1,2084,1957,127,1,93,89
1,1865,1689,176,2,79,65
1,1976,1452,524,6,112,49
-1,1693,1487,206,-7,-350,70
-1,1692,1633,59,0,1,54
1,1574,1624,-50,1,569,121
-1,1967,2072,-105,-2,-79,48
-1,1596,1500,96,-1,-122,118
-1,1655,1977,-322,-1,-306,76
1,1549,1275,274,-1,-5,61
1,1605,1399,206,1,-90,127
0,1215,1399,-184,2,-261,126
1,1713,1571,142,0,-63,109
1,1695,1730,-35,4,274,139
1,1649,1348,301,-4,-163,47
1,1601,1834,-233,0,199,121
1,1753,1545,208,2,609,103
1,2093,1996,97,-8,54,79
-1,1296,1346,-50,0,-379,76
-1,1950,2082,-132,-1,-84,94
1,1544,1194,350,3,75,113
1,1504,1224,280,-2,228,97
1,2091,1959,132,3,40,45
1,1722,1722,0,0,16,63
1,1500,1496,4,-1,39,61
-1,1618,1652,-34,0,-3,82
1,1759,1465,294,-2,299,87
-1,1712,1606,106,0,-66,122
-1,1829,1980,-151,2,80,60
-1,1544,1386,158,-1,-95,62
-1,1662,1608,54,0,-22,98
1,1684,1338,346,1,266,71
1,1526,1457,69,0,109,147
1,1987,1820,167,1,71,71
1,1517,1618,-101,-1,182,99
1,1943,1957,-14,0,-11,43
-1,1812,1993,-181,0,-46,65
1,1806,1683,123,0,-4,117
-1,1421,1620,-199,0,-19,56
-1,1540,1765,-225,-1,-292,102
1,1871,1673,198,4,197,69
0,1547,1500,47,-1,-105,120
-1,1367,1999,-632,-7,-192,68
0,1544,1941,-397,-11,-340,128
1,1954,1835,119,0,-13,57
1,1467,1532,-65,25,1632,81
1,1547,1443,104,0,307,112
1,2000,1366,634,-2,304,93
-1,1386,1337,49,1,63,44
1,1647,1492,155,-2,417,175
1,1564,1344,220,2,735,125
-1,1959,1946,13,1,65,46
1,1619,1460,159,1,19,65
-1,1534,1449,85,0,50,62
-1,1611,1531,80,0,-51,52
1,1693,1701,-8,0,32,67
1,1770,1535,235,0,28,41
-1,1395,1625,-230,0,1,100
-1,1957,1946,11,0,-29,78
0,1375,1386,-11,2,714,152
1,1783,1692,91,0,16,49
1,1463,1491,-28,-1,-32,71
1,1620,1697,-77,5,316,79
-1,1569,1774,-205,2,20,58
-1,1486,1549,-63,3,225,74
1,1933,2104,-171,0,75,107
-1,1521,1469,52,-1,-12,54
-1,1139,1263,-124,-22,-590,64
1,1600,1539,61,1,5,51
-1,1383,1651,-268,-10,-60,40
1,1555,1585,-30,3,181,47
-1,1833,1658,175,-5,-149,90
-1,1559,1476,83,0,-33,82
1,1354,1387,-33,0,14,77
-1,1958,1948,10,1,-19,112
1,1683,1542,141,-1,-14,49
-1,1596,1469,127,-1,-25,62
1,1574,1600,-26,1,33,51
1,1456,1476,-20,0,207,111
1,1496,1545,-49,0,402,103
-1,1530,1610,-80,2,-67,112
1,1340,1418,-78,-12,-862,83
-1,1530,1520,10,-6,-1091,98
1,1339,1570,-231,-2,-183,73
-1,1563,1521,42,0,-83,89
-1,1780,1787,-7,4,62,46
0,1405,1440,-35,0,-367,126
1,1435,1362,73,-2,-52,67
1,1527,1461,66,-5,-191,91
-1,1487,1500,-13,-3,-179,74
1,1535,1691,-156,3,54,61
-1,1714,1435,279,-2,-143,94
-1,1393,1356,37,-7,-120,44
-1,1729,1588,141,1,-27,54
1,1720,1532,188,0,103,65
-1,1630,1892,-262,2,-53,96
-1,1615,1552,63,0,2,122
1,1546,1271,275,1,34,49
1,1946,1958,-12,-2,184,79
-1,1896,1626,270,-1,-46,106
1,1568,1126,442,0,279,104
1,1306,1438,-132,0,5,47
-1,1318,1385,-67,-1,-87,66
-1,1221,1281,-60,-13,-305,46
-1,1302,1368,-66,-6,-271,74
-1,1531,1774,-243,-1,-36,76
1,1544,1611,-67,1,256,121
1,1525,1401,124,4,108,71
1,1587,1387,200,7,84,47
1,1522,1610,-88,1,151,99
-1,1816,1564,252,-1,-179,76
-1,1406,1392,14,0,45,78
1,1813,1392,421,0,103,77
-1,1785,1458,327,-5,-67,44
1,1722,1646,76,0,27,101
-1,1558,1733,-175,-1,-410,124
-1,1525,1813,-288,0,-131,104
1,1742,1695,47,2,36,55
1,1485,1535,-50,7,419,81
-1,1449,1382,67,0,-28,62
-1,1419,1650,-231,-1,-8,46
1,1557,1263,294,2,-4,75
1,1766,1827,-61,0,11,93
1,1653,1557,96,-5,305,155
1,1655,1414,241,8,188,49
0,1815,1623,192,7,523,146
1,1570,2073,-503,-3,-94,57
-1,1375,1394,-19,0,1,90
1,1778,1381,397,2,75,77
1,1813,1247,566,4,26,43
-1,1756,1992,-236,-1,-28,90
-1,1312,1346,-34,7,135,60
-1,0,901,-901,-13,-889,96
1,1593,1552,41,7,191,59
1,1660,1477,183,-4,-21,43
1,1292,1211,81,8,350,69
1,1797,1860,-63,0,-7,43
-1,1246,1814,-568,-8,-138,50
0,1766,1583,183,-2,-19,83
-1,1437,1386,51,-4,-720,144
-1,1529,1788,-259,-2,4,60
1,1380,1379,1,-3,-3,60
1,1590,1593,-3,1,345,83
1,1704,1838,-134,0,14,45
1,1374,1292,82,1,239,99
-1,1393,1485,-92,1,26,42
1,1653,1515,138,1,81,55
-1,1244,1816,-572,-2,-290,74
-1,1213,1518,-305,5,35,40
-1,1312,1571,-259,-4,-291,88
1,2030,1835,195,0,62,59
1,1817,1243,574,3,57,53
-1,1811,1662,149,-3,-123,54
1,1805,1525,280,-3,-315,81
1,1301,1689,-388,6,27,53
1,1347,1449,-102,3,370,113
1,1774,1779,-5,1,82,89
-1,1349,1621,-272,-6,-154,56
-1,1603,1542,61,-2,-22,42
-1,1242,1818,-576,2,-77,62
1,1588,1501,87,0,121,73
-1,1535,1456,79,-4,-182,70
-1,1785,1861,-76,-5,-480,84
-1,1829,2042,-213,-2,-67,172
-1,1601,1576,25,0,-39,76
1,1568,1597,-29,7,255,55
-1,1525,1349,176,6,139,88
1,1819,1241,578,2,149,59
1,1759,1678,81,-11,-204,121
-1,1672,1521,151,-3,-26,86
1,1810,1522,288,-1,27,48
-1,1566,1592,-26,0,54,88
0,1768,1777,-9,7,479,87
-1,1240,1820,-580,-5,-45,48
1,1660,1493,167,9,303,51
1,1367,1206,161,1,-9,51
-1,1796,1970,-174,1,10,40
1,1522,1471,51,-1,363,97
-1,1318,1500,-182,0,-52,74
-1,1745,1764,-19,0,-37,68
1,1821,1239,582,1,36,53
1,1814,1546,268,5,284,89
-1,1358,1410,-52,3,156,78
1,1508,1665,-157,-3,-105,75
-1,1366,1509,-143,-11,-130,48
-1,1445,1323,122,-1,-162,90
1,1657,1565,92,4,103,53
-1,1439,1555,-116,-8,-346,110
-1,1739,1615,124,0,-16,87
-1,1730,1488,242,-2,-277,92
1,1564,1255,309,1,34,103
-1,1590,1710,-120,0,-11,86
-1,1493,1597,-104,-4,-268,70
1,1515,1405,110,1,41,47
1,1537,1656,-119,1,161,89
-1,1722,1666,56,0,19,58
1,1844,1351,493,10,274,53
1,1283,1575,-292,0,141,101
-1,1769,1631,138,0,-34,74
-1,1355,1627,-272,1,60,64
-1,1655,1510,145,2,-3,54
-1,1572,1694,-122,1,47,62
-1,1541,1819,-278,-3,-102,48
1,1471,1585,-114,7,505,73
-1,1427,1761,-334,0,-42,52
-1,1263,1291,-28,-3,-181,98
1,1774,1631,143,-9,38,57
1,1562,1462,100,2,238,81
0,1531,1523,8,-1,-279,126
1,1432,1500,-68,-1,-68,93
1,1555,1437,118,0,54,69
1,1775,1500,275,2,159,71
1,1518,1537,-19,0,-344,97
1,1606,1485,121,-1,76,81
1,1681,1631,50,0,-29,77
1,1983,1947,36,0,179,89
-1,1410,964,446,1,-16,44
1,1724,1707,17,0,11,63
1,1518,1552,-34,2,222,97
1,1995,1731,264,0,59,93
1,1298,1364,-66,1,-17,65
-1,1589,1866,-277,0,-123,102
1,1732,942,790,0,-16,51
-1,1429,1529,-100,-7,-6,40
-1,1563,1697,-134,-1,-137,98
-1,1810,1817,-7,-3,-5,44
1,1527,1348,179,2,17,41
1,1548,1476,72,2,218,107
-1,1526,1639,-113,-5,-184,58
1,1605,1454,151,0,97,91
-1,1537,1414,123,-12,-1051,122
-1,1051,1390,-339,-7,-943,122
1,1727,1435,292,0,3,65
1,1567,1458,109,1,67,78
-1,1936,1970,-34,1,-56,178
1,1732,1646,86,0,40,69
1,1832,1836,-4,1,38,55
1,1876,1898,-22,0,49,69
1,2108,1707,401,5,239,67
-1,1472,1640,-168,-1,-115,96
1,1568,1521,47,0,13,47
-1,1435,1331,104,-2,-320,100
1,1952,1599,353,0,102,115
-1,1743,1998,-255,0,-27,84
-1,1655,1568,87,-10,-788,86
1,1658,1559,99,1,-129,81
-1,2296,1970,326,-3,-341,76
-1,1967,1813,154,2,53,60
1,1874,1602,272,0,-13,77
-1,1743,1768,-25,0,-12,60
1,1775,1224,551,10,419,61
-1,2003,1731,272,-1,-153,68
1,1743,1500,243,4,385,65
1,1704,1653,51,0,32,59
-1,1952,1746,206,0,41,64
1,1730,1802,-72,-3,231,83
1,1909,1865,44,0,11,71
1,1691,1716,-25,5,123,73
1,1550,1175,375,6,213,59
-1,1598,1878,-280,-2,-46,54
1,1675,1375,300,3,32,49
1,1777,1981,-204,-1,23,57
1,1842,1826,16,0,-4,71
-1,1432,1452,-20,-2,-88,78
1,1646,1688,-42,-2,-4,98
1,1719,1753,-34,0,76,111
1,1209,1216,-7,1,267,81
1,1960,1278,682,9,443,61
1,1683,1366,317,1,41,59
-1,1872,1997,-125,-1,-337,108
-1,1882,1595,287,-1,-93,64
1,1600,1368,232,3,103,89
-1,1678,1712,-34,-3,-31,136
1,1968,1946,22,0,33,81
0,1796,1714,82,0,-45,131
-1,1608,1562,46,1,176,114
-1,1748,1719,29,3,226,96
-1,1687,1839,-152,-1,5,120
-1,1349,1383,-34,-11,-205,54
1,1716,1745,-29,-1,-46,89
1,1961,1550,411,1,18,49
-1,1489,1626,-137,1,24,80
-1,1934,1743,191,0,45,70
-1,1113,1550,-437,-10,-239,52
-1,1703,1704,-1,1,101,72
-1,1640,1547,93,-12,-175,44
1,1853,1679,174,1,165,69
-1,1815,1855,-40,2,252,94
1,1596,1616,-20,0,62,107
1,1716,1794,-78,0,-4,41
1,1672,1866,-194,1,25,53
0,1487,1297,190,-3,-95,90
-1,1421,1384,37,-2,-185,70
1,1781,1730,51,2,60,59
-1,1691,1832,-141,-2,-494,102
-1,1552,1578,-26,-6,-46,80
-1,1334,1230,104,0,-139,100
1,1586,1363,223,-1,503,121
1,1788,1743,45,-4,58,62
1,1967,1743,224,0,-5,53
1,1744,1611,133,0,23,71
-1,1684,1697,-13,2,-77,94
-1,1720,1790,-70,0,-6,60
-1,1212,1553,-341,-3,-357,95
1,1452,1491,-39,4,160,73
1,1581,1426,155,-4,-74,47
1,1845,1683,162,0,599,107
-1,1577,1741,-164,-8,-119,50
-1,1733,2068,-335,0,-145,86
-1,1553,1166,387,9,350,54
1,1963,1613,350,2,116,69
1,1784,1564,220,1,303,103
-1,1492,1813,-321,1,10,66
1,1580,1370,210,5,136,63
1,1921,1919,2,0,14,67
1,2111,1752,359,3,134,53
-1,1410,1474,-64,-1,-7,52
-1,1676,1658,18,0,-64,57
1,1668,1567,101,-4,-43,77
-1,1342,1603,-261,3,78,46
-1,1438,1607,-169,0,-17,60
1,1867,1804,63,1,102,119
-1,1622,1698,-76,-2,38,50
1,1628,1715,-87,-1,-11,149
-1,1676,1857,-181,-17,-236,40
-1,1603,1542,61,-3,-6,54
1,1234,1330,-96,-2,-57,75
1,1673,1430,243,-1,1,50
1,1751,1669,82,8,67,45
1,1747,1570,177,2,105,67
-1,1533,1528,5,0,10,68
-1,1196,1325,-129,-1,-63,72
-1,1978,2038,-60,2,152,82
-1,1613,1779,-166,-4,7,42
-1,1703,1807,-104,-1,-44,50
-1,1745,2115,-370,0,-139,94
-1,1760,1929,-169,-3,-7,86
1,1660,1564,96,0,349,97
1,1302,1168,134,3,102,51
1,1029,1500,-471,-1,6,59
1,1785,1620,165,3,143,73
-1,1734,1798,-64,1,-70,83
1,1760,1608,152,3,139,65
-1,1416,1573,-157,-3,-87,86
1,1869,2005,-136,-1,-56,69
0,1979,1789,190,0,130,118
-1,1409,1625,-216,-4,-268,67
-1,1775,2079,-304,-2,-44,66
1,1626,1669,-43,1,129,55
-1,1564,1972,-408,-2,5,52
1,1678,1374,304,0,557,133
1,1814,1695,119,1,8,41
1,1555,1708,-153,0,627,87
1,1522,1160,362,0,-16,51
-1,1472,1463,9,-2,-5,52
1,1357,1310,47,7,238,51
1,1908,1708,200,3,213,95
-1,1671,1744,-73,-1,-36,51
-1,1917,2188,-271,-1,-5,70
-1,1362,1554,-192,2,104,54
1,1493,1361,132,1,22,43
-1,1170,1499,-329,-7,-198,56
-1,1688,1821,-133,-1,-87,60
1,1633,1481,152,0,9,49
-1,1555,1975,-420,0,13,64
-1,1401,1483,-82,0,-14,49
-1,1429,1707,-278,0,-90,62
1,1633,1711,-78,-10,35,61
-1,1648,1629,19,-2,-171,61
1,1626,1655,-29,5,413,79
-1,1283,1318,-35,-3,-406,70
1,1401,1047,354,6,406,81
1,1767,1312,455,3,200,65
-1,1543,1571,-28,2,144,54
1,1868,1601,267,0,-18,95
-1,1597,1575,22,-1,0,40
-1,1646,1367,279,-10,-723,118
1,1828,1681,147,1,15,45
-1,1587,1397,190,1,755,130
1,1977,1553,424,0,-97,67
1,1661,1876,-215,2,72,69
1,1597,1307,290,14,956,81
1,1832,1737,95,1,50,63
-1,1652,1476,176,-7,-233,52
0,1354,1502,-148,-2,-85,124
1,2048,2082,-34,0,42,69
-1,1638,1642,-4,9,725,84
1,1336,1519,-183,-6,-50,53
-1,1157,2137,-980,-4,-252,56
-1,1525,1732,-207,-1,-15,70
1,1674,1835,-161,0,2,43
-1,1551,1980,-429,-1,-147,74
1,1771,1573,198,8,438,73
1,1062,1303,-241,0,-233,99
1,1597,1583,14,-3,22,59
-1,1458,1654,-196,-12,-411,94
1,2132,1878,254,0,42,77
-1,1439,1734,-295,-4,-290,86
-1,1404,1634,-230,-6,-161,44
-1,1982,1549,433,2,20,58
1,1646,1807,-161,0,194,99
1,1587,1586,1,5,47,43
-1,1572,1955,-383,4,213,76
1,1556,1769,-213,0,-4,48
-1,1574,1785,-211,0,-85,102
0,2060,2069,-9,-2,-12,110
-1,1531,1592,-61,-2,-30,48
-1,1492,1669,-177,-2,-85,50
1,1913,1849,64,1,20,53
1,1157,1214,-57,5,80,47
-1,1392,1600,-208,-8,-127,48
-1,1418,1486,-68,12,320,54
1,1958,1570,388,0,35,53
-1,1678,1568,110,-4,-1007,130
1,1477,1332,145,2,45,58
-1,1575,1539,36,0,20,64
-1,1399,1568,-169,-2,-5,73
1,2137,1361,776,6,161,57
1,1929,1885,44,1,38,43
-1,1567,1961,-394,0,129,72
-1,1450,1503,-53,9,537,108
1,1873,1543,330,0,5,49
-1,1627,1598,29,1,16,54
1,2018,1601,417,0,239,71
-1,1110,1302,-192,-14,-676,72
-1,1193,1353,-160,-14,-419,59
-1,1678,1741,-63,-1,-106,82
-1,1791,1661,130,-5,-228,78
1,1690,1672,18,0,82,74
1,1964,1564,400,-6,-199,61
-1,1574,1598,-24,-2,-133,60
1,1596,1315,281,0,5,53
1,1681,1792,-111,0,6,71
-1,1341,1614,-273,0,-39,70
1,1608,1419,189,4,67,45
-1,1433,1495,-62,-1,-111,118
-1,1661,1700,-39,0,-251,96
-1,1562,1967,-405,0,0,56
-1,1540,2137,-597,-2,-115,80
1,1922,1847,75,0,89,73
1,1753,1610,143,0,25,53
-1,2069,2061,8,0,-10,40
-1,1417,1697,-280,-8,-259,60
1,1692,1564,128,0,11,45
-1,1351,1505,-154,-3,-166,57
1,1754,1778,-24,-4,188,127
-1,1564,1602,-38,1,-47,82
-1,1717,1587,130,1,-90,62
1,1970,1559,411,-1,-71,73
1,1710,1651,59,6,91,46
-1,1557,1410,147,-12,-708,80
1,1360,1085,275,2,514,91
0,1641,1719,-78,-2,-167,108
-1,1179,1316,-137,-1,137,72
-1,1338,1119,219,0,-24,78
-1,1875,1938,-63,-3,-79,50
1,1669,1522,147,6,675,117
-1,1644,1760,-116,1,8,58
-1,1860,2072,-212,2,-18,88
-1,1676,1574,102,2,-190,84
-1,1557,1972,-415,-2,-20,62
-1,1392,1683,-291,-15,-435,68
1,1958,1758,200,-1,13,107
-1,1702,1914,-212,0,-8,70
0,1567,1606,-39,-5,115,193
-1,1554,1613,-59,-1,38,62
1,1699,1580,119,1,57,77
-1,1223,1359,-136,-12,-655,72
1,1975,1555,420,-4,-412,81
1,1595,1522,73,-1,43,81
1,1545,1623,-78,-2,-7,55
-1,1717,1644,73,1,530,98
1,2138,1609,529,0,-32,67
1,1766,1766,0,0,100,83
1,1619,1406,213,8,246,61
1,1795,1609,186,2,64,55
1,1552,1978,-426,-2,25,67
1,1624,1571,53,3,34,67
1,1679,1357,322,0,81,75
1,1600,1424,176,2,337,87
-1,1701,1794,-93,0,-34,58
-1,1657,1704,-47,-6,-232,64
1,1382,1316,66,6,130,71
-1,1634,1562,72,0,34,68
1,1950,1577,373,-3,-74,67
-1,1569,1392,177,2,-82,74
1,1441,1495,-54,-3,-67,71
-1,1707,1794,-87,0,-471,136
1,1170,1714,-544,1,9,43
1,1755,1777,-22,0,-35,73
1,1713,1647,66,0,66,65
1,1662,1697,-35,-1,20,61
1,2078,1855,223,0,78,83
-1,1513,1562,-49,-4,-255,74
-1,1574,1953,-379,1,173,74
0,1563,1541,22,1,-90,148
1,1730,1500,230,2,103,67
-1,1512,1604,-92,-5,-102,84
1,1630,1566,64,-1,69,43
-1,1713,1693,20,2,351,132
-1,2040,1989,51,0,-81,98
1,1956,1571,385,0,-71,65
1,1638,1722,-84,-1,-24,61
1,1567,1608,-41,-1,8,43
1,1841,1729,112,2,243,123
1,1450,1336,114,10,652,84
-1,1388,1605,-217,-3,-31,52
-1,1569,1960,-391,4,107,62
1,1947,1865,82,-2,-11,43
-1,1592,1431,161,-3,-31,42
-1,1766,1767,-1,0,72,80
1,1709,1652,57,2,119,61
-1,1443,1325,118,3,77,60
1,1443,1424,19,1,368,129
1,1684,1863,-179,-3,-76,51
1,1413,1179,234,1,-18,61
1,1524,1509,15,-1,-24,79
-1,1535,1687,-152,2,63,64
1,1963,1566,397,2,101,63
-1,1196,1534,-338,-9,-179,62
1,1658,1582,76,4,-231,105
1,2142,1347,795,-3,-26,51
-1,1726,1634,92,-4,-105,58
-1,1563,1966,-403,0,27,78
1,1417,1606,-189,4,55,43
-1,1850,2083,-233,1,50,84
1,1735,1410,325,1,152,57
1,1642,1573,69,1,118,91
1,1383,1500,-117,3,82,47
-1,1648,1713,-65,-2,-593,140
-1,1537,1660,-123,-1,-239,92
1,1611,1701,-90,-3,-67,61
-1,1701,1844,-143,-7,-101,42
1,1679,1772,-93,0,-48,89
1,1969,1560,409,0,-190,73
-1,1667,1564,103,1,-123,90
-1,1589,1435,154,2,20,69
-1,1694,1852,-158,0,-12,76
-1,1519,1598,-79,0,-50,58
-1,1558,1971,-413,1,360,88
-1,1193,1382,-189,-1,-526,90
1,1778,1755,23,0,15,81
-1,1815,2020,-205,-2,-145,88
-1,1452,1434,18,-1,-165,68
-1,1755,2162,-407,-1,-18,48
1,1606,1485,121,0,63,75
1,1272,1458,-186,0,161,93
-1,1442,1728,-286,-2,-87,56
0,1953,1861,92,0,-49,137
-1,1318,1456,-138,-6,-144,49
-1,1534,1584,-50,-2,-92,60
1,1771,1299,472,3,96,55
1,1609,1545,64,6,365,79
-1,1872,1988,-116,0,9,66
-1,1467,1499,-32,1,-443,106
-1,1809,2026,-217,0,-16,64
-1,1601,1293,308,-20,-341,48
1,1928,1712,216,7,207,43
1,1582,1452,130,-1,-32,45
1,1636,1619,17,0,-4,77
1,1527,1389,138,0,34,91
-1,1415,1469,-54,-2,-427,88
1,1607,1803,-196,0,8,77
-1,1775,1653,122,0,-3,56
-1,1297,1776,-479,1,25,68
-1,1578,1716,-138,2,69,60
-1,1680,1705,-25,-1,-519,162
-1,1912,1955,-43,0,-23,60
-1,1673,1661,12,-1,-222,88
1,1552,1753,-201,-7,-105,71
-1,1624,1757,-133,-10,-374,60
-1,1398,1516,-118,-4,-75,46
-1,1507,1510,-3,1,-283,124
1,1571,1396,175,-3,-188,109
-1,1318,1477,-159,5,1,108
1,1996,1864,132,0,51,55
-1,1753,2032,-279,1,27,56
1,1792,1496,296,0,-9,41
1,1677,1381,296,2,58,59
-1,1647,1760,-113,0,-39,102
1,1668,1586,82,-4,149,59
1,1501,1183,318,-11,-510,67
-1,1626,1616,10,0,242,124
-1,1765,1617,148,-6,-126,70
1,1463,1362,101,-1,-58,67
1,1588,1576,12,1,14,59
-1,1377,1698,-321,-2,-623,90
1,1534,1391,143,-2,-55,99
1,1441,1753,-312,0,87,77
1,1414,1500,-86,3,127,63
1,1880,1628,252,-6,-81,45
-1,1992,1749,243,-1,3,76
0,1322,1240,82,-5,-189,116
1,1906,1435,471,2,145,51
1,1857,2003,-146,3,436,111
-1,1564,1765,-201,3,185,90
1,1629,1727,-98,5,154,49
-1,1534,1427,107,-2,-127,98
1,1731,1592,139,1,-3,41
1,1964,1903,61,0,-6,135
1,1712,1644,68,9,606,109
-1,1735,1868,-133,-3,-84,54
-1,1517,1398,119,-8,-113,54
-1,1639,1777,-138,-1,-32,64
1,1391,1422,-31,1,171,127
-1,1768,1973,-205,-1,-93,64
1,1626,1478,148,0,97,95
0,1384,1549,-165,0,-221,111
1,1796,1483,313,4,224,75
-1,1635,1722,-87,-2,-194,66
-1,1719,1940,-221,-2,-167,72
-1,996,1220,-224,0,-364,104
1,1581,1502,79,5,33,41
1,2038,1930,108,0,38,51
-1,1730,1626,104,1,31,56
-1,1433,1909,-476,-3,-144,66
1,1500,1390,110,1,80,59
-1,1277,1425,-148,-2,-263,152
1,2036,1979,57,0,-20,89
1,1640,1716,-76,0,-7,77
-1,1456,1579,-123,0,-76,81
-1,1504,1509,-5,-7,-473,76
1,1505,1389,116,0,50,67
-1,1654,1721,-67,-9,-126,48
-1,1354,1472,-118,-7,-290,56
0,1702,1654,48,-10,-141,131
-1,1767,1771,-4,0,9,114
-1,1678,1723,-45,-2,-25,154
1,1520,1557,-37,0,5,63
1,1628,1391,237,-1,-46,79
1,1670,1552,118,2,264,85
1,2047,1500,547,12,332,59
1,1494,1457,37,0,128,95
1,1696,1228,468,-3,-3,47
1,1922,1811,111,2,232,71
1,1614,1392,222,-1,15,59
-1,1655,1700,-45,0,-16,50
1,1685,1883,-198,2,307,137
-1,1710,1646,64,0,22,44
1,1664,1716,-52,0,427,131
-1,1656,1671,-15,1,141,124
1,1383,1407,-24,6,419,75
-1,1539,1327,212,-6,422,122
-1,1728,2004,-276,2,77,72
1,2048,1785,263,0,-57,99
1,1700,1224,476,-2,17,49
-1,1659,1697,-38,-1,-181,68
1,1763,1502,261,2,110,85
-1,1713,1676,37,0,-376,118
1,1707,1646,61,10,22,40
-1,1780,2053,-273,0,-221,86
1,1968,1707,261,3,158,77
-1,1221,1701,-480,-4,-527,90
-1,1500,1799,-299,-1,-28,52
1,1633,1520,113,0,73,65
1,1436,1438,-2,0,40,65
1,1635,1605,30,0,7,47
1,1738,1703,35,0,68,71
1,1571,1588,-17,0,93,65
1,1974,1938,36,0,60,69
-1,1738,1791,-53,-3,-150,60
1,2058,1879,179,-1,-65,65
0,1448,1414,34,9,563,81
1,1453,1211,242,1,-62,53
-1,1817,1667,150,-1,-157,76
-1,1684,1520,164,-1,-167,116
-1,1515,1739,-224,1,-11,64
-1,1651,1654,-3,-6,-389,72
1,1767,1315,452,4,388,67
1,1693,1535,158,2,2,45
0,1204,1461,-257,14,1248,84
1,1503,1734,-231,0,23,63
1,2064,1713,351,2,729,163
1,1427,1450,-23,-11,-332,71
1,1872,1983,-111,-3,-8,41
1,1344,1391,-47,0,3,51
-1,1665,1796,-131,0,-71,94
1,1749,1331,418,-2,66,89
-1,1394,1395,-1,-1,-125,76
1,1512,1688,-176,-2,-10,113
1,1641,1635,6,3,306,103
-1,1589,1791,-202,-1,165,130
1,1314,1346,-32,3,75,58
-1,1639,1756,-117,0,-46,110
0,1969,1886,83,-2,23,142
1,1493,1532,-39,-2,-510,97
1,1101,1213,-112,-8,14,58
-1,1619,1603,16,-11,-197,52
1,1706,1500,206,-1,-200,91
-1,1634,1490,144,0,-81,82
1,1583,1658,-75,-2,-293,105
1,1803,1797,6,0,-11,125
-1,1766,1947,-181,0,-87,89
-1,1543,1500,43,-2,-134,60
1,1655,1558,97,3,421,93
0,1719,1595,124,0,45,199
1,1655,1358,297,6,569,105
0,1328,1751,-423,0,-66,130
-1,1819,1677,142,-2,2,44
-1,1331,1378,-47,0,33,68
1,1615,1607,8,-1,323,165
1,1650,1620,30,2,274,107
-1,1624,1652,-28,-6,-347,70
-1,1599,1709,-110,-6,-514,90
1,1901,1928,-27,-3,-355,87
-1,1764,1796,-32,0,-5,72
1,1597,1694,-97,0,-11,65
-1,1765,1671,94,-5,-17,42
1,1785,1644,141,-2,94,137
-1,1441,1814,-373,-3,-308,78
1,1728,1590,138,-1,-79,77
-1,1397,1381,16,2,-157,92
-1,1889,1967,-78,0,-29,62
1,1565,1494,71,1,96,105
1,1228,1295,-67,-1,220,83
-1,1770,1772,-2,-2,-197,77
0,1583,1745,-162,0,308,142
-1,1506,1354,152,-6,-120,44
1,1674,1567,107,0,46,55
1,1685,1752,-67,2,53,59
1,1676,1490,186,-1,21,68
1,1632,1676,-44,3,64,51
-1,1670,1697,-27,-4,-50,42
1,1805,1754,51,-1,41,68
1,1775,1635,140,1,-3,51
1,1358,1240,118,0,126,65
-1,1366,1334,32,-11,-306,58
1,1465,1645,-180,0,88,83
1,1916,1913,3,3,583,115
-1,1817,1611,206,0,-301,122
-1,1421,1680,-259,6,217,72
1,1407,1490,-83,-3,-135,87
-1,1500,1535,-35,-2,-116,59
-1,1820,1734,86,1,35,64
-1,1484,1759,-275,-2,-189,94
-1,1671,1500,171,2,42,44
-1,1558,1682,-124,0,-86,76
1,1975,1880,95,2,134,77
-1,1836,1763,73,1,-173,81
1,1631,1803,-172,0,-53,71
1,1249,1194,55,0,30,69
1,1682,1417,265,0,1,47
1,1521,1545,-24,-2,54,66
-1,1334,1636,-302,5,890,118
1,1805,1597,208,3,50,51
1,1791,1578,213,1,17,81
-1,1790,1822,-32,0,16,88
-1,1598,1690,-92,-10,-288,56
1,1927,1987,-60,-2,-103,81
-1,1745,1815,-70,-5,-17,50
1,1365,1596,-231,3,350,89
1,1465,1120,345,1,530,107
1,1644,1714,-70,-1,-50,85
1,1832,1771,61,0,37,63
0,1547,1341,206,3,168,75
-1,1436,1742,-306,1,56,104
1,1950,1722,228,3,62,47
1,1794,1687,107,0,-21,41
1,1873,1983,-110,0,-2,57
1,1754,1842,-88,3,97,51
1,1573,1252,321,-1,268,83
1,1851,1584,267,0,46,59
1,1876,1929,-53,1,61,63
-1,1828,1778,50,0,99,90
-1,1413,1500,-87,-4,-123,58
0,1816,1699,117,0,-131,138
-1,1683,1851,-168,-1,-341,114
-1,1532,1461,71,1,19,54
1,1974,1939,35,2,184,89
-1,1749,1810,-61,-1,-6,54
-1,1500,1698,-198,0,48,78
-1,1698,1590,108,0,-205,70
1,1309,1422,-113,2,61,49
1,1840,1689,151,7,164,53
-1,1367,1480,-113,-1,-51,68
1,1383,1346,37,5,380,83
-1,1969,1887,82,0,18,76
-1,1740,1647,93,-2,-100,76
-1,1321,1665,-344,-6,-139,64
-1,1385,1478,-93,7,150,60
1,1485,1574,-89,1,113,73
1,1703,1576,127,1,73,55
-1,1310,1853,-543,-1,-110,84
1,1804,1819,-15,1,58,61
-1,1345,1501,-156,-4,7,56
-1,1581,1246,335,-16,-413,48
-1,1587,1628,-41,1,-22,92
1,1378,1528,-150,-9,-239,45
-1,1789,1679,110,0,4,126
-1,1465,1500,-35,-2,-244,72
-1,1800,1815,-15,-5,-290,72
-1,1420,1609,-189,-11,-158,40
1,1819,1740,79,-6,-41,43
-1,1568,1710,-142,0,-85,84
1,1650,1724,-74,5,220,61
1,1763,1633,130,0,-22,73
-1,1438,1429,9,3,36,50
1,1664,1733,-69,2,260,92
-1,1406,1870,-464,-1,-18,52
-1,1512,1395,117,2,51,46
-1,1826,1784,42,-5,-467,118
1,1269,1561,-292,2,208,71
1,1930,1984,-54,-1,-29,53
1,1896,1803,93,1,3,48
1,1695,1498,197,1,121,111
-1,1732,1827,-95,1,19,60
-1,1310,1581,-271,0,-43,60
-1,1717,1628,89,-1,-10,44
-1,1803,1814,-11,0,-123,88
1,1786,1648,138,0,152,89
1,1414,1614,-200,-1,-130,101
-1,1894,1956,-62,0,-8,120
1,1483,1425,58,7,251,57
-1,1490,1243,247,-4,-221,74
-1,1607,1595,12,-2,-26,54
1,1986,1813,173,0,42,61
-1,1560,1499,61,0,-87,158
1,1389,1212,177,15,313,41
1,1520,1441,79,3,253,123
0,1508,1604,-96,-4,-175,130
1,1406,1487,-81,0,563,97
-1,1403,1875,-472,0,-110,82
1,1787,1703,84,-1,356,81
-1,1415,1492,-77,-2,-203,90
-1,1332,1427,-95,1,55,58
1,1786,1662,124,-7,-123,51
0,1723,1882,-159,-10,-49,111
1,1447,1637,-190,-2,58,57
-1,1475,1461,14,1,-12,46
1,1393,1566,-173,0,26,57
0,1932,2041,-109,0,-97,127
1,1799,1695,104,0,76,89
-1,1771,1697,74,-5,-114,82
1,1662,1508,154,0,-11,65
1,1694,1337,357,6,316,65
-1,1395,1593,-198,0,-402,136
1,1426,1339,87,-3,-68,65
1,1593,1560,33,0,-6,47
-1,1862,1966,-104,-8,-452,68
-1,1646,1795,-149,-1,-99,100
-1,1596,1739,-143,1,45,42
-1,1807,2029,-222,0,-20,76
1,1500,1687,-187,0,7,63
1,1561,1511,50,0,18,53
0,1688,1628,60,-1,-165,108
1,1677,1794,-117,-4,267,117
1,1728,1394,334,1,76,59
-1,1746,1590,156,-1,-24,44
1,1444,1466,-22,8,266,59
-1,1877,1401,476,0,-1,80
1,1965,1885,80,0,18,85
1,1697,1293,404,3,122,55
1,1938,1724,214,0,293,99
-1,1620,1688,-68,-2,-416,94
1,1500,1396,104,4,226,61
1,1605,1731,-126,-2,-15,69
-1,1740,1592,148,1,-20,54
1,1757,1339,418,1,80,61
-1,1660,1577,83,-7,-174,48
-1,1317,2020,-703,-9,-511,78
1,1698,1409,289,0,448,89
1,1680,1412,268,5,101,49
1,1332,1090,242,8,739,81
-1,1658,1818,-160,-4,-81,83
-1,1744,1599,145,-13,-197,56
-1,1541,1696,-155,0,4,46
-1,1432,1670,-238,0,-169,62
1,1388,1553,-165,0,100,145
-1,1426,1528,-102,1,86,64
-1,1336,1182,154,0,-248,90
-1,1556,1598,-42,-2,-597,164
1,1684,1643,41,1,-2,71
1,1702,1494,208,4,108,49
1,1668,1729,-61,-8,-4,55
-1,1719,1944,-225,-1,-225,96
-1,1394,1625,-231,2,82,70
-1,1759,1655,104,2,84,72
1,1633,1451,182,-7,90,69
-1,1750,1686,64,0,-311,120
-1,1425,1844,-419,-3,8,80
1,1716,1619,97,6,165,61
-1,1632,1694,-62,-1,-31,62
-1,1391,1509,-118,0,-133,80
1,1724,1868,-144,1,226,81
-1,1467,1434,33,3,62,50
-1,1775,1699,76,0,-75,76
1,1293,1601,-308,1,463,207
-1,1637,1647,-10,-2,-137,86
-1,1703,1623,80,0,-54,70
-1,1554,1740,-186,3,29,50
-1,1916,1525,391,2,285,102
1,1526,1392,134,0,49,65
1,1726,1500,226,8,77,41
1,1427,1323,104,-1,-27,81
-1,1330,1419,-89,0,23,68
-1,1802,1877,-75,0,-8,56
1,1199,1236,-37,3,477,121
1,1731,1780,-49,1,74,67
-1,1612,1724,-112,2,49,88
-1,1637,1689,-52,-5,-333,64
-1,1714,1762,-48,-3,-96,63
1,1746,1762,-16,0,8,49
-1,1619,1443,176,4,52,90
-1,1668,1590,78,3,-233,114
-1,1652,1638,14,0,32,117
1,1703,1647,56,0,178,85
1,1699,1627,72,5,194,83
0,1949,1714,235,-3,3,115
-1,1581,1412,169,-4,-40,50
-1,1598,1607,-9,-1,-74,56
1,1847,1423,424,0,52,64
-1,1714,1638,76,0,-15,58
-1,1359,1498,-139,-3,-257,72
-1,1202,1321,-119,-6,-17,40
-1,1718,1793,-75,-1,-162,98
1,1759,1793,-34,0,22,57
1,1651,1723,-72,-4,-180,69
1,1680,1447,233,1,13,41
-1,1746,1439,307,1,106,78
1,2191,1973,218,0,26,65
1,1626,1707,-81,0,40,73
-1,1694,1617,77,1,-47,80
1,1455,1328,127,-4,59,47
1,1732,1685,47,0,56,99
-1,1619,1852,-233,-2,-181,74
1,1652,1581,71,3,84,59
1,1223,1214,9,-5,-254,43
1,1435,1314,121,-2,245,137
-1,1678,1695,-17,-1,119,92
1,1720,1942,-222,-1,36,119
1,2200,1575,625,-1,7,75
1,1469,1478,-9,1,134,91
1,2280,1964,316,-1,-44,59
-1,1717,1772,-55,0,-137,130
-1,1383,1684,-301,-1,-126,96
1,1541,1536,5,1,162,103
1,1749,1512,237,1,1030,123
1,1471,1386,85,3,75,89
-1,1960,2283,-323,-3,-136,88
-1,1706,1813,-107,-2,12,56
1,1662,1629,33,3,245,75
-1,1801,2201,-400,-5,-68,42
1,1560,1654,-94,-1,132,91
1,1820,1739,81,1,169,87
1,1604,1420,184,1,91,81
-1,1470,1724,-254,-1,-53,60
1,2205,1798,407,0,7,79
-1,1604,1656,-52,0,-153,104
-1,2286,1957,329,-1,-48,78
1,1781,1630,151,3,136,69
-1,1704,1706,-2,-1,-4,42
-1,1534,1475,59,-5,-276,76
-1,1672,1885,-213,-2,22,62
-1,1550,1693,-143,-17,-198,42
-1,1978,2266,-288,1,60,84
-1,1537,1082,455,3,54,42
1,1698,1692,6,0,9,72
1,1218,1234,-16,1,56,49
1,1923,1738,185,0,27,53
1,2270,1974,296,-1,-23,59
1,1743,1314,429,4,430,73
1,1623,1788,-165,-8,29,121
1,1676,1385,291,1,237,117
1,1467,1500,-33,3,498,127
-1,1566,1584,-18,-1,-9,48
-1,1615,1582,33,-2,-220,100
-1,1970,2274,-304,-2,-64,76
-1,1711,1707,4,0,27,92
-1,1724,1776,-52,0,41,54
1,1424,1517,-93,12,444,57
-1,1582,1314,268,-4,-421,86
-1,1520,1667,-147,1,104,96
-1,1892,1894,-2,-5,-50,86
0,1699,1677,22,-1,-83,124
1,2278,1966,312,-5,9,101
-1,1854,1780,74,-5,-215,94
1,1521,1432,89,-1,102,63
1,1721,1710,11,-2,18,59
0,1525,1559,-34,-7,-97,68
1,1672,1628,44,-2,-69,49
-1,1443,1413,30,-2,-169,68
1,1745,1835,-90,1,-48,107
-1,1772,1639,133,-7,-174,60
1,1686,1424,262,1,132,103
1,1839,1729,110,0,-25,91
-1,2094,2281,-187,-1,-13,62
-1,1618,1963,-345,-3,-144,66
-1,1481,1612,-131,3,77,68
1,1935,1726,209,0,69,145
-1,1411,1669,-258,0,-4,54
0,2088,2287,-199,0,87,114
1,1966,1615,351,5,287,59
-1,1793,1840,-47,0,-45,112
1,1619,1389,230,-1,354,117
1,1738,1901,-163,2,16,45
1,1422,1529,-107,4,22,41
0,1386,1234,152,2,37,111
1,1928,2197,-269,0,-25,67
-1,1654,1758,-104,0,-74,70
-1,1531,1715,-184,-10,-127,45
0,1705,1687,18,-1,-306,127
-1,1612,1969,-357,-1,-64,52
-1,1529,1691,-162,0,-110,134
1,1478,1852,-374,0,-37,67
-1,1513,1813,-300,0,-451,104
-1,1657,1688,-31,2,87,126
-1,1515,1438,77,-3,31,42
1,1729,1509,220,-5,-20,113
0,1681,1876,-195,0,-48,59
1,1312,1487,-175,3,119,55
1,2094,1972,122,0,8,79
1,1676,1481,195,4,112,49
0,1884,1802,82,-3,-53,70
1,1623,1481,142,3,31,46
0,1821,1759,62,0,290,108
1,1539,1229,310,1,22,49
1,1719,1700,19,0,53,131
1,1688,1704,-16,3,285,101
-1,1384,1624,-240,-1,-20,84
1,1736,1500,236,0,-17,71
-1,1766,1646,120,0,-30,60
-1,1171,1505,-334,0,33,84
-1,1393,1879,-486,0,-7,56
1,1963,2102,-139,0,57,81
1,2281,1872,409,1,-3,41
1,1817,1509,308,-1,-19,83
-1,1500,1532,-32,-4,-152,88
0,1594,1470,124,0,1,132
-1,1870,2283,-413,0,-36,68
1,1698,1406,292,-1,-40,47
1,1540,1340,200,2,115,55
1,1697,1617,80,0,-60,115
1,2085,1981,104,-4,-251,77
1,1883,1980,-97,-1,70,133
1,1784,1753,31,0,-7,59
1,1333,1564,-231,-9,-24,49
-1,1922,1738,184,0,-191,112
-1,1481,1308,173,-6,-386,84
1,1732,1597,135,0,47,57
-1,1597,1414,183,-2,-73,50
-1,1790,2093,-303,-4,-45,44
1,1815,1615,200,-4,134,79
-1,1710,1882,-172,3,64,78
-1,1596,1628,-32,-10,-262,42
-1,1637,1579,58,-2,-399,114
-1,1392,1599,-207,2,-277,92
1,1400,1262,138,1,20,67
1,1901,1786,115,-1,14,57
1,1889,1931,-42,-2,-16,65
1,1888,1619,269,5,508,75
1,1345,1357,-12,7,274,81
1,1610,1822,-212,-1,17,59
1,1852,1768,84,0,31,97
1,1593,1624,-31,8,375,61
1,1745,1641,104,3,99,51
-1,1405,1627,-222,-4,-65,58
-1,1557,1538,19,0,-131,142
1,1386,1476,-90,-1,-45,51
0,1822,2114,-292,-1,-150,153
-1,1846,1706,140,-1,-99,58
1,1311,1438,-127,4,454,101
-1,1604,1607,-3,-2,-181,84
1,1688,1727,-39,0,17,75
1,1363,1500,-137,6,573,77
1,1903,1831,72,0,9,49
1,1639,1586,53,-2,68,49
-1,1438,1252,186,-1,-17,46
-1,1778,1909,-131,0,-91,106
1,1580,1404,176,1,-68,69
-1,1576,1678,-102,-7,-427,98
1,1511,1494,17,-2,78,97
1,1371,1372,-1,2,448,105
1,1619,1593,26,-1,-29,65
1,1609,1607,2,-3,-107,61
1,1328,1438,-110,-1,331,145
1,1700,1660,40,2,114,67
-1,1423,1620,-197,1,-200,104
-1,1759,1862,-103,0,-24,66
-1,1631,1834,-203,-3,-206,66
-1,1718,1581,137,-5,-65,48
-1,1738,1744,-6,-1,-77,82
1,1806,1500,306,8,722,69
1,1346,1358,-12,7,310,63
1,1704,1912,-208,4,275,143
-1,1417,1630,-213,0,-7,68
-1,1661,1710,-49,-3,-103,58
1,1798,1398,400,3,138,71
-1,1604,1681,-77,0,4,60
1,1657,1665,-8,5,246,62
-1,1704,1746,-42,0,-47,98
1,1993,1693,300,1,54,65
-1,1603,1478,125,0,262,126
-1,1703,1865,-162,0,-14,52
-1,1557,1731,-174,-4,-189,64
-1,1892,1855,37,-1,-12,40
1,1565,1446,119,-1,211,87
1,1494,1508,-14,3,76,53
-1,1345,1357,-12,0,-48,76
0,1703,1917,-214,-6,-99,150
-1,1585,1612,-27,1,4,44
1,1566,1340,226,-8,-39,43
1,1613,1597,16,3,139,105
-1,1545,1470,75,-2,-73,98
1,1890,1889,1,-2,133,89
1,1755,1694,61,0,210,141
1,1421,1382,39,11,160,45
1,1426,1513,-87,3,115,57
-1,1877,1901,-24,0,-193,102
-1,1411,1538,-127,-9,-154,48
1,1373,1571,-198,3,349,59
1,1689,1892,-203,0,-13,59
-1,1727,1754,-27,0,-61,136
1,1613,1595,18,2,97,55
-1,1313,1452,-139,-4,-350,82
-1,1720,1770,-50,-3,-389,128
-1,1651,1711,-60,-2,-821,120
-1,1780,2184,-404,0,84,90
-1,1767,1551,216,-8,-48,58
1,1703,1590,113,0,603,121
-1,1895,2192,-297,-1,-30,110
1,1867,1627,240,1,77,85
1,1408,1311,97,7,862,88
-1,1500,1622,-122,0,-196,120
1,1438,1573,-135,2,65,69
1,1403,1167,236,2,81,53
-1,1623,1872,-249,1,-12,100
-1,1531,1561,-30,-2,-69,56
-1,1469,1860,-391,-5,-611,136
1,1793,1546,247,-1,599,95
1,1801,1437,364,3,83,55
0,1619,1582,37,0,-120,131
-1,1524,1360,164,-2,-51,44
1,1391,1747,-356,1,-18,47
-1,1633,1642,-9,-2,-79,48
1,1500,1490,10,-2,308,129
1,1876,1601,275,-2,-295,103
-1,1653,1648,5,0,-105,172
1,1693,1585,108,-1,-72,77
-1,1432,1719,-287,-2,-379,90
-1,1393,1639,-246,0,3,44
-1,1740,1327,413,-1,-20,46
-1,1696,1750,-54,1,12,46
1,1446,1393,53,0,-7,47
-1,1618,1857,-239,-4,-193,116
1,1685,1624,61,1,43,139
-1,1532,1558,-26,-5,-244,68
-1,1504,1444,60,3,334,76
1,2197,1764,433,-1,193,103
-1,1276,1430,-154,-1,62,68
1,1630,1492,138,0,214,93
-1,1571,1521,50,0,-66,94
1,2187,1487,700,0,28,53
-1,1500,1518,-18,-3,-145,77
0,1425,1359,66,3,148,125
1,1566,1675,-109,1,61,49
-1,1804,1622,182,-1,-149,102
-1,1790,1862,-72,0,94,86
0,1454,1306,148,-4,-150,68
0,1810,1910,-100,0,16,210
1,1611,1598,13,1,43,47
-1,1686,1735,-49,0,3,54
1,1131,1567,-436,-2,685,95
-1,1823,1701,122,0,-166,78
1,1630,1500,130,-2,161,135
1,1780,1871,-91,2,319,119
0,1388,1564,-176,-2,-48,66
1,1593,1648,-55,-3,-104,61
1,1694,1500,194,-2,-126,119
-1,1411,1271,140,-16,-276,52
-1,1688,1577,111,1,-41,96
-1,1717,1764,-47,-2,-87,54
-1,1066,1501,-435,0,-57,93
1,2188,1746,442,-1,23,55
1,2150,1911,239,-2,-149,137
1,1588,1622,-34,1,133,67
-1,1857,1795,62,-1,-37,60
1,1446,1510,-64,2,28,43
-1,1521,1826,-305,-1,-27,72
-1,1638,1784,-146,0,-7,88
0,1906,2155,-249,-2,-705,117
1,1534,1558,-24,3,427,121
1,2193,1743,450,0,-40,73
1,1857,1871,-14,2,35,45
1,1451,1339,112,2,378,71
-1,1608,1632,-24,2,5,46
0,1078,1365,-287,-6,-208,105
1,1441,1473,-32,1,-1,45
1,1720,1695,25,2,67,61
0,1598,1643,-45,2,717,103
-1,1423,1341,82,-2,-277,74
1,1607,1579,28,0,47,55
-1,1521,1314,207,2,-105,114
-1,1147,1500,-353,-1,-27,50
1,1545,1157,388,0,273,105
1,2148,1913,235,7,477,75
-1,1599,1641,-42,-5,-187,58
-1,1804,1980,-176,5,249,72
-1,1589,1564,25,-9,-38,40
1,1550,1768,-218,1,97,82
-1,1532,1727,-195,0,-55,116
-1,1465,1365,100,1,14,100
1,1844,1802,42,0,-5,69
-1,1590,1651,-61,-8,-30,44
-1,1393,1427,-34,1,22,52
-1,1687,1721,-34,0,-4,50
-1,1584,1500,84,-2,-342,139
1,1773,1840,-67,0,16,117
-1,1175,1526,-351,-19,-832,64
1,1581,1660,-79,-8,-89,49
-1,1641,1632,9,2,38,60
-1,1591,1673,-82,-1,1,50
-1,1890,1908,-18,-7,-231,66
1,1917,1799,118,4,323,99
-1,1564,1540,24,2,-272,116
1,1594,1647,-53,2,15,41
-1,1392,1239,153,-1,-149,94
-1,1854,1815,39,-10,-1332,98
1,1070,1519,-449,12,1499,109
1,1606,1634,-28,5,350,73
-1,1708,1578,130,0,-7,62
-1,1518,1533,-15,-2,-90,64
-1,1550,1831,-281,0,-21,104
1,1905,1843,62,0,334,123
1,1676,1719,-43,1,76,85
-1,1154,1548,-394,-14,-282,44
1,1584,1485,99,1,403,99
-1,1877,2153,-276,-9,-346,82
1,1618,1622,-4,1,119,43
1,1597,1580,17,0,3,59
1,1633,1604,29,0,-2,44
-1,1291,1653,-362,-2,-82,70
-1,1628,1611,17,0,-135,54
-1,1835,1960,-125,0,-12,54
1,1791,1637,154,2,33,55
-1,1673,1700,-27,-1,-17,52
1,1871,1743,128,-1,-31,65
-1,1765,1827,-62,-8,0,40
1,1500,1491,9,2,178,69
1,1388,1416,-28,1,19,51
-1,1453,1500,-47,1,-27,42
1,1607,1633,-26,-2,-11,47
-1,1837,2157,-320,-1,-28,50
-1,1631,1798,-167,2,27,48
1,1618,1622,-4,-8,-181,43
1,1998,1578,420,3,135,53
1,1986,1753,233,-2,-94,53
1,1778,1739,39,1,17,67
1,1485,1423,62,7,687,95
-1,1567,1702,-135,-3,-104,52
1,1682,1583,99,-1,-90,69
1,1629,1611,18,-11,-328,57
-1,1350,1793,-443,-7,-115,48
1,1368,1572,-204,-6,-106,69
1,2164,1830,334,0,386,103
-1,1383,1453,-70,0,1,54
1,1732,1526,206,0,7,41
-1,1649,1715,-66,-5,-503,92
-1,1664,2007,-343,2,86,62
-1,1639,1601,38,-1,-74,74
-1,1403,1406,-3,-7,-96,76
1,1827,1786,41,0,-10,79
-1,1483,1670,-187,-3,-613,102
-1,1507,1633,-126,-3,-72,48
1,1444,1478,-34,3,525,73
-1,1619,1622,-3,6,92,40
1,2020,1662,358,2,159,65
-1,1827,2168,-341,-7,-503,118
-1,1627,1613,14,-5,-416,108
-1,1529,1773,-244,-1,-28,54
-1,1458,1522,-64,-1,-20,42
1,1625,1731,-106,-4,-368,105
0,1694,1779,-85,0,9,125
1,1643,1555,88,2,525,125
-1,1710,1748,-38,0,-40,78
1,1423,1391,32,4,195,75
-1,1821,2174,-353,-2,-140,72
1,1614,1616,-2,9,199,41
-1,2174,1821,353,-5,-251,130
-1,1546,1575,-29,0,104,46
-1,1663,1459,204,-4,-105,50
-1,1625,1438,187,-7,-1006,112
1,1777,1525,252,4,142,57
1,1414,1494,-80,7,91,53
1,1498,1489,9,-1,-8,59
1,1499,1483,16,0,-7,42
1,1629,1465,164,1,555,143
-1,1458,1552,-94,-3,-605,108
1,1865,1788,77,3,116,47
-1,1317,1537,-220,1,-229,99
-1,1555,1385,170,1,-180,142
-1,1133,1415,-282,1,24,54
-1,1608,1606,2,0,18,42
1,1277,1500,-223,7,413,61
1,1401,1498,-97,5,202,59
1,1690,1531,159,0,136,75
-1,1362,1807,-445,-2,-85,68
-1,1597,1469,128,-1,-349,119
-1,1705,1581,124,-2,-3,104
-1,1480,1428,52,-2,-89,80
1,1349,1282,67,-6,-191,55
1,1689,1850,-161,-3,34,87
-1,1521,1782,-261,0,-284,86
1,1451,1370,81,1,290,139
1,1354,1376,-22,2,36,67
1,1598,1565,33,8,491,71
1,1462,1411,51,0,42,59
1,1873,1779,94,-8,23,67
1,1699,1804,-105,1,11,47
-1,1504,1961,-457,-1,-27,74
-1,1478,1392,86,2,-234,80
-1,1777,1836,-59,0,14,56
-1,1510,1414,96,-7,-150,70
1,1664,1459,205,0,-38,45
-1,1604,1641,-37,-3,-122,58
-1,1604,1485,119,-1,-35,50
1,1533,1444,89,0,-3,40
1,1086,0,1086,7,420,91
-1,1501,1457,44,3,-22,70
-1,1560,1798,-238,-2,-196,64
1,1907,1722,185,-1,-3,69
1,1790,1538,252,7,161,45
1,1435,1616,-181,-1,194,125
1,1581,1650,-69,-1,10,69
-1,1697,1777,-80,2,129,78
1,1592,1327,265,1,56,81
1,1535,1446,89,9,61,40
-1,1809,1360,449,1,-26,74
-1,1377,1637,-260,-3,-396,92
1,1582,1641,-59,0,33,57
1,1586,1500,86,3,131,51
0,1450,1501,-51,2,55,120
-1,1318,1854,-536,-3,-104,64
1,1601,1452,149,1,625,117
0,1440,1658,-218,0,205,144
-1,1533,1794,-261,1,28,44
1,1728,1616,112,4,81,51
1,1768,1758,10,0,24,93
1,1543,1446,97,-2,-64,53
-1,1453,1429,24,3,59,40
1,1636,1871,-235,-1,-10,43
1,1737,1691,46,0,29,58
1,1812,1554,258,3,171,77
1,1642,1535,107,2,74,51
-1,1717,1925,-208,-3,-85,58
-1,1536,1594,-58,-5,-173,54
1,1745,1690,55,0,0,45
1,1516,1524,-8,0,32,101
1,1836,2111,-275,-1,-43,103
-1,1491,1623,-132,-1,-12,54
-1,1595,1448,147,-9,-214,80
1,1681,1682,-1,-3,-72,69
-1,1526,1604,-78,-9,-839,100
1,1392,1292,100,4,891,99
1,1782,1734,48,-2,482,135
-1,1804,1824,-20,0,-20,98
1,1510,1243,267,0,-5,45
0,1576,1479,97,2,154,128
1,1780,1612,168,11,363,61
1,1601,1586,15,0,17,73
0,1370,1856,-486,1,-1101,198
1,1917,1654,263,0,7,61
1,1725,1651,74,0,159,73
1,1594,1392,202,1,36,63
0,1663,1712,-49,-1,378,153
-1,1671,1693,-22,-3,-100,68
1,1305,1553,-248,1,10,73
1,1930,1706,224,-1,85,95
-1,1771,1600,171,-4,-34,48
-1,1500,1834,-334,0,-79,60
1,1673,1609,64,5,110,55
0,1853,1844,9,0,85,119
-1,1566,1399,167,0,-170,96
-1,1549,1500,49,1,26,68
-1,1310,1206,104,2,-222,94
-1,1605,1381,224,0,-26,108
1,1768,1956,-188,-3,-47,57
1,1486,1535,-49,-3,-19,57
1,2092,1855,237,1,94,59
-1,1301,1342,-41,-3,-173,78
1,1724,1623,101,9,679,91
1,1704,1400,304,5,534,117
-1,1835,1794,41,1,59,106
-1,1500,1402,98,-2,-81,92
-1,1512,1675,-163,-5,-120,54
-1,1822,1840,-18,-3,-43,44
1,1817,1457,360,3,280,83
1,1585,1683,-98,3,117,71
1,1736,1682,54,0,42,73
-1,1229,1329,-100,5,112,66
-1,1739,1506,233,5,160,74
-1,1298,1397,-99,2,-227,80
1,1709,1531,178,5,145,63
1,1707,1479,228,-3,6,71
-1,1539,1482,57,-5,-416,74
1,1593,1305,288,0,14,55
1,1455,1820,-365,0,-149,111
-1,1491,1516,-25,-2,-223,114
1,1767,1624,143,0,52,73
1,1540,1423,117,1,48,63
-1,1845,1710,135,0,58,110
-1,1513,1651,-138,-2,-28,44
1,1315,1578,-263,9,647,103
-1,1711,1665,46,0,0,108
-1,1630,1246,384,5,167,54
-1,1553,1701,-148,-1,-562,88
1,1797,1476,321,6,31,41
1,1413,1406,7,6,407,129
1,1967,1495,472,1,72,69
1,1779,1418,361,4,174,67
1,1668,1745,-77,0,10,41
1,1405,1290,115,1,329,145
-1,1822,1673,149,-2,9,63
1,1547,1507,40,-4,-129,75
-1,1495,1526,-31,-3,4,50
-1,1386,1508,-122,-3,-131,72
1,2034,1935,99,1,42,51
-1,1559,1806,-247,-11,-258,48
1,1562,1267,295,4,258,80
-1,1877,1785,92,1,-145,102
1,1806,1325,481,1,13,51
1,1404,1362,42,3,283,133
1,1811,1555,256,-1,25,59
-1,1536,1776,-240,0,-144,52
-1,1281,1468,-187,0,-115,84
1,1732,1682,50,0,2,63
1,1369,1409,-40,2,31,47
-1,1793,1649,144,-8,-460,96
-1,1786,1759,27,1,-29,112
-1,1659,1828,-169,-2,-27,88
1,1616,1615,1,-3,72,85
1,1462,1409,53,0,0,79
1,1901,1540,361,0,709,149
-1,1708,1550,158,1,10,64
1,1927,2045,-118,0,10,61
1,1571,1389,182,-1,-57,117
1,1888,1863,25,-5,65,85
-1,1447,1468,-21,-2,-9,40
1,1688,1683,5,1,82,89
1,1969,1695,274,0,19,71
1,1681,1566,115,0,0,51
1,1533,1562,-29,1,213,101
-1,1324,1808,-484,-4,-220,75
-1,1463,1568,-105,1,0,60
1,1680,1698,-18,1,76,97
1,1794,2077,-283,0,79,113
-1,1500,1413,87,0,-225,142
-1,1635,1574,61,0,-5,48
1,1694,1558,136,0,-3,67
-1,1558,1607,-49,0,-83,68
1,1565,1569,-4,0,121,139
1,1833,1653,180,1,27,49
-1,1451,1817,-366,-2,-19,40
1,1604,1628,-24,4,340,115
-1,1672,1742,-70,4,144,86
0,1842,1474,368,0,-9,113
1,1941,1797,144,1,-17,75
-1,1333,1446,-113,-13,-392,52
1,1532,1527,5,4,154,116
1,1705,1660,45,-1,12,79
1,1816,1641,175,0,-38,81
1,1653,1587,66,2,170,89
1,1823,1448,375,1,52,59
0,1764,1905,-141,-1,-89,125
-1,1573,1818,-245,-3,-42,62
-1,1437,1329,108,0,-10,51
-1,1474,1275,199,3,14,62
-1,1163,1671,-508,-9,-99,42
-1,1411,1296,115,2,65,56
1,1839,1698,141,-1,-3,55
1,1566,1572,-6,7,273,61
-1,1649,1935,-286,-3,-404,98
-1,1411,1594,-183,0,-97,66
1,1843,1744,99,-1,-14,77
1,1754,1781,-27,-7,220,103
1,1750,1663,87,-7,52,67
-1,1224,1332,-108,-4,-710,118
-1,1795,2057,-262,-2,-306,84
1,1616,1615,1,-6,-320,67
1,1410,1269,141,0,13,51
1,1452,1410,42,12,289,45
1,1940,1645,295,0,63,79
1,1809,1568,241,2,337,117
1,1720,1551,169,5,388,99
-1,1354,1421,-67,-9,-350,80
1,1549,1515,34,2,65,48
1,1542,1578,-36,-1,120,79
-1,1401,1534,-133,0,-87,72
1,1828,1502,326,0,88,81
1,1666,1775,-109,7,572,101
0,1604,1627,-23,-3,-79,158
1,1250,1391,-141,8,780,103
1,1646,1436,210,-3,-64,85
1,1899,1673,226,0,35,65
-1,1561,1579,-18,0,-349,112
1,1640,1686,-46,3,190,59
1,1823,1211,612,0,7,47
-1,1402,1713,-311,0,-13,48
1,1299,1455,-156,0,25,99
-1,1654,1759,-105,-4,-118,60
-1,1417,1378,39,1,75,54
-1,1430,1652,-222,-7,-404,84
-1,1821,1899,-78,0,-183,130
1,1554,1623,-69,0,990,149
1,1583,1394,189,5,10,41
-1,1686,1694,-8,-1,-248,108
1,1938,1657,281,0,12,93
1,1669,1724,-55,0,-3,49
-1,1398,1351,47,-2,-25,70
1,1282,1259,23,0,-16,51
-1,1388,1617,-229,-15,-334,56
1,1627,1605,22,8,218,45
-1,1678,1693,-15,-9,-46,78
-1,1653,1942,-289,-1,-36,62
-1,1230,1204,26,-2,-8,44
-1,1314,1906,-592,-2,-55,54
1,1835,1288,547,4,109,47
1,1559,1377,182,0,400,109
1,1946,1649,297,1,-13,57
1,1642,1621,21,-3,-20,45
1,1743,1575,168,1,115,61
1,1607,1404,203,-1,185,77
1,1641,1573,68,10,569,83
-1,1433,1404,29,0,-16,50
-1,1750,1782,-32,-3,-29,48
-1,1455,1440,15,2,-30,62
-1,1389,1857,-468,-3,-313,100
1,1297,1222,75,10,452,63
1,1681,1292,389,-3,136,91
1,1544,1243,301,13,354,51
-1,1340,1467,-127,-2,-149,76
-1,1955,2058,-103,-2,-175,106
1,1611,1690,-79,0,6,51
1,1837,1313,524,3,55,41
1,1706,1675,31,1,84,105
-1,1607,1907,-300,-2,-100,58
1,1865,1739,126,0,105,99
-1,1483,1946,-463,-5,-164,70
-1,1225,1205,20,-4,-667,150
1,1759,1681,78,2,196,69
-1,1566,1797,-231,-1,-148,93
0,1284,1339,-55,7,400,140
1,1635,1623,12,2,56,51
-1,1365,1493,-128,-1,-31,44
-1,1200,1417,-217,0,-362,88
1,1548,1654,-106,-1,-8,45
1,1567,1671,-104,4,140,63
1,1730,1824,-94,-1,-111,75
-1,1585,1543,42,-1,12,70
1,1840,1286,554,3,102,69
-1,1695,1613,82,-3,-24,40
0,1625,1786,-161,-3,-19,68
0,1388,1382,6,0,31,76
-1,1362,1806,-444,1,-48,75
1,1336,1300,36,-4,39,57
-1,1638,1562,76,-2,-355,122
-1,1781,1629,152,0,-5,80
-1,1950,1672,278,0,1,50
-1,1585,1500,85,-3,-145,54
1,1392,1316,76,1,9,45
-1,1124,1303,-179,-1,-420,123
1,1598,1599,-1,3,324,61
-1,1357,1405,-48,0,-35,58
1,1646,1781,-135,0,226,101
1,1742,1570,172,0,169,81
-1,1857,1930,-73,-6,-306,76
-1,1440,1695,-255,-5,-364,100
1,1666,1473,193,-1,-26,65
-1,1550,1719,-169,-2,-367,150
1,1808,1691,117,-1,-14,53
-1,1668,1860,-192,0,15,70
1,1581,1657,-76,-1,-25,63
1,1672,1768,-96,-10,308,121
-1,1560,1558,2,7,188,72
1,1939,1844,95,-1,-37,51
-1,1474,1686,-212,-4,-145,66
1,1947,1842,105,0,-23,65
-1,1683,1816,-133,0,-23,64
1,1475,1332,143,4,181,63
-1,1576,1617,-41,-3,-114,66
-1,1661,1948,-287,0,36,70
-1,1185,1316,-131,-4,-362,72
-1,1738,1899,-161,-7,-98,46
1,1732,1691,41,1,23,53
1,1691,1514,177,-3,-468,91
-1,1548,1534,14,-1,6,72
-1,1793,1901,-108,0,-368,154
1,1269,1369,-100,6,492,79
1,2070,1777,293,4,125,61
-1,1352,1436,-84,-9,-289,56
-1,1963,1657,306,-1,-1,64
-1,1729,1934,-205,0,-135,116
1,1421,1346,75,6,211,53
1,1584,1743,-159,-3,-148,75
-1,2061,2088,-27,0,-15,52
1,1371,1391,-20,-7,97,59
1,1672,1497,175,0,55,87
-1,1677,1676,1,0,-47,96
-1,1514,1765,-251,0,-18,40
1,1722,1672,50,0,0,97
1,1910,1722,188,1,49,79
1,1587,1398,189,1,86,79
1,1336,1028,308,1,13,58
1,1562,1509,53,4,945,105
1,2086,1954,132,0,23,81
-1,1944,1770,174,-3,-329,115
1,1611,1144,467,2,110,57
1,1401,1500,-99,4,86,47
1,1822,1433,389,3,169,91
1,1666,1278,388,3,182,61
-1,1594,1643,-49,-6,-264,56
1,1557,1445,112,1,162,113
-1,1677,1735,-58,2,78,72
-1,1697,2100,-403,0,-8,64
1,1786,1794,-8,2,212,113
-1,1558,1791,-233,0,-25,54
-1,1917,1956,-39,0,3,94
1,1312,1092,220,10,762,91
1,1952,1834,118,1,144,129
-1,1659,1744,-85,2,26,86
0,1662,1739,-77,0,8,120
-1,1337,1435,-98,-4,-149,74
-1,1584,1657,-73,0,-90,68
1,1424,1714,-290,0,-103,89
-1,1948,2114,-166,-2,-74,50
-1,1612,1691,-79,0,11,70
-1,1392,1516,-124,1,-373,106
1,1905,1668,237,0,2,75
-1,1397,1343,54,-3,-99,124
1,1618,1142,476,3,555,117
1,1678,1489,189,1,85,87
-1,1695,2102,-407,0,-9,51
1,1678,1796,-118,0,-45,123
-1,1325,1482,-157,-6,-164,144
-1,1576,1493,83,-17,-815,90
1,1974,1524,450,1,64,73
1,1824,1421,403,-2,15,47
-1,1516,1916,-400,0,-243,102
1,1911,1600,311,0,55,47
-1,1592,1415,177,1,101,78
1,1977,1531,446,1,38,47
-1,1941,2050,-109,-2,-350,98
1,1593,1734,-141,0,127,85
-1,1581,1915,-334,0,-105,124
-1,1826,1687,139,-4,-466,106
1,1662,1569,93,1,-27,71
1,1507,1571,-64,-5,-262,64
-1,1641,1771,-130,-10,-603,120
1,1308,1552,-244,2,701,143
-1,1538,1599,-61,-1,185,86
-1,1630,1720,-90,-7,-339,60
1,1811,1628,183,0,112,115
0,1589,1581,8,-1,-19,116
-1,1699,1597,102,2,38,44
1,1628,1597,31,-3,17,117
0,1591,1848,-257,6,155,56
1,1741,1112,629,3,49,41
-1,1100,1475,-375,-2,-448,132
1,1833,1625,208,2,117,73
1,1560,1670,-110,0,-23,57
1,1818,1597,221,-1,-64,83
1,1730,1615,115,7,1367,141
1,1515,1525,-10,1,110,75
-1,1446,1525,-79,-5,-50,66
1,1730,1622,108,2,61,93
1,1423,1564,-141,9,277,59
0,1742,1758,-16,0,164,101
-1,0,1178,-1178,-10,-106,48
1,1624,1249,375,0,-86,81
1,1772,1744,28,5,257,73
-1,1591,1824,-233,-1,62,60
1,1907,1571,336,-3,-137,49
1,1277,1206,71,5,542,105
-1,1314,1856,-542,0,71,58
-1,1519,1684,-165,0,-200,116
-1,1758,1663,95,-1,-304,76
-1,1814,2100,-286,-3,-22,48
1,1909,1828,81,4,350,89
-1,1674,1583,91,-4,-197,70
1,1524,1440,84,-3,629,179
1,1787,1814,-27,3,58,63
-1,1615,1739,-124,-5,-14,46
1,1829,1585,244,0,29,53
1,1770,1725,45,-2,-189,99
-1,1858,2046,-188,0,-10,56
1,1312,1733,-421,9,494,65
1,1574,1410,164,7,522,65
1,1472,1403,69,8,423,65
1,2045,1775,270,0,10,81
-1,1568,1910,-342,-6,-16,40
-1,1626,1660,-34,2,-279,104
-1,1857,1880,-23,0,146,92
1,1857,1681,176,3,57,53
-1,1777,1893,-116,-4,-103,46
1,1748,1608,140,1,54,63
1,1580,1833,-253,2,10,41
1,1648,1463,185,7,79,42
1,2104,1810,294,-5,23,59
1,1718,1550,168,10,530,77
-1,1530,1784,-254,0,-60,84
-1,1475,1567,-92,-3,-410,108
-1,1449,1742,-293,-9,-668,94
1,1814,1602,212,2,140,75
-1,1544,1724,-180,-7,-203,48
1,1774,1316,458,-1,41,147
1,1513,1734,-221,-5,13,57
1,1528,1443,85,4,181,51
1,1891,1529,362,-1,-446,97
0,1820,1919,-99,-8,282,129
1,1731,1538,193,3,662,93
1,1527,1438,89,1,115,61
-1,1815,2049,-234,0,-32,46
1,2051,1853,198,5,54,49
1,1902,1770,132,0,-13,47
-1,1418,1645,-227,-2,-11,44
1,1573,1801,-228,4,180,85
1,1677,1744,-67,-5,89,103
1,1635,1441,194,3,301,69
-1,1619,1808,-189,-1,-71,82
-1,1806,1758,48,-2,-501,140
1,1601,1755,-154,0,207,107
1,1526,1893,-367,1,-33,63
1,1513,1556,-43,-2,-34,47
-1,1657,1621,36,0,-33,74
-1,1434,1533,-99,-4,-767,144
1,1656,1714,-58,3,150,67
-1,1807,2108,-301,0,-44,98
-1,1601,1552,49,-4,-63,73
1,1737,1377,360,1,72,69
1,1840,1641,199,2,130,69
1,2054,1809,245,3,16,45
0,1748,1709,39,-4,-12,89
1,1873,1548,325,-9,-513,103
-1,1567,1500,67,0,-21,60
-1,1586,1817,-231,0,-42,82
-1,1739,1691,48,1,-17,106
1,1526,1537,-11,1,529,151
-1,1371,1740,-369,0,32,90
-1,1283,1147,136,-10,-419,112
-1,1478,1086,392,-7,-647,90
1,1072,0,1072,1,69,53
-1,1701,1747,-46,0,-116,134
1,1722,1876,-154,1,230,109
1,1717,1763,-46,1,-2,93
1,1544,1526,18,0,-146,73
-1,1346,1457,-111,-2,-251,74
-1,1677,1789,-112,-1,-223,90
1,1686,1536,150,0,18,53
1,1915,1823,92,-1,5,95
1,1535,1428,107,3,149,60
-1,1325,1554,-229,1,-32,94
-1,1861,1738,123,-9,-949,88
-1,1450,1243,207,-1,-127,134
-1,1600,1500,100,0,-18,56
-1,1309,1593,-284,-13,-541,66
-1,1731,1690,41,-11,-154,100
-1,1595,1771,-176,-1,-63,62
-1,1846,2154,-308,-3,-87,49
1,1783,1615,168,0,1,75
-1,1784,1534,250,5,20,44
1,1594,1444,150,0,27,59
1,2159,1842,317,1,12,49
-1,1675,1642,33,-1,-268,162
-1,1483,1508,-25,0,-73,74
-1,1839,2164,-325,0,626,118
1,1785,1610,175,6,949,155
1,1543,1414,129,0,13,55
0,1554,1616,-62,0,1,97
1,1515,1490,25,5,192,49
0,1804,1913,-109,0,25,81
-1,1359,1640,-281,-11,-493,72
-1,1815,1613,202,1,117,114
-1,1723,1500,223,0,-323,100
1,1796,1692,104,4,61,71
1,2169,1836,333,-2,-27,61
1,2112,1856,256,-4,-27,43
1,1660,1721,-61,1,-111,117
1,0,1072,-1072,0,185,83
-1,1323,1604,-281,-5,4,42
1,1507,1510,-3,-3,-224,85
-1,1537,1553,-16,-5,-385,86
0,1751,1729,22,-2,-136,72
1,1777,1590,187,-3,-74,47
1,1432,1580,-148,0,174,91
-1,1753,1833,-80,1,116,78
1,1691,1822,-131,-1,-9,89
1,1480,1526,-46,-1,-44,83
-1,1614,1556,58,-5,-353,86
1,1580,1520,60,9,642,73
1,1558,1520,38,0,29,89
-1,1842,1744,98,0,-419,122
-1,1486,1512,-26,-3,-48,48
-1,1563,1500,63,-1,-58,54
-1,1823,1557,266,-2,-299,168
-1,1464,1747,-283,-4,-8,44
-1,1527,1718,-191,0,-93,72
1,1608,1317,291,0,-116,109
0,1550,1674,-124,0,-15,70
1,1543,1409,134,3,171,85
1,1708,1581,127,0,47,123
-1,1852,2117,-265,0,-53,70
-1,1338,1269,69,3,0,122
-1,1621,1465,156,0,22,70
0,1791,1685,106,0,150,148
-1,1616,1492,124,-3,-72,74
-1,1656,1707,-51,2,-91,72
1,1709,1522,187,4,348,101
1,1541,1426,115,-4,619,127
-1,1584,1783,-199,-2,-160,70
1,1846,1755,91,-9,-159,143
1,1513,1492,21,3,371,98
1,1789,1577,212,2,13,40
-1,1439,1709,-270,-16,-342,51
-1,1899,2057,-158,0,-326,144
1,1730,1750,-20,2,46,53
-1,1430,1636,-206,-7,-191,76
1,1523,1475,48,1,48,56
0,1827,1633,194,-8,-423,85
-1,1221,1503,-282,-13,-650,68
1,1774,1484,290,-6,110,61
-1,1646,1758,-112,-1,-158,93
1,2063,1769,294,0,24,87
-1,1334,1567,-233,-4,-129,74
-1,1751,1655,96,0,-27,64
1,1500,1660,-160,0,38,69
1,1764,1254,510,0,18,41
-1,1630,1794,-164,-5,-124,52
1,1398,1517,-119,0,-97,97
1,1578,1593,-15,1,350,105
1,1589,1193,396,6,97,41
-1,1577,1592,-15,-8,-84,40
-1,1766,1821,-55,0,-422,94
1,1610,1658,-48,0,-89,95
1,1363,1221,142,1,180,103
1,2122,1848,274,-1,-71,89
1,1482,1524,-42,4,104,41
-1,1746,1516,230,-4,-364,98
1,1647,1523,124,0,-18,69
-1,1400,1307,93,2,-246,128
-1,1742,1789,-47,-2,-199,126
-1,1533,1687,-154,2,43,54
-1,1787,1739,48,0,-343,132
1,1666,1554,112,1,59,55
-1,1833,1703,130,-2,-62,62
-1,1511,1494,17,0,-2,42
-1,1585,1837,-252,0,1,46
1,1653,1572,81,9,748,73
-1,1412,1572,-160,-1,-149,84
-1,1462,1456,6,0,2,44
-1,1083,1355,-272,-4,-162,60
-1,1776,1697,79,0,87,60
1,1656,1464,192,0,-25,83
1,1539,1717,-178,-1,-158,101
0,1550,1399,151,-1,-628,237
1,1718,1640,78,0,264,155
1,1505,1499,6,1,15,43
1,1880,1526,354,-2,470,111
-1,1520,1604,-84,0,-45,104
1,1807,1892,-85,0,296,115
-1,1469,1778,-309,1,24,121
-1,1503,1413,90,-1,-55,68
1,1556,1402,154,2,161,85
1,1611,1727,-116,1,37,58
1,1532,1647,-115,2,256,93
-1,1669,1555,114,1,90,100
1,1775,1987,-212,-2,-113,105
1,1409,1195,214,4,357,63
-1,1819,1350,469,1,71,100
1,1700,1562,138,0,715,133
-1,1509,1737,-228,-3,-59,80
-1,1321,1385,-64,-4,-66,42
-1,1639,1831,-192,-3,-42,44
1,1548,1480,68,2,436,97
-1,1451,1475,-24,0,12,66
-1,1488,1516,-28,5,103,54
1,1100,1286,-186,1,103,69
1,1837,1633,204,-2,-30,57
-1,1523,1904,-381,-4,-166,88
1,1800,1527,273,-1,-110,87
-1,1798,1732,66,-2,-275,102
1,1596,1630,-34,-4,5,59
-1,1686,1505,181,1,-31,78
1,1405,1313,92,-1,-36,69
1,1762,1623,139,0,292,163
-1,1628,1842,-214,-2,-114,76
1,1552,1707,-155,0,4,59
1,1807,1727,80,1,36,63
1,1580,1268,312,14,492,65
-1,1702,1550,152,1,159,82
1,1729,1545,184,3,124,53
-1,1602,1501,101,-3,-74,54
-1,1878,2127,-249,0,-3,42
-1,1403,1643,-240,-1,-24,54
0,1591,1658,-67,0,-20,132
1,1897,2013,-116,0,26,91
-1,1767,1848,-81,1,38,76
1,1414,1489,-75,4,390,67
-1,1708,1776,-68,-1,38,94
1,1691,1574,117,-4,34,59
-1,1286,1249,37,-7,-321,86
1,2067,1759,308,-3,21,61
1,1856,1675,181,1,40,53
-1,1673,1691,-18,-5,-30,48
-1,1478,1923,-445,-5,-212,69
1,1520,1604,-84,3,115,65
-1,1567,1324,243,-1,-137,90
-1,1564,1699,-135,-1,-10,86
-1,1710,1761,-51,-4,-169,54
1,1472,1380,92,-1,65,47
1,1897,1676,221,4,795,123
1,1567,1686,-119,-3,-92,67
1,1269,1136,133,-1,120,57
-1,1863,1667,196,0,-59,74
-1,1538,1656,-118,0,-6,104
-1,1405,1612,-207,0,-151,124
1,1338,1416,-78,9,272,51
1,1756,2071,-315,0,99,105
1,1476,1428,48,11,167,43
1,1741,1860,-119,2,97,85
-1,1669,1500,169,0,-238,100
-1,1864,1987,-123,1,13,54
1,1476,1325,151,2,63,55
-1,1441,1563,-122,0,-8,48
1,1745,1785,-40,0,62,105
-1,1761,1832,-71,-1,49,50
-1,1398,1484,-86,-1,-8,54
1,1706,1554,152,0,-2,65
-1,1546,1590,-44,-2,-81,52
1,1651,1844,-193,0,51,73
-1,1414,1617,-203,-1,-65,60
-1,1388,1610,-222,5,58,48
-1,1305,1421,-116,-6,-321,68
1,1459,1602,-143,3,61,53
-1,1651,1902,-251,-6,-12,56
1,1479,1433,46,-1,35,67
1,1161,1377,-216,2,60,107
1,1751,1512,239,-1,218,73
-1,1437,1489,-52,-5,-184,60
1,1646,1649,-3,5,150,53
1,1480,1264,216,2,425,133
1,2050,1775,275,0,-128,77
-1,1546,1713,-167,0,-6,74
-1,1616,1772,-156,-3,-207,106
1,1754,1571,183,0,121,145
1,1915,1785,130,1,65,69
-1,1121,1277,-156,-9,-623,84
1,1971,1736,235,-1,549,125
-1,1562,1681,-119,-2,-127,56
1,1374,1427,-53,8,247,47
1,1808,1564,244,0,-36,65
-1,1503,1490,13,2,43,52
-1,1656,1696,-40,-5,-17,58
1,1318,1166,152,8,132,47
1,2006,1745,261,0,6,71
-1,1375,1338,37,0,2,62
-1,1578,1558,20,-1,-9,68
1,1930,1900,30,0,130,105
1,1512,1522,-10,0,12,97
0,1714,1554,160,-10,-613,146
1,1615,1337,278,6,510,109
-1,1812,1911,-99,-1,-99,84
-1,1892,1942,-50,0,-29,88
-1,1643,1752,-109,-2,-365,120
1,1856,1560,296,1,-31,63
1,1598,1719,-121,0,7,49
1,1204,1115,89,3,387,139
-1,1582,1637,-55,-4,-861,120
-1,1560,1813,-253,-1,25,102
1,1950,1791,159,2,157,53
1,1451,1216,235,0,221,61
1,1806,1814,-8,0,46,73
-1,1693,1630,63,0,23,66
-1,1592,1730,-138,-2,-22,44
1,1309,1396,-87,2,108,51
-1,1688,1807,-119,0,-334,152
0,1556,1862,-306,0,55,114
1,1477,1022,455,1,181,61
-1,1590,1705,-115,1,-65,66
-1,1290,1619,-329,0,11,64
-1,1595,1823,-228,-6,-166,60
-1,1628,1801,-173,0,-474,106
1,1524,1529,-5,1,265,133
-1,1456,1769,-313,0,-176,70
-1,1709,1559,150,3,163,70
-1,1919,1804,115,3,49,56
1,1520,1429,91,-2,141,111
-1,1311,1196,115,-1,-13,52
1,1838,1737,101,0,106,75
-1,1152,1206,-54,-3,-40,88
1,1406,1189,217,3,85,45
-1,1452,1722,-270,0,-699,104
1,1621,1555,66,-2,-287,87
1,1365,1421,-56,0,10,47
1,1635,1684,-49,0,24,67
1,1713,1582,131,1,53,107
-1,1680,1446,234,0,-1,86
1,1681,1462,219,2,192,93
1,1819,1904,-85,0,-50,67
-1,1290,1371,-81,-6,-1153,130
1,1957,1856,101,2,219,101
-1,1323,1246,77,-4,-41,54
-1,1569,1643,-74,12,338,56
-1,1632,1632,0,-7,-56,50
-1,1889,1940,-51,0,-146,74
-1,1448,1477,-29,-2,-217,154
-1,1808,1622,186,4,301,92
1,1726,1576,150,6,263,69
-1,1492,1578,-86,0,-138,87
1,2114,1561,553,0,12,65
1,1505,1315,190,1,23,53
1,1833,1733,100,-1,2,55
-1,1152,1572,-420,-1,-186,58
-1,1546,1631,-85,0,-79,72
1,1879,1898,-19,0,12,65
-1,1560,2115,-555,-3,-76,44
1,1839,1862,-23,-1,215,101
-1,1646,1950,-304,0,-18,118
1,1720,1574,146,0,-28,67
1,1694,1725,-31,0,151,89
-1,1492,1517,-25,-1,-165,148
1,2116,1559,557,0,-3,78
1,1455,1420,35,0,101,69
-1,1687,1653,34,0,-194,86
-1,1465,1643,-178,-2,-37,50
-1,1762,1846,-84,0,22,54
1,1639,1789,-150,0,110,67
-1,1355,1381,-26,-3,-819,104
1,1918,1574,344,-1,277,101
-1,1648,1672,-24,0,-257,134
-1,1706,1975,-269,-9,175,136
1,1411,1539,-128,0,14,57
1,1511,1394,117,3,75,57
1,1818,1751,67,5,248,67
-1,1745,1872,-127,-1,-14,52
1,1558,2118,-560,1,57,75
-1,2062,1975,87,0,20,62
-1,1637,1528,109,-1,-157,118
1,1500,1713,-213,0,14,47
-1,1530,1751,-221,2,34,46
-1,1500,1314,186,-2,-38,72
1,1889,1795,94,-2,-90,81
1,2011,1753,258,0,228,61
-1,1814,1702,112,-6,-115,94
1,1741,1662,79,3,85,55
-1,1989,2048,-59,0,3,72
1,1649,1459,190,2,51,55
1,2087,1583,504,1,122,97
1,1841,1759,82,-2,-38,57
1,1479,1601,-122,2,129,57
1,1413,1312,101,7,101,47
1,1638,1713,-75,0,-7,79
1,1458,1223,235,6,690,93
-1,2058,1980,78,0,500,108
1,1667,1769,-102,1,19,41
1,1134,1359,-225,1,49,55
1,1603,1310,293,-1,117,81
1,1524,1426,98,1,632,155
1,1545,1657,-112,2,23,49
-1,1751,1850,-99,0,25,104
1,1887,1772,115,0,15,53
0,1758,1702,56,2,-29,88
-1,1993,2044,-51,0,-68,59
1,1583,1490,93,-9,34,53
1,1755,1682,73,5,423,85
1,1614,1883,-269,2,-1,47
0,1953,1643,310,-1,-136,169
0,1858,1743,115,0,-1,73
-1,1285,1582,-297,1,-9,40
1,1800,1655,145,1,70,59
-1,1569,1541,28,1,-143,108
1,2054,1984,70,0,66,51
-1,1319,1578,-259,2,33,42
-1,1727,1567,160,0,9,48
1,1745,1517,228,-1,70,67
-1,1728,1621,107,-1,29,64
1,1591,1500,91,-9,-229,71
-1,1762,1896,-134,0,-13,52
-1,1746,1854,-108,0,18,84
-1,1897,1624,273,0,-354,100
1,1638,1317,321,0,189,75
-1,1673,1764,-91,0,-309,152
-1,1649,1703,-54,-8,-426,72
0,1481,1337,144,0,-69,130
1,1869,1861,8,0,-21,41
-1,1289,1503,-214,1,-11,48
1,1775,1738,37,-1,-108,73
1,1713,1639,74,1,392,73
1,1378,1406,-28,0,-31,77
-1,1288,1585,-297,-1,-147,118
1,1628,1869,-241,-1,-44,55
-1,1491,1595,-104,-1,156,104
1,1904,1583,321,-1,366,79
-1,1637,1713,-76,0,-381,150
-1,1826,1862,-36,-5,-97,50
1,1364,1584,-220,-1,-10,65
1,1772,1664,108,4,244,87
-1,1157,1332,-175,3,111,60
1,1629,1722,-93,0,-1,75
1,1729,1797,-68,-1,1,43
-1,1633,1633,0,0,24,50
-1,1518,1598,-80,2,-104,114
-1,1688,1782,-94,-10,-245,66
1,1445,1409,36,-1,-24,53
-1,1553,1747,-194,-1,16,78
-1,1708,1644,64,0,-213,94
-1,1364,1659,-295,-4,-77,54
1,1434,1410,24,-1,-29,61
1,1880,1492,388,0,27,59
1,1314,1404,-90,0,273,105
1,1643,1393,250,0,-2,75
1,1656,1780,-124,5,207,63
1,1839,1851,-12,2,82,81
1,1814,1680,134,-2,135,83
-1,1849,1647,202,-4,-49,72
1,2091,1358,733,2,35,41
-1,1659,1694,-35,0,-40,58
1,1839,1882,-43,0,0,49
1,1389,1559,-170,4,194,65
-1,1303,1215,88,0,-25,66
1,1490,1666,-176,8,244,51
-1,1617,1622,-5,0,-16,51
-1,1579,1907,-328,-4,-458,108
-1,1603,1691,-88,-2,-166,62
-1,1704,1648,56,-1,-94,82
-1,1765,1529,236,0,-20,48
1,1840,1272,568,0,8,107
1,1357,1330,27,6,114,41
-1,1668,1671,-3,1,4,60
0,1349,1386,-37,1,187,112
-1,1141,1434,-293,-1,-21,48
-1,1662,1691,-29,-1,-165,94
1,1750,1595,155,0,45,53
-1,1287,1722,-435,-5,-151,52
1,1600,1495,105,-1,-7,47
-1,0,800,-800,6,137,110
1,1754,1284,470,1,18,47
0,1844,1437,407,2,585,83
1,1789,1551,238,0,-188,73
1,1702,1651,51,-5,-15,49
-1,1509,1278,231,1,22,50
-1,1682,1657,25,1,36,66
-1,1666,1831,-165,-3,-365,74
1,1871,1354,517,0,56,75
-1,1651,1945,-294,1,11,94
1,1478,1399,79,2,344,105
1,1641,1711,-70,0,-54,71
1,1882,1606,276,1,56,101
1,1724,1633,91,0,75,95
-1,1603,1628,-25,-2,-167,80
-1,1813,1510,303,-7,-118,60
1,1496,1607,-111,4,164,59
1,1545,1814,-269,0,424,81
-1,1438,1494,-56,2,34,78
-1,1607,1756,-149,1,-8,48
-1,1351,1873,-522,-6,-258,102
1,1750,1446,304,1,42,61
1,1698,1655,43,1,149,93
1,1651,1572,79,0,57,89
1,1839,1851,-12,2,65,61
-1,1329,1400,-71,-7,-58,46
1,1827,1203,624,4,265,73
1,1589,1478,111,3,249,77
1,1725,1566,159,0,-17,75
1,1634,1633,1,0,151,79
1,1761,1442,319,21,346,41
1,1493,1490,3,-1,34,57
-1,1598,1889,-291,-1,-383,100
1,1874,1349,525,3,335,85
-1,1645,1708,-63,-1,-42,62
-1,1267,1281,-14,-6,-249,57
1,1496,1594,-98,9,410,75
1,1764,1992,-228,-1,3,45
1,1771,1252,519,6,131,59
-1,1702,1838,-136,0,-415,132
-1,1239,1392,-153,-3,-619,98
0,1717,1635,82,0,127,115
-1,1347,1753,-406,-1,-218,88
1,1686,1778,-92,2,180,163
1,1901,1739,162,0,20,63
1,1774,1541,233,7,145,61
1,1505,1622,-117,2,72,45
-1,1154,1403,-249,-6,-669,96
0,1638,1714,-76,-4,-409,122
1,1500,1543,-43,1,-2,49
-1,1203,1828,-625,-1,-161,84
0,1886,1649,237,0,78,94
-1,1785,1616,169,-1,-3,48
-1,1641,1500,141,-5,-449,126
-1,1733,1910,-177,-6,-587,126
-1,1602,1625,-23,-4,-119,86
1,1560,1607,-47,2,95,47
1,1407,1607,-200,1,239,91
-1,1503,1427,76,-3,-246,78
1,1788,1536,252,-1,28,49
-1,1622,1645,-23,-7,-303,64
1,1876,1687,189,1,13,63
0,1893,1593,300,2,503,137
1,1830,1469,361,7,430,105
-1,1319,1409,-90,1,-77,68
0,1840,1851,-11,0,-64,112
-1,1712,1640,72,-5,-336,72
-1,1800,1532,268,-1,-428,90
-1,1926,1875,51,-6,-99,116
0,1533,1659,-126,1,189,113
-1,1359,1699,-340,2,29,74
-1,1589,1424,165,5,121,44
1,1647,1500,147,1,46,51
1,1921,1570,351,2,85,71
1,1278,1479,-201,6,155,67
-1,1148,1594,-446,3,24,42
-1,1673,1571,102,0,-299,70
1,1752,1550,202,-1,-35,71
1,1846,1695,151,0,376,85
-1,1547,1918,-371,-4,-63,42
0,1534,1697,-163,-5,-57,50
-1,1441,1573,-132,-5,-174,80
-1,1504,1641,-137,-9,-308,58
-1,1593,1789,-196,-5,-439,106
1,1765,1544,221,-5,-275,79
-1,1349,1597,-248,0,-59,80
-1,1443,1490,-47,2,-116,114
1,1921,1544,377,-4,11,60
-1,1727,1654,73,0,-9,42
1,1524,1659,-135,3,773,95
1,1736,1146,590,0,194,101
-1,1492,1595,-103,1,46,66
-1,1631,1708,-77,-1,-357,94
1,1885,1652,233,0,138,97
-1,1777,1713,64,-3,-34,52
1,1591,1383,208,6,225,63
1,1764,1700,64,1,21,77
-1,1635,1805,-170,0,-19,58
-1,1748,1512,236,0,115,94
-1,1633,1851,-218,-2,-147,70
-1,1553,1924,-371,0,-301,144
-1,1689,1853,-164,-1,-41,74
0,1433,1805,-372,-1,-247,88
1,1568,1405,163,-5,-193,49
-1,1720,1662,58,-2,-154,114
0,1709,1530,179,1,-175,144
-1,1829,1861,-32,-3,-42,48
0,1394,1338,56,0,-69,130
-1,1487,1519,-32,-10,-369,64
1,1484,1632,-148,0,-78,85
-1,1699,1667,32,-6,-313,80
1,1622,1580,42,12,219,43
0,1653,1952,-299,2,141,168
1,1643,1537,106,3,134,51
-1,1796,1928,-132,-5,-48,122
1,1410,1399,11,-2,-129,57
1,1689,1692,-3,-1,-50,75
1,1734,1791,-57,0,6,60
-1,1540,1500,40,-7,-368,68
1,1528,1570,-42,0,51,95
-1,1186,1292,-106,0,-125,90
-1,1624,1588,36,1,18,54
1,1732,1174,558,0,49,79
-1,1533,1732,-199,-1,52,82
1,1523,1553,-30,-1,112,93
1,1704,1729,-25,3,353,123
-1,1388,1421,-33,-1,-116,96
-1,1799,1821,-22,0,67,100
-1,1980,1964,16,-2,-12,42
-1,1429,1465,-36,-3,-35,66
-1,1531,1448,83,3,661,86
1,1546,1546,0,0,169,87
1,1311,1248,63,-2,-53,49
1,1531,1486,45,1,55,63
-1,1666,1602,64,0,0,110
1,1869,1886,-17,-3,50,57
-1,1461,1569,-108,-7,-119,48
1,1976,1969,7,1,63,63
-1,1299,1576,-277,0,5,70
1,1600,1533,67,1,121,59
1,1874,1880,-6,-1,-51,55
-1,1434,1524,-90,4,110,58
1,1733,1558,175,0,313,115
1,1776,1846,-70,-2,12,61
1,1981,1926,55,0,10,55
-1,1679,1661,18,-1,197,162
-1,1576,1509,67,-4,-194,72
1,1789,1540,249,1,183,93
-1,1613,1550,63,0,-621,230
-1,1398,1657,-259,-2,-75,50
1,2172,1986,186,0,11,55
0,1835,1817,18,1,94,110
1,1707,1500,207,3,255,91
-1,1749,1751,-2,5,-100,112
-1,1889,1808,81,-1,-57,58
1,1766,1515,251,1,0,49
-1,1532,1397,135,-3,-77,67
-1,1371,1467,-96,-9,-231,57
-1,1556,1476,80,1,30,52
-1,1475,1608,-133,0,-12,56
-1,1869,1681,188,5,76,42
1,1511,1770,-259,0,-158,65
-1,1585,1651,-66,-8,-792,101
-1,1831,1901,-70,0,-5,56
-1,1548,1591,-43,3,-55,58
1,1677,1541,136,5,353,87
0,1433,1446,-13,-1,-468,113
-1,1542,1675,-133,0,-55,70
1,1649,1646,3,3,136,69
1,1529,1551,-22,0,10,57
1,1793,1665,128,0,-2,55
1,1667,1490,177,-1,-71,85
-1,1575,1881,-306,0,4,80
-1,1542,1654,-112,-5,-88,60
1,1291,1613,-322,-3,-69,47
0,1927,1822,105,-2,-361,202
-1,1837,1780,57,-3,4,50
-1,1534,1685,-151,-2,-68,74
-1,1540,1660,-120,-2,-96,62
-1,1263,1289,-26,5,248,54
1,1534,1485,49,9,208,52
-1,1663,1961,-298,-1,-108,82
-1,1737,1762,-25,-3,-52,44
1,1354,1483,-129,-4,-68,75
1,1617,1793,-176,0,-131,77
-1,1741,1576,165,-2,-74,98
-1,1527,1562,-35,0,-52,68
-1,1714,1837,-123,-1,-45,64
-1,1663,1654,9,1,17,46
1,1299,1253,46,-2,107,119
1,1411,1708,-297,-1,51,45
1,1382,1320,62,0,184,80
1,1225,1412,-187,4,237,61
-1,1486,1458,28,0,-327,116
-1,1534,1423,111,-1,-37,52
1,1594,1556,38,0,19,73
1,1434,1443,-9,10,247,55
1,1740,1681,59,-3,-63,43
1,1630,1468,162,1,6,52
-1,1339,1580,-241,-13,-364,51
1,1244,1308,-64,0,331,77
1,1764,1759,5,2,40,59
1,1570,1530,40,4,181,73
-1,1576,1660,-84,0,9,74
1,1821,1835,-14,0,13,51
1,1775,1737,38,0,-90,101
1,1672,1875,-203,0,7,67
1,1532,1809,-277,0,146,75
1,1296,1256,40,0,-47,51
-1,1670,1766,-96,-11,-455,66
1,1805,1652,153,-1,-5,73
-1,1519,1527,-8,-7,-317,56
-1,1778,1672,106,-3,-30,72
1,1800,1637,163,1,36,77
1,1427,1446,-19,5,231,113
1,1824,1792,32,-2,8,41
1,1852,1538,314,-3,80,95
1,1604,1656,-52,1,49,79
-1,1700,1875,-175,-1,-184,86
1,1682,1507,175,0,1,45
1,1247,1305,-58,12,507,55
1,1462,1261,201,1,397,103
1,1536,1538,-2,2,56,61
1,1470,1315,155,-1,48,47
-1,1370,1561,-191,1,-1,46
-1,1645,1813,-168,1,31,84
-1,1679,1523,156,0,-274,100
1,1712,1547,165,0,-41,123
-1,1453,1838,-385,-2,-62,50
1,1597,1707,-110,1,14,51
-1,1785,1645,140,-18,-200,40
1,1598,1500,98,6,98,41
-1,1270,1399,-129,0,26,72
1,1689,1821,-132,-2,383,141
-1,1660,1770,-110,-4,-472,106
-1,1571,1769,-198,1,29,80
1,1713,1552,161,-1,288,85
1,1500,1665,-165,3,117,69
-1,1271,1282,-11,4,231,88
-1,1508,1567,-59,-2,-14,58
1,1542,1500,42,18,491,51
1,1778,1652,126,0,110,65
-1,1348,1224,124,-10,-85,46
-1,1773,1500,273,-1,27,98
1,1538,1521,17,3,198,61
-1,1645,1785,-140,0,-387,108
1,1668,1548,120,0,158,87
-1,1523,1630,-107,2,-36,74
-1,1549,1582,-33,-2,-56,82
-1,1292,1261,31,3,61,70
-1,1948,2088,-140,0,-59,94
0,1318,1590,-272,-2,395,141
-1,1389,1404,-15,3,16,72
1,1567,1706,-139,0,112,101
-1,1473,1311,162,1,148,75
-1,1434,1614,-180,-4,-355,70
-1,1272,1280,-8,6,237,56
-1,1605,1656,-51,-1,-28,64
1,1499,1732,-233,0,11,43
1,1500,1500,0,-2,-78,86
-1,1389,1467,-78,-5,-171,162
-1,1562,1678,-116,-1,-70,58
1,1510,1549,-39,-2,-123,83
1,1547,1628,-81,0,109,137
1,1605,1783,-178,-1,72,69
1,1500,1717,-217,0,78,79
0,1367,1477,-110,-7,-993,96
1,1774,1662,112,1,16,43
1,1845,1825,20,-2,28,81
-1,1517,1715,-198,-1,-15,48
1,1364,1680,-316,7,339,73
-1,1965,1897,68,0,-31,66
1,1465,1479,-14,9,132,51
1,1591,1580,11,2,144,59
1,1542,1552,-10,-1,-5,59
1,1273,1279,-6,10,445,71
1,1958,1822,136,6,187,57
1,1673,1696,-23,0,-22,55
1,1783,1500,283,2,63,55
-1,1414,1378,36,1,-10,70
1,1511,1638,-127,-4,-166,81
-1,1615,1561,54,1,-120,84
1,1371,1201,170,-3,-73,77
1,1655,1751,-96,0,204,97
1,1269,1284,-15,5,310,71
-1,1537,1522,15,-1,212,86
1,1849,1578,271,1,381,157
-1,1965,1815,150,1,39,84
-1,1427,1617,-190,-5,-48,40
-1,1501,1823,-322,6,5,122
-1,1238,1364,-126,-6,-145,46
1,1438,1636,-198,0,153,171
-1,1638,1689,-51,-4,-441,138
1,1815,1863,-48,0,54,71
-1,1144,1306,-162,-21,-640,48
1,1273,1280,-7,10,729,85
1,1782,1558,224,7,202,55
-1,1583,1916,-333,-1,-95,70
-1,1475,1670,-195,0,277,110
-1,1531,1674,-143,1,-265,128
-1,1619,1467,152,-1,-12,40
1,1761,1622,139,0,48,71
-1,1424,1787,-363,-7,-72,46
-1,1686,1863,-177,0,-142,112
-1,1557,1476,81,1,-46,134
-1,1273,1280,-7,0,-59,74
1,1434,1408,26,2,6,89
1,1391,1365,26,2,93,67
-1,1555,1470,85,0,-538,108
1,1534,1525,9,-2,-60,73
1,1787,1577,210,1,467,99
1,1421,1243,178,4,95,43
-1,1578,1540,38,0,-50,68
0,1573,1602,-29,6,102,41
1,1950,2095,-145,0,-6,73
1,1377,1111,266,3,31,45
1,1453,1248,205,2,386,103
1,1828,1843,-15,0,46,57
1,1629,1686,-57,-4,-180,79
-1,1554,1672,-118,0,-193,90
1,1563,1383,180,0,-7,43
1,1770,1778,-8,2,3,41
-1,1290,1263,27,-13,-648,72
1,1722,1638,84,2,36,63
-1,1654,1657,-3,-2,-537,136
1,1972,1752,220,0,122,79
-1,1471,1679,-208,-9,-567,82
-1,1790,1987,-197,-2,-3,84
1,1601,1574,27,2,248,101
1,1768,1630,138,3,605,153
1,1623,1374,249,1,406,91
-1,1517,1410,107,0,-255,86
1,1151,1603,-452,13,340,61
-1,1396,1705,-309,-1,-84,54
-1,1911,1984,-73,0,-29,76
1,1604,1041,563,13,617,65
-1,1378,1334,44,-3,-164,56
1,1236,1428,-192,3,231,61
-1,1268,1284,-16,-4,-267,68
-1,1623,1775,-152,0,-351,124
1,2079,1824,255,2,72,51
-1,1536,1584,-48,2,35,42
-1,1766,1782,-16,-1,-133,80
0,1294,1259,35,10,455,86
-1,1478,1503,-25,-1,-25,42
-1,1572,1793,-221,0,-173,100
-1,1720,1649,71,0,5,50
-1,1781,1617,164,3,43,42
-1,1591,1690,-99,0,-14,70
1,1472,1401,71,0,66,63
1,1839,1735,104,2,65,63
-1,1784,1951,-167,1,-209,105
-1,1633,1766,-133,-1,-15,46
-1,1295,1532,-237,0,130,76
1,1668,1640,28,0,24,45
0,1564,1611,-47,-3,85,118
1,1700,1685,15,1,26,43
0,1579,1710,-131,-1,-78,55
-1,1366,1408,-42,-3,-13,56
-1,1431,1619,-188,0,107,126
0,1773,1626,147,2,-23,139
1,1260,1293,-33,2,85,91
-1,1646,1528,118,-3,-653,114
1,1132,1679,-547,-1,-65,103
1,1424,1502,-78,0,73,113
1,1448,1348,100,4,410,103
-1,1628,1679,-51,-3,-141,50
1,1221,1570,-349,-9,-23,41
-1,1726,1847,-121,1,-162,125
1,1418,1455,-37,0,-2,53
1,1040,1605,-565,-8,-175,53
1,1282,1271,11,-2,-49,87
-1,1789,1303,486,-5,-213,58
1,1703,1454,249,4,55,45
-1,1775,1623,152,-2,-166,100
-1,1364,1374,-10,-1,100,92
-1,1628,1688,-60,1,24,102
0,1611,1654,-43,1,63,143
1,1818,1730,88,-2,52,137
1,1261,1292,-31,-4,-194,57
-1,1410,1623,-213,-15,-441,52
-1,1475,1536,-61,-2,-43,48
-1,1193,1158,35,3,32,80
-1,2002,2069,-67,-4,-184,68
1,1556,1619,-63,-2,-58,63
-1,1588,1632,-44,-4,-87,61
1,1525,1195,330,8,623,69
1,1639,1760,-121,1,-28,63
1,1519,1444,75,-3,-200,87
1,1961,1882,79,-2,6,79
1,1583,1676,-93,1,56,65
-1,1478,1576,-98,0,-17,50
-1,1281,1272,9,-4,-47,42
-1,1979,1924,55,0,200,104
1,1200,1351,-151,0,6,83
1,1752,1787,-35,-4,-49,45
1,1857,1501,356,2,116,117
-1,1488,1608,-120,-8,-215,50
1,1727,1562,165,0,1,73
-1,1404,1798,-394,-4,-296,64
1,1699,1685,14,3,151,71
1,1260,1293,-33,10,399,63
1,1500,1718,-218,-3,206,72
1,1500,1398,102,4,115,56
-1,1607,1569,38,-3,-169,76
1,1582,1602,-20,1,12,45
1,1877,1732,145,3,69,45
-1,1664,1406,258,0,4,58
1,1697,1621,76,3,150,67
1,1281,1271,10,4,121,55
1,1708,1508,200,1,90,53
-1,1697,1618,79,-1,27,44
-1,1509,1309,200,3,54,52
1,1489,1778,-289,3,659,111
1,1323,1563,-240,3,149,66
1,1976,1874,102,1,-39,69
1,1967,1938,29,0,274,95
-1,1261,1291,-30,0,-320,90
1,1705,1713,-8,-4,71,56
1,1649,1331,318,6,16,43
-1,1500,1354,146,-2,-42,60
-1,1680,1603,77,0,24,50
1,1661,1481,180,3,272,67
-1,1673,1826,-153,0,-91,74
1,1380,1509,-129,-1,-27,43
1,1301,1252,49,3,38,69
-1,1491,1507,-16,0,-22,60
1,1553,1617,-64,-1,-6,47
1,1424,1645,-221,-1,-19,47
-1,1494,1278,216,1,-98,90
1,1337,1317,20,4,443,87
-1,1666,1598,68,-1,-151,70
1,1573,1854,-281,-2,-56,71
-1,1417,1607,-190,5,93,46
1,1830,1654,176,0,117,129
-1,1328,1380,-52,1,26,56
-1,1706,1927,-221,-1,-48,77
1,1589,1684,-95,5,121,51
0,1396,1163,233,-7,-331,68
1,1500,1343,157,-2,-89,73
-1,1578,1276,302,-1,34,60
1,1649,1382,267,2,313,89
1,1799,1910,-111,0,85,87
1,1267,1286,-19,1,133,69
-1,1391,1631,-240,2,39,51
-1,1594,1605,-11,-6,-786,104
1,1534,1334,200,1,-84,91
-1,1706,1515,191,0,1,51
1,1387,1669,-282,0,42,55
-1,1456,1626,-170,4,146,58
1,1478,1571,-93,2,310,77
1,1675,1726,-51,-2,-45,59
-1,1370,1339,31,1,0,52
1,1411,1294,117,-3,371,109
-1,1483,1419,64,0,-5,84
1,1700,1932,-232,-1,324,109
-1,1275,1278,-3,-5,-365,96
1,1754,1460,294,2,29,41
-1,1528,1586,-58,-7,-173,46
-1,1198,1390,-192,-3,-665,110
1,1535,1621,-86,1,439,71
1,1500,1881,-381,-4,58,69
-1,1513,1483,30,0,19,48
1,1717,1670,47,1,31,45
1,1288,1265,23,12,-12,41
-1,1603,1772,-169,-12,-316,57
-1,1707,1500,207,0,-71,64
1,1528,1396,132,-3,-45,53
1,1645,1616,29,0,16,53
1,1391,1359,32,10,404,67
-1,1492,1360,132,-1,52,74
-1,1497,1758,-261,-4,98,86
1,1512,1518,-6,-2,-27,65
1,1977,1834,143,-2,-8,45
1,1473,1413,60,1,110,53
1,1425,1779,-354,0,325,95
1,1519,1329,190,-3,41,94
1,1983,2078,-95,3,74,65
1,1484,1818,-334,-2,-108,69
0,1752,1683,69,0,20,52
1,1687,1387,300,4,222,65
1,1913,2121,-208,0,51,99
1,1514,1558,-44,-1,456,109
-1,1384,1366,18,1,14,48
1,1597,1738,-141,0,0,47
1,1396,1171,225,5,110,43
1,1574,978,596,2,177,63
-1,1340,1450,-110,-5,-15,42
0,1567,1589,-22,-3,71,147
1,1441,1435,6,0,9,69
-1,1605,1659,-54,2,-71,148
-1,1158,1442,-284,-1,-27,68
1,1983,1822,161,0,33,79
1,1421,1506,-85,4,195,85
-1,1707,1839,-132,-2,-49,54
-1,1466,1751,-285,-8,-503,80
-1,1351,1543,-192,3,-326,80
1,1628,1550,78,-1,-14,83
1,1401,1149,252,-5,-402,99
-1,1583,1387,196,-8,-168,54
1,1997,1816,181,0,138,63
-1,1477,1647,-170,0,-137,116
-1,1243,1496,-253,-9,-311,54
-1,2064,1992,72,0,-77,54
1,1457,1860,-403,-2,-27,67
1,1541,1637,-96,-8,-587,89
1,1540,1342,198,1,128,72
1,1457,1459,-2,0,337,93
1,2103,1932,171,0,63,63
1,1516,1445,71,3,126,57
1,1784,1446,338,0,-5,53
1,1446,1104,342,2,59,55
-1,1401,1598,-197,1,69,78
1,1767,1800,-33,0,92,87
1,1478,1476,2,3,131,53
-1,1728,1661,67,0,14,88
-1,1517,1521,-4,1,2,52
-1,1417,1526,-109,3,-24,42
1,1696,1867,-171,-2,28,51
1,1476,1579,-103,6,1003,93
-1,1810,1898,-88,-1,-48,72
-1,1619,1873,-254,-9,-113,40
0,1627,1692,-65,-8,-443,82
1,1798,1546,252,0,243,107
1,1625,1790,-165,13,822,81
1,1567,1684,-117,1,14,45
1,1703,1549,154,-3,228,99
-1,1925,2109,-184,-1,-22,48
1,1878,1614,264,1,88,53
1,1514,1615,-101,4,57,45
-1,1419,1288,131,2,49,54
-1,2006,2051,-45,0,-18,58
1,1830,1391,439,8,853,93
1,1500,1238,262,6,156,51
1,1610,1882,-272,3,131,59
-1,1534,1403,131,-1,-76,56
1,1750,1688,62,-2,-197,133
-1,1505,1575,-70,0,-453,152
-1,1662,1619,43,-1,-97,118
-1,1556,1732,-176,-6,-237,64
1,1471,1418,53,1,269,73
-1,1383,1722,-339,0,-633,118
1,2010,2116,-106,0,101,133
1,1534,1428,106,2,82,71
1,1283,1328,-45,0,48,59
-1,1659,1446,213,-4,-67,64
0,1712,1670,42,1,15,108
1,1643,1850,-207,1,49,69
-1,1773,1759,14,1,-41,102
1,1501,1394,107,1,258,93
-1,1837,1575,262,1,-102,84
-1,1336,1546,-210,-1,-290,88
1,1762,1493,269,0,41,77
-1,1602,1542,60,2,105,76
1,1529,1340,189,2,165,71
-1,1625,1275,350,-3,-748,114
-1,1629,1690,-61,3,214,100
1,1659,1528,131,-4,-463,91
1,1720,1803,-83,-1,77,53
1,1919,1794,125,0,7,43
-1,1884,1585,299,-8,-627,122
-1,1502,1634,-132,-4,-113,50
1,1771,1761,10,0,-2,65
1,1849,1696,153,1,24,45
-1,1707,1977,-270,2,-169,104
1,1679,1816,-137,-1,-29,55
1,2100,1866,234,1,107,95
-1,2024,2061,-37,-5,-254,68
-1,1498,1517,-19,0,-221,134
0,1672,1711,-39,-1,11,135
-1,1420,1542,-122,-1,-64,60
1,1787,1927,-140,-1,51,99
1,1406,1213,193,-6,41,107
-1,1480,1643,-163,0,-441,110
-1,1393,1907,-514,-2,-296,84
1,1800,1696,104,-2,-33,51
1,1789,1858,-69,1,127,123
1,1782,1605,177,-1,-16,45
0,1850,1744,106,0,133,144
-1,1406,1392,14,-9,-655,70
-1,1415,1735,-320,2,124,72
-1,1687,1808,-121,-1,-44,56
-1,1912,1682,230,4,51,52
1,1550,1412,138,1,51,73
1,1587,1567,20,16,222,41
1,1543,1711,-168,-3,-204,87
-1,1363,1428,-65,0,-71,60
1,1788,1619,169,-2,-21,67
0,2015,2070,-55,0,11,93
-1,1816,1679,137,1,-42,56
1,1509,1673,-164,0,119,71
1,1488,1651,-163,-1,-34,45
1,1505,1413,92,1,164,79
1,1534,1500,34,-5,-276,111
1,1696,1800,-104,4,51,47
-1,1555,1534,21,0,2,66
1,1566,1366,200,-6,-454,123
1,1853,1543,310,-1,20,45
1,1709,1673,36,1,126,91
1,1589,1679,-90,12,879,89
1,1613,1794,-181,-4,441,113
1,1786,1711,75,0,169,73
-1,1545,1584,-39,-3,-96,72
1,1900,1985,-85,0,13,65
-1,1530,1750,-220,-3,-96,80
1,1910,1802,108,-1,34,85
1,1392,1717,-325,-5,-98,99
1,1857,1539,318,-2,289,91
1,1527,1487,40,2,74,53
-1,1487,1540,-53,-2,-78,70
1,1749,1386,363,2,47,47
-1,1701,1795,-94,0,-151,75
-1,2016,2069,-53,0,-312,126
-1,1611,1862,-251,0,-15,82
1,1543,1546,-3,1,62,69
1,1787,1642,145,3,343,75
1,1489,1354,135,2,223,67
1,1557,1330,227,4,250,75
-1,1736,1686,50,0,-17,62
1,1834,1609,225,0,85,95
-1,1748,1966,-218,0,-1,46
-1,1578,1808,-230,-1,-247,98
0,1676,1793,-117,5,144,97
1,1955,1991,-36,-2,-91,79
-1,1396,1788,-392,-2,-35,52
1,1620,1101,519,6,116,51
-1,1759,1797,-38,-3,-108,68
1,1722,1778,-56,-6,6,75
1,1635,1616,19,-1,65,80
1,1998,1520,478,-3,-17,95
1,1411,1518,-107,-3,-290,149
1,1822,1793,29,0,107,91
-1,1746,2060,-314,0,2,104
-1,1449,1678,-229,-4,-18,46
1,1489,1629,-140,0,6,41
-1,1324,1207,117,-1,-10,50
-1,1449,1379,70,4,-49,114
1,1822,1573,249,2,347,93
1,1710,1146,564,-2,66,57
-1,1775,1671,104,-4,-235,83
-1,1530,1469,61,-2,192,80
0,1467,1466,1,-3,-7,71
-1,1619,1835,-216,-2,-93,76
1,1967,1843,124,-4,337,125
-1,1547,1664,-117,-7,-72,50
1,1799,1742,57,0,0,43
-1,1158,1393,-235,3,140,78
1,1769,1561,208,1,39,55
-1,1704,1444,260,-1,-6,46
1,1504,1389,115,-2,-65,43
-1,1568,1760,-192,0,-225,146
-1,1642,1769,-127,-6,-13,40
0,1662,1596,66,1,87,69
0,1791,1638,153,0,6,67
1,1404,1634,-230,-2,-146,103
1,1893,1712,181,2,95,69
-1,1613,1848,-235,-8,-917,134
1,1369,1439,-70,3,163,75
1,1679,1317,362,1,38,57
1,1777,1592,185,3,134,59
1,1310,1326,-16,0,18,73
1,1612,1307,305,0,6,45
1,1766,1561,205,0,62,57
-1,1379,1474,-95,3,-213,112
-1,1738,1607,131,-1,-69,74
1,1971,1737,234,0,371,129
1,1877,1860,17,5,199,53
1,1614,1596,18,0,56,75
1,1974,1961,13,1,48,73
0,1720,1461,259,-1,44,162
1,1860,1608,252,4,123,73
1,1564,1383,181,3,79,51
1,1889,1321,568,3,43,49
-1,1734,1775,-41,0,-237,78
1,1244,1314,-70,3,117,57
-1,1551,1878,-327,0,-1,108
1,1398,1424,-26,-3,-318,105
-1,1440,1625,-185,-1,-149,94
-1,1398,1345,53,-1,-276,112
1,1783,1890,-107,-3,-108,79
-1,1705,1900,-195,1,67,72
1,1504,1318,186,-3,-81,79
1,1472,1548,-76,-1,47,69
0,1883,1512,371,1,0,63
1,1872,1555,317,2,51,57
1,1786,1403,383,-5,2,69
-1,1497,1750,-253,-2,-135,82
1,1881,2104,-223,5,496,93
1,1721,1584,137,0,24,47
-1,1425,1382,43,-3,-137,52
1,1532,1490,42,-3,-106,63
-1,1685,1677,8,-1,-77,106
1,1892,1781,111,0,67,67
-1,1682,1615,67,0,-76,132
-1,1785,1725,60,-3,-36,50
1,1544,1674,-130,12,446,59
-1,1444,1599,-155,-1,-115,100
-1,1603,1871,-268,-4,-103,56
1,1794,1787,7,3,162,69
1,2084,1920,164,2,104,121
-1,1577,1729,-152,0,-37,104
-1,1479,1543,-64,3,-7,44
1,1394,1299,95,4,224,75
1,1458,1627,-169,0,102,77
1,1783,1469,314,0,-3,87
-1,1410,1907,-497,-5,-39,46
1,1500,1621,-121,1,80,53
-1,1520,1520,0,5,103,40
1,1571,1488,83,1,30,51
0,1182,1386,-204,3,249,109
0,1554,1376,178,-2,-43,129
1,1518,1508,10,6,589,91
1,1568,1514,54,-1,-81,47
-1,1395,1413,-18,-2,-20,46
1,1659,1562,97,0,469,159
1,1456,1415,41,-2,-38,47
1,1925,1773,152,1,23,43
-1,1365,1346,19,1,-298,106
-1,1907,2091,-184,1,-183,130
1,1532,1509,23,-5,-97,63
1,1789,1276,513,-5,80,65
1,1737,1772,-35,-5,34,81
-1,1579,1775,-196,-9,-145,52
1,1901,1560,341,16,1101,79
-1,1598,1617,-19,0,-43,46
-1,1736,1570,166,1,53,64
1,1738,1265,473,1,321,69
-1,1498,1543,-45,0,-160,100
-1,1808,2083,-275,0,5,54
-1,1412,1550,-138,0,-15,64
1,1623,1647,-24,-6,-135,49
-1,1344,1315,29,1,-304,88
-1,1515,1300,215,0,-247,96
-1,1557,1904,-347,1,39,66
-1,1378,1596,-218,-2,-48,60
-1,1909,1766,143,0,102,82
1,1646,1631,15,1,30,53
1,1474,1454,20,-3,-60,53
-1,1701,1899,-198,-6,-24,42
0,1558,1383,175,1,50,84
1,1907,1554,353,3,115,51
-1,1733,1781,-48,2,65,62
1,1290,1379,-89,6,107,51
1,1402,1314,88,2,102,55
1,1574,1692,-118,-1,-31,61
-1,1628,1668,-40,-1,-222,70
1,2088,1804,284,4,140,55
1,1667,1552,115,-2,358,105
-1,1910,1695,215,1,1,226
-1,1533,1446,87,-4,122,84
-1,1656,1488,168,-2,-311,96
-1,1671,1717,-46,1,-32,54
1,1384,1099,285,6,359,59
1,1912,1549,363,3,1205,113
1,1759,1749,10,2,223,85
-1,1402,1553,-151,-1,-102,86
0,1311,1366,-55,3,643,105
-1,1508,1626,-118,5,154,52
1,1447,1423,24,9,133,41
-1,1403,1419,-16,-15,-323,56
-1,1790,1497,293,-1,-138,122
-1,1622,1745,-123,-4,-138,58
-1,1546,1915,-369,5,22,46
-1,1766,1586,180,0,27,112
1,1677,1588,89,0,126,59
1,2092,1801,291,0,56,62
1,1505,1641,-136,0,-8,53
1,1560,1379,181,0,111,78
1,1918,1543,375,-5,655,99
1,1792,1556,236,-2,77,69
-1,1315,1725,-410,-13,-286,44
1,1675,1586,89,2,239,107
1,1784,1544,240,4,683,117
1,1893,1233,660,7,251,55
-1,1713,1921,-208,-1,-125,70
1,1727,1662,65,0,126,81
1,1889,1686,203,4,90,61
-1,1532,1388,144,-10,-423,168
-1,1360,1566,-206,-3,-34,50
-1,1556,1613,-57,-17,-438,50
1,1633,1604,29,2,98,57
1,1305,1411,-106,4,330,91
-1,1469,1520,-51,-2,-83,63
-1,1707,1927,-220,-3,-30,46
-1,1818,1780,38,4,12,66
-1,1622,1546,76,3,202,96
1,1877,1849,28,0,71,81
-1,1413,1457,-44,-8,-321,78
1,1572,1344,228,1,36,56
-1,1639,1534,105,-3,-71,192
1,1738,1770,-32,-1,-94,57
1,2097,1835,262,3,7,43
-1,1535,1313,222,-3,-34,102
-1,1560,1609,-49,-4,-625,124
1,1750,1474,276,1,-4,64
1,1727,1565,162,0,25,63
-1,1976,2026,-50,-1,-86,86
-1,1530,1933,-403,-1,-109,72
-1,1577,1576,1,-2,-137,78
1,1683,1797,-114,0,173,105
1,1618,1550,68,3,268,69
-1,1680,1896,-216,-4,-92,56
1,1522,1468,54,2,238,81
-1,1364,1349,15,1,-12,70
1,1303,1242,61,0,-6,43
-1,1627,1540,87,18,874,66
1,2051,1966,85,0,52,57
1,1339,1332,7,-1,281,95
-1,1392,1528,-136,1,98,106
-1,1702,1935,-233,-2,-8,60
0,1470,1469,1,-1,-121,116
-1,1271,1754,-483,-4,-117,52
-1,1461,1519,-58,-2,-253,104
1,1740,1324,416,3,123,71
-1,1368,1519,-151,-3,-155,62
1,1411,1271,140,2,88,57
1,1903,1275,628,-5,55,47
1,1552,1469,83,1,12,65
-1,1330,1578,-248,-1,-74,61
1,1758,1750,8,1,221,69
1,1333,1233,100,0,156,83
-1,1534,1310,224,-3,-509,122
-1,1337,1469,-132,-3,-219,64
1,1589,1374,215,1,41,51
-1,1683,1719,-36,1,75,58
1,1746,1421,325,4,605,85
1,1692,1946,-254,-1,415,91
1,1653,1655,-2,-1,60,67
-1,1498,1540,-42,0,-49,62
-1,1950,1938,12,-1,-37,54
0,1742,1688,54,-3,-51,165
1,1542,1354,188,0,36,73
1,1499,1571,-72,0,-17,65
-1,1523,1711,-188,2,67,94
1,1635,1925,-290,-2,-18,43
-1,1501,1674,-173,-4,-216,74
1,1500,1314,186,0,2,91
1,1740,1769,-29,2,204,93
1,1520,1516,4,-1,183,69
-1,1403,1750,-347,-3,-92,52
1,1480,1634,-154,-1,-13,51
1,1803,1803,0,-1,-21,57
1,1717,1621,96,-2,299,135
-1,1811,1929,-118,0,-1,86
-1,1264,1418,-154,0,-6,50
1,1754,1550,204,0,11,121
1,1382,1094,288,3,368,65
1,1670,1699,-29,0,-11,79
-1,1619,1341,278,-8,-43,40
1,2180,1403,777,0,66,75
-1,1938,1803,135,0,-86,70
1,1795,1718,77,0,-27,53
-1,1631,1867,-236,-1,-106,80
-1,1590,1403,187,-2,-10,54
1,1447,1321,126,3,210,57
1,1503,1519,-16,0,1,53
1,1789,1059,730,-1,19,51
1,1608,1601,7,-1,78,53
1,1404,1378,26,0,-11,97
1,1528,1451,77,2,45,55
1,1753,1548,205,0,8,53
-1,1740,1947,-207,-1,-68,46
-1,1467,1578,-111,1,-15,60
-1,1982,1921,61,-5,-56,56
-1,1505,1530,-25,-2,-13,48
-1,1605,1470,135,3,-3,68
-1,1820,2098,-278,0,19,80
1,1566,1515,51,7,160,51
0,1759,1686,73,3,134,97
-1,1403,2181,-778,0,45,100
-1,1935,1968,-33,0,-12,94
1,1757,1751,6,0,40,65
-1,1760,1690,70,1,-8,80
1,1617,1499,118,2,583,105
-1,1541,1494,47,-3,-52,40
-1,1726,1540,186,0,-42,56
-1,1551,1437,114,0,-17,116
-1,1767,1771,-4,0,50,72
1,1570,1558,12,1,35,103
1,1380,1188,192,-1,36,49
1,1426,1257,169,5,80,47
1,2103,1815,288,0,137,89
-1,1637,1666,-29,-5,-66,42
1,1798,1717,81,2,30,53
-1,1451,1675,-224,0,-11,50
1,1238,1100,138,6,135,55
-1,1629,1685,-56,5,236,72
1,2181,1402,779,4,107,57
1,1590,1620,-30,13,451,65
1,1989,1914,75,0,126,67
1,1757,1688,69,2,-7,45
-1,1378,1367,11,-3,-88,114
-1,1089,1385,-296,-20,-782,64
-1,1805,1797,8,-1,-34,78
-1,1365,1507,-142,-2,-89,64
1,1333,1327,6,0,147,47
1,1865,1528,337,2,562,91
1,1734,1704,30,1,131,111
-1,1741,1768,-27,-1,142,76
1,1516,1450,66,0,21,73
-1,1904,1999,-95,0,-47,70
1,1552,1580,-28,0,75,119
0,1482,1600,-118,-3,67,160
1,1679,1591,88,1,173,99
1,1412,1456,-44,4,365,77
-1,1532,1348,184,-5,-24,50
1,1680,1446,234,-2,-61,103
1,1869,1526,343,-3,62,79
-1,1504,1553,-49,1,8,90
-1,1705,1831,-126,-8,-320,61
1,1415,1377,38,8,261,47
-1,1134,1347,-213,-5,-74,44
-1,1490,1625,-135,1,-265,108
-1,1766,1716,50,0,-40,80
-1,1380,1352,28,4,167,50
-1,1582,1738,-156,0,-48,92
-1,1390,1817,-427,-8,-295,68
1,1777,1872,-95,-1,-7,41
1,1593,1476,117,1,28,43
1,1953,1966,-13,2,62,51
1,1855,1791,64,-2,54,131
-1,1623,1657,-34,-5,-301,110
0,1492,1676,-184,-3,-328,134
1,1808,1697,111,-4,-6,49
-1,1476,1536,-60,-2,-382,78
1,1423,1598,-175,0,21,67
-1,1250,1433,-183,0,81,88
-1,1782,1866,-84,-3,-28,40
-1,1348,1401,-53,-4,-196,72
-1,1756,1895,-139,1,-343,76
-1,1066,1260,-194,-3,2,72
-1,1903,2007,-104,-1,-16,62
-1,1607,1994,-387,0,27,40
1,1441,1352,89,10,291,47
1,1305,1389,-84,0,-45,65
1,1821,1838,-17,1,358,107
-1,1493,1581,-88,-3,-122,60
1,1742,1735,7,0,12,107
0,1225,1084,141,8,581,97
-1,1284,1368,-84,-6,-470,74
-1,1894,1876,18,0,20,78
-1,1626,1379,247,0,125,110
1,1729,1685,44,-2,62,71
1,1485,1384,101,0,14,67
-1,1514,1728,-214,0,-55,108
-1,1388,1181,207,-8,-851,116
1,1745,1384,361,0,81,91
1,1344,1203,141,3,136,54
0,2001,1605,396,0,49,154
0,1589,1613,-24,0,5,141
1,1688,1365,323,1,67,115
1,1889,1882,7,0,-169,91
-1,1450,1500,-50,-10,-150,50
-1,1856,1709,147,0,-37,86
1,1827,1697,130,1,215,90
-1,1482,1410,72,-3,-101,64
-1,1563,1848,-285,0,-233,120
1,1493,1496,-3,0,6,57
1,1842,2107,-265,0,108,81
-1,1402,1514,-112,4,437,103
-1,1590,1871,-281,-5,-122,98
1,1710,1562,148,3,429,145
0,1739,1670,69,0,-122,129
1,1587,1319,268,4,248,77
-1,1365,1368,-3,-3,-358,96
-1,1504,1712,-208,-1,-11,66
1,1768,1816,-48,0,443,175
1,1461,1215,246,4,60,81
-1,1875,1586,289,-16,-352,50
-1,1388,1690,-302,-4,-94,56
1,1681,1513,168,5,52,43
-1,1493,1508,-15,-1,-48,68
1,1855,1538,317,5,545,91
1,1718,1605,113,-2,29,61
-1,1611,1661,-50,-3,-274,78
-1,1515,1526,-11,2,75,72
1,1509,1713,-204,0,-80,79
1,1560,1384,176,4,44,51
-1,1856,1693,163,0,-86,86
-1,1585,1258,327,0,49,86
-1,1535,1858,-323,2,285,64
1,1441,1352,89,3,180,75
1,1597,1725,-128,-10,-701,85
1,1467,1304,163,3,87,54
1,1610,1584,26,0,-16,69
1,1562,1736,-174,1,63,71
1,1571,1453,118,4,111,53
0,1825,1846,-21,1,245,225
0,1498,1311,187,-2,253,129
1,1710,1612,98,8,691,101
-1,1499,1865,-366,-7,-172,42
-1,1526,1411,115,-6,-228,64
-1,1087,1444,-357,-2,-101,54
-1,1496,1868,-372,-2,-55,52
1,1745,1841,-96,1,72,71
1,1621,1604,17,2,141,71
-1,1768,1681,87,-1,-72,58
-1,1528,1719,-191,-3,-74,78
1,1500,1728,-228,0,-20,71
-1,1494,1870,-376,-3,-48,48
-1,1556,1430,126,0,483,96
1,1631,1594,37,3,807,119
1,1782,1516,266,3,187,57
-1,1202,1365,-163,2,87,86
-1,2016,2085,-69,0,69,68
1,1724,1522,202,4,131,53
1,1695,1674,21,2,319,157
-1,1720,1634,86,1,54,66
1,1729,1862,-133,-1,26,107
-1,1491,1864,-373,-7,-50,40
1,1600,1381,219,3,189,75
1,1435,1518,-83,2,68,55
1,1641,1584,57,0,-18,73
1,1753,1479,274,-1,39,69
-1,1516,1730,-214,-1,-30,48
-1,1513,1716,-203,0,-31,64
1,1489,1512,-23,-1,-265,109
-1,1753,1791,-38,0,-70,94
-1,1607,1500,107,-8,-272,86
1,1623,1639,-16,2,236,117
1,2182,1794,388,3,107,63
1,1476,1426,50,-10,-463,99
1,1743,1731,12,1,-165,95
1,1876,1575,301,1,417,115
1,1497,1657,-160,5,837,127
-1,1501,1500,1,13,499,96
-1,1776,2096,-320,-1,-163,74
0,1475,1758,-283,0,-6,195
1,1465,1678,-213,0,127,129
-1,1512,1541,-29,-8,-297,54
-1,1550,1447,103,-4,-68,50
-1,1571,1880,-309,-5,-171,48
1,1244,1291,-47,3,75,61
1,1708,1663,45,-1,37,89
-1,1489,1802,-313,-11,-393,70
1,1520,1559,-39,-2,-268,79
-1,1870,1958,-88,1,27,52
-1,1791,2186,-395,-11,-303,50
1,1766,1744,22,2,564,93
-1,1735,1556,179,0,-35,64
1,1729,1675,54,0,-203,73
1,1744,1801,-57,0,-60,119
1,1883,1568,315,8,246,53
-1,1473,1565,-92,-5,-68,44
1,1341,1295,46,-2,-49,71
0,1227,1376,-149,-6,-923,96
-1,1486,1546,-60,1,-45,68
-1,1565,1887,-322,-11,-385,60
1,1531,1363,168,12,249,43
1,1641,1677,-36,-3,-61,45
1,1500,1343,157,-2,-96,69
0,2189,1789,400,1,-9,99
-1,1666,1744,-78,-8,-8,40
-1,1653,1562,91,-12,-1291,136
1,1452,1714,-262,5,77,41
0,1782,1500,282,-2,175,161
-1,1966,1861,105,-2,-325,158
1,1891,1533,358,1,122,61
-1,1476,1555,-79,-5,-161,76
-1,1445,1579,-134,-2,-125,74
1,1822,1722,100,-2,-57,53
-1,1500,1461,39,-16,-654,62
1,1786,1721,65,3,174,79
-1,1523,1476,47,-1,-225,104
1,1749,1377,372,3,65,49
1,1618,1725,-107,-1,-12,56
-1,1502,1416,86,-4,-191,72
1,1485,1507,-22,7,-28,83
-1,1727,1674,53,-1,76,56
1,1749,1805,-56,-1,-45,95
-1,1649,1894,-245,-5,12,40
1,1259,1455,-196,8,341,95
-1,1501,1445,56,0,-413,100
-1,1756,1788,-32,-7,-622,132
-1,1467,1564,-97,4,210,78
-1,1468,1549,-81,-9,-143,46
1,2063,1717,346,1,58,57
1,1640,1576,64,1,-32,69
1,1581,1505,76,-4,-21,63
-1,1762,1899,-137,-3,-72,54
-1,1713,1511,202,0,4,54
1,1733,1558,175,0,5,45
-1,1795,1757,38,-1,-68,76
1,1530,1545,-15,-8,-161,47
-1,1436,1478,-42,-2,-351,109
1,2178,1796,382,0,332,115
1,1907,1755,152,4,485,93
-1,1458,1572,-114,-1,178,94
1,1372,1500,-128,9,396,59
1,1632,1567,65,-3,-8,63
-1,1714,2066,-352,0,-111,102
-1,1407,1405,2,-8,-368,72
1,1752,1007,745,2,219,45
1,1578,1649,-71,-5,-51,59
-1,1748,1914,-166,1,91,90
-1,1640,1773,-133,-4,-166,72
-1,1542,1792,-250,0,-91,60
1,1450,1558,-108,0,76,91
-1,1459,1558,-99,-3,-188,64
1,1672,1974,-302,9,758,99
-1,1430,1338,92,2,-30,107
1,1451,1534,-83,4,84,55
1,1876,1952,-76,4,78,61
-1,1469,1338,131,2,-32,102
-1,1101,1407,-306,-1,-5,42
1,1622,1762,-140,-2,-67,87
1,1781,1633,148,2,179,85
1,1745,1489,256,6,650,79
-1,1373,1257,116,-7,-565,88
-1,1793,2182,-389,-1,-189,66
-1,1653,1622,31,-3,-7,46
-1,1639,1543,96,1,18,44
-1,1627,1787,-160,-2,-262,64
-1,1351,1330,21,-1,-2,67
1,1279,1210,69,2,61,51
-1,1711,1680,31,3,25,80
-1,1538,1717,-179,-2,-182,68
1,1381,1249,132,8,313,55
-1,1465,1921,-456,-1,-68,68
-1,1758,1682,76,0,-6,46
1,2186,1791,395,0,34,77
1,1529,1556,-27,4,60,53
1,1662,1337,325,7,361,61
1,1824,1552,272,-4,-15,45
-1,1265,1338,-73,-1,-37,48
-1,1557,1137,420,2,135,68
1,1743,1744,-1,1,197,91
-1,1542,1286,256,-19,-801,84
-1,1723,1796,-73,0,-29,66
-1,1784,1746,38,-1,-130,120
-1,1794,1951,-157,0,-46,74
1,1923,1833,90,-4,-292,79
1,1464,1638,-174,3,329,113
-1,1687,1714,-27,0,-76,110
-1,1411,1248,163,-6,-166,58
0,2100,1570,530,0,138,107
1,1591,1539,52,2,156,79
1,1464,1541,-77,-1,117,83
1,1698,1798,-100,1,-57,123
1,1638,1656,-18,-7,0,66
-1,1695,1754,-59,0,-35,84
-1,1417,1592,-175,-2,-94,66
-1,1777,1518,259,1,50,76
-1,1416,1427,-11,-3,-208,78
-1,1559,1501,58,-1,-7,50
1,1742,1285,457,2,133,57
0,1788,2189,-401,-1,-71,70
1,1837,1548,289,-7,-252,95
-1,1824,1933,-109,0,-9,66
1,1625,1527,98,9,105,43
-1,1805,1909,-104,0,-36,62
1,1714,1697,17,-8,-138,71
1,1365,1455,-90,0,678,103
-1,1485,1714,-229,-3,-190,62
-1,1503,1749,-246,0,-94,74
1,2088,1582,506,0,83,75
0,1876,1942,-66,0,23,67
-1,1712,1618,94,1,118,106
-1,1488,1488,0,-2,37,64
-1,1513,1446,67,0,2,100
1,1468,1500,-32,-5,-96,47
1,1765,1626,139,4,411,95
-1,1350,1804,-454,0,-8,100
1,1380,1199,181,0,130,71
1,1859,1500,359,11,460,57
-1,1939,1878,61,0,-11,76
1,1617,1869,-252,0,2,105
1,1756,1622,134,0,317,119
-1,1692,1922,-230,8,447,78
-1,1441,1864,-423,1,86,54
1,1444,1349,95,1,79,69
-1,1549,1588,-39,-1,-1,58
-1,1590,1573,17,0,137,118
1,1326,1564,-238,6,40,81
1,1704,1725,-21,-4,114,115
1,1388,1322,66,-1,433,123
1,1514,1478,36,1,51,57
-1,1391,1447,-56,-1,-19,42
-1,1451,1590,-139,-3,-147,70
-1,1933,1866,67,-3,-329,148
1,1772,1781,-9,0,416,125
1,1371,1536,-165,-1,65,126
-1,1382,1872,-490,3,-23,60
1,1314,1923,-609,0,54,65
-1,1661,1785,-124,-3,-82,81
-1,1687,1875,-188,0,-26,78
1,1988,1729,259,-3,-2,104
1,1483,1225,258,6,352,61
-1,1621,1708,-87,0,-209,134
-1,999,1301,-302,1,-60,118
-1,1477,1357,120,2,116,62
1,1884,1681,203,2,93,57
-1,1698,1670,28,1,80,104
-1,1683,1595,88,-2,-93,80
1,1500,1326,174,3,45,47
-1,1629,1777,-148,-4,-172,66
1,1469,1537,-68,1,24,63
0,1676,1893,-217,4,391,88
-1,1752,1366,386,-1,-163,118
-1,1900,1928,-28,0,153,126
1,1793,1654,139,0,152,51
1,1783,1769,14,1,108,73
-1,1340,1452,-112,0,-18,52
-1,1500,1500,0,0,-21,50
-1,1635,1862,-227,0,56,70
1,1597,1443,154,1,764,95
1,1883,1682,201,0,-6,73
-1,1457,1754,-297,-1,-89,86
-1,1941,1887,54,2,-218,132
-1,1392,1374,18,-13,-398,64
1,1756,1613,143,1,21,47
-1,1796,1623,173,0,-26,48
1,1488,1282,206,0,218,81
-1,1676,1814,-138,0,-24,76
-1,1903,1925,-22,0,87,88
1,1606,1790,-184,14,718,75
-1,1678,1905,-227,0,-44,100
1,1372,1192,180,0,181,93
1,1776,1388,388,1,46,54
0,1500,1470,30,-3,-80,141
1,1793,1758,35,0,-601,123
1,1758,1453,305,2,364,127
1,1387,1384,3,-2,-65,77
-1,1130,1435,-305,-1,75,56
-1,1495,1669,-174,-1,-333,140
-1,1435,1605,-170,2,-1,126
1,1890,1905,-15,0,137,93
1,1731,1207,524,-1,-76,69
-1,1101,1589,-488,-14,-1014,72
1,1807,1649,158,0,51,63
-1,2088,1954,134,1,91,80
1,1518,1448,70,0,155,107
-1,1717,1621,96,0,-42,66
1,1460,1325,135,0,-47,59
-1,1630,1641,-11,-1,-80,65
-1,1381,1221,160,-17,-369,46
-1,1354,1476,-122,1,-80,62
1,1993,1646,347,4,168,68
-1,1374,1444,-70,-3,-72,40
1,1445,1035,410,7,253,49
1,1520,1867,-347,0,31,141
1,1753,1638,115,-2,-39,43
1,1802,1747,55,2,-92,135
-1,1634,1661,-27,-3,-13,48
1,1735,1554,181,0,127,105
0,1477,1709,-232,-5,80,86
1,1436,1497,-61,0,171,67
1,1611,1428,183,1,268,83
-1,2073,1976,97,2,13,40
-1,1732,1616,116,0,15,74
1,1682,1763,-81,-3,-237,87
-1,1415,1296,119,-5,-144,54
-1,1584,1523,61,-3,-220,78
-1,1560,1532,28,-5,-378,72
1,1493,1698,-205,-2,15,55
1,1990,2058,-68,-1,-12,43
-1,1703,1825,-122,-1,-923,118
1,1378,1373,5,-2,259,91
0,1500,1537,-37,0,41,151
1,1814,1590,224,0,79,71
-1,1185,1801,-616,-2,-66,50
1,1272,1475,-203,4,388,79
1,1488,1500,-12,8,123,47
1,1772,1520,252,3,277,87
1,1643,1387,256,2,98,53
1,2013,1920,93,0,-163,117
-1,1632,1693,-61,-5,-281,70
-1,1996,1744,252,0,-25,80
1,1716,1380,336,-1,-96,71
-1,1757,1723,34,-1,-38,54
1,2045,2004,41,-4,27,47
-1,1340,1716,-376,2,11,48
1,1832,1696,136,5,84,52
-1,1638,1802,-164,0,-12,50
-1,1689,1675,14,-6,-375,92
1,1718,1337,381,-3,7,63
-1,1320,1354,-34,0,421,104
-1,1890,1968,-78,0,-277,174
1,1619,1606,13,-6,482,131
-1,1351,1642,-291,0,-98,56
-1,1696,1967,-271,0,-79,64
1,1648,1382,266,-1,-65,89
0,1389,1386,3,0,-223,172
1,1687,1678,9,1,163,149
1,1846,1540,306,-1,23,64
1,1737,1741,-4,1,88,119
1,1510,1703,-193,5,108,61
-1,1539,1806,-267,-1,-4,46
1,1496,1389,107,-3,31,53
1,1619,1631,-12,3,389,67
1,1975,1692,283,-1,208,133
-1,1668,1698,-30,3,-361,181
1,1463,1782,-319,-7,34,93
1,1631,1566,65,-4,-89,115
-1,1544,1548,-4,-11,-189,48
-1,1482,1461,21,0,-41,124
1,1819,1639,180,-10,85,121
-1,1949,1733,216,0,120,78
1,1536,1529,7,0,179,95
-1,1681,1840,-159,-2,-55,62
-1,2022,1973,49,0,-286,100
1,1536,1572,-36,6,262,67
-1,1702,1623,79,5,72,40
1,1685,1696,-11,3,166,91
-1,1976,1593,383,-3,-106,72
1,1688,1505,183,0,21,69
-1,1709,1892,-183,0,-58,54
-1,1847,1674,173,-8,-186,86
1,1309,983,326,8,610,139
1,1730,1749,-19,1,317,119
1,1500,1513,-13,1,55,75
1,1688,1982,-294,-3,-91,61
1,1462,1500,-38,-3,419,93
-1,1450,1673,-223,-7,-222,54
1,1569,1381,188,-2,61,77
1,1898,1658,240,3,108,51
-1,1459,1298,161,-4,-799,130
-1,1703,1821,-118,-4,-84,70
1,1898,1553,345,8,136,53
1,1499,1527,-28,-2,-115,83
1,1932,1751,181,0,75,95
1,1535,1608,-73,2,163,97
-1,1533,1483,50,-1,-491,136
1,2009,1932,77,0,3,51
-1,1550,1902,-352,0,-68,72
1,1694,1721,-27,2,86,59
-1,1636,1689,-53,-6,-607,90
-1,1497,1547,-50,-5,-146,58
1,2055,1985,70,-7,125,75
1,1677,1671,6,0,-71,63
-1,1764,2204,-440,-4,-76,70
1,1905,1547,358,3,133,59
1,1446,1481,-35,0,222,128
1,1403,1365,38,2,29,49
-1,1471,1574,-103,0,95,62
1,1654,1500,154,0,214,91
-1,1471,1518,-47,2,71,52
1,1687,1660,27,-1,25,47
-1,1471,1386,85,0,-7,74
0,1938,1912,26,-2,-264,125
1,1951,1850,101,1,163,93
-1,1697,1649,48,0,-39,86
1,1548,1766,-218,0,-4,59
1,1737,1741,-4,2,140,57
1,2018,1994,24,0,20,71
1,1509,1273,236,2,212,61
1,1511,1442,69,-3,-709,167
1,1472,1100,372,9,625,73
1,1685,1662,23,-4,-44,81
1,1557,1472,85,8,372,51
-1,1641,1652,-11,-4,-99,70
1,1697,1678,19,-5,100,85
-1,1462,1495,-33,-1,-66,62
1,1695,1652,43,4,422,99
1,1853,1908,-55,-7,-102,43
0,1612,1487,125,11,400,57
1,2028,2187,-159,3,410,161
0,1671,1611,60,0,-43,106
1,1585,1471,114,-6,-93,101
1,1466,1557,-91,0,-19,67
-1,1801,1892,-91,-2,2,96
1,1893,1866,27,-1,-16,51
-1,1923,2064,-141,0,16,50
1,1660,987,673,3,408,73
-1,1444,1677,-233,-11,-327,56
-1,1937,1913,24,0,-233,108
1,1978,1879,99,-1,-40,55
1,1666,1548,118,3,107,63
1,1642,1905,-263,5,-1,41
-1,1354,1413,-59,-3,-7,40
-1,1826,1687,139,-3,-293,106
1,1731,1748,-17,8,255,81
-1,1376,1577,-201,-9,-324,70
1,1704,1660,44,-1,-19,41
1,1463,1185,278,5,334,79
1,1774,1536,238,4,220,85
1,1704,1660,44,12,121,47
1,1713,1650,63,-3,5,49
-1,1409,1188,221,-8,-845,106
1,1499,1451,48,2,395,91
1,2026,1571,455,7,545,80
1,1963,2171,-208,1,218,89
-1,1926,1916,10,0,-102,92
1,1521,1376,145,-10,-36,49
1,1641,1484,157,0,6,63
-1,1614,1662,-48,1,5,46
-1,1817,1695,122,-3,-199,60
1,1728,1694,34,-5,-43,81
1,1559,1492,67,-1,65,75
1,1494,1491,3,1,657,127
1,1871,1987,-116,1,64,55
1,1452,1453,-1,0,-3,41
1,1648,1810,-162,0,-16,43
-1,2044,2122,-78,-3,-116,100
1,1792,1615,177,-4,37,57
1,1422,1344,78,13,301,53
-1,1663,1793,-130,0,-35,58
-1,1983,2154,-171,-2,-56,50
1,1347,1661,-314,-4,-360,69
-1,1801,1738,63,2,-134,76
1,1722,1656,66,-1,15,55
1,1737,1754,-17,0,-1,55
-1,1587,1841,-254,0,-5,58
0,1668,1709,-41,1,303,142
-1,1466,1180,286,-5,-233,72
-1,1915,1774,141,0,-94,136
1,1462,1670,-208,1,-46,73
1,1527,1234,293,0,89,89
1,1647,1693,-46,-3,-62,61
1,1463,1442,21,0,199,91
0,2035,2131,-96,0,18,132
1,1528,1344,184,4,391,87
0,1761,1380,381,0,50,121
1,2160,1928,232,4,83,47
1,1665,1505,160,-6,-45,47
-1,1609,1798,-189,0,-42,78
-1,1702,1704,-2,-4,-65,132
1,1516,1205,311,-1,-25,43
1,1430,1301,129,1,192,53
1,1521,1475,46,0,201,125
1,1338,1397,-59,13,409,55
-1,1629,1716,-87,-9,-100,44
-1,1612,1690,-78,-2,-186,92
1,1540,1637,-97,0,214,79
1,1660,1321,339,0,16,73
0,1885,1993,-108,-3,61,132
-1,1436,1334,102,0,-7,76
-1,1492,1666,-174,0,7,92
-1,1476,1509,-33,0,-229,158
1,1660,1499,161,0,40,71
1,1795,1220,575,5,130,49
1,2038,2128,-90,2,192,95
-1,1389,1751,-362,-2,-315,100
-1,1477,1675,-198,3,-321,140
1,1827,1785,42,0,-1,57
1,1751,1697,54,0,23,53
1,1684,1541,143,0,31,115
1,1534,1366,168,9,255,53
-1,1480,1735,-255,0,-4,40
1,1663,1672,-9,1,35,63
-1,1202,1145,57,-6,-432,76
1,1749,1645,104,3,25,41
1,1688,1760,-72,3,184,76
1,1421,1399,22,0,0,49
-1,1724,1850,-126,-1,-35,46
1,1739,1475,264,-3,-8,49
1,1583,1540,43,3,22,45
-1,1696,1499,197,-1,-197,64
-1,1370,1567,-197,-8,-528,94
1,1259,1293,-34,-5,41,77
-1,1809,1651,158,-2,-33,122
-1,1350,1399,-49,0,-5,58
-1,1531,1748,-217,-3,-372,116
-1,1203,1555,-352,-3,-136,56
1,1701,1704,-3,-2,217,123
-1,1747,2117,-370,1,20,62
1,1554,1521,33,9,171,43
1,1702,1809,-107,0,-19,71
1,1754,1386,368,1,174,99
-1,1603,1771,-168,1,-91,162
-1,1430,1363,67,-2,-125,66
-1,1339,1276,63,-2,-42,56
1,1990,1888,102,0,89,113
-1,1353,1540,-187,-4,-27,40
-1,1632,1611,21,-3,-60,46
-1,1463,1605,-142,0,-9,56
1,2120,1806,314,-2,-28,45
0,1458,1650,-192,-3,-1,193
-1,1217,1796,-579,-5,-228,52
1,1691,1713,-22,1,114,77
1,1187,1461,-274,-4,-92,53
-1,1419,1506,-87,-4,-21,44
-1,1384,1757,-373,-1,-223,94
1,1669,1775,-106,0,-29,71
-1,1155,1493,-338,0,-37,48
-1,1436,1429,7,-3,-66,48
-1,1701,1705,-4,-3,-115,126
1,1668,1444,224,0,66,129
1,1715,1730,-15,5,221,71
-1,1387,1482,-95,-1,1,64
-1,1576,1411,165,1,-467,84
1,1762,1577,185,0,219,93
1,1824,1593,231,0,2,91
1,1620,1398,222,-2,52,43
1,1535,1561,-26,0,95,79
-1,1364,1432,-68,-3,-94,50
1,1546,1342,204,-1,-73,67
0,1552,1456,96,6,69,41
-1,1774,2152,-378,0,-2,62
1,1355,1468,-113,-1,228,97
-1,1814,1937,-123,-4,-445,110
1,2124,1745,379,-3,71,89
-1,1520,1702,-182,-6,-106,52
-1,1690,1645,45,1,42,78
1,1500,1585,-85,-2,85,69
1,1753,1681,72,10,267,59
-1,1502,1612,-110,1,113,82
1,1787,1500,287,7,707,75
1,1983,1895,88,5,414,123
1,1657,1677,-20,0,70,75
1,1383,1625,-242,0,30,65
-1,1620,1687,-67,2,72,60
-1,1623,1624,-1,1,-3,46
1,1707,1684,23,4,185,84
1,1760,1381,379,0,689,135
1,1441,1355,86,11,406,56
-1,1627,1672,-45,4,109,52
1,1762,1717,45,5,719,101
-1,1761,1699,62,1,41,52
-1,1588,1829,-241,0,-36,82
-1,1215,1263,-48,-1,-216,110
-1,1494,1552,-58,-1,-411,70
1,1702,1547,155,0,10,49
-1,1343,1621,-278,-5,-247,92
1,1535,1332,203,1,373,99
1,1378,1572,-194,-2,39,103
-1,1640,1699,-59,-13,-173,40
-1,1197,1443,-246,-13,-144,41
1,1796,1440,356,-2,17,51
-1,1440,1455,-15,-1,-70,51
-1,1901,2031,-130,-1,-31,50
1,1623,1411,212,0,18,51
1,1674,1797,-123,3,190,81
-1,1545,1520,25,-3,-74,64
-1,1793,1716,77,-1,-94,50
1,2039,1894,145,6,44,41
-1,1379,1763,-384,-3,-251,93
-1,1617,1806,-189,-4,-82,54
1,1562,1484,78,-5,-101,99
-1,1690,1772,-82,-3,-224,86
1,1992,1682,310,0,160,97
1,1627,1376,251,9,678,69
-1,978,1346,-368,-1,-277,68
-1,1500,1481,19,-12,-830,92
-1,1620,1783,-163,0,-10,65
-1,1437,1803,-366,0,-9,62
0,1608,1432,176,0,-18,125
-1,1669,1533,136,1,1,46
-1,1653,1630,23,-6,-72,42
1,1381,1291,90,-1,-29,53
-1,1435,1448,-13,7,188,62
-1,1204,1192,12,-10,-59,42
1,1694,1654,40,0,22,111
-1,1724,1748,-24,-2,-140,96
1,1945,1797,148,1,1,43
-1,1404,1208,196,0,-9,74
-1,1610,1569,41,-1,-43,80
-1,1631,1710,-79,-2,-34,46
1,1448,1189,259,0,339,111
-1,1768,1500,268,-9,-362,68
-1,1540,1500,40,0,-107,108
1,1765,1376,389,0,48,58
1,1619,1727,-108,0,14,57
-1,1673,1718,-45,-5,-687,152
1,1475,1571,-96,0,696,107
-1,1495,1469,26,-6,-189,54
0,1772,1795,-23,0,54,104
-1,1549,1545,4,1,-521,102
-1,1976,1995,-19,-4,-8,41
-1,1494,1678,-184,2,91,134
0,1681,1790,-109,0,-20,115
1,1780,1667,113,0,8,51
-1,1556,1537,19,-4,-621,104
1,1772,1659,113,-4,-20,45
-1,1432,1401,31,1,32,66
-1,1896,1951,-55,-3,-77,78
-1,1374,1768,-394,-4,-253,72
0,1559,1460,99,0,-47,115
-1,1556,1538,18,-10,-1331,152
-1,1449,1498,-49,-1,-155,106
-1,1429,1465,-36,-2,-82,57
-1,1790,1868,-78,0,-117,76
1,1779,1619,160,-3,123,141
-1,1713,1758,-45,1,31,54
-1,1586,1564,22,-5,-258,77
-1,1613,1646,-33,0,-401,148
1,1735,1260,475,6,175,53
0,1530,1696,-166,-5,-847,92
1,1513,1409,104,-2,1,55
1,1771,1372,399,1,132,86
-1,1788,1834,-46,0,-31,112
-1,1685,1516,169,3,-456,128
-1,1474,1597,-123,-1,-92,208
0,1782,1787,-5,0,-42,126
0,0,936,-936,-6,-833,98
1,2076,1815,261,0,-4,75
-1,1653,1684,-31,1,-100,66
-1,1666,1742,-76,1,-108,92
1,1961,1887,74,0,21,57
1,1445,1603,-158,-1,3,45
-1,1532,1723,-191,-5,-33,44
1,1490,1419,71,2,108,69
-1,1557,1385,172,-5,-482,108
-1,1414,1655,-241,-2,-12,64
1,1629,1376,253,4,311,67
-1,1517,1629,-112,-4,-52,66
-1,1369,1773,-404,0,-261,94
1,1858,1348,510,4,240,63
-1,1353,1387,-34,-9,-399,62
1,1751,1657,94,0,29,69
-1,1181,1576,-395,0,-34,48
-1,1432,1549,-117,11,135,106
-1,1712,1830,-118,-2,28,70
-1,1524,1540,-16,-1,-102,66
1,1500,1409,91,-3,-270,101
0,1773,1876,-103,1,153,145
-1,1526,1348,178,9,699,92
-1,1695,1629,66,1,109,78
-1,1403,1467,-64,-2,-45,54
1,1838,1705,133,-3,-85,53
1,1782,1786,-4,1,92,59
1,1678,1794,-116,3,-3,105
-1,1498,1474,24,2,295,90
1,1776,1367,409,0,456,109
1,1844,1778,66,-1,-3,113
-1,1445,1387,58,-3,-21,54
-1,1225,1263,-38,-5,-80,46
0,1557,1583,-26,-5,-102,69
1,2165,1881,284,-1,56,81
1,1757,1821,-64,1,7,57
-1,1633,1756,-123,-5,-213,70
1,1801,1660,141,1,-9,51
-1,1510,1668,-158,0,-1,44
1,1405,1377,28,-1,-72,69
1,1500,1516,-16,-3,181,65
0,1851,1923,-72,-3,-254,133
1,1514,1539,-25,8,567,77
-1,1168,1463,-295,0,-490,90
-1,1873,1776,97,0,1,58
1,1768,1653,115,2,130,107
-1,1550,1536,14,2,98,76
-1,1441,1590,-149,-3,-123,88
1,1486,1486,0,6,384,69
1,1808,1793,15,-1,166,77
0,1476,1393,83,3,-29,127
-1,1493,1548,-55,-2,-62,68
1,1580,1177,403,8,283,62
1,1471,1582,-111,-1,-52,47
1,1799,1665,134,1,446,97
0,1753,1388,365,1,-19,119
1,1533,1581,-48,0,26,99
1,1538,1548,-10,-2,89,69
-1,1674,1681,-7,0,-22,65
1,1788,1346,442,6,91,53
-1,1743,1799,-56,-1,-315,122
1,1789,1859,-70,1,16,45
1,1598,1184,414,4,275,77
-1,1878,2169,-291,0,-146,94
-1,1224,1546,-322,-16,-177,41
-1,1698,1500,198,-3,-71,50
1,1809,1596,213,1,117,189
-1,1854,1878,-24,-1,-144,142
1,1371,1343,28,-4,-149,63
-1,1666,1400,266,-2,-249,86
1,1567,1486,81,3,89,67
1,1458,1564,-106,1,321,119
-1,1560,1526,34,6,31,42
1,1507,1683,-176,0,-12,53
1,1613,1679,-66,0,18,57
-1,1406,1921,-515,-3,-10,46
1,1474,1498,-24,-4,57,79
1,1510,1697,-187,-1,17,47
1,1646,1776,-130,1,36,75
0,1546,1554,-8,0,-322,149
1,1764,1626,138,2,104,53
1,1568,975,593,18,339,43
1,1846,1802,44,1,71,75
-1,1500,1569,-69,-6,-561,92
0,1559,1527,32,1,14,118
-1,1896,1663,233,-3,-13,80
1,1483,1513,-30,-4,-510,105
1,1350,1106,244,0,63,47
0,1618,1560,58,-5,700,100
-1,1398,1742,-344,0,-109,106
1,1722,1639,83,3,-30,47
-1,1633,1651,-18,-7,-1034,112
1,1653,1578,75,4,-56,125
1,1986,2279,-293,-1,95,77
-1,1500,1423,77,-16,-317,52
-1,1630,1730,-100,-1,-30,68
1,2274,1990,284,0,-6,59
-1,1694,1529,165,0,100,78
1,1974,1555,419,1,7,73
-1,1393,1739,-346,-4,-144,64
1,2257,2006,251,2,120,79
1,1738,1622,116,-4,202,83
1,1751,1528,223,0,246,99
1,1707,1588,119,1,39,49
-1,1444,1675,-231,-2,-136,56
-1,1661,1622,39,-4,-234,96
0,1574,1576,-2,-3,-422,86
-1,1552,1977,-425,-6,-44,76
1,1576,1625,-49,0,2,57
-1,1949,2002,-53,-4,-26,50
1,1356,1282,74,11,269,47
1,1568,1453,115,2,29,43
1,1964,1826,138,0,145,139
-1,2001,2262,-261,-1,-122,66
1,1529,1323,206,0,78,91
1,1980,1550,430,-5,-392,79
-1,1615,1745,-130,-4,-70,54
-1,1340,1500,-160,-8,37,68
-1,1370,1842,-472,-1,-202,88
-1,1635,1649,-14,0,4,54
1,1935,1849,86,1,9,43
-1,1752,1608,144,-2,-296,84
1,1186,1374,-188,-1,30,71
-1,1466,1469,-3,-19,-66,41
1,1982,1547,435,-1,3,51
1,1671,1659,12,0,218,107
1,1541,1585,-44,3,105,81
1,1758,1693,65,4,250,75
-1,1545,1985,-440,-3,25,48
-1,1623,1737,-114,0,-46,86
1,1500,1500,0,0,394,71
-1,1551,1500,51,-1,-25,92
1,1607,1436,171,4,220,83
-1,1777,1809,-32,0,11,114
1,1558,1467,91,2,450,85
1,1649,1791,-142,-1,501,131
-1,1623,1733,-110,-1,-197,66
-1,1721,1608,113,1,18,78
-1,1629,1574,55,-4,-29,66
1,1987,1543,444,0,40,77
1,1506,1480,26,1,5,45
-1,1392,1400,-8,1,236,100
-1,1491,1496,-5,-4,-402,76
1,1555,1586,-31,0,80,99
-1,1540,1990,-450,1,86,66
-1,1741,1615,126,-1,-43,118
1,1206,1261,-55,-1,-20,71
1,2012,1925,87,0,-20,51
-1,1390,1743,-353,-3,-74,48
1,1992,1538,454,-4,-126,61
-1,1310,1459,-149,2,-2,66
-1,1218,1398,-180,0,31,60
1,1455,1544,-89,-6,-370,75
-1,1535,1576,-41,-7,-70,64
1,1614,1575,39,-1,-27,109
-1,1615,1500,115,-6,-159,60
-1,1664,1833,-169,-1,-22,56
1,1742,1606,136,1,43,57
-1,1600,1823,-223,0,-134,102
-1,1434,1722,-288,-4,-79,51
1,1839,1658,181,0,218,109
-1,1776,1498,278,-3,-406,78
1,1749,1719,30,1,345,145
0,1820,1767,53,0,7,131
-1,1387,1746,-359,-2,-86,62
-1,1425,1690,-265,0,-756,142
1,1868,1595,273,6,222,65
-1,1536,1995,-459,-1,7,58
1,1535,1466,69,3,52,49
1,1458,1566,-108,0,33,85
-1,1303,1257,46,-3,-93,42
1,1575,1500,75,5,545,101
0,1350,1014,336,-3,-4,118
-1,1421,1479,-58,-3,-78,62
-1,1448,1413,35,2,-31,52
-1,1656,1565,91,4,499,96
-1,1555,1686,-131,-6,-1139,104
1,1507,1480,27,0,-20,87
1,1542,1335,207,-1,34,79
-1,1631,1751,-120,-1,-30,42
0,1591,1845,-254,-1,-199,139
-1,1603,1578,25,2,41,44
-1,1729,2057,-328,-2,28,78
-1,1278,1363,-85,5,-170,102
0,1616,1837,-221,0,-71,116
1,1917,2021,-104,5,383,101
1,1221,1571,-350,11,158,47
-1,1759,1623,136,-1,-250,74
1,1689,1804,-115,1,79,63
1,1838,1598,240,-10,309,131
-1,1461,1433,28,7,411,100
1,1690,1581,109,-3,-23,49
1,1469,1470,-1,4,157,57
1,1702,1036,666,-4,51,73
-1,1500,1574,-74,0,12,66
1,1768,1818,-50,3,164,79
1,1609,1551,58,2,114,61
1,1593,1843,-250,-9,-194,55
1,1639,1743,-104,0,-92,77
1,1384,1505,-121,-1,22,59
-1,1395,1654,-259,-4,-185,78
-1,2060,1726,334,-3,0,62
-1,1358,1580,-222,2,132,90
-1,1612,2009,-397,0,1,78
-1,1698,1736,-38,0,-197,116
-1,1749,1370,379,0,17,84
1,2021,1609,412,0,64,77
1,1469,1513,-44,1,66,63
-1,1702,1647,55,-10,-190,42
0,1805,1781,24,-2,-415,142
-1,1480,1612,-132,-5,-236,60
-1,1299,1585,-286,13,275,50
-1,1707,1742,-35,-1,-464,126
0,2160,1854,306,0,-8,105
-1,1473,1501,-28,-2,-335,92
-1,1705,1578,127,-3,-138,64
1,1728,1653,75,4,335,79
1,1327,1234,93,4,211,51
1,1500,1329,171,1,45,41
1,1688,1511,177,10,483,69
0,1607,2032,-425,0,-354,98
1,1825,1997,-172,0,192,73
1,1959,1767,192,0,-27,69
1,1984,1616,368,2,194,61
1,1288,1048,240,-3,-80,55
-1,1748,1948,-200,-1,-278,90
1,1644,1737,-93,-1,-87,77
1,1420,1412,8,0,-8,57
-1,1434,1518,-84,-4,-77,54
1,1694,1589,105,11,245,53
1,1486,1681,-195,0,771,141
1,1902,1634,268,9,289,51
-1,1634,1902,-268,-11,-556,72
-1,1400,1751,-351,0,12,44
1,1708,1611,97,8,91,41
-1,1525,1742,-217,2,107,92
1,1484,1515,-31,3,-14,115
-1,1473,1619,-146,-5,-159,66
1,1781,1804,-23,0,125,103
1,1920,1629,291,5,174,63
-1,1702,1634,68,-1,-64,58
-1,1658,1788,-130,-4,-156,52
-1,1754,1925,-171,-2,-38,42
-1,1462,1531,-69,0,-131,108
1,1689,1625,64,-2,384,125
1,1394,1724,-330,4,59,53
-1,1658,1998,-340,0,-241,158
1,1481,1594,-113,0,407,149
1,1841,1325,516,8,149,49
0,1689,1654,35,-1,53,137
1,1747,1520,227,0,-58,79
-1,1379,1268,111,0,17,74
1,1590,1294,296,3,285,87
1,1584,1543,41,0,62,89
1,1796,1651,145,-3,68,65
1,1588,1576,12,2,63,63
-1,1032,1711,-679,-15,-553,54
-1,1397,1472,-75,0,-66,73
1,1698,1615,83,2,39,105
-1,1709,1761,-52,-2,-150,60
1,1500,1714,-214,-1,9,65
1,1853,1308,545,3,84,53
1,1792,1793,-1,0,5,89
-1,1761,1622,139,0,4,46
1,1452,1449,3,4,267,89
1,1411,1262,149,-1,-4,43
1,1820,1749,71,1,28,55
1,1706,1605,101,-1,-91,139
1,2002,1655,347,3,44,69
-1,1293,1777,-484,-6,-103,52
1,2006,1931,75,1,57,77
1,1395,1043,352,-2,-90,62
-1,1453,1644,-191,-2,-63,100
1,1965,1544,421,-3,70,81
1,1843,1828,15,-5,-388,83
1,1776,1802,-26,0,-3,89
1,1561,1833,-272,-2,319,133
0,1653,2005,-352,-4,-207,83
-1,1714,1596,118,-4,-38,42
1,1419,1233,186,-8,-179,53
1,1725,1703,22,1,187,83
1,1700,1612,88,-6,-272,79
1,1818,1853,-35,1,258,77
-1,1638,1859,-221,-1,7,86
1,1688,1295,393,7,86,49
-1,1994,1661,333,-1,-174,66
-1,1841,1830,11,2,27,54
1,1716,1595,121,9,1232,125
1,1872,1702,170,1,26,46
1,1378,1491,-113,-5,-158,107
-1,1277,1388,-111,-6,-468,80
1,1508,1398,110,-8,-336,85
1,1841,1830,11,4,124,51
-1,1739,1744,-5,-1,-116,130
1,1783,1803,-20,2,50,55
1,1819,1851,-32,1,5,61
1,1587,1768,-181,0,2,43
1,1244,1503,-259,-4,-100,57
1,1515,1339,176,1,384,105
1,1397,1118,279,7,279,61
-1,1748,1775,-27,0,-73,88
-1,1922,2016,-94,0,-60,92
1,1751,1604,147,0,-3,67
-1,1445,1539,-94,-6,-414,71
1,1697,1462,235,0,145,129
-1,1323,1446,-123,-3,-54,42
-1,1839,1831,8,-1,-43,70
-1,1597,1758,-161,0,-46,54
1,1791,1794,-3,0,-134,79
-1,1638,1458,180,2,-106,64
1,1969,1301,668,0,178,87
-1,1590,1765,-175,-1,-50,62
1,1274,1315,-41,-5,-132,47
-1,1625,1693,-68,-3,-88,66
-1,1594,1607,-13,0,-7,58
-1,1682,1723,-41,-1,-57,86
1,1828,1755,73,-7,-343,87
1,1771,1584,187,9,37,41
-1,1728,1916,-188,7,132,50
-1,1558,1384,174,-6,-263,68
1,1414,1352,62,6,176,49
1,1578,1723,-145,-5,202,95
1,1291,1090,201,8,234,47
-1,1475,1622,-147,-1,-317,82
-1,1708,1594,114,-8,-651,116
-1,1746,1837,-91,-4,-583,210
1,1733,1671,62,0,74,59
1,1436,1498,-62,0,161,71
-1,1514,1777,-263,-8,-106,52
1,1394,1472,-78,1,-9,69
1,1783,1802,-19,0,-20,71
-1,1609,1694,-85,-10,-911,86
-1,1411,1183,228,0,-51,88
-1,1243,1396,-153,-12,-713,84
1,1662,1742,-80,-1,-56,79
1,1629,1468,161,0,295,149
0,1560,1307,253,2,-85,121
1,1702,1601,101,-3,58,85
-1,1297,1615,-318,-4,-161,50
1,1967,1626,341,1,10,41
-1,1882,1594,288,-3,-239,66
-1,1790,1794,-4,-1,16,92
1,2039,1808,231,-3,-238,95
-1,1256,1563,-307,0,1,80
-1,1592,1710,-118,-13,-187,78
1,1553,1336,217,0,-1,41
1,1845,1738,107,0,8,67
1,1530,1762,-232,-7,-230,53
-1,1728,1676,52,0,27,40
1,1377,1448,-71,4,143,51
-1,1692,1579,113,0,-13,74
1,1558,1316,242,9,380,63
1,1717,1584,133,1,245,79
-1,1402,1346,56,1,-137,92
1,1563,1299,264,0,47,73
-1,1731,1852,-121,0,-8,72
1,1870,1623,247,-7,25,53
1,1577,1724,-147,-4,-154,99
-1,1567,996,571,-2,156,98
1,1744,1549,195,0,26,105
1,1568,1285,283,-1,120,85
-1,1805,1779,26,0,12,64
1,1605,1212,393,6,455,79
1,1726,1500,226,2,167,83
0,1709,1593,116,8,567,124
1,1801,2045,-244,1,53,53
1,1692,1053,639,-5,82,73
-1,1293,1199,94,-2,-78,90
-1,1408,1790,-382,-9,-223,64
1,1860,1724,136,-4,134,93
1,1682,1938,-256,-1,-66,115
-1,1303,1455,-152,-15,-211,40
-1,1728,1273,455,2,67,56
1,1875,1405,470,1,12,51
1,1566,1462,104,0,108,79
1,1706,1597,109,10,1303,105
-1,1500,1340,160,-4,-116,40
1,1708,1980,-272,-1,-72,55
1,1446,1494,-48,-1,359,93
-1,1543,1750,-207,-6,-356,100
1,1717,1866,-149,-1,78,89
1,1754,1523,231,6,428,80
1,1713,1589,124,0,221,97
-1,1388,1689,-301,0,113,60
-1,1265,1642,-377,-1,-375,98
-1,1042,1552,-510,2,-297,128
-1,1791,1794,-3,-6,-97,42
1,1971,1877,94,2,103,77
1,1698,1619,79,0,-163,109
-1,1581,1720,-139,3,-52,92
1,1702,1694,8,0,48,58
1,1851,1732,119,0,-13,61
1,1960,1981,-21,2,167,73
1,1521,1600,-79,5,737,101
0,1392,1830,-438,-1,-94,131
-1,1804,1780,24,0,-70,126
-1,1755,1537,218,0,-11,84
-1,1574,1727,-153,-3,-57,44
-1,1500,1500,0,-6,-171,58
-1,1607,1568,39,-2,-265,93
0,1725,1859,-134,-2,10,123
-1,1984,1958,26,0,-20,82
-1,1352,1756,-404,-4,-93,122
1,1934,1448,486,1,99,65
1,1567,1734,-167,0,347,139
1,1588,1259,329,-1,43,57
1,1612,1756,-144,-4,-63,57
-1,1834,1972,-138,-5,-215,114
1,1970,1937,33,1,16,48
-1,1584,1940,-356,-1,-206,78
-1,1707,1867,-160,-2,-47,52
-1,1532,1405,127,-5,-133,53
1,1721,1862,-141,1,71,87
1,1718,1461,257,0,-29,61
-1,1925,1752,173,3,11,64
-1,1039,1470,-431,-3,-223,102
-1,1402,1803,-401,0,-155,138
1,1950,1581,369,1,61,61
1,1979,1827,152,3,65,45
-1,1553,1610,-57,-2,-231,72
-1,1712,1498,214,0,-74,63
-1,1689,1443,246,1,-225,100
-1,1792,1793,-1,-4,-350,120
-1,1578,1959,-381,-1,-183,114
1,1980,1986,-6,0,69,75
1,1847,1736,111,3,18,47
-1,1492,1701,-209,-2,-83,101
1,1636,1031,605,5,157,47
1,1967,1575,392,0,126,97
-1,1459,1564,-105,0,-603,136
1,1516,1422,94,0,-19,59
1,1645,1246,399,-1,547,143
1,1816,1881,-65,0,20,55
1,1591,1347,244,7,80,45
-1,1729,1854,-125,0,136,84
-1,1573,1975,-402,0,-73,66
-1,1619,1543,76,0,102,72
1,1737,1637,100,-9,-419,99
-1,1364,1662,-298,3,222,82
1,1982,1571,411,0,41,69
1,1916,1731,185,0,128,113
1,1867,1835,32,1,362,135
-1,1672,1974,-302,-5,-183,64
1,1413,1801,-388,-1,-17,45
1,1803,1781,22,1,88,79
-1,1477,1706,-229,1,19,58
-1,1741,2139,-398,-3,-202,64
-1,1568,1988,-420,-7,-320,66
-1,1574,1720,-146,5,82,44
0,1637,1454,183,0,-127,182
-1,1364,1883,-519,-1,-29,46
1,1517,1413,104,2,720,101
-1,1715,1868,-153,-2,-62,56
-1,1377,1515,-138,-2,-42,48
1,1980,1969,11,0,-11,75
1,1695,1515,180,-2,-35,53
-1,1558,1606,-48,-2,-164,90
-1,1348,1457,-109,0,-263,72
-1,1502,1709,-207,-4,-283,100
1,1875,1708,167,0,7,81
-1,1170,1469,-299,-8,-443,56
1,1771,1813,-42,-1,-22,75
1,1683,1466,217,1,279,99
-1,1745,1878,-133,0,-20,62
1,1721,1620,101,-1,-16,43
1,1702,1881,-179,-1,254,93
1,1178,1241,-63,5,101,46
-1,1615,1547,68,-1,-31,62
1,1597,1590,7,0,134,101
1,1701,1511,190,1,384,105
-1,1524,1612,-88,-1,-50,74
-1,1967,2002,-35,0,-23,62
1,1885,1698,187,1,96,77
-1,1865,1718,147,-3,-95,108
-1,1860,1758,102,-1,43,104
-1,1404,1581,-177,-6,-74,46
1,1458,1632,-174,0,9,65
-1,1632,1850,-218,-1,-100,66
-1,1562,1602,-40,-7,-143,54
1,1884,1361,523,-1,-13,65
1,1734,1850,-116,0,-135,95
-1,1731,2012,-281,0,-4,52
1,1416,1511,-95,0,217,117
-1,1398,1588,-190,0,-19,62
-1,1801,1892,-91,-1,-70,100
1,1612,1551,61,0,208,79
-1,1692,1622,70,1,23,72
1,1992,1477,515,-3,9,95
-1,1450,1275,175,-10,-309,58
-1,1250,1521,-271,1,2,44
-1,1835,1748,87,1,-18,76
-1,1640,1827,-187,-1,-1,46
-1,1241,1548,-307,0,-71,98
1,1601,1566,35,0,166,85
1,1621,1540,81,-2,-11,59
-1,1761,1822,-61,0,-43,90
-1,1517,1431,86,0,-7,52
-1,1277,1568,-291,-1,-17,64
1,1679,1547,132,2,51,51
-1,1410,1549,-139,-3,-149,66
1,2016,1769,247,3,234,75
1,1392,1529,-137,0,120,117
-1,1256,1525,-269,5,5,56
-1,1702,1772,-70,-3,-10,50
1,1831,1752,79,3,38,53
-1,1764,1718,46,-3,-30,46
1,2021,1715,306,0,8,57
1,1686,1635,51,1,30,47
-1,1609,1855,-246,-1,-20,48
1,1744,1839,-95,1,3,49
-1,1696,1476,220,-3,-104,58
1,1300,1154,146,-1,150,129
0,2136,1904,232,-2,-116,122
1,1308,1246,62,6,599,95
1,2024,1997,27,0,27,57
1,1504,1693,-189,-1,26,107
1,1445,1500,-55,7,96,47
1,1494,1506,-12,1,113,57
1,1515,1629,-114,-2,-45,51
1,1982,2035,-53,-4,-43,77
1,1323,1235,88,-2,-4,45
-1,1514,1634,-120,0,-20,44
1,2022,2000,22,-7,417,95
1,1354,1204,150,-2,10,51
-1,1718,1818,-100,-5,-161,60
1,1434,1541,-107,7,322,63
1,1678,1540,138,-1,-1,41
1,1552,1402,150,0,79,79
-1,1763,1844,-81,-9,-55,45
-1,1295,1453,-158,-1,-599,140
-1,1986,2032,-46,-2,-219,70
-1,1376,1181,195,-1,-34,44
-1,1396,1556,-160,-2,-32,40
-1,1520,1567,-47,-1,-330,132
1,1860,1774,86,0,12,53
1,1739,1794,-55,-1,-4,61
1,1370,1489,-119,14,492,69
-1,1911,2117,-206,0,18,78
1,1675,1628,47,-3,22,125
1,1994,1629,365,0,28,60
1,1285,1273,12,-2,-204,69
1,1961,2051,-90,-2,-121,61
-1,1533,1525,8,0,40,78
1,1400,1348,52,-1,-23,49
-1,1268,1547,-279,1,-82,84
1,1854,1745,109,12,931,87
1,1404,1359,45,5,75,51
-1,1314,1244,70,-4,-78,54
1,1422,1307,115,-3,-70,55
1,1979,1820,159,0,445,117
1,1281,1278,3,2,76,43
-1,1351,1326,25,-1,-373,142
1,1559,1507,52,0,73,79
1,1761,1732,29,-3,-267,81
1,1987,1726,261,-1,-32,48
1,1307,1251,56,-9,-244,55
1,2132,1905,227,-6,70,99
-1,1376,1615,-239,-5,-56,46
1,1290,1169,121,3,154,57
-1,1215,1351,-136,-3,-90,60
1,1970,1992,-22,0,240,87
1,1328,1230,98,-7,-197,53
1,1793,1669,124,-4,209,75
-1,1830,1765,65,-1,29,102
1,1400,1518,-118,0,35,87
-1,1646,1814,-168,0,-13,56
1,1414,1413,1,0,50,67
1,1511,1395,116,2,60,45
-1,1978,1985,-7,-3,-90,66
-1,1604,1230,374,2,107,88
-1,1405,1620,-215,-9,-740,80
0,1304,1331,-27,-5,-339,94
0,1456,1403,53,-2,-42,111
1,1999,1965,34,9,404,89
1,1157,1298,-141,0,93,59
-1,1397,1508,-111,-2,-401,134
1,2230,1962,268,-1,33,63
-1,1900,2144,-244,0,-82,78
-1,1500,1753,-253,-5,-503,76
-1,1437,1565,-128,-8,-382,82
-1,1576,1666,-90,-10,-204,46
1,1703,1806,-103,1,172,75
1,1555,1140,415,6,273,57
-1,1466,1653,-187,-2,-7,40
1,1919,1566,353,-3,75,57
1,1500,1980,-480,12,404,53
-1,1651,1866,-215,-3,-347,158
-1,1796,1548,248,7,170,58
1,1384,1356,28,9,766,97
1,1684,1480,204,-1,-13,55
-1,1576,1788,-212,0,-52,56
1,1801,1665,136,0,99,127
-1,1392,1422,-30,0,-55,63
1,1261,1448,-187,6,120,59
1,1698,1468,230,0,-25,87
-1,1620,1647,-27,1,7,52
-1,1593,1873,-280,0,-32,94
-1,1432,1575,-143,-5,-2,50
-1,1274,1956,-682,-5,-66,54
-1,1431,1461,-30,4,103,46
-1,1795,1553,242,-3,-515,132
1,1718,1608,110,1,128,118
1,1923,1564,359,1,285,123
1,1708,1513,195,0,71,67
1,1957,1273,684,4,98,49
1,1564,1519,45,5,169,57
-1,1116,1320,-204,-3,-338,84
-1,1430,1600,-170,-2,-161,60
-1,1397,1647,-250,1,-242,120
-1,1603,1589,14,0,8,40
-1,1137,1560,-423,-3,-94,63
1,1689,1473,216,0,101,67
1,1733,1763,-30,2,5,45
-1,1272,1958,-686,-3,49,62
-1,1919,2105,-186,3,-10,74
-1,1617,1840,-223,-2,-206,104
1,1582,1425,157,3,326,83
-1,1632,1926,-294,-2,-160,76
-1,1757,1695,62,-3,-291,122
-1,1598,1531,67,0,-232,130
1,1465,1346,119,1,26,67
-1,1960,1928,32,0,2,42
1,1959,1774,185,0,93,133
1,1907,1742,165,3,21,41
1,1846,1612,234,2,20,47
1,1703,1674,29,1,190,103
-1,1658,1540,118,-4,-16,83
1,1856,1941,-85,3,117,75
-1,1425,1646,-221,-6,-239,52
-1,1767,1969,-202,3,188,76
1,1479,1420,59,1,4,67
1,1850,1872,-22,1,50,51
1,1510,1502,8,3,118,57
-1,1500,2111,-611,-4,-268,92
-1,1423,1405,18,2,68,44
1,1911,1500,411,6,166,47
1,1575,1626,-51,0,477,171
-1,1574,1705,-131,-5,-186,68
1,1947,1934,13,0,92,161
-1,1760,1978,-218,0,45,92
1,1930,1717,213,1,-108,103
-1,1403,1569,-166,2,3,68
1,1352,1358,-6,8,101,47
1,1644,1852,-208,0,393,115
1,1735,1914,-179,0,70,89
-1,1810,1658,152,1,-1,48
1,1574,1617,-43,1,28,52
1,1855,1987,-132,0,131,75
1,1664,1714,-50,8,413,67
1,1417,1412,5,5,364,105
1,1723,1651,72,0,52,77
-1,1446,1522,-76,0,-35,58
1,1618,1397,221,2,69,51
-1,1343,1782,-439,0,-107,58
1,1871,2166,-295,-1,43,69
1,2113,1452,661,8,177,47
1,1694,1604,90,-2,1,79
1,1544,1443,101,7,351,67
-1,1521,1520,1,0,-184,100
1,2135,1891,244,-2,89,75
0,1673,1791,-118,-3,-29,120
1,1587,1491,96,-4,-30,61
-1,1962,1634,328,-12,-558,116
-1,1738,1743,-5,0,-90,86
0,1835,1269,566,4,525,129
-1,1658,1598,60,0,85,128
1,1589,1456,133,1,90,78
-1,1572,1915,-343,-1,31,86
-1,1834,1886,-52,0,-25,100
-1,1701,1677,24,0,-2,40
1,1488,1318,170,3,319,87
1,2142,1932,210,0,447,125
-1,1420,1704,-284,-4,-219,70
1,1663,1657,6,1,54,93
1,1435,1551,-116,-1,170,70
-1,1959,1896,63,0,-15,86
1,1859,1457,402,1,27,53
-1,1441,1480,-39,-17,-460,52
1,1500,1289,211,8,558,81
1,1364,1214,150,16,609,57
-1,1255,1712,-457,0,5,56
-1,1924,2151,-227,1,-109,78
-1,1566,1689,-123,2,38,44
1,1369,1559,-190,-1,390,111
-1,1337,1500,-163,1,-21,40
1,1703,1283,420,1,-15,59
-1,1935,1765,170,1,-351,168
-1,2131,1910,221,0,-36,98
1,2158,1916,242,-3,-13,91
1,1787,1413,374,0,32,109
-1,1601,1326,275,1,46,46
1,1595,1500,95,0,251,147
1,1675,1646,29,0,163,113
1,1696,1558,138,1,-10,47
-1,1928,2109,-181,0,-49,70
-1,1453,1574,-121,-9,-362,74
-1,1428,1533,-105,-1,-72,60
1,1562,1918,-356,3,629,181
-1,1571,1646,-75,-1,-99,142
1,2116,1922,194,1,367,155
1,2114,1623,491,7,151,47
1,1576,1696,-120,-3,467,87
-1,1755,1825,-70,0,-4,56
1,1712,1775,-63,0,39,109
-1,1752,1710,42,0,-19,56
1,1696,1542,154,0,119,97
-1,1916,2123,-207,-9,-427,98
-1,1551,1703,-152,-4,-391,90
1,1920,1692,228,2,260,63
-1,1322,1601,-279,-14,-169,76
1,1705,1278,427,0,-41,69
0,2130,1910,220,-1,170,132
-1,1324,1291,33,3,32,48
1,1416,1360,56,1,37,53
-1,1840,1735,105,-8,-655,98
-1,1531,1409,122,0,-5,80
1,1678,1926,-248,0,18,63
-1,1636,1602,34,-2,-48,72
1,1311,1375,-64,-8,-129,167
-1,1917,2122,-205,-2,-55,48
-1,1245,1450,-205,1,20,46
-1,1500,1504,-4,-2,-111,62
1,1905,1727,178,-1,184,89
-1,1790,1726,64,0,24,106
-1,1500,1549,-49,0,-4,46
1,2059,1921,138,-5,-4,77
1,1582,1655,-73,5,590,81
1,1109,1308,-199,6,110,47
-1,1582,1599,-17,0,-140,102
1,1835,1741,94,-2,-389,111
1,1880,1757,123,0,-6,69
1,1412,1382,30,3,575,111
-1,1761,1726,35,-1,-31,44
-1,1711,1912,-201,-1,-134,96
0,1736,1752,-16,3,141,70
1,1622,1410,212,-3,-301,77
-1,1706,1595,111,0,15,58
1,1092,0,1092,2,93,51
-1,1355,1540,-185,1,-10,82
-1,1913,2066,-153,-4,-118,78
1,1664,1833,-169,0,219,92
-1,1426,1556,-130,-2,-124,54
-1,1292,1648,-356,-2,-21,48
1,1569,1471,98,4,179,63
-1,1739,1748,-9,0,0,62
-1,1843,1733,110,-5,-240,66
-1,1736,1737,-1,-1,-37,57
1,1563,1892,-329,-7,-523,115
1,1920,1387,533,2,43,51
-1,1698,1651,47,-9,-311,58
-1,1488,1599,-111,-1,-79,92
-1,1747,1829,-82,-2,-71,54
1,1483,1405,78,1,282,85
1,1555,1478,77,2,4,40
1,1668,1665,3,3,511,159
1,2073,1907,166,-2,-13,87
-1,1437,1260,177,-5,-188,72
1,1515,1272,243,-6,-250,65
1,1628,1230,398,0,53,63
1,1922,1687,235,1,41,47
-1,1457,1577,-120,-3,-130,54
1,1907,1824,83,-2,-204,98
-1,1264,1520,-256,1,-22,88
-1,1259,1729,-470,-7,-150,42
-1,1653,1693,-40,1,52,100
1,1766,1827,-61,4,54,45
-1,1342,1494,-152,-1,-65,56
-1,1867,2069,-202,-1,-33,66
-1,1448,1630,-182,-7,-32,41
1,1760,1728,32,0,91,95
-1,1583,1837,-254,-1,49,64
-1,1524,1257,267,0,24,74
-1,1607,1474,133,2,115,88
-1,1545,1930,-385,0,-393,118
-1,1945,1916,29,-4,49,64
1,1636,1293,343,0,98,91
1,1583,1644,-61,0,6,57
1,1894,1685,209,1,146,107
1,1584,1443,141,2,81,61
-1,1657,1566,91,0,-74,108
1,1752,1646,106,0,226,129
-1,1293,1221,72,-2,-271,72
-1,1288,1500,-212,-2,-153,60
1,1860,1227,633,0,78,77
1,1287,1505,-218,9,255,61
1,1885,1500,385,1,722,99
1,1933,1543,390,-2,110,75
1,1630,1597,33,0,2,73
-1,1820,1929,-109,1,75,82
1,1441,1500,-59,3,149,59
1,1488,1314,174,1,1,47
-1,1522,1929,-407,-5,-155,56
1,1811,1731,80,1,90,80
-1,1244,1620,-376,-1,-54,42
-1,1540,1936,-396,-1,-495,130
1,1098,1301,-203,-13,-555,63
1,1586,1641,-55,0,-37,81
1,1985,1557,428,-1,18,51
-1,1722,1820,-98,-1,-125,112
-1,1305,1494,-189,0,1,88
1,1462,1281,181,1,49,51
-1,1226,1861,-635,-4,-384,93
1,1987,1931,56,5,424,69
1,1500,1500,0,0,18,57
-1,1130,1362,-232,-17,-275,63
-1,1353,1428,-75,-8,-420,78
-1,1627,1599,28,-3,21,80
1,1939,1945,-6,1,14,45
1,1432,1509,-77,3,54,67
-1,1921,1997,-76,-1,-13,42
-1,1505,1530,-25,-1,-36,42
1,1633,1680,-47,0,-82,103
-1,1571,1665,-94,-1,-33,54
1,1639,1406,233,1,42,63
1,1829,1714,115,1,46,53
1,1715,1132,583,5,112,49
1,2006,1912,94,0,94,79
-1,1504,1614,-110,-4,-587,142
1,1500,1296,204,0,51,69
1,1573,1575,-2,1,8,89
-1,1931,1953,-22,0,-59,84
-1,1458,1665,-207,-14,-396,54
-1,1706,1838,-132,-2,-52,60
-1,1130,1717,-587,-14,-181,44
1,1903,2014,-111,1,134,101
1,1861,1618,243,0,355,87
1,1644,1052,592,18,280,43
-1,1447,1888,-441,-1,-25,55
-1,1665,1901,-236,-1,-33,60
-1,1720,1719,1,-1,-307,76
1,1564,1585,-21,8,134,43
1,1468,1356,112,9,466,73
0,1515,1591,-76,1,-102,101
-1,1311,1760,-449,0,-54,64
-1,1573,1576,-3,-5,-94,56
1,1645,1495,150,2,537,103
-1,1846,1901,-55,0,11,60
-1,1113,1378,-265,-7,-487,64
1,1905,1659,246,2,173,81
-1,1587,1562,25,-3,-170,84
1,1867,1668,199,0,31,57
1,1611,1561,50,0,9,47
-1,1429,1482,-53,-2,-33,42
1,2016,1910,106,3,609,103
-1,1454,1399,55,-1,-113,68
1,1621,1835,-214,1,-155,101
1,1389,1104,285,1,355,73
-1,1902,2024,-122,-1,-346,90
1,1574,1575,-1,0,5,57
-1,1345,1476,-131,5,201,72
1,1891,1596,295,5,47,51
-1,1301,1601,-300,0,7,72
-1,2031,1895,136,0,94,76
1,1441,978,463,5,241,59
-1,1653,1910,-257,-3,-282,92
1,1564,1585,-21,-4,-40,57
1,1861,1446,415,3,58,43
1,1817,1940,-123,-2,-51,81
1,1638,1500,138,0,25,49
1,1781,1813,-32,-7,-3,73
-1,1451,1595,-144,-1,-22,44
1,1663,1875,-212,0,348,113
1,1910,2016,-106,0,-31,87
1,1545,1317,228,7,252,73
1,1280,1373,-93,-2,-25,43
-1,1515,1835,-320,-6,-126,52
-1,1573,1576,-3,-2,-116,64
0,2002,1932,70,-1,-506,101
-1,1273,1863,-590,3,17,50
1,1914,1648,266,14,351,53
1,1419,1434,-15,8,298,67
1,1587,1562,25,-1,9,45
-1,1420,1750,-330,1,-101,90
-1,1833,1934,-101,0,-22,76
1,1852,1918,-66,1,86,99
-1,1445,1581,-136,-6,-223,60
1,1599,1559,40,3,115,65
1,2004,1737,267,1,38,59
1,1562,1482,80,1,99,77
-1,1762,1795,-33,-4,-298,86
1,1501,1374,127,1,94,75
1,1652,1063,589,-1,-13,55
-1,1233,1253,-20,-7,-165,44
-1,1327,1913,-586,-4,-112,54
-1,1824,2008,-184,0,-28,80
1,1500,1888,-388,-1,35,63
1,1328,1465,-137,0,0,53
1,1296,1500,-204,0,37,61
-1,1818,2014,-196,-8,-99,50
1,1394,1150,244,4,58,41
-1,1319,1016,303,-8,-273,58
1,2019,1812,207,-3,20,63
-1,1338,1477,-139,-3,-58,70
1,1416,1436,-20,-2,-54,43
1,1759,1497,262,-1,66,57
1,1905,1869,36,1,214,129
1,1294,1120,174,11,425,49
-1,1433,1580,-147,-1,-123,86
-1,1142,1500,-358,7,164,42
-1,1925,2025,-100,-11,-19,40
1,1589,1445,144,1,130,71
1,1793,1678,115,-6,-7,83
1,1481,1512,-31,2,22,49
-1,1275,1301,-26,-3,-123,68
1,1719,1864,-145,0,25,65
-1,1809,1943,-134,-5,368,114
1,1839,1495,344,-1,-42,59
-1,1350,1438,-88,-4,-238,75
1,1433,1587,-154,0,14,49
1,1510,1488,22,0,161,99
-1,1426,1526,-100,0,-174,100
1,1856,1915,-59,0,71,103
1,1802,1552,250,1,133,93
-1,1071,1311,-240,2,-164,120
-1,1742,1830,-88,-5,-140,62
1,1852,1950,-98,0,13,55
1,1705,1588,117,0,26,71
-1,1213,1366,-153,4,-88,78
-1,1736,1430,306,-1,-53,98
1,1581,1727,-146,0,1,45
-1,1936,2033,-97,-2,-51,88
1,1715,1809,-94,0,-2,68
1,1866,1811,55,0,11,103
1,1571,1519,52,-1,13,76
-1,1760,1848,-88,0,-214,146
0,1451,1699,-248,-2,-270,134
1,1902,1873,29,1,402,107
-1,1534,1734,-200,0,32,90
1,1418,1456,-38,2,422,77
1,1927,2041,-114,0,124,87
-1,1463,1330,133,1,22,61
-1,1316,1263,53,-4,-211,68
1,1942,2026,-84,0,-15,79
-1,1956,2013,-57,0,-84,98
-1,1479,1842,-363,-4,-392,92
-1,1875,1814,61,1,-58,68
1,1441,1423,18,5,85,77
-1,1795,1730,65,-10,-832,102
1,1341,1509,-168,8,456,85
-1,1763,1500,263,-4,-141,72
1,1947,2022,-75,1,-73,80
-1,1828,1862,-34,9,242,54
1,1653,1857,-204,0,69,89
1,1801,1850,-49,0,52,91
1,1686,1596,90,-1,226,131
1,2009,1960,49,1,87,75
-1,1532,1836,-304,-5,-10,40
1,1739,1528,211,1,87,87
1,1679,1427,252,1,121,85
1,1818,1615,203,0,-22,55
1,1419,1560,-141,1,-90,115
1,1717,2018,-301,3,-173,83
-1,1409,1474,-65,-5,-195,82
-1,1609,1823,-214,1,97,82
-1,1999,1736,263,-2,-21,88
-1,1379,1438,-59,-2,-314,76
1,1981,1755,226,8,568,67
1,1840,1529,311,0,92,79
-1,1496,1535,-39,0,-50,64
1,1838,1509,329,1,89,63
1,1829,1084,745,12,147,45
-1,1525,1844,-319,4,223,116
-1,1751,1912,-161,-1,-79,80
1,1285,1246,39,3,275,71
-1,1986,1750,236,-1,-81,66
-1,1885,1782,103,-3,-26,76
-1,1872,1636,236,-4,-63,100
-1,1968,1768,200,-3,-37,50
-1,1223,1710,-487,-10,-255,58
1,1672,1271,401,0,48,49
1,1312,1227,85,6,489,91
1,1786,1604,182,-1,-58,53
-1,1744,1707,37,-4,-108,90
1,1855,1951,-96,-1,-12,81
-1,1500,1718,-218,-2,-127,60
1,1615,1587,28,1,187,87
1,1842,1483,359,0,72,91
1,1792,1598,194,-1,26,71
1,1674,1266,408,-2,87,77
-1,1936,1868,68,2,198,92
1,1596,1506,90,-1,76,59
-1,1615,1697,-82,0,-3,64
1,1855,1751,104,0,50,103
1,1848,1522,326,-2,25,51
1,1711,1222,489,-3,-101,67
-1,1207,1294,-87,-4,-321,182
-1,1567,1617,-50,-1,134,56
1,1798,1592,206,4,49,63
1,1829,1771,58,-1,153,99
1,1925,1923,2,0,92,221
1,1744,1832,-88,-7,-506,121
-1,1519,1852,-333,-2,-42,48
-1,1586,1803,-217,0,-27,48
-1,1309,1530,-221,-4,-150,76
1,1760,1839,-79,3,126,79
-1,1216,1676,-460,3,70,58
1,1321,1500,-179,19,526,55
1,1423,1801,-378,-1,35,45
1,1919,1739,180,-4,-90,83
-1,1358,1558,-200,-1,-133,88
1,1912,1809,103,7,499,73
1,1856,1523,333,0,-5,83
-1,1480,1844,-364,-2,-5,48
1,1572,1261,311,-1,401,117
-1,1825,1776,49,-2,-223,98
-1,1800,1920,-120,0,7,94
-1,1352,1413,-61,-2,-103,82
-1,1860,1984,-124,-3,-179,100
-1,1134,1580,-446,-4,-424,83
-1,1479,1277,202,0,-70,88
-1,1927,1793,134,-1,-167,70
1,1678,1712,-34,0,-86,93
1,1791,1811,-20,1,18,109
1,1558,1745,-187,1,75,57
1,1808,1912,-104,2,111,67
1,1936,1709,227,1,400,105
-1,1733,1925,-192,2,-66,88
1,1898,1823,75,-2,198,105
1,1780,1445,335,-6,-96,55
1,1303,1500,-197,9,292,51
1,1799,1881,-82,4,78,43
1,1963,1847,116,-2,62,81
1,1804,1917,-113,8,458,71
-1,1814,1907,-93,-12,-84,44
1,1581,1131,450,-4,141,53
1,1604,1684,-80,-1,66,61
-1,1342,1583,-241,-5,-111,46
-1,1941,1821,120,3,-2,90
-1,1577,1625,-48,0,-687,104
1,1859,1627,232,0,2,93
1,1728,1692,36,0,382,100
-1,1282,1396,-114,1,67,90
1,1902,1915,-13,-1,-72,101
1,1700,1294,406,2,183,69
1,1813,1043,770,1,84,61
-1,1541,1531,10,2,86,62
1,1783,1837,-54,0,-35,63
-1,1904,1914,-10,0,-98,154
-1,1314,1534,-220,-1,-167,80
1,1930,1727,203,-2,-32,58
-1,1500,1668,-168,-10,-147,46
0,1823,1796,27,-1,-75,107
1,1941,1915,26,0,-30,75
1,1814,1043,771,5,175,49
-1,1924,1893,31,-4,-171,60
1,1670,1617,53,2,79,77
1,1905,1951,-46,0,122,83
-1,1809,1809,0,-3,-130,56
-1,1239,1465,-226,0,1,48
-1,1942,1839,103,1,60,78
1,1821,1798,23,-1,-182,111
-1,1419,1763,-344,-1,-140,100
1,1939,1917,22,-1,-42,55
-1,1702,1603,99,-1,-337,94
1,1823,1913,-90,-1,7,71
1,1695,1674,21,3,82,61
1,1814,1349,465,0,-33,47
-1,1540,1502,38,-5,-23,44
1,1918,1739,179,-1,-32,131
1,1348,1500,-152,-4,573,87
-1,1326,1454,-128,-2,-20,44
1,1838,1900,-62,-1,-16,113
1,1618,1687,-69,1,37,51
-1,1608,1545,63,-1,-122,94
1,1887,1851,36,0,70,89
-1,1354,1573,-219,-2,3,48
1,1520,1855,-335,3,238,65
1,1816,1334,482,1,32,45
1,1706,1726,-20,1,187,95
-1,1841,1897,-56,0,-235,90
-1,1390,1492,-102,-3,-460,98
-1,1912,1838,74,-1,-73,50
1,1673,1631,42,1,-28,51
-1,1906,1831,75,0,-29,80
1,1851,1899,-48,10,309,53
-1,1833,1539,294,3,-42,56
-1,1699,1538,161,-1,4,42
1,1255,1273,-18,3,64,63
-1,1482,1511,-29,1,337,84
1,1535,1224,311,2,198,65
1,1845,1269,576,1,23,67
-1,1378,1621,-243,-1,-22,72
1,1907,1632,275,0,-5,51
1,1492,1312,180,2,46,45
-1,1571,1456,115,-7,-215,66
1,1719,1537,182,0,6,61
1,1752,1607,145,2,265,81
1,1610,1528,82,-1,177,109
-1,1771,2054,-283,1,-36,72
1,1825,1758,67,-4,33,65
1,1434,1316,118,3,283,93
-1,1537,1436,101,-5,-367,68
-1,1670,1664,6,-1,-107,58
1,1530,1725,-195,-1,-119,103
1,1626,1373,253,1,-24,63
-1,1526,1833,-307,0,17,88
1,1846,1638,208,-1,95,99
1,1682,1583,99,2,364,71
1,1611,1352,259,2,407,135
1,1536,1317,219,-6,-85,103
-1,1997,1911,86,-1,-185,98
1,1539,1521,18,-1,384,103
1,1824,1812,12,0,27,103
-1,1701,1756,-55,-2,-82,48
-1,1601,1829,-228,-3,-473,120
1,1757,1944,-187,1,64,91
-1,1369,1630,-261,1,95,66
1,1743,1599,144,5,104,43
1,1410,1497,-87,-2,334,155
-1,1674,2049,-375,0,-65,61
1,1511,1516,-5,-2,-59,43
1,1708,1551,157,0,41,67
1,1538,1775,-237,4,170,75
-1,1373,1629,-256,-2,-357,148
-1,1527,1701,-174,1,39,48
-1,1912,2058,-146,0,12,76
-1,1189,1217,-28,-9,-349,66
1,1936,1608,328,1,10,53
-1,1428,1289,139,0,-30,70
1,1620,1746,-126,0,176,89
-1,1498,1469,29,0,-14,52
1,1599,1303,296,-1,-40,47
1,1313,1450,-137,3,242,95
-1,1676,1658,18,0,-7,54
1,1648,1657,-9,0,455,123
1,2052,1835,217,0,8,61
1,1635,1364,271,-5,-93,47
1,1855,1742,113,2,27,43
1,1718,1563,155,1,-20,89
-1,1600,1684,-84,0,3,64
1,1590,1466,124,1,28,67
1,1543,1627,-84,0,33,85
-1,1582,1835,-253,-4,-177,62
-1,1360,1639,-279,-1,2,40
1,1957,1633,324,2,42,43
1,1456,1253,203,0,541,129
1,1489,1398,91,1,233,115
1,1511,1550,-39,10,551,153
1,1757,1574,183,4,342,77
1,1556,1188,368,11,263,45
1,1645,1660,-15,0,-15,61
-1,1605,1726,-121,0,-445,114
-1,1585,1754,-169,0,-483,92
-1,1830,2057,-227,4,-7,40
1,1400,1327,73,-5,-75,55
1,1623,1328,295,1,11,125
-1,1560,1385,175,-1,-11,48
1,1644,1356,288,3,159,63
0,1602,1561,41,1,30,67
1,2066,1852,214,-3,233,91
-1,1630,1976,-346,-2,-81,54
1,1517,1145,372,-3,32,47
-1,1762,1578,184,-3,-207,90
1,1841,1565,276,13,286,49
-1,1452,1603,-151,0,-10,56
1,1541,1411,130,-3,-36,93
-1,1553,1766,-213,-1,-96,92
1,1648,1847,-199,-2,491,77
0,1924,1773,151,-5,49,150
-1,1595,1743,-148,6,229,72
-1,1352,1648,-296,1,69,92
-1,1793,1749,44,0,-28,64
1,1637,1305,332,-2,-4,115
-1,1829,2173,-344,2,-259,122
-1,1782,1665,117,-2,-84,74
-1,1481,1670,-189,-3,-56,48
1,1568,1315,253,-10,-459,73
1,1750,1588,162,1,496,91
1,1924,1624,300,0,88,57
1,2005,1597,408,10,241,53
1,1436,1818,-382,1,339,157
-1,1549,1514,35,5,-543,86
0,1536,1538,-2,1,-14,230
1,1319,1500,-181,-3,-82,136
1,1652,1348,304,-3,-117,59
1,1825,1735,90,3,323,115
-1,1590,1569,21,0,4,46
1,1610,1441,169,1,13,57
1,1735,1864,-129,-2,9,57
-1,1582,1758,-176,3,161,44
1,1633,1500,133,4,121,61
1,1801,1835,-34,-1,-16,67
1,1572,1548,24,-3,522,129
-1,1764,1576,188,1,-278,74
1,1526,1534,-8,7,363,69
-1,1345,1656,-311,-1,-213,100
-1,1621,1929,-308,0,-38,82
1,2016,1671,345,12,345,54
1,1763,1736,27,0,225,115
1,1597,1424,173,0,10,65
1,1431,1386,45,0,55,73
-1,1424,1384,40,-1,-62,50
1,1593,1746,-153,-5,-100,75
1,1625,1322,303,0,137,57
1,1837,1472,365,0,69,75
0,1676,1640,36,0,-5,139
-1,1343,1500,-157,0,-379,116
1,1728,1609,119,3,335,81
1,1504,1500,4,2,260,75
1,1680,1636,44,-4,-71,51
0,1784,1587,197,-6,-106,219
-1,1778,1919,-141,-4,-179,76
1,1534,1516,18,7,358,71
-1,1470,1840,-370,0,5,54
-1,1728,1769,-41,-6,-370,82
1,1601,1737,-136,0,-3,53
-1,1650,1760,-110,-2,-472,94
1,1457,1507,-50,-3,196,91
-1,1581,1617,-36,0,-270,116
1,1458,1442,16,-2,-116,81
-1,1384,1323,61,-6,-154,58
1,1843,1467,376,3,72,49
1,1598,1777,-179,-4,47,73
1,1532,1626,-94,4,192,75
1,1720,1617,103,3,142,77
-1,1726,1604,122,-1,-53,64
-1,1497,1500,-3,-14,-113,40
1,1637,1909,-272,0,3,81
1,1545,1465,80,-1,322,119
-1,1538,1536,2,0,-295,176
-1,1129,1167,-38,3,58,52
-1,1609,1729,-120,-7,-280,78
1,1689,1575,114,2,109,65
-1,1548,1386,162,4,441,144
-1,1852,2029,-177,0,-62,108
1,1933,1491,442,4,92,49
-1,1414,1375,39,2,16,63
1,1333,1396,-63,0,3,63
-1,1642,1675,-33,-8,-164,44
1,1613,1489,124,2,31,51
-1,1601,1593,8,0,-104,76
-1,1572,1583,-11,3,46,45
-1,1457,1555,-98,1,80,80
-1,1300,1283,17,-6,-269,76
1,1847,1749,98,3,77,43
1,1778,1573,205,4,108,47
-1,1493,1469,24,-2,-55,44
1,1593,1646,-53,2,91,49
-1,1709,1723,-14,0,22,52
1,1337,1370,-33,-3,70,87
-1,1505,1620,-115,-5,-610,80
1,1686,1427,259,0,-11,53
1,1765,1433,332,-6,-194,61
-1,1545,1754,-209,-4,-203,70
1,1885,1664,221,-4,-11,61
-1,1623,1551,72,-5,-127,50
1,1630,1686,-56,2,123,135
-1,1735,1789,-54,-1,-346,72
0,1719,1927,-208,0,3,144
1,1564,1449,115,1,139,65
1,2055,1846,209,3,196,73
0,1411,1500,-89,0,68,86
-1,1771,1866,-95,0,-297,126
1,1657,1609,48,3,324,117
1,1623,1594,29,1,387,83
-1,1759,1904,-145,0,11,74
1,1628,1497,131,1,405,85
1,1643,1425,218,5,408,71
1,1595,1724,-129,0,232,101
-1,1369,1641,-272,-1,-49,49
1,1611,1349,262,0,-2,47
1,1725,1608,117,2,76,57
1,1441,1573,-132,0,-3,73
-1,1741,1856,-115,-4,-102,58
1,1572,1503,69,0,81,51
-1,1281,1292,-11,1,-143,116
-1,1615,1303,312,-1,-14,56
-1,1480,1480,0,-4,-408,106
-1,1649,1737,-88,0,-316,96
-1,1549,1324,225,2,29,44
-1,1572,1733,-161,-4,-143,82
-1,1271,1307,-36,-1,-17,44
-1,1668,2076,-408,-3,-118,60
1,1404,1112,292,-1,207,95
1,1556,1456,100,-1,-116,91
-1,1449,1780,-331,-5,-159,60
-1,1707,1690,17,0,-359,138
-1,1739,1529,210,3,173,94
1,1563,1530,33,2,144,85
-1,1405,1519,-114,-1,-50,58
1,1592,1570,22,0,-200,83
1,1891,1534,357,2,209,73
1,1934,1784,150,0,33,95
-1,1430,1515,-85,-1,18,100
1,1605,1565,40,0,282,87
-1,1636,1646,-10,0,12,62
1,1672,1613,59,1,240,111
1,1472,1487,-15,6,184,49
-1,1624,1723,-99,-11,-210,48
1,1624,1522,102,-1,323,139
1,1652,1548,104,0,84,113
-1,1581,1595,-14,0,-10,52
1,1179,1410,-231,3,-16,73
1,2084,1710,374,2,80,49
1,1764,1060,704,-2,116,79
1,1536,1586,-50,8,344,75
-1,1305,1607,-302,-4,-207,76
0,1379,1432,-53,-5,-99,107
0,2032,2084,-52,0,-3,55
1,1457,1610,-153,0,211,107
-1,1731,1585,146,-3,-323,98
-1,1583,1634,-51,0,-7,44
-1,1504,1722,-218,-5,-34,40
-1,1874,2078,-204,0,7,68
1,1565,2004,-439,1,-105,77
1,1492,1470,22,2,227,123
-1,1846,1658,188,-1,129,90
1,1571,1625,-54,-1,-86,67
-1,1298,1500,-202,0,1,60
-1,1651,1716,-65,-1,-2,40
1,1467,1489,-22,-8,-98,41
-1,1409,1912,-503,-3,-106,48
-1,1548,1419,129,-10,-165,46
-1,1725,1617,108,-2,57,94
-1,1895,1729,166,-2,-318,118
1,1784,1567,217,0,330,109
1,1724,1603,121,7,955,119
1,1671,1099,572,-5,407,99
1,1530,1373,157,3,-68,83
1,1667,1711,-44,2,90,81
-1,1611,1584,27,-1,-32,58
1,1766,1438,328,-1,190,129
1,1355,1503,-148,1,-37,86
-1,1494,1397,97,-3,-249,88
1,1588,1497,91,2,243,135
-1,1278,1581,-303,-3,-124,64
1,1532,1632,-100,3,172,81
1,1550,1424,126,5,71,44
-1,1698,1706,-8,0,-97,74
-1,1548,1574,-26,0,-9,74
1,1499,1682,-183,1,208,75
1,1596,1599,-3,0,273,97
1,1661,1509,152,-4,193,79
1,1308,1072,236,1,149,55
-1,1464,1676,-212,-3,-6,40
-1,1515,1660,-145,-8,-27,72
0,1397,1412,-15,-2,8,67
-1,1279,1720,-441,-14,-308,44
1,1702,1480,222,0,515,127
-1,1737,1687,50,0,153,88
1,1507,1570,-63,-1,245,113
1,1597,1798,-201,0,139,117
-1,1639,1810,-171,-1,77,66
-1,1672,1546,126,1,29,144
-1,1749,1875,-126,-5,-1081,158
-1,1436,1682,-246,3,107,58
1,1426,1485,-59,8,250,65
-1,1244,1346,-102,0,-12,42
-1,1216,1413,-197,0,-72,62
-1,1521,1648,-127,-3,-141,58
1,1781,1616,165,4,154,71
-1,1341,1500,-159,0,37,72
1,1769,1311,458,1,-139,101
1,1605,1618,-13,-4,128,108
-1,1434,1696,-262,0,-26,70
-1,1784,1925,-141,-1,-26,56
1,1942,1595,347,8,709,105
1,1900,1483,417,9,72,41
1,1472,1442,30,-3,36,133
0,1535,1709,-174,-2,-141,125
1,1665,1633,32,-1,285,69
-1,1371,1765,-394,0,-63,86
-1,1433,1472,-39,3,137,72
-1,1205,1201,4,0,-8,64
1,1609,1408,201,13,80,41
0,1397,1277,120,11,624,75
1,1655,1352,303,3,46,49
-1,1481,1902,-421,1,83,82
-1,1649,1529,120,0,-16,56
0,1757,1667,90,0,-109,117
1,1711,1402,309,-1,159,77
1,1599,1057,542,3,213,59
-1,1393,1704,-311,-8,-782,104
1,1659,1550,109,1,35,53
1,1588,1588,0,-2,165,97
1,1356,1235,121,3,183,69
-1,1503,1681,-178,0,-12,46
1,1841,1562,279,-2,-28,43
0,1850,1633,217,0,31,136
-1,1398,1715,-317,1,73,74
-1,1740,1601,139,-4,-93,48
-1,1314,1361,-47,3,40,44
1,1721,1600,121,-4,-122,67
-1,1578,1769,-191,-3,-21,58
1,1474,1407,67,-1,-20,59
1,1430,1482,-52,5,84,43
-1,1268,1339,-71,-5,-510,101
1,1751,1587,164,2,29,43
1,1249,1299,-50,-3,-108,43
-1,1787,1820,-33,-2,-290,94
1,1668,1348,320,7,619,105
-1,1513,1635,-122,0,-16,50
-1,1615,1458,157,0,-232,92
1,1904,1479,425,-8,5,101
1,1718,1394,324,-1,-17,45
1,1588,1329,259,-2,-33,49
1,1768,1368,400,1,310,99
1,1679,1607,72,-4,-56,105
1,1826,1758,68,-3,148,95
1,1366,1383,-17,5,210,58
1,1758,1708,50,-1,205,115
1,1580,1500,80,-1,7,44
-1,1668,1777,-109,-2,-14,50
-1,1615,1675,-60,-1,-69,106
-1,1500,1770,-270,-2,-59,59
1,1611,1600,11,-14,-553,63
1,1390,1707,-317,1,4,67
-1,1628,1603,25,-6,-374,78
1,1843,1630,213,1,65,75
1,1689,1628,61,1,6,47
1,1469,1445,24,0,61,127
-1,1785,1659,126,-2,-348,70
-1,1598,1752,-154,0,-35,90
-1,1458,1704,-246,-1,-129,53
1,1774,1573,201,-4,12,57
1,1790,1301,489,5,457,111
-1,1558,1969,-411,-6,-135,40
1,1477,1906,-429,5,579,147
0,1613,1540,73,-1,105,129
-1,1593,1518,75,0,5,64
1,1675,1770,-95,0,200,103
1,1057,1302,-245,2,603,141
1,1884,1743,141,0,-55,87
-1,1624,1609,15,1,37,68
1,1538,1420,118,-1,27,75
1,1371,1423,-52,1,85,107
1,1458,1538,-80,0,-43,65
1,1519,1500,19,-6,-71,93
1,1767,1830,-63,4,190,61
-1,1500,1480,20,-1,-14,54
1,1759,1591,168,-9,-15,47
-1,1757,1621,136,10,219,48
1,1484,1500,-16,-2,23,51
-1,1483,1619,-136,-10,-148,44
-1,1612,1790,-178,-1,4,42
1,1756,1690,66,4,194,67
-1,1606,1684,-78,-2,-164,72
0,1509,1672,-163,0,213,119
1,1817,1757,60,1,143,113
1,1505,1483,22,7,164,51
1,1631,1645,-14,1,96,83
-1,1625,1676,-51,-5,-386,72
1,1806,1849,-43,-3,-117,65
-1,1747,1489,258,4,67,60
1,1413,1454,-41,2,593,167
1,1680,1765,-85,0,-25,99
1,1571,1524,47,0,567,145
-1,1584,1606,-22,-1,-45,134
1,1581,1488,93,0,12,53
-1,1567,1780,-213,-7,-73,52
1,1622,1664,-42,2,97,49
1,1781,1807,-26,0,65,81
-1,1698,1769,-71,-1,2,46
-1,1342,1630,-288,-2,-109,74
-1,1751,1695,56,1,36,132
-1,1634,1709,-75,-4,-640,130
1,1326,1555,-229,10,497,79
-1,1492,1366,126,-3,25,106
-1,1212,1655,-443,0,0,42
-1,1479,1589,-110,0,-6,50
1,1464,1437,27,2,528,107
-1,1826,1657,169,-2,-25,48
-1,1411,1666,-255,-6,-555,98
-1,1708,1738,-30,0,82,93
1,1730,1481,249,-1,-13,77
-1,1573,1766,-193,0,-398,132
-1,1837,2141,-304,-2,4,110
1,1785,1562,223,-1,-25,43
0,1892,1484,408,0,15,156
1,1749,1698,51,1,178,67
0,1712,1524,188,0,-29,130
1,1803,1829,-26,-5,103,107
1,1515,1598,-83,4,-7,43
-1,1751,1860,-109,-6,-727,96
-1,1641,1353,288,1,-218,126
-1,1751,1815,-64,0,-42,54
1,1460,1486,-26,2,365,103
1,1688,1758,-70,6,273,83
1,1281,1109,172,-5,-144,61
1,1780,1688,92,0,65,86
1,1772,1567,205,0,0,133
-1,1545,1614,-69,-2,-62,50
-1,1534,1674,-140,0,-30,56
1,1220,1421,-201,3,124,47
1,1268,1336,-68,1,124,61
-1,1514,1797,-283,-4,-119,62
1,1693,1701,-8,-1,-14,103
-1,1745,1702,43,1,-55,110
-1,1545,1585,-40,0,-20,50
0,1371,1865,-494,-1,-33,88
-1,1470,1607,-137,-5,-589,130
-1,1258,1537,-279,-3,-134,64
1,1840,1542,298,3,430,99
1,1557,1790,-233,0,9,55
1,1818,1824,-6,0,232,119
1,1637,1695,-58,4,783,99
1,1633,1547,86,9,611,175
1,1373,1511,-138,0,21,51
-1,1063,1328,-265,2,103,68
1,1714,1733,-19,3,142,81
-1,1652,1517,135,-9,-37,108
1,1561,1778,-217,0,-94,131
1,1833,1749,84,0,21,101
1,1532,1480,52,-1,-56,43
1,1500,1650,-150,0,27,53
1,1410,1515,-105,6,548,89
-1,1380,1622,-242,-8,-190,64
1,1665,1418,247,3,59,49
-1,1287,1558,-271,-1,-44,50
-1,1092,1288,-196,-2,-43,46
-1,1535,1407,128,-1,-106,94
-1,1370,1766,-396,4,155,68
1,1722,1254,468,6,63,43
-1,1222,1525,-303,2,44,94
1,1759,1579,180,0,6,73
-1,1316,1881,-565,-10,-904,112
1,1706,1640,66,1,435,91
1,1772,1575,197,1,167,75
1,1533,1510,23,5,180,59
1,1403,1324,79,-7,-601,101
-1,1467,1589,-122,0,-41,54
1,1295,1078,217,11,134,40
1,1742,1789,-47,0,-3,57
-1,1356,1731,-375,-1,-86,64
1,1563,1282,281,3,355,69
1,1471,1541,-70,6,546,91
-1,1392,1588,-196,1,6,72
1,1298,1546,-248,7,785,83
1,1713,1614,99,3,261,87
-1,1391,1802,-411,0,-149,78
1,1635,1649,-14,5,101,45
-1,1272,1507,-235,-3,-282,88
0,1721,1640,81,0,-303,138
1,1500,1843,-343,2,22,81
1,1529,1447,82,7,300,65
-1,1215,1792,-577,-1,-216,80
-1,1065,1301,-236,-9,-804,114
1,1493,1381,112,-1,-142,77
1,1616,1454,162,2,234,67
1,1828,1626,202,0,10,69
-1,1573,1784,-211,-2,-137,86
1,1921,1706,215,9,241,53
1,1520,1374,146,-5,-42,47
-1,1707,1723,-16,-4,-108,52
-1,1121,1500,-379,-6,-1029,142
1,1567,1744,-177,1,57,83
-1,1569,1778,-209,0,-22,64
-1,1845,1773,72,-3,-163,90
-1,1996,1701,295,-1,8,44
-1,1673,1711,-38,-6,-723,116
-1,1776,1717,59,3,85,76
-1,1425,1471,-46,-8,-325,78
1,1689,1617,72,-2,-7,45
-1,1835,1620,215,0,-74,72
1,1527,1454,73,8,529,77
1,1823,1624,199,-5,-3,57
-1,1310,1367,-57,0,-143,121
-1,1620,1484,136,2,113,60
1,1663,1777,-114,3,-43,59
-1,1307,1419,-112,8,538,84
1,1643,1512,131,0,285,95
-1,1825,1829,-4,-3,-87,49
1,1741,1447,294,-1,64,95
1,1805,1608,197,-2,34,69
-1,1642,2144,-502,-4,-56,62
-1,1606,1582,24,0,-279,92
-1,1583,1716,-133,-15,-413,58
1,1515,1588,-73,2,191,73
1,1815,1452,363,0,-28,55
1,1744,1580,164,2,-5,107
1,1945,1630,315,1,53,55
1,1576,1724,-148,0,-1,65
1,2146,1641,505,1,58,65
-1,1559,1512,47,0,26,61
1,1783,1572,211,2,342,71
-1,1514,1335,179,-2,-88,52
-1,1606,1715,-109,-5,-35,42
-1,1784,1391,393,0,-5,74
1,1401,1539,-138,-2,-64,47
-1,1554,1447,107,-7,-309,70
1,1445,1607,-162,0,246,121
1,1108,989,119,-9,-114,51
-1,1734,1879,-145,-6,-251,68
-1,1594,1651,-57,0,-53,108
-1,1967,2155,-188,-3,-515,112
1,1499,1461,38,3,95,43
1,1785,1689,96,-1,-3,41
-1,1393,1563,-170,0,-18,50
1,2162,1947,215,0,200,63
1,1445,1471,-26,0,32,83
-1,1913,1833,80,0,4,82
0,1592,1461,131,0,1,98
1,1500,1531,-31,-3,-94,65
1,1533,1506,27,0,12,63
-1,1697,1991,-294,0,-97,69
1,1462,1431,31,3,141,49
1,1851,1655,196,1,16,45
1,1814,1722,92,0,32,83
-1,1551,1861,-310,-3,-168,64
1,1463,1464,-1,8,581,81
-1,1930,2168,-238,0,3,80
1,1606,1496,110,10,336,51
-1,1787,1381,406,-6,-123,52
1,1751,1225,526,8,727,121
-1,1878,1300,578,-2,-31,44
-1,1505,1525,-20,-1,-239,114
-1,1356,1551,-195,-3,-150,60
-1,1500,1529,-29,-3,-65,42
-1,1446,1338,108,-7,-391,102
-1,1580,1588,-8,-1,-182,86
-1,1451,1483,-32,1,18,46
1,1798,1333,465,-2,240,77
1,1681,1792,-111,3,51,49
-1,1465,1588,-123,-1,-263,104
-1,1367,1504,-137,2,80,56
-1,1738,1831,-93,-7,-104,46
-1,1488,1614,-126,0,-104,76
-1,1628,1915,-287,0,-2,66
-1,1438,1553,-115,-8,-264,58
-1,1489,1376,113,1,-101,80
0,1301,1470,-169,-3,-783,104
-1,1778,1786,-8,0,10,94
1,1524,1416,108,14,410,59
-1,1652,1865,-213,-3,-143,80
1,1771,1605,166,0,291,161
1,1548,1625,-77,0,-92,91
1,1494,1122,372,9,283,43
-1,1475,1591,-116,-7,-63,40
-1,1800,1764,36,0,145,98
1,1457,1188,269,0,14,55
1,1890,1543,347,1,185,75
1,1654,1569,85,2,133,69
1,1494,1495,-1,-7,-173,69
1,1786,1535,251,3,242,133
1,1378,1253,125,-3,140,97
-1,1405,1763,-358,-4,-28,48
1,1847,1899,-52,-2,61,95
1,1407,1493,-86,0,-6,47
1,1522,1498,24,-1,50,47
-1,1443,1445,-2,-1,-39,84
1,1621,1569,52,8,244,47
1,1599,1614,-15,7,997,101
-1,1118,1496,-378,-8,-133,46
1,1408,1532,-124,-2,-75,83
1,1841,1730,111,2,45,48
-1,1332,1615,-283,0,-87,172
-1,1348,1511,-163,1,117,58
1,1857,1557,300,1,102,55
1,1695,1620,75,3,326,81
-1,1548,1632,-84,2,-79,77
-1,1498,1419,79,5,141,64
1,1631,1579,52,1,18,45
-1,1454,1552,-98,-2,-366,70
-1,1564,1797,-233,-1,-99,54
1,1435,1675,-240,-6,-214,67
-1,1569,1926,-357,-2,-136,58
1,1497,1500,-3,0,74,45
1,1867,1409,458,11,252,51
1,1603,1610,-7,3,375,89
1,1768,1870,-102,1,27,73
1,1766,1402,364,13,409,59
1,1289,1344,-55,0,405,113
-1,1526,1572,-46,-6,-234,68
1,1597,1778,-181,1,558,99
-1,1499,1494,5,-5,-120,64
0,1544,1448,96,-1,-422,138
-1,1500,1461,39,-6,-62,50
1,1461,1446,15,6,540,81
-1,1934,2097,-163,0,40,88
-1,1976,1921,55,-2,-280,72
1,1304,1256,48,0,-10,55
-1,1599,1614,-15,-4,-77,74
-1,1287,1799,-512,1,-113,62
1,1535,1437,98,6,172,55
1,1703,1634,69,-1,127,58
-1,1443,1529,-86,-2,-276,108
1,1457,1583,-126,0,417,127
-1,1594,1644,-50,-1,-20,50
-1,1470,1466,4,-7,-520,80
-1,1916,1918,-2,0,8,100
-1,1673,1531,142,0,-42,50
-1,1670,1611,59,0,7,78
-1,1781,1855,-74,-2,-20,82
-1,1640,1499,141,0,-19,40
-1,1660,1592,68,-4,-48,42
1,2024,1547,477,0,46,75
-1,1961,1934,27,-5,-67,60
-1,1624,1589,35,-3,-323,112
1,1864,1425,439,-3,1,51
1,1399,1769,-370,3,389,83
1,1929,1888,41,-3,-10,99
-1,1885,1860,25,0,-62,98
1,1517,1423,94,3,249,81
1,1871,1502,369,10,407,53
1,1514,1539,-25,-1,15,87
-1,1573,1500,73,0,-17,70
1,1948,1664,284,0,26,67
1,1864,1938,-74,1,71,67
-1,1553,1547,6,1,-28,51
1,1495,1584,-89,3,72,55
1,1601,1612,-11,6,1277,117
1,1267,1577,-310,8,133,55
1,1669,1643,26,0,370,101
1,1925,1895,30,-1,444,129
-1,1409,1430,-21,-11,-114,46
1,1483,1254,229,-2,-83,71
1,1554,1732,-178,3,-3,43
-1,1406,1445,-39,0,249,150
1,1960,1726,234,-6,-96,43
0,1696,1509,187,0,43,154
1,1588,1906,-318,2,46,61
-1,1281,1256,25,0,-214,88
-1,1416,1406,10,0,-55,65
-1,1500,1660,-160,-1,-23,50
1,1876,1507,369,3,173,61
1,1601,1612,-11,-1,-127,85
1,1873,1935,-62,0,1,81
-1,1435,1472,-37,-15,-289,63
-1,1475,1522,-47,1,7,69
-1,1480,1421,59,1,44,112
1,1314,1123,191,6,38,41
1,1660,1952,-292,-2,136,69
-1,1773,1864,-91,0,-83,110
1,1745,1422,323,-2,-93,49
1,1656,1339,317,4,474,69
1,1923,1899,24,-4,-190,67
1,1719,1596,123,1,49,59
1,1648,1409,239,0,113,121
-1,1558,1603,-45,0,7,130
-1,1526,1545,-19,-3,-285,94
-1,1458,1467,-9,-3,-332,98
1,1509,1559,-50,5,877,173
-1,1601,1633,-32,-4,-114,48
1,1872,1873,-1,0,103,81
1,1879,1932,-53,0,76,87
1,1474,1558,-84,1,311,121
-1,1672,1687,-15,4,182,56
-1,1930,1678,252,-5,-253,92
1,1448,1529,-81,0,-92,57
-1,1398,1468,-70,-6,-142,96
-1,1415,1525,-110,-1,-212,104
-1,1608,1503,105,0,0,66
1,1791,1671,120,4,149,51
1,1643,1597,46,-5,-36,45
1,1721,1683,38,4,307,81
1,1465,1728,-263,1,118,75
-1,1419,1748,-329,-7,-299,70
-1,1292,1270,22,-5,-253,70
1,1664,1799,-135,-5,605,173
1,1594,1738,-144,1,266,95
-1,1653,1964,-311,-3,-28,54
-1,1587,1797,-210,-2,-97,66
1,1910,1765,145,0,-77,87
1,1902,1696,206,0,43,97
1,1979,1867,112,-2,-79,49
-1,1335,1715,-380,0,-355,122
1,1612,1595,17,0,109,60
1,1609,1437,172,-1,145,83
-1,1802,1582,220,-3,-151,76
1,1462,1500,-38,1,163,67
-1,1489,1839,-350,-18,-958,80
1,1898,1476,422,15,426,51
1,1599,1784,-185,-1,-10,47
-1,1657,1605,52,2,-10,68
1,1862,1883,-21,0,53,95
1,1968,1555,413,1,165,58
1,1554,1347,207,2,151,75
1,1766,1616,150,1,52,81
1,1918,1759,159,0,45,79
1,1784,1679,105,2,347,111
1,1752,1415,337,2,169,63
1,1522,1473,49,1,44,51
-1,1786,2104,-318,-1,-56,94
-1,1621,1302,319,-3,-83,122
-1,1349,1364,-15,-3,-81,52
1,1698,1644,54,-1,-18,109
-1,1642,1684,-42,0,6,48
1,1987,1761,226,-2,81,77
-1,1542,1556,-14,-7,-204,74
1,1533,1407,126,4,305,116
-1,1619,1459,160,-1,-6,66
-1,1221,1236,-15,-4,-47,58
1,1474,1475,-1,0,249,173
1,1398,1489,-91,7,431,127
1,1652,1624,28,1,606,139
-1,1691,1791,-100,-3,-184,66
1,1907,1970,-63,-5,605,175
1,1585,1648,-63,5,301,83
-1,1925,1753,172,0,-88,68
1,1525,1670,-145,-1,70,89
1,1783,2107,-324,-1,254,133
-1,1831,1500,331,-1,-66,59
-1,1553,1504,49,1,-110,68
0,1616,1483,133,-1,-479,147
-1,1422,1798,-376,-11,-235,46
-1,1562,1732,-170,-1,-254,76
-1,1662,1527,135,-4,-32,48
1,1723,1609,114,-3,115,67
-1,1920,1834,86,0,-9,52
-1,1412,1656,-244,-3,-117,58
1,1602,1167,435,3,691,101
-1,1476,1799,-323,10,232,70
1,1647,1543,104,3,87,51
1,1907,1850,57,0,2,89
-1,1652,1795,-143,-1,-73,60
-1,1803,2086,-283,1,44,70
-1,1756,1992,-236,1,-31,50
-1,1530,1730,-200,-1,-29,76
1,1916,1840,76,4,345,133
-1,1655,1535,120,-9,-1257,138
1,1801,1419,382,1,113,123
1,1708,1692,16,1,120,77
1,1531,1462,69,4,147,93
-1,1799,2090,-291,0,-74,62
-1,1697,1656,41,0,0,54
0,1687,1395,292,-6,-152,161
1,1802,1472,330,1,122,83
0,1641,1550,91,4,-225,124
1,1541,1435,106,2,193,85
1,1567,1299,268,1,57,46
-1,1754,1751,3,1,-8,94
1,1531,1531,0,4,113,45
-1,1400,1540,-140,-9,-416,76
-1,1660,1726,-66,0,-106,66
-1,1708,1604,104,-2,-175,88
1,1553,1526,27,3,64,49
0,1183,1753,-570,5,357,105
0,1795,1808,-13,0,-113,97
-1,1667,1668,-1,-6,-376,74
1,1462,1378,84,2,394,89
-1,1458,1406,52,-8,-342,64
-1,1616,1860,-244,0,-245,130
1,1719,1397,322,2,219,65
1,1638,1563,75,-3,-274,77
-1,1652,1676,-24,0,39,92
1,1542,1331,211,4,143,57
0,1957,1805,152,0,118,120
0,1602,1731,-129,2,-248,165
-1,1796,2094,-298,-3,-399,86
1,1495,1334,161,8,241,53
-1,1485,1696,-211,1,-447,100
0,1554,1233,321,0,310,92
1,1443,1386,57,7,213,69
-1,1533,1807,-274,-1,9,120
-1,1792,2098,-306,-2,-34,78
-1,1971,1620,351,0,-315,146
1,1557,1719,-162,0,0,57
1,1763,1743,20,-3,-11,53
-1,1137,1612,-475,0,-10,46
-1,1586,1571,15,0,-71,70
-1,1585,1641,-56,-1,-19,46
1,1622,1393,229,1,132,69
-1,1788,2102,-314,-8,-155,66
-1,1237,1689,-452,-1,-20,48
-1,1575,1830,-255,-3,-185,82
1,1810,1952,-142,1,181,105
1,1547,1393,154,6,336,63
-1,1549,1912,-363,-9,-101,100
-1,1455,1547,-92,-10,-297,50
1,1454,1479,-25,2,181,79
0,1864,1614,250,0,-8,92
-1,1722,1559,163,0,-6,54
-1,1550,1590,-40,6,133,48
-1,1785,2105,-320,0,-243,100
1,1540,1392,148,-6,-23,47
1,1747,1482,265,2,85,51
-1,1670,1531,139,-3,-729,148
-1,1418,1644,-226,-4,-72,52
1,1732,1774,-42,0,166,99
-1,1782,2109,-327,-1,-279,96
-1,1555,1446,109,-3,757,142
1,1702,1479,223,0,308,73
1,1812,1531,281,6,62,40
-1,1649,1527,122,-1,-105,60
-1,1517,1514,3,-2,-227,98
-1,1547,1453,94,-1,-41,51
-1,1778,1840,-62,-1,-16,50
-1,1430,1490,-60,-3,-73,48
1,1491,1518,-27,5,210,63
-1,1503,1426,77,-2,84,126
-1,1363,1562,-199,-8,-488,84
-1,1524,1857,-333,-1,-111,68
1,1710,1701,9,0,85,107
1,1816,1620,196,0,83,61
-1,1487,1612,-125,-1,-204,90
-1,1531,1521,10,-2,12,50
1,1840,1922,-82,-1,-148,81
1,1706,1333,373,1,355,97
-1,1376,1294,82,0,-217,164
1,1404,1366,38,-3,-161,59
1,1768,1925,-157,-1,-14,45
1,1634,1638,-4,1,8,45
-1,1299,1500,-201,2,-286,84
1,1542,1574,-32,4,319,101
1,1801,1628,173,3,292,89
-1,1910,1785,125,0,-2,46
1,1739,1297,442,1,30,61
-1,1801,1895,-94,0,152,98
-1,1817,1735,82,-5,-34,46
1,1474,1386,88,3,265,83
-1,1427,1484,-57,-6,-138,44
-1,1620,1411,209,-2,-331,120
-1,1850,1773,77,-12,-545,64
1,1593,1205,388,4,82,45
1,1903,1792,111,-2,-93,115
0,1749,1786,-37,0,-38,109
0,1386,1582,-196,-7,-73,138
1,1835,1650,185,-5,-31,43
-1,1563,1554,9,-1,-230,124
1,1461,1707,-246,4,190,83
-1,1708,1815,-107,-4,-211,112
-1,1625,1486,139,0,-54,56
-1,1788,1842,-54,2,37,42
1,1611,1683,-72,0,-1,59
1,1623,1550,73,-2,7,62
1,1874,1651,223,0,26,49
1,1546,1525,21,1,35,41
1,1515,1428,87,0,69,81
-1,1777,1852,-75,-4,16,53
-1,1784,1911,-127,2,113,116
1,1702,1893,-191,-1,48,139
1,1284,1229,55,-4,-63,47
-1,1768,1861,-93,-9,-722,80
-1,1416,1329,87,0,-57,96
-1,1472,1646,-174,-2,38,58
1,1918,1776,142,-3,-209,85
-1,1506,1529,-23,-4,-127,60
-1,1870,1759,111,0,-4,56
1,1378,1483,-105,0,-42,59
1,1741,1415,326,0,10,47
1,1679,1607,72,1,16,112
-1,1769,1924,-155,1,40,86
-1,1383,1515,-132,-3,-54,76
1,1557,1337,220,3,187,73
1,1855,1774,81,2,193,131
-1,1595,1632,-37,-1,-90,68
1,1689,1621,68,3,190,73
1,1653,1552,101,-1,189,121
1,1824,1416,408,3,67,41
1,1958,1466,492,0,-4,53
-1,1757,1872,-115,-5,-505,72
-1,1462,1503,-41,-7,-244,54
-1,1722,1542,180,-3,-363,98
1,1468,1392,76,-1,-46,53
-1,1286,1561,-275,0,2,62
1,1664,1429,235,2,68,43
1,1880,1748,132,6,555,107
1,1762,1749,13,0,38,115
-1,1757,1808,-51,2,110,98
1,1833,1424,409,0,29,59
-1,1577,1736,-159,-1,-46,60
0,1567,1298,269,-2,-117,134
1,1713,1352,361,8,204,51
-1,1384,1477,-93,1,-99,68
-1,1741,1267,474,0,-98,74
-1,1465,1734,-269,4,103,48
0,1231,1220,11,-2,-245,140
1,1738,1773,-35,2,307,85
-1,1738,1432,306,0,-29,56
1,1716,1343,373,-2,-71,53
-1,1544,1662,-118,-2,-15,52
1,1559,1751,-192,0,46,81
-1,1264,1343,-79,0,-9,48
1,1568,1721,-153,2,43,53
-1,1362,1612,-250,-8,-186,48
1,1677,1646,31,2,11,53
-1,1761,1750,11,-4,-231,108
-1,1448,1555,-107,-1,-83,82
1,1618,1581,37,4,148,73
-1,1513,1739,-226,0,-11,58
-1,1411,1404,7,-1,-292,116
1,1574,1703,-129,7,224,71
1,1569,1342,227,2,425,109
1,1148,1237,-89,4,131,72
-1,1482,1575,-93,-4,-269,76
-1,1634,1688,-54,-2,-262,82
1,1663,1706,-43,10,443,86
1,1274,1392,-118,2,182,63
1,1862,1427,435,4,264,95
1,1462,1367,95,1,705,151
-1,1125,1841,-716,1,19,62
-1,1697,1600,97,0,-187,108
1,1744,1542,202,1,47,83
-1,1337,1571,-234,-2,-38,50
-1,1669,1683,-14,-5,-137,56
-1,1498,1568,-70,0,-64,66
1,1493,1187,306,0,145,73
1,1437,1647,-210,-1,149,131
-1,0,1204,-1204,-13,-327,54
1,1955,1642,313,5,364,89
-1,1368,1648,-280,-2,-374,86
1,1670,1500,170,1,73,89
1,1459,1321,138,0,463,123
1,1584,1634,-50,2,67,61
1,1500,1628,-128,-3,-30,73
-1,1695,1845,-150,-3,-687,90
1,1852,1688,164,0,-45,73
1,1536,1750,-214,0,-164,129
1,1575,1329,246,0,457,95
1,1694,1613,81,2,38,47
-1,1401,1380,21,-8,-208,48
-1,1681,1859,-178,-10,-312,68
-1,1658,1532,126,12,252,46
-1,1497,1487,10,0,-30,110
-1,1260,1353,-93,-2,-755,110
1,1351,1176,175,3,31,69
1,1324,1416,-92,0,52,81
1,1865,1675,190,1,385,169
1,1654,1364,290,-2,148,88
-1,1361,1181,180,1,-245,140
-1,1303,1344,-41,0,-616,134
0,1630,1537,93,-2,-120,122
-1,1246,1701,-455,-5,-225,54
1,1507,1534,-27,5,54,43
1,1390,1321,69,0,-49,57
-1,1471,1483,-12,0,-4,42
-1,1669,1871,-202,-10,-104,66
1,1317,1195,122,1,15,43
1,1484,1363,121,7,403,63
1,1466,1356,110,-1,-12,51
1,1877,1663,214,-2,153,167
1,1525,1639,-114,3,47,51
1,1732,1549,183,5,107,41
1,1628,1610,18,2,35,41
-1,1521,1645,-124,1,-16,104
-1,1343,1583,-240,-2,-113,56
1,1357,1612,-255,-5,87,59
1,1730,1738,-8,2,209,85
-1,1499,1485,14,-5,-84,48
1,1554,1500,54,4,139,61
1,1744,1660,84,1,293,105
1,1658,1883,-225,-2,1068,105
-1,1208,1344,-136,-9,-398,66
1,1635,1703,-68,1,32,109
1,1676,1864,-188,1,151,107
-1,1239,1426,-187,-6,-217,66
-1,1325,1410,-85,-6,-539,94
1,1638,1519,119,-2,-42,61
1,1293,1398,-105,0,10,61
1,1864,1498,366,0,52,69
-1,1387,1240,147,-4,-87,52
-1,1356,1738,-382,-2,-274,77
-1,1086,1270,-184,-2,-33,40
-1,1429,1998,-569,-4,-8,42
-1,1686,1853,-167,-5,-469,87
1,1474,1588,-114,-6,-66,69
1,1351,1197,154,3,1203,165
0,1338,1596,-258,1,45,66
-1,1680,1860,-180,-6,-225,48
1,1307,1259,48,1,33,43
1,1645,1559,86,-1,-38,65
1,1674,1866,-192,-1,-98,69
-1,1700,1879,-179,0,-2,67
1,1848,1691,157,0,-6,65
1,1691,1848,-157,0,-42,65
-1,1741,1754,-13,1,-158,100
1,1491,1563,-72,-4,-116,61
1,1514,1552,-38,0,15,91
0,1832,1708,124,1,132,162
-1,1712,1828,-116,-6,-264,78
1,1425,1592,-167,1,265,77
-1,1396,1513,-117,-4,-149,55
-1,1241,1316,-75,-2,-125,69
1,1828,1712,116,0,143,87
1,1489,1573,-84,-2,-175,61
-1,1704,1836,-132,0,-362,102
-1,1593,1495,98,2,46,57
1,1656,1220,436,8,394,55
1,1500,1287,213,0,637,139
-1,2068,1954,114,-1,-360,124
-1,1187,1358,-171,-5,-481,78
1,1885,1500,385,12,523,57
0,1730,1719,11,3,816,180
1,1553,1489,64,1,96,85
-1,1386,1539,-153,-2,-25,46
-1,1526,1652,-126,0,-62,72
-1,1677,1649,28,-1,-10,52
1,1651,1579,72,-5,-85,55
1,1380,1338,42,-4,261,133
-1,1696,1823,-127,-1,-129,92
-1,1844,1895,-51,3,150,92
1,1662,1583,79,24,455,47
-1,1689,1831,-142,1,39,60
-1,1218,1668,-450,-15,-309,44
-1,1412,1402,10,-4,-48,40
1,1808,1622,186,10,256,53
-1,1270,1502,-232,-4,-184,76
-1,1558,1318,240,-1,-136,94
1,1308,1330,-22,2,234,59
-1,1720,1729,-9,1,-505,126
1,1904,1682,222,6,410,71
-1,1388,1207,181,-2,15,46
1,1909,1676,233,-9,-106,71
-1,1488,1500,-12,-4,-588,84
-1,1672,1838,-166,-2,-35,102
-1,1451,1500,-49,-3,-23,42
-1,1461,1717,-256,-4,-301,98
1,1373,1512,-139,-12,-221,49
-1,1629,1482,147,0,-1,54
-1,1626,1649,-23,-6,-21,50
-1,1405,1402,3,-10,-414,78
-1,1645,1890,-245,0,-155,96
1,1674,1228,446,-5,-60,51
-1,1391,1558,-167,3,60,44
0,1632,1829,-197,0,-12,107
1,1669,1690,-21,1,27,65
-1,1879,1886,-7,-1,-257,118
-1,1665,1689,-24,-4,-335,94
-1,1788,1937,-149,0,-145,80
1,1678,1566,112,4,118,65
1,1296,1415,-119,6,248,73
1,1656,1548,108,-2,-4,43
1,2094,1529,565,1,3,79
1,1871,1820,51,-3,4,85
-1,1562,1496,66,-2,-451,154
-1,1644,1785,-141,-5,-169,86
-1,1678,1681,-3,0,64,88
-1,1391,1439,-48,0,729,108
1,1693,1679,14,2,182,77
1,1524,1811,-287,1,12,51
1,1514,1596,-82,2,46,41
-1,1553,1773,-220,-1,-89,68
-1,1545,1446,99,-3,124,110
-1,1557,1946,-389,-6,-524,86
-1,1255,1447,-192,-4,-247,80
-1,1548,1883,-335,-2,-7,54
-1,1469,1621,-152,0,-67,118
-1,1652,1809,-157,0,459,132
1,1446,1405,41,-2,7,72
1,1712,1449,263,4,843,113
1,1669,1785,-116,-1,-22,63
-1,1638,1821,-183,0,-247,160
1,1895,1778,117,0,12,85
1,1830,1646,184,-10,-644,113
-1,1693,1667,26,1,-96,72
1,1949,1554,395,2,-125,99
1,1720,1445,275,-1,530,101
-1,1276,1310,-34,-9,-594,84
-1,1518,1579,-61,-7,16,66
-1,1628,2007,-379,-2,14,53
-1,1931,1906,25,0,8,82
-1,1726,1781,-55,0,-279,72
-1,1495,1675,-180,-5,-141,56
-1,1396,1640,-244,4,108,48
1,2016,1592,424,0,13,81
-1,1587,1544,43,-1,-16,76
-1,1456,1500,-44,6,-360,92
1,1602,1431,171,2,570,103
-1,1551,1952,-401,-3,-81,62
1,1919,1645,274,2,599,125
1,1468,1325,143,16,610,60
-1,1711,1679,32,-3,-85,46
1,1509,1473,36,0,735,101
-1,1564,1653,-89,1,9,50
1,1825,1886,-61,3,174,79
-1,1249,1498,-249,-1,-92,79
-1,1605,1676,-71,0,-10,52
-1,1691,1857,-166,-2,-198,78
-1,1463,1627,-164,0,-143,98
-1,1641,1923,-282,-1,-186,104
1,1414,1450,-36,1,6,49
1,1984,1811,173,-3,-45,46
1,1955,1691,264,8,218,59
-1,1770,1903,-133,-6,-86,116
1,1874,1555,319,1,347,71
1,1887,1521,366,-1,-19,57
1,1927,1637,290,1,380,93
-1,1880,1960,-80,-3,-136,98
1,1625,1829,-204,-3,-68,73
-1,1551,1883,-332,0,21,88
1,2096,1239,857,1,50,55
-1,1683,1806,-123,-2,113,100
1,1911,1652,259,-3,-32,63
1,1680,1765,-85,-3,-173,71
1,1519,1359,160,4,116,55
-1,1975,1924,51,0,-86,120
1,1575,1429,146,0,281,91
-1,1456,1450,6,-3,-208,90
1,1696,1604,92,1,25,61
-1,1310,1430,-120,-13,-314,52
-1,1648,1915,-267,-10,-251,52
-1,1548,1791,-243,-2,-20,40
-1,1813,1676,137,-1,-33,56
1,1805,2012,-207,0,4,45
0,1879,2145,-266,-7,-781,90
-1,1263,1961,-698,0,-121,104
-1,1570,1427,143,-4,-195,68
1,1449,1429,20,1,163,79
1,1796,1543,253,3,649,123
1,1920,1644,276,-4,-69,57
-1,1691,1798,-107,-3,-283,66
1,1421,1426,-5,-2,53,115
1,1456,1634,-178,1,134,71
1,2136,1896,240,-1,28,75
-1,1518,1890,-372,0,-5,54
1,1654,1445,209,1,148,67
-1,1888,1966,-78,-2,-185,68
-1,1806,1683,123,9,414,72
-1,1526,1913,-387,-1,-38,66
1,1673,1508,165,6,316,63
1,1904,1659,245,-3,-70,51
1,1899,1694,205,14,701,77
-1,1885,2142,-257,-6,-69,42
1,1980,1872,108,3,37,55
-1,1737,1683,54,2,94,66
-1,1619,1373,246,1,4,82
-1,1655,1909,-254,-4,-174,62
1,2148,1876,272,0,37,113
-1,1873,1820,53,-3,-7,40
1,1441,1303,138,-2,210,85
1,1450,1486,-36,-4,-339,119
1,1541,1493,48,6,931,105
-1,1689,1934,-245,1,-123,76
1,1565,1463,102,2,97,53
-1,1511,1704,-193,-5,-267,86
1,1913,1650,263,1,315,69
1,1375,1221,154,-3,94,101
-1,1525,1423,102,-1,-46,52
-1,1867,2154,-287,-1,-59,64
-1,1547,1633,-86,-1,-14,66
-1,1115,1978,-863,0,20,64
0,1844,2096,-252,0,-20,92
1,1961,1684,277,1,222,91
1,1443,1337,106,6,395,73
0,1584,1961,-377,0,-18,119
-1,1646,1918,-272,-3,-69,56
1,1416,1846,-430,-1,-79,51
1,2159,1860,299,9,266,53
1,1940,1820,120,3,81,63
-1,1864,1997,-133,0,-30,72
-1,1501,1679,-178,0,-127,80
1,1896,1596,300,-1,260,79
-1,1922,1641,281,6,332,100
-1,1708,1982,-274,-1,-270,84
1,1314,1553,-239,-2,-113,56
-1,1852,2164,-312,0,-167,116
1,1824,1439,385,-4,-9,107
-1,1754,2001,-247,0,-14,48
-1,1661,1902,-241,-7,-186,52
-1,1748,1763,-15,-1,-184,100
1,1432,1315,117,4,219,67
1,1459,1385,74,0,77,51
1,1499,1286,213,3,498,123
-1,1749,1790,-41,-1,-5,48
1,2169,1846,323,0,141,105
1,1575,1573,2,-1,-41,59
1,1604,1523,81,1,57,57
1,1698,2021,-323,-1,-36,75
1,1907,1656,251,-2,331,71
1,1857,1570,287,1,-31,75
1,2086,1695,391,3,110,61
-1,1652,1912,-260,0,-33,62
1,1408,1479,-71,16,581,51
1,1940,1839,101,0,42,109
1,2012,1857,155,0,5,48
-1,1429,1612,-183,-4,-158,66
-1,1389,1505,-116,-5,-337,78
-1,1502,1473,29,1,90,78
1,1916,1647,269,2,74,53
-1,1767,1775,-8,0,-69,102
-1,1501,1486,15,1,-86,96
-1,1489,1710,-221,1,-7,72
-1,1594,1490,104,0,-6,74
1,1978,1889,89,1,355,117
1,1710,1538,172,0,7,56
-1,1824,1643,181,3,51,50
-1,1693,2090,-397,-1,-34,52
-1,1440,1778,-338,-11,-403,68
-1,1685,1779,-94,-4,-364,112
-1,1468,1549,-81,0,-76,69
-1,1335,1810,-475,-1,-305,150
1,1754,1739,15,0,89,83
-1,1562,1623,-61,-1,-189,104
1,1859,1586,273,-4,-198,91
-1,1660,1794,-134,8,-87,114
0,1740,1864,-124,1,61,107
1,1507,1625,-118,-6,-200,61
-1,1851,2026,-175,-4,-52,64
1,1618,1423,195,0,-10,49
0,1728,1784,-56,0,29,129
1,1282,1399,-117,2,155,93
-1,1786,1786,0,2,111,60
1,1296,1215,81,-4,-112,49
1,1328,1451,-123,8,240,55
1,1680,1728,-48,0,-5,64
-1,1439,1228,211,5,85,62
1,1807,1653,154,5,520,93
-1,1146,1620,-474,1,30,50
1,1681,1532,149,-2,546,145
-1,1556,1583,-27,2,-63,75
-1,1500,1474,26,-3,-215,72
-1,1349,1611,-262,2,-290,152
1,1508,1463,45,6,443,79
0,1602,1434,168,-2,-374,140
-1,1592,1900,-308,-1,-34,44
-1,1646,1818,-172,0,-97,64
-1,1420,1751,-331,0,-82,72
-1,1498,1532,-34,-3,-306,116
-1,1716,1693,23,-12,-62,60
1,1430,1535,-105,-3,24,65
1,1434,1497,-63,-5,-53,41
1,1945,1671,274,5,115,45
1,1610,1624,-14,0,228,109
-1,1401,1430,-29,-7,-409,90
1,1197,1304,-107,2,150,63
1,1513,1379,134,6,233,49
1,1829,1775,54,0,-2,79
-1,1447,1141,306,14,517,48
-1,1384,1425,-41,-12,-1459,104
-1,1109,1623,-514,0,3,86
-1,1642,1691,-49,3,183,72
-1,1744,1857,-113,2,38,54
-1,1766,2113,-347,0,24,58
-1,1787,1677,110,0,-86,80
1,1459,1573,-114,6,298,65
-1,1782,1729,53,-2,-241,124
0,1844,1879,-35,-1,273,142
1,1484,1606,-122,-3,-61,60
1,1715,1666,49,2,78,59
-1,1716,1553,163,0,-133,68
-1,1767,1661,106,-3,90,64
1,1580,1500,80,1,86,49
0,1587,1558,29,-1,609,121
1,2093,1669,424,2,24,49
-1,1763,2116,-353,-3,-94,52
1,1500,1521,-21,4,166,65
-1,1311,1173,138,-6,-685,94
0,1878,1846,32,0,334,136
1,1244,1211,33,-1,-54,45
-1,1496,1226,270,-3,-264,88
1,1710,1627,83,-7,315,105
-1,1454,1877,-423,0,-287,98
-1,1683,2096,-413,-2,-243,93
-1,1840,2048,-208,0,21,94
1,1691,1773,-82,-1,263,110
1,2122,1758,364,2,148,79
-1,1447,1440,7,-1,-129,96
1,1878,1452,426,-2,228,77
1,1750,1847,-97,-3,-193,81
0,1425,1455,-30,2,141,125
1,1870,1736,134,0,-77,93
1,1640,1276,364,3,43,45
1,1733,1383,350,2,108,101
0,1646,1733,-87,0,68,66
-1,1487,1625,-138,-2,-62,60
-1,1726,1777,-51,-1,-45,72
-1,1298,1585,-287,8,79,40
-1,1450,1880,-430,0,-496,92
1,1632,1545,87,2,93,67
-1,1569,1700,-131,-3,-53,62
1,1069,1492,-423,0,48,67
1,1826,1570,256,6,632,87
1,1422,1590,-168,0,15,87
-1,1242,1643,-401,0,-121,68
-1,1618,1769,-151,-3,-129,52
1,1882,1614,268,-4,-415,101
-1,1521,1968,-447,0,-122,78
1,1608,1886,-278,-2,-27,41
0,1565,1833,-268,-1,488,114
1,1645,1217,428,10,149,45
1,1255,1333,-78,2,82,53
1,1867,1638,229,0,405,105
1,1611,1179,432,-12,-293,59
1,1776,1420,356,1,151,75
1,1534,1442,92,5,152,57
1,1822,1573,249,7,665,91
1,1383,1155,228,4,311,67
-1,1598,1907,-309,-3,-45,124
0,1877,2063,-186,0,70,110
1,1718,1581,137,-1,14,57
1,2058,1834,224,0,65,73
1,1648,1560,88,2,65,63
-1,1380,1735,-355,0,-31,78
1,1734,1700,34,0,122,83
1,1436,1266,170,-1,-96,69
0,1613,1640,-27,0,30,79
1,1882,1452,430,6,199,51
1,1707,1562,145,4,262,80
1,1474,1499,-25,-2,-29,59
1,1872,1670,202,2,56,55
1,2057,1883,174,1,141,75
1,1704,1729,-25,-3,-74,47
1,1479,1526,-47,0,132,65
-1,1665,1878,-213,-12,-296,56
1,1767,1613,154,2,59,49
1,1876,2063,-187,0,-29,73
1,2099,1573,526,0,78,71
1,1574,1513,61,4,221,57
-1,1710,1649,61,-3,-94,72
0,1568,1833,-265,-4,90,69
1,1883,1660,223,0,-76,91
1,1458,1500,-42,0,499,113
1,1197,1532,-335,0,33,77
1,1481,1420,61,2,156,63
1,1500,1500,0,20,270,40
-1,1552,1657,-105,6,-24,59
-1,1270,1172,98,8,237,104
-1,1717,1497,220,-6,-538,84
-1,1738,1377,361,-1,28,48
1,1715,1881,-166,0,128,117
1,1716,1540,176,3,59,51
1,1655,1888,-233,1,395,139
1,1774,1725,49,-2,14,49
1,1344,1212,132,0,486,115
1,1766,1629,137,-8,14,71
-1,1830,2067,-237,0,-120,129
-1,1388,1537,-149,-4,-55,50
1,1435,1453,-18,9,565,135
1,1531,1461,70,6,762,111
1,1665,1544,121,5,155,47
-1,1399,1717,-318,-3,-237,106
1,1716,1508,208,-1,-46,101
-1,1390,1407,-17,-7,-115,48
1,1555,1351,204,3,5,41
1,1744,1571,173,3,525,103
-1,1716,1785,-69,0,-8,56
-1,1490,1545,-55,-4,17,50
-1,1218,1442,-224,0,-30,76
0,1470,1643,-173,0,-20,50
1,1413,1500,-87,2,118,79
1,1536,1673,-137,1,16,55
-1,1943,1893,50,0,108,130
1,1774,1774,0,-2,26,61
1,1481,1624,-143,0,-62,69
-1,1458,1587,-129,0,-116,78
-1,1218,1506,-288,-7,-201,50
1,1720,1329,391,3,82,63
-1,1290,1534,-244,-12,-46,40
1,1534,1722,-188,0,3,53
1,1707,1750,-43,-1,-16,45
1,1565,1441,124,1,154,65
1,1830,1638,192,4,28,45
1,1607,1433,174,-2,-51,75
1,1639,1450,189,-2,347,103
1,1202,1327,-125,2,123,47
1,1595,1450,145,3,146,59
1,1492,1298,194,0,305,125
-1,1160,1451,-291,-3,24,60
1,1721,1715,6,-2,22,75
-1,1246,1379,-133,-4,-259,92
1,1539,1286,253,5,189,51
1,1467,1569,-102,-1,-2,79
1,1592,1513,79,5,333,77
-1,1690,1691,-1,-3,-417,116
1,1486,1604,-118,9,354,57
-1,1496,1719,-223,-1,-64,70
-1,1613,1427,186,-2,95,104
-1,1259,1551,-292,-6,-359,72
-1,1504,1679,-175,-1,-358,118
1,1490,1511,-21,1,64,48
-1,1632,1837,-205,-3,-102,54
-1,1827,1708,119,-1,-192,72
-1,1677,1500,177,0,-92,90
-1,1662,1450,212,-3,-603,144
-1,2089,1816,273,0,6,52
1,1578,1485,93,3,187,61
1,1725,1491,234,-3,87,87
1,1124,1119,5,-2,12,45
1,1300,1443,-143,1,92,67
-1,1724,1491,233,1,20,48
-1,1862,1582,280,0,-21,94
1,1467,1645,-178,0,5,49
1,1346,1124,222,2,-3,67
1,1487,1639,-152,3,439,137
0,1730,1811,-81,0,-19,125
1,1555,1481,74,3,267,93
-1,1503,1601,-98,-6,-747,106
1,1423,1253,170,-2,89,73
-1,1870,1755,115,0,-311,126
-1,1509,1503,6,0,58,64
-1,1500,1169,331,-5,-1191,126
-1,1835,2059,-224,2,59,57
-1,1448,1500,-52,-4,-599,112
1,1826,1571,255,2,57,81
1,1730,1417,313,0,-12,63
1,1586,1499,87,1,94,59
1,1311,1441,-130,5,56,49
1,1916,1651,265,0,59,85
-1,1707,1809,-102,0,42,100
-1,1238,1205,33,-5,-3,42
1,1415,1428,-13,-3,-52,49
1,1722,1556,166,4,61,45
1,1445,1462,-17,6,334,101
1,1494,1593,-99,-1,-44,83
1,1316,1331,-15,0,25,49
1,1843,1627,216,4,109,43
-1,1731,1864,-133,-3,-120,50
-1,1061,1400,-339,-2,-102,62
1,1786,1785,1,-4,-12,71
-1,1429,1488,-59,-1,-138,86
1,1850,1676,174,6,286,51
-1,1817,1808,9,0,-225,76
-1,1734,1514,220,-1,-569,112
-1,1251,1218,33,-3,-201,68
-1,1559,1519,40,-1,-188,72
1,1564,1413,151,3,89,53
1,2100,1785,315,0,18,73
1,1472,1420,52,0,617,157
1,1670,1859,-189,-5,-449,93
-1,1605,1494,111,1,5,76
-1,2067,1830,237,0,-18,54
1,1380,1477,-97,1,679,165
0,1573,1450,123,0,13,77
-1,1587,1794,-207,0,-3,40
-1,1773,1673,100,0,-131,90
-1,1798,1652,146,-3,-13,46
0,1747,1396,351,-5,-60,110
0,1500,1575,-75,-2,-137,124
-1,1442,1486,-44,-9,-435,60
1,1236,1040,196,11,816,71
0,1656,1567,89,0,66,62
-1,1542,1489,53,-2,-180,94
0,1847,1676,171,0,-445,126
-1,1832,1617,215,-1,-93,112
1,1820,1805,15,2,140,67
1,1709,1658,51,2,237,75
-1,1733,1597,136,0,-39,68
-1,1687,1758,-71,-10,-316,60
1,1499,1183,316,7,55,43
-1,1508,1509,-1,0,-5,54
-1,1686,1833,-147,-5,-118,48
1,1530,1220,310,-6,-85,69
1,1848,2038,-190,1,34,61
1,1768,1678,90,0,185,83
1,1794,1830,-36,-1,0,69
-1,1893,1680,213,2,127,106
1,1570,1419,151,4,202,63
1,1327,1385,-58,-5,-44,41
1,1271,1344,-73,1,367,111
1,1670,1776,-106,-2,-7,65
-1,1695,1765,-70,0,-587,104
1,1640,1810,-170,-4,-121,79
-1,1570,1653,-83,-2,-26,46
1,1818,1807,11,-2,61,95
1,1712,1503,209,-1,9,73
-1,1761,1684,77,1,22,60
-1,1194,1372,-178,0,-63,78
1,1531,1520,11,1,121,59
1,1687,1820,-133,0,-77,91
-1,1469,1424,45,0,-180,92
-1,1508,1613,-105,3,78,115
1,1581,1412,169,4,-354,127
1,1789,1662,127,13,243,43
-1,1242,1500,-258,-1,-22,44
1,1698,1748,-50,-1,78,75
-1,1611,1871,-260,-8,-361,84
-1,1577,1438,139,-2,64,78
0,1724,1920,-196,0,-19,134
-1,1786,1741,45,-5,-137,54
1,1591,1482,109,3,643,121
-1,1796,1829,-33,-6,-17,43
-1,1483,1717,-234,-6,-405,74
-1,1509,1542,-33,-10,-86,44
1,1797,1500,297,4,51,47
1,1773,1701,72,-2,67,61
1,1704,1690,14,2,207,65
-1,1652,1798,-146,-3,-396,100
-1,2108,1860,248,0,-102,80
1,1839,1786,53,-1,-64,55
-1,1340,1505,-165,5,311,166
-1,1712,1734,-22,-1,-20,42
-1,1783,1679,104,-4,-477,100
1,1622,1500,122,0,33,124
-1,1561,1615,-54,0,-53,82
-1,1562,1368,194,16,303,40
-1,1663,1709,-46,0,-76,114
1,1737,1500,237,0,114,53
-1,1744,1701,43,0,-416,122
1,1776,1848,-72,0,365,107
-1,1237,1392,-155,0,70,50
-1,1712,1542,170,0,-33,52
1,1456,1438,18,11,73,41
-1,1729,1559,170,-2,-229,142
1,1559,1696,-137,-2,-58,61
1,1826,1346,480,1,94,51
1,1132,1214,-82,0,-13,43
1,1238,1894,-656,4,500,115
-1,1394,1463,-69,-7,-254,57
-1,1500,1830,-330,-2,-249,92
-1,1714,1732,-18,3,34,48
-1,1454,1331,123,-5,-123,52
1,1574,1767,-193,10,113,47
-1,1796,1504,292,-6,-138,48
1,1749,1591,158,-1,27,47
1,1840,1490,350,-2,-115,75
1,1742,1703,39,1,9,41
-1,1585,1694,-109,1,-4,52
1,1891,1590,301,0,209,81
1,1173,1157,16,7,212,49
-1,1577,1848,-271,1,61,104
-1,1519,1334,185,-8,-379,64
-1,1421,1582,-161,-4,-278,64
-1,1399,1230,169,1,-12,68
1,1756,1704,52,-1,47,81
-1,1554,1463,91,0,12,68
-1,1628,1530,98,0,-84,121
-1,1138,1203,-65,-4,-47,74
-1,1766,1695,71,-5,-200,54
-1,1438,1472,-34,-4,-130,62
-1,1587,1894,-307,-2,14,40
-1,1752,1708,44,-5,-29,40
1,1714,1792,-78,0,149,91
-1,1230,1562,-332,-2,-116,96
0,1588,1413,175,3,719,105
1,1739,1680,59,12,520,85
-1,1713,2114,-401,-3,-213,64
0,1518,1330,188,3,360,81
1,1712,1733,-21,0,122,109
-1,1510,1336,174,0,-79,90
1,1490,1656,-166,0,511,129
1,1673,1505,168,1,47,67
-1,1391,1514,-123,-1,-204,72
1,1617,1589,28,1,112,57
1,1682,1854,-172,1,-3,41
-1,1766,1500,266,0,-32,80
1,2117,1671,446,3,-50,79
-1,1659,1778,-119,-4,-252,88
1,1743,1603,140,2,90,69
-1,1339,1575,-236,-1,-36,59
-1,1656,1546,110,0,56,78
-1,1624,1500,124,-3,-50,60
-1,1770,1756,14,-1,-56,57
1,1540,1518,22,-2,-408,101
-1,1579,1628,-49,-3,-94,90
-1,1261,1230,31,0,-122,90
-1,1331,1573,-242,-10,-97,43
-1,1669,2119,-450,0,-11,66
-1,1403,1614,-211,-7,-220,60
-1,1480,1477,3,0,-95,52
1,1500,1413,87,-1,16,95
1,1759,1286,473,3,444,127
-1,1843,1854,-11,0,52,78
-1,1617,1715,-98,-1,-187,144
-1,1545,1462,83,-6,-181,78
-1,1528,1537,-9,-1,-165,102
-1,2121,1667,454,3,-37,104
0,1688,1539,149,-1,-69,111
-1,1450,1429,21,-4,-50,44
-1,1641,1593,48,0,50,74
-1,1631,1779,-148,1,-165,114
1,1857,1753,104,7,340,77
-1,1513,1610,-97,-2,-375,83
-1,1935,2057,-122,1,-13,46
1,1551,1625,-74,2,167,85
-1,1691,2095,-404,2,61,66
-1,1570,1596,-26,-4,-193,109
1,1392,1624,-232,-5,-14,65
1,2098,1689,409,1,232,129
1,1637,1305,332,2,36,51
0,1785,1651,134,-1,-81,109
-1,1677,1718,-41,-9,-262,98
-1,1867,1831,36,0,3,64
-1,1488,1442,46,0,-97,88
1,1560,1794,-234,0,38,59
1,1227,1288,-61,-1,-2,61
-1,1744,1643,101,0,3,44
-1,1456,1580,-124,-10,-375,48
1,2101,1726,375,-1,305,75
1,1560,1648,-88,4,149,59
-1,1939,1595,344,-1,-122,134
1,1745,1498,247,-2,-25,63
1,1299,1438,-139,1,110,65
-1,1612,1565,47,0,-257,90
-1,1372,1494,-122,3,114,62
1,1836,1754,82,0,12,75
0,2003,1674,329,-1,-24,111
-1,1724,2104,-380,-2,-190,72
1,1641,1923,-282,-1,-29,91
1,1820,1560,260,0,170,138
-1,1500,1408,92,-7,-543,62
-1,1241,1758,-517,-1,-12,46
-1,1845,1853,-8,0,-9,68
1,2107,1721,386,4,475,71
-1,1335,1494,-159,1,72,66
1,1876,1829,47,-1,-13,61
-1,1577,1573,4,-13,-288,46
1,1790,1621,169,-2,-40,53
-1,1719,2110,-391,-6,-129,60
-1,1341,1376,-35,-3,-99,70
1,1655,1781,-126,0,58,87
-1,1801,1660,141,0,-111,108
-1,1501,1743,-242,-2,-138,92
1,1612,1476,136,0,19,52
1,2112,1716,396,2,531,107
-1,1343,1655,-312,-9,-665,78
1,1696,1506,190,0,481,189
-1,1438,1610,-172,-5,-225,62
-1,1820,1784,36,0,3,42
-1,1759,1773,-14,-2,-133,82
-1,1483,1596,-113,-2,-101,180
1,1796,1639,157,0,64,59
1,1800,1759,41,2,212,67
-1,1860,1555,305,1,103,114
-1,1577,1600,-23,0,90,68
1,1832,1585,247,0,113,55
-1,1606,1264,342,0,566,114
1,1726,1030,696,5,269,57
1,1820,1886,-66,-1,33,55
1,1753,1682,71,1,76,75
-1,1697,1712,-15,-4,5,40
-1,1395,1507,-112,-7,-132,44
1,1953,1808,145,2,37,45
1,1327,1035,292,8,444,89
1,1639,1657,-18,2,1,59
1,1606,1585,21,-10,-2,107
1,1424,1483,-59,0,39,193
-1,1511,1331,180,0,15,52
1,1722,1600,122,5,428,117
-1,1815,1940,-125,0,55,78
1,1767,1670,97,1,71,91
1,1592,1735,-143,-1,0,41
-1,1578,1633,-55,2,222,86
-1,1659,1323,336,2,26,44
1,1506,1616,-110,-1,23,61
-1,1336,1571,-235,-6,-27,42
-1,1499,1501,-2,-1,-525,174
1,1640,1765,-125,1,178,77
-1,1750,1837,-87,-3,-86,44
-1,1873,1833,40,-2,-99,96
-1,1552,1580,-28,-3,-93,74
1,1466,1277,189,3,105,57
1,1546,1435,111,0,6,41
-1,1365,1480,-115,-11,-1092,116
1,1070,1299,-229,8,226,57
1,1642,1323,319,1,37,50
1,1784,1879,-95,-1,-11,88
-1,1015,1331,-316,-5,-763,90
-1,1611,1824,-213,0,-23,72
1,1718,1607,111,8,288,55
-1,1639,1572,67,0,-20,50
-1,1382,1428,-46,-3,-38,48
-1,1307,1588,-281,-6,-786,86
-1,1263,1348,-85,-1,-33,42
-1,1794,2057,-263,-3,-105,56
1,1514,1353,161,4,447,125
1,1936,1796,140,0,9,91
1,1738,1797,-59,0,504,133
-1,1989,1847,142,0,14,60
-1,1486,1594,-108,-1,-214,88
-1,1662,1486,176,0,-52,112
1,1668,1563,105,0,145,149
1,1456,1476,-20,-2,294,147
-1,1586,1375,211,-10,-324,62
1,1282,1170,112,-3,-84,61
-1,1740,1763,-23,1,-445,126
1,1595,1544,51,10,343,59
-1,1472,1481,-9,1,52,52
1,2061,1789,272,-1,-11,75
-1,1365,1359,6,-2,-141,100
-1,1845,1861,-16,0,-19,66
-1,1848,1674,174,-1,-73,68
-1,1500,1669,-169,0,-490,114
-1,1642,1568,74,2,7,96
-1,1374,1633,-259,0,-91,92
1,1797,1457,340,2,77,65
-1,1073,1319,-246,-11,-806,74
1,1440,1919,-479,-3,-35,87
1,1681,1586,95,0,271,93
-1,1219,1442,-223,-3,-65,58
1,1666,1644,22,2,35,51
1,1633,1586,47,7,137,41
1,1619,1577,42,0,-73,85
-1,1536,1591,-55,0,-284,86
-1,1862,1947,-85,-4,-57,46
1,1502,1718,-216,0,297,133
-1,1645,1651,-6,-9,-185,52
-1,1374,1463,-89,-9,-453,64
1,1728,1186,542,-4,-111,51
-1,1659,2012,-353,0,-215,136
1,1244,1356,-112,2,125,51
1,1296,1393,-97,2,201,75
1,1462,1531,-69,10,379,63
-1,1193,1465,-272,-6,-422,68
-1,1748,1846,-98,-12,-67,40
0,1587,1455,132,-4,104,117
-1,1465,1467,-2,-3,-109,48
-1,1711,1747,-36,-7,-78,58
-1,1575,1616,-41,1,23,64
1,1799,1532,267,3,406,123
1,1669,1568,101,2,62,51
-1,1384,1364,20,-8,-81,52
-1,1447,1117,330,9,326,76
-1,1782,1751,31,3,-17,96
-1,1917,1871,46,-4,-48,54
-1,1534,1609,-75,0,180,84
-1,1512,1487,25,3,343,86
-1,1850,1862,-12,4,184,68
-1,1403,1591,-188,0,-197,126
-1,1956,1887,69,-3,-132,60
1,1490,1500,-10,0,28,97
-1,1323,1606,-283,5,-68,100
1,1646,1627,19,-4,-109,53
1,1470,1154,316,2,114,69
-1,1185,1729,-544,-1,3,48
1,1475,1517,-42,0,25,45
1,1511,1181,330,7,174,49
-1,1830,1560,270,2,45,46
-1,1629,1684,-55,0,-7,82
-1,1646,1565,81,0,-15,56
1,1498,1498,0,1,71,67
-1,1901,1663,238,0,-24,48
-1,1702,1574,128,-1,-133,74
-1,1500,1481,19,2,-65,70
-1,1785,2132,-347,0,-40,52
1,1618,1468,150,-1,57,67
1,1582,1629,-47,2,97,65
-1,1479,1532,-53,5,149,52
-1,1865,1853,12,0,-24,58
1,1487,1471,16,-2,-70,65
1,1740,1901,-161,5,96,51
1,1782,1982,-200,-4,132,117
1,1805,1670,135,-1,-75,105
-1,1560,1453,107,1,0,48
-1,1558,1578,-20,-2,-192,94
1,1661,1635,26,6,317,53
-1,1525,1804,-279,-2,-614,124
-1,1240,1381,-141,-1,-110,56
-1,1633,1500,133,-2,-801,132
-1,1800,1885,-85,-1,-52,54
0,1675,1689,-14,1,42,112
-1,1500,1299,201,9,232,44
1,1315,1467,-152,2,68,67
1,1196,1067,129,8,934,113
1,1744,1657,87,-2,-148,68
1,1236,1252,-16,3,79,41
1,2007,1868,139,1,146,107
1,1596,1663,-67,2,34,53
1,1823,1865,-42,0,168,105
-1,1489,1455,34,-4,-117,62
-1,1885,1756,129,-1,-37,60
-1,1494,1769,-275,3,18,86
1,1625,1616,9,2,39,57
1,1520,1238,282,4,263,89
1,1498,1460,38,-2,250,74
-1,1388,1483,-95,-1,-18,52
0,1633,1659,-26,0,13,141
1,1617,1610,7,4,165,57
0,1915,1776,139,0,59,136
-1,1127,1227,-100,-4,-283,80
1,1900,1939,-39,-8,65,57
1,1627,1548,79,-4,81,161
1,1500,1314,186,0,27,75
-1,1245,1365,-120,0,-4,40
-1,1815,1771,44,-3,-295,118
1,1626,1500,126,1,23,55
1,1364,1387,-23,5,185,53
1,1697,1638,59,3,108,53
-1,1769,1798,-29,1,-439,102
1,1569,1528,41,-3,-21,41
1,1199,1388,-189,7,257,53
-1,1801,2115,-314,-1,-61,50
1,1501,1377,124,-1,14,53
-1,1621,1525,96,-3,-439,122
-1,1232,1422,-190,0,-21,52
1,1774,1580,194,0,-32,85
1,1492,1633,-141,3,91,57
-1,1621,1394,227,-8,-65,44
1,1309,1391,-82,8,343,69
-1,1800,1911,-111,-1,-25,46
1,1699,1164,535,2,201,105
-1,1508,1456,52,-3,-22,44
-1,1701,1861,-160,-3,-18,54
-1,1417,1604,-187,1,119,54
-1,1232,1661,-429,1,2,60
1,2119,1797,322,-4,-22,45
1,1808,1759,49,3,56,53
-1,1773,1957,-184,-2,-18,42
1,1611,1622,-11,2,416,89
1,1500,1516,-16,9,330,59
-1,1071,1524,-453,-2,-238,72
1,1601,1309,292,2,155,67
1,1920,1761,159,0,17,93
1,1618,1409,209,-1,45,51
1,1308,1397,-89,1,-99,91
1,1495,1469,26,-2,1,57
-1,1236,1428,-192,-3,-66,74
1,1655,1500,155,8,409,73
-1,1802,1784,18,-1,-23,53
-1,1893,1966,-73,-2,-224,82
-1,1506,1669,-163,-10,-201,42
1,1410,1562,-152,1,25,63
1,1749,1817,-68,0,-97,115
-1,1793,2123,-330,-6,-73,48
1,1490,1832,-342,0,5,51
-1,1234,1558,-324,-13,-1104,91
-1,1867,1804,63,-2,-33,76
-1,1230,1198,32,6,179,64
1,1795,1791,4,0,-4,43
-1,1599,1627,-28,-4,-155,75
-1,1648,1754,-106,0,-28,63
1,1396,1628,-232,0,29,65
1,1385,1323,62,2,428,89
-1,1688,1496,192,4,126,42
-1,1697,1865,-168,-9,-156,58
1,2127,1484,643,0,18,89
1,1927,1776,151,0,320,151
-1,1426,1550,-124,0,-130,86
-1,1628,1710,-82,1,213,110
1,1676,1500,176,9,87,43
1,1504,1490,14,6,103,51
1,1615,1579,36,0,181,97
-1,1929,1806,123,0,22,82
1,1549,1471,78,-1,815,133
-1,1780,1978,-198,-8,-181,50
1,1629,1677,-48,1,216,151
1,1675,1387,288,0,4,67
1,1711,1419,292,1,13,53
-1,1629,1380,249,0,5,62
-1,1972,2094,-122,-1,-252,104
-1,1523,1671,-148,0,-247,96
-1,1277,1546,-269,-4,-65,42
-1,1760,1699,61,-1,-162,66
1,1303,1489,-186,1,28,41
-1,1588,1642,-54,-8,-190,48
1,1473,1800,-327,11,375,59
0,1239,1376,-137,-3,1431,169
1,1723,1678,45,0,58,103
-1,1867,1667,200,1,47,66
1,1467,1569,-102,0,65,105
-1,1448,1685,-237,-2,-164,76
-1,1500,1539,-39,-4,-94,42
1,1467,1711,-244,-2,40,71
1,1550,1239,311,0,521,89
0,1761,1868,-107,1,169,113
1,1508,1150,358,1,88,59
-1,1676,1563,113,0,-203,96
-1,1687,1619,68,2,-282,108
-1,1644,1804,-160,-3,-76,56
1,1331,1365,-34,0,352,129
-1,1702,1652,50,-1,-59,62
-1,1613,1455,158,-1,-113,72
1,1701,1225,476,4,215,55
1,1706,1473,233,0,99,109
1,1434,1496,-62,1,-23,77
-1,1694,1489,205,0,-8,52
1,2166,1696,470,-1,23,65
-1,1753,1794,-41,2,-1261,168
-1,1649,1642,7,-7,-158,66
-1,1504,1666,-162,0,4,70
1,1211,1200,11,0,158,67
0,1516,1441,75,1,67,110
1,1510,1678,-168,0,12,55
1,1391,1296,95,0,7,59
-1,1755,1904,-149,0,-31,74
-1,1654,1638,16,-1,59,66
1,1310,1490,-180,6,270,83
-1,1695,2168,-473,-8,-189,42
1,1638,1516,122,2,257,55
-1,1511,1337,174,0,-1,72
-1,1640,1870,-230,-3,15,74
1,1698,1647,51,1,176,63
1,1596,1394,202,0,3,51
1,1638,1482,156,-8,103,121
-1,1690,1730,-40,0,-47,68
1,1506,1507,-1,0,565,139
-1,1945,2054,-109,0,184,124
-1,1771,1905,-134,0,-15,82
-1,1631,1660,-29,0,27,84
-1,1764,1819,-55,-2,-275,98
1,1547,1368,179,6,111,45
1,1730,1662,68,-3,-70,55
-1,1474,1590,-116,-4,-67,40
1,1431,1238,193,9,381,65
-1,1215,1283,-68,-1,-79,88
1,2171,1693,478,-2,-49,57
-1,1417,1530,-113,-2,-192,94
-1,1711,1862,-151,-4,-308,76
-1,1596,1327,269,1,50,58
1,1546,1352,194,4,166,63
-1,1508,1673,-165,-7,-53,52
1,1577,1650,-73,2,25,43
-1,1268,1886,-618,-6,-181,48
1,1410,1110,300,12,765,93
1,1367,1423,-56,1,13,43
1,1744,1632,112,1,15,47
-1,1619,1645,-26,-1,-19,48
1,1779,1495,284,-4,-123,63
1,1667,1689,-22,1,111,97
1,1731,1841,-110,-1,-36,57
-1,1389,1602,-213,-1,-277,76
-1,1691,2173,-482,-5,-48,41
-1,1640,1500,140,0,9,122
0,1912,1764,148,3,149,156
-1,1955,1803,152,0,-399,164
-1,1628,1713,-85,-2,12,74
-1,1828,1755,73,-1,-79,118
1,1354,1466,-112,0,59,61
1,1925,1736,189,-2,-12,65
1,1758,1332,426,-5,208,115
1,1517,1398,119,1,50,69
1,1439,1334,105,-3,650,84
1,1826,1745,81,-3,279,131
1,2208,2102,106,0,45,109
-1,1619,1577,42,-2,-90,76
1,1611,1348,263,0,169,93
0,1458,1391,67,0,-60,129
1,1483,1609,-126,0,24,47
-1,1403,1414,-11,-2,-34,50
1,1792,1680,112,0,-59,119
1,1577,1599,-22,2,56,63
1,1448,1353,95,2,106,71
-1,1624,1704,-80,0,3,94
0,1367,1243,124,0,397,109
-1,1737,1835,-98,0,-39,74
1,1111,1035,76,13,879,81
-1,1327,1497,-170,0,-83,54
1,1639,1475,164,0,25,57
-1,1402,1452,-50,-7,-278,84
1,1443,1286,157,6,242,63
1,1762,1875,-113,0,43,89
-1,2094,2222,-128,-2,-131,54
1,1474,1223,251,11,295,47
-1,1843,1729,114,-5,-259,96
0,1751,1609,142,-1,-169,125
1,1743,1689,54,0,98,67
0,1659,1732,-73,1,98,118
1,1525,1390,135,1,629,113
-1,1480,1323,157,-7,-113,46
-1,1343,1615,-272,-12,-634,68
-1,1674,1711,-37,0,-61,78
-1,1818,1940,-122,0,-89,94
1,1595,1661,-66,-3,62,60
-1,1938,1802,136,0,-79,78
1,1877,1740,137,3,295,77
-1,1743,1828,-85,0,-67,60
1,1735,1476,259,0,29,103
1,1397,1466,-69,10,179,43
-1,1454,1568,-114,-2,-41,44
1,1321,1581,-260,-5,-184,57
-1,1744,1768,-24,-5,-155,82
1,1837,1735,102,-1,20,109
1,1656,1330,326,10,788,71
1,2086,1708,378,2,34,45
-1,1769,1907,-138,0,-2,64
-1,1453,1451,2,1,58,62
-1,1632,1549,83,0,90,98
-1,1590,1528,62,0,7,50
1,1276,1702,-426,0,-42,67
-1,1644,1713,-69,-6,-233,60
0,1532,1383,149,3,449,113
-1,1489,1457,32,-1,-142,52
-1,1292,1601,-309,-1,66,72
-1,1678,1681,-3,-1,-84,110
-1,1454,1392,62,-3,-189,74
-1,1639,1661,-22,1,7,76
-1,1515,2088,-573,0,-307,94
1,1492,1443,49,-9,-21,45
-1,1471,1461,10,0,-38,92
-1,1539,1638,-99,-1,-223,94
-1,1747,1800,-53,-1,-592,124
-1,1034,1354,-320,0,-622,96
-1,1500,1813,-313,-3,-2,48
-1,1491,1783,-292,-8,-88,40
1,1973,1935,38,0,58,69
-1,1881,1601,280,0,-3,46
1,1890,1564,326,0,-59,85
1,1670,1524,146,1,283,75
-1,1613,1689,-76,0,-40,60
1,1388,1528,-140,0,9,97
-1,1503,1676,-173,0,7,46
-1,1647,1353,294,0,100,102
-1,1382,1749,-367,-1,-80,64
0,1439,1585,-146,-2,432,112
-1,1576,1256,320,1,8,56
-1,1327,1659,-332,-2,-158,66
-1,1740,1507,233,0,-52,54
-1,1800,1990,-190,-4,-74,52
1,1478,1430,48,-1,-19,101
1,1681,1417,264,3,121,56
-1,1500,1821,-321,-3,-56,44
-1,1738,1841,-103,-3,-105,52
0,1845,1704,141,0,-42,97
1,1486,1471,15,8,420,67
1,1608,1702,-94,1,149,101
1,1796,1760,36,0,-4,65
-1,1894,1860,34,-3,-84,160
1,2005,1926,79,1,60,69
1,1472,1572,-100,0,21,73
-1,1680,1596,84,-1,-61,114
1,1787,1487,300,0,26,46
1,1542,1692,-150,-2,-41,61
-1,1630,1629,1,-1,-39,44
-1,1847,1914,-67,-2,-39,42
1,1502,1755,-253,0,99,93
1,1605,1289,316,0,808,123
-1,1530,1418,112,-3,-55,66
-1,1448,1314,134,0,43,50
1,1541,1829,-288,0,-8,67
1,1678,1298,380,8,159,41
1,1524,1719,-195,3,673,193
-1,1556,1500,56,-1,-165,78
-1,1709,1849,-140,0,-82,78
-1,1540,1593,-53,2,-66,72
1,1733,1897,-164,-1,144,79
1,1321,1563,-242,-1,-14,55
-1,1727,1736,-9,0,56,76
-1,1377,1578,-201,-5,-135,68
1,1747,1558,189,4,290,65
1,1512,1698,-186,0,-29,59
1,1624,1576,48,-1,-11,41
1,1730,1833,-103,0,40,101
1,1759,1668,91,0,-13,103
1,1753,1552,201,8,265,69
1,1518,1517,1,-1,311,93
-1,1709,1698,11,-9,-270,62
-1,1320,1665,-345,3,115,64
1,1523,1630,-107,0,34,95
1,1547,1280,267,4,111,65
1,1917,1983,-66,0,76,63
1,1772,1760,12,0,-4,53
1,1468,1251,217,-3,461,151
-1,1758,1546,212,-3,-225,64
1,1685,1493,192,3,136,55
1,1664,1722,-58,-1,175,74
-1,1749,1783,-34,0,-195,74
1,1729,1651,78,3,63,47
0,1331,1295,36,-1,197,87
-1,1343,1498,-155,-3,-121,82
1,1717,1739,-22,0,-11,67
-1,1730,1945,-215,-6,-460,124
1,1563,1367,196,7,109,41
1,1742,1290,452,7,234,55
-1,1603,1531,72,-1,-204,68
1,1705,1559,146,2,107,107
1,2014,1720,294,0,28,55
0,1731,1574,157,0,-11,112
0,1580,1512,68,-1,-144,114
1,1529,1268,261,1,43,47
-1,1483,1791,-308,-2,-134,74
-1,1243,1473,-230,-6,-781,90
1,1298,1432,-134,5,221,63
-1,1811,1930,-119,0,28,74
-1,1589,1641,-52,-3,-125,76
-1,1551,1615,-64,1,72,60
1,1727,1728,-1,-1,-49,59
-1,1635,1924,-289,-2,-43,48
1,1340,1409,-69,0,8,43
1,2018,1757,261,1,89,133
1,1478,1236,242,1,319,115
-1,1733,1572,161,-1,25,46
1,1717,1738,-21,0,78,77
1,1433,1515,-82,-5,-155,59
1,1717,1588,129,-3,-6,45
0,1721,1728,-7,0,342,170
-1,1432,1680,-248,0,-12,58
-1,1507,1607,-100,3,86,64
-1,1371,1622,-251,-1,-61,106
-1,1765,1555,210,2,-1,82
-1,1744,1625,119,-2,-74,70
-1,1230,1483,-253,-1,-477,102
0,1727,1729,-2,-3,-287,110
1,1700,1541,159,-3,47,89
1,1731,1574,157,1,25,45
1,1542,1266,276,18,897,57
-1,1266,1472,-206,-5,-362,62
1,1738,1567,171,8,111,41
1,1559,1552,7,2,-280,101
1,1859,1590,269,1,85,84
-1,1738,1872,-134,-1,-47,80
1,1781,1452,329,3,84,91
-1,1459,1555,-96,-1,-30,60
-1,1729,1727,2,0,-81,156
0,1342,1366,-24,0,33,121
0,1469,1667,-198,8,168,122
-1,1218,1492,-274,-5,-609,108
-1,1530,1800,-270,-1,-7,42
-1,1340,1615,-275,0,18,46
1,1905,1803,102,-1,71,110
-1,1575,1563,12,-5,-275,86
1,1413,1497,-84,-2,-90,53
1,1631,1663,-32,0,135,63
1,1730,1681,49,0,12,65
1,1809,1816,-7,0,6,58
-1,1546,1403,143,-1,-52,78
1,1685,1427,258,0,-2,55
-1,1609,1484,125,2,205,68
1,1550,1574,-24,8,169,55
1,1738,1718,20,-1,41,65
0,1203,1332,-129,-1,16,107
0,1489,1578,-89,3,177,127
-1,1708,1748,-40,3,194,96
-1,1574,1563,11,0,42,64
-1,1475,1578,-103,0,-20,60
-1,1551,1653,-102,1,-77,120
1,1682,1793,-111,0,-7,47
1,1707,1619,88,1,229,85
1,1739,1671,68,0,81,89
-1,1658,1447,211,0,-47,70
1,1805,1820,-15,0,312,167
-1,1479,1626,-147,-5,-86,50
1,1750,1552,198,-1,349,101
-1,1326,1810,-484,-7,-496,80
-1,1478,1353,125,0,-59,112
1,1779,1697,82,5,364,71
1,1535,1572,-37,-3,695,119
-1,1609,1853,-244,-1,-67,62
1,1677,1532,145,-4,9,75
-1,1499,1661,-162,1,4,74
1,1688,1787,-99,-1,-33,53
1,1450,1847,-397,3,55,55
1,1500,1425,75,1,68,61
1,1541,1574,-33,0,27,73
1,1336,1418,-82,-2,129,91
-1,1530,1478,52,0,0,66
-1,1436,1104,332,-5,38,45
-1,2090,1699,391,2,31,52
-1,1756,1773,-17,-2,-97,66
1,1822,1473,349,2,224,67
1,1516,1646,-130,-1,76,124
-1,1725,1966,-241,0,-143,106
-1,1681,1622,59,-1,-32,108
-1,1536,1861,-325,-6,-253,66
-1,1777,1989,-212,-2,-196,96
-1,1634,1793,-159,-5,-334,72
-1,1658,1602,56,-1,-411,108
-1,1663,1825,-162,-3,-67,82
1,1632,1504,128,1,95,61
1,1865,1568,297,-2,-85,75
1,1535,1554,-19,2,232,102
1,1564,1399,165,-1,46,71
-1,1772,1628,144,0,76,74
1,1539,1468,71,0,-4,69
1,1562,1734,-172,0,-7,47
1,1833,1393,440,3,263,71
1,1571,1525,46,-3,-376,91
-1,1752,1719,33,-3,-90,80
-1,1831,1657,174,2,-1,62
-1,1644,1757,-113,-9,-667,122
-1,1971,2078,-107,0,-111,78
0,1562,1650,-88,2,-345,144
-1,1530,1725,-195,-8,-177,48
-1,1765,1636,129,1,-62,100
1,1716,1788,-72,2,164,93
-1,1736,1897,-161,0,-64,88
-1,1673,1815,-142,0,-55,74
-1,1615,1500,115,-3,-117,46
-1,1777,1802,-25,0,-249,115
1,1577,1515,62,4,95,49
-1,1256,1264,-8,0,-131,80
-1,1651,1750,-99,-2,-206,84
1,1205,1554,-349,-2,-39,55
1,1730,1502,228,1,128,67
-1,1413,1388,25,-5,-40,40
1,1331,1444,-113,3,28,43
1,1822,1666,156,0,139,114
1,1497,1641,-144,2,160,83
1,1548,1373,175,0,7,49
1,1668,1663,5,0,44,69
-1,1758,1643,115,2,377,110
-1,1617,1712,-95,0,-292,130
-1,1562,1835,-273,-5,-315,78
1,1491,1127,364,1,347,107
-1,1316,1403,-87,-3,-125,62
-1,1866,1903,-37,-6,-156,52
-1,1597,1571,26,0,-137,120
1,1504,1673,-169,0,545,157
1,1306,1388,-82,-7,-194,53
-1,1660,1888,-228,2,-75,112
-1,1541,1552,-11,-5,-82,48
1,1913,1856,57,-4,30,109
-1,1584,1529,55,-1,-121,92
1,1501,1715,-214,3,145,71
-1,1349,1521,-172,-5,-110,44
1,2047,2085,-38,0,28,73
1,1726,1581,145,-1,-37,45
0,1673,1817,-144,0,233,177
-1,1604,1698,-94,-7,-667,88
1,1701,1652,49,1,40,51
-1,1380,1594,-214,-10,-113,45
1,1086,0,1086,3,154,59
-1,1146,1628,-482,0,-356,90
-1,1556,1585,-29,0,-19,42
1,1508,1593,-85,1,241,119
1,2074,1968,106,0,-47,57
1,1494,1534,-40,5,79,51
1,1841,1310,531,3,476,79
1,1416,1413,3,-2,-27,67
-1,1518,1731,-213,2,161,62
-1,1519,1819,-300,-1,-31,54
-1,1679,1828,-149,-1,-26,54
1,1710,1644,66,2,117,74
-1,1599,1527,72,-15,-673,81
1,1546,1504,42,-2,105,69
-1,1847,1923,-76,-3,-83,54
-1,1543,1481,62,-1,-141,70
1,1317,1595,-278,5,218,69
-1,1650,1899,-249,-2,-223,138
0,1514,1418,96,0,0,77
-1,1525,1739,-214,0,30,55
1,1619,1574,45,8,357,61
-1,1244,1208,36,2,25,46
1,1495,1301,194,14,403,53
-1,1216,1600,-384,-8,-244,56
1,1743,1494,249,-2,-142,65
1,2081,1845,236,0,283,149
-1,1736,1513,223,-6,-199,80
-1,1488,1549,-61,-6,-219,58
-1,1563,1719,-156,-1,-23,50
1,1630,1143,487,4,588,93
-1,1990,1774,216,-1,-41,54
1,1556,1515,41,2,52,71
1,1468,1478,-10,0,14,135
-1,1745,1747,-2,-7,6,56
1,1753,1594,159,-2,-33,41
1,1615,1461,154,0,-19,82
1,1759,1489,270,4,174,61
1,1525,1666,-141,0,175,121
-1,1650,1635,15,-4,-58,72
-1,1931,1839,92,0,78,98
-1,1373,1207,166,1,54,52
-1,1520,1380,140,1,-104,100
-1,1500,1744,-244,2,58,86
-1,1122,1338,-216,-18,-429,44
-1,1291,1500,-209,-6,-307,66
1,1763,1485,278,5,60,45
1,1558,1381,177,4,131,59
1,1766,1481,285,2,170,79
0,1605,1540,65,4,146,108
1,1803,1600,203,2,132,59
1,1443,1480,-37,2,223,99
-1,1543,1507,36,-1,18,44
-1,1356,1530,-174,4,34,46
1,1474,1585,-111,3,449,101
-1,1506,1647,-141,-1,35,48
-1,1725,1556,169,-1,-34,42
1,1769,1646,123,4,95,56
1,1770,1478,292,-7,-97,75
-1,1625,1729,-104,0,27,70
-1,1529,1809,-280,0,7,64
-1,1110,1344,-234,-21,-1072,70
-1,1774,1474,300,-13,-769,84
-1,1399,1289,110,-4,-871,122
1,1480,1304,176,7,186,47
1,1387,1350,37,1,293,69
1,1573,1709,-136,1,114,95
-1,1365,1500,-135,-1,-66,52
1,1601,1582,19,-1,-80,67
-1,1520,1531,-11,2,66,58
-1,1652,1525,127,0,17,56
1,1754,1494,260,-7,-204,87
1,1751,1468,283,5,203,75
-1,1813,1938,-125,-3,-59,48
-1,1535,1460,75,0,15,42
1,1283,1486,-203,0,118,61
-1,1539,1776,-237,-1,-168,96
1,1656,1642,14,1,104,99
1,1599,1525,74,1,232,63
1,1617,1461,156,0,2,61
1,1565,1589,-24,0,3,59
-1,1852,1917,-65,2,196,74
1,1759,1489,270,-2,211,61
1,1946,1805,141,3,138,81
1,1498,1670,-172,2,106,67
1,1541,1637,-96,0,-15,41
1,1469,1338,131,0,82,69
1,1489,1524,-35,2,426,101
0,1733,1570,163,0,168,137
1,1763,1485,278,1,72,65
1,1623,1556,67,3,212,75
-1,1798,1953,-155,-2,-121,124
1,1696,1676,20,0,1,43
1,1767,1481,286,13,87,41
1,1748,1457,291,1,38,53
1,1583,1464,119,9,427,71
1,1803,1584,219,-1,-10,77
1,1771,1477,294,-1,-14,43
1,1475,1404,71,3,62,41
1,1364,1278,86,8,260,61
-1,1694,1706,-12,-5,-147,60
-1,1546,1632,-86,-2,-188,76
1,1737,1637,100,-5,4,57
-1,1517,1489,28,3,107,86
1,1724,1521,203,0,5,57
-1,1146,1449,-303,-5,-62,48
-1,1541,1509,32,-5,-56,41
1,1505,1473,32,7,200,59
1,1456,1591,-135,0,7,61
1,1588,1842,-254,3,636,125
-1,1396,1353,43,0,-333,156
-1,1541,1526,15,0,20,88
1,1535,1371,164,0,29,57
-1,1588,1408,180,0,-36,92
1,1960,1791,169,0,-22,47
-1,1695,1758,-63,0,-126,94
-1,2060,1746,314,-1,-21,72
-1,1601,1653,-52,0,-3,108
-1,1926,1843,83,-2,34,56
-1,1372,1412,-40,0,-567,124
-1,1755,1632,123,-5,-61,44
1,1575,1472,103,-2,46,67
-1,1748,1521,227,2,42,54
1,1624,1585,39,0,366,97
0,1210,1203,7,4,321,198
-1,1305,1301,4,5,208,92
-1,1650,1390,260,-1,-114,56
-1,1452,1573,-121,0,264,116
1,1549,1784,-235,3,245,89
1,1505,1355,150,18,778,69
1,2122,1612,510,1,45,53
1,1773,1685,88,2,463,117
-1,1501,1430,71,0,-17,78
1,1364,1541,-177,4,55,41
1,1474,1338,136,13,236,41
1,1545,1227,318,2,107,63
-1,1633,1679,-46,0,-10,48
-1,1473,1326,147,-2,-88,72
1,1470,1256,214,7,178,59
-1,1729,1760,-31,-2,-366,84
1,2124,1964,160,-1,-283,93
1,1766,1568,198,1,315,137
-1,1676,1786,-110,0,-103,83
-1,1464,1583,-119,-2,-158,78
-1,1547,1560,-13,-1,-11,86
1,1766,1257,509,8,525,93
-1,1509,1502,7,-3,-46,44
1,1475,1530,-55,0,-22,67
1,1857,1913,-56,0,10,41
-1,1328,1494,-166,0,-614,110
-1,1463,1515,-52,-1,-17,64
1,1525,1381,144,-1,1,107
-1,1500,1574,-74,1,9,40
1,1500,1474,26,15,274,51
-1,1531,1693,-162,-7,-259,54
1,1536,1512,24,8,199,55
-1,1590,1392,198,-3,42,44
-1,1785,2134,-349,0,19,82
-1,1678,1447,231,-3,-189,118
0,1562,1771,-209,-3,-241,132
1,1570,1484,86,1,253,117
-1,1421,1554,-133,-5,-255,71
-1,1294,1227,67,-1,-35,52
-1,1543,1410,133,1,159,88
1,1655,1557,98,1,41,69
-1,1432,1663,-231,-4,-208,54
1,1679,1460,219,4,223,62
-1,1475,1443,32,0,-73,124
-1,1768,1798,-30,-2,-28,107
1,1488,1398,90,-1,-19,43
-1,1482,1586,-104,-10,-227,116
1,1900,1869,31,-5,-18,69
-1,1658,2137,-479,0,-184,70
-1,1782,1848,-66,2,55,70
1,1578,1622,-44,-1,5,79
-1,1522,1662,-140,0,-113,112
-1,1409,1529,-120,3,-25,78
-1,1404,1721,-317,-1,-125,62
-1,1500,1570,-70,-5,-475,80
1,1523,1462,61,1,22,69
-1,1591,1569,22,5,406,74
1,1956,1657,299,4,344,83
-1,1858,1773,85,-1,-81,58
1,1888,1834,54,-4,-270,79
-1,1434,1700,-266,-6,-216,62
1,1557,1776,-219,0,1,54
-1,1536,1571,-35,1,7,68
-1,1518,1500,18,1,54,58
-1,1848,1590,258,-2,-78,80
1,1636,1342,294,-3,9,61
1,1633,1419,214,0,0,109
-1,1669,1653,16,1,-27,70
1,1600,1529,71,6,224,67
1,1574,1203,371,5,179,67
1,1488,1646,-158,0,243,92
-1,1844,1754,90,0,7,64
-1,1357,1307,50,-1,-195,56
1,1531,1389,142,1,627,201
-1,1426,1499,-73,0,-112,120
1,1590,1380,210,2,64,45
-1,1824,1897,-73,-3,3,56
-1,1524,1612,-88,-4,-47,46
1,1445,1578,-133,2,88,67
-1,1475,1579,-104,-1,-96,131
1,1497,1382,115,-1,4,53
-1,1864,1832,32,3,-707,182
1,2007,1803,204,2,55,51
1,1580,1717,-137,2,112,61
-1,1813,1801,12,-7,-335,62
-1,1905,1815,90,0,-194,64
1,1472,1668,-196,1,275,91
1,1898,1871,27,1,23,43
1,1486,1488,-2,0,22,93
1,1608,1332,276,-1,162,89
1,1843,1787,56,0,221,125
-1,1280,1492,-212,-1,-77,64
-1,1556,1506,50,0,-3,66
1,1757,1243,514,2,174,83
1,1510,1358,152,-3,-38,83
1,1658,1430,228,0,119,89
1,2012,2039,-27,0,25,57
-1,1650,1931,-281,0,-114,84
-1,1453,1608,-155,-1,-13,76
1,1737,1852,-115,2,446,95
1,1830,1413,417,0,17,67
1,1862,1908,-46,3,97,51
-1,1601,1628,-27,0,-17,58
1,1830,1892,-62,2,11,107
1,1468,1599,-131,5,547,87
1,1321,1341,-20,7,213,47
-1,1838,1805,33,0,-637,130
-1,1787,1646,141,0,20,58
-1,1513,1538,-25,-2,-156,58
-1,1610,1696,-86,2,-59,93
-1,1670,1622,48,-5,-322,84
-1,1544,1515,29,-1,-94,86
-1,1389,1379,10,0,25,126
-1,1725,1879,-154,0,-34,78
1,1521,1500,21,8,176,59
1,1123,1294,-171,3,36,57
-1,1356,1604,-248,0,-47,72
-1,1620,1593,27,0,-55,64
1,1615,1205,410,0,-22,63
-1,1880,1843,37,-6,-216,82
-1,1312,1560,-248,-3,-41,44
1,1576,1126,450,3,44,43
-1,1546,1740,-194,-1,-222,78
1,1558,1528,30,2,40,47
1,1486,1554,-68,4,137,57
-1,1432,1397,35,2,17,60
-1,1375,1600,-225,-1,-110,68
1,2050,1922,128,-3,-86,43
1,2097,1966,131,0,-9,93
1,1576,1356,220,-2,-36,107
1,1554,1518,36,-1,-11,47
-1,1546,1897,-351,-4,-189,82
-1,1620,1557,63,-4,-596,124
-1,1064,1447,-383,-17,-195,40
1,1760,1660,100,0,69,69
1,1475,1497,-22,0,327,89
-1,1698,1513,185,-1,-214,94
1,1716,1584,132,4,193,56
1,1569,1811,-242,0,26,63
1,1570,1409,161,1,73,63
1,1173,1264,-91,6,413,121
1,1459,1334,125,6,321,81
-1,1845,1665,180,3,106,70
-1,1432,1682,-250,-1,-96,80
-1,1416,1474,-58,0,-72,62
-1,1656,1804,-148,-4,-217,62
1,1759,1533,226,3,28,61
-1,1805,1770,35,0,-91,114
-1,1521,1499,22,2,6,52
-1,1551,1541,10,-4,-414,89
1,1746,1394,352,5,197,59
-1,1619,1771,-152,-1,-127,76
1,1279,1234,45,0,68,73
-1,1882,2028,-146,-1,-156,98
1,1548,1493,55,0,24,49
1,1561,1344,217,2,82,57
1,1466,1510,-44,3,80,43
-1,1569,1818,-249,-2,-182,82
-1,1652,1769,-117,-1,-98,102
1,1402,1577,-175,0,116,65
1,1640,1543,97,5,193,103
1,1793,1879,-86,-8,64,71
-1,1598,1489,109,-3,-61,52
1,1472,1809,-337,-1,55,67
1,1860,1526,334,3,710,107
-1,1386,1485,-99,-3,-83,60
-1,1487,1501,-14,1,24,76
1,1649,1535,114,2,117,59
0,1578,1686,-108,-2,423,157
-1,1391,1749,-358,0,-165,86
-1,1479,1499,-20,2,31,66
1,1915,2172,-257,1,156,95
1,1540,1365,175,-1,-2,61
-1,1960,2104,-144,0,-109,135
1,1866,1806,60,0,12,77
-1,1682,1520,162,2,33,54
1,1785,1557,228,-8,282,95
-1,1626,1556,70,1,96,126
1,1844,1888,-44,-2,-53,95
1,1773,1789,-16,-4,60,57
1,1776,1645,131,0,-8,58
-1,1552,1540,12,-9,-857,146
1,1870,1666,204,-1,309,115
1,1770,1769,1,7,149,49
1,1807,1790,17,-2,-25,113
1,1407,1500,-93,1,62,71
1,1493,1390,103,-1,-23,41
1,1511,1402,109,-2,60,101
-1,1576,1725,-149,-4,-59,42
1,1672,1526,146,12,636,67
-1,1486,1583,-97,2,32,40
1,1558,1360,198,1,23,47
-1,1717,1875,-158,3,181,76
-1,1068,1339,-271,-13,-241,78
1,1638,1783,-145,-3,-91,115
1,1752,1388,364,14,610,75
-1,1777,1784,-7,-6,-66,50
-1,1510,1782,-272,-3,-97,56
1,2154,1933,221,0,-39,77
1,1304,1343,-39,-2,73,55
-1,1572,1811,-239,0,-46,62
-1,1289,1156,133,3,142,74
1,1882,1710,172,0,72,61
1,1453,1562,-109,6,620,81
-1,1560,1558,2,1,-45,76
-1,1435,1771,-336,-6,-68,44
0,1795,1765,30,1,115,140
1,1501,1546,-45,4,367,65
1,1823,1564,259,2,688,139
-1,1700,1590,110,-4,-367,126
1,1558,1165,393,1,352,81
1,1477,1368,109,-2,-193,81
1,1385,1756,-371,-5,283,118
1,1888,1703,185,1,8,49
1,1551,1541,10,0,421,177
1,1732,1568,164,0,64,92
-1,1459,1654,-195,1,-16,64
1,1696,1497,199,-9,-298,57
1,1606,1407,199,5,76,47
-1,1876,1856,20,0,-12,94
-1,1970,1953,17,0,-16,62
1,1468,1506,-38,8,471,71
-1,1768,1653,115,-2,-5,62
-1,1534,1338,196,0,-129,64
-1,1899,1691,208,1,19,54
-1,1420,1683,-263,0,-31,98
-1,1650,1781,-131,-1,-23,72
1,1605,1409,196,2,112,63
0,2035,1869,166,0,12,72
1,1549,1369,180,-8,-111,51
1,1730,1649,81,0,130,93
-1,1709,1882,-173,-2,-59,86
1,1789,1719,70,0,15,75
-1,1514,1686,-172,0,-9,54
-1,1302,1281,21,-12,-934,104
1,1482,1197,285,4,524,81
-1,1667,1753,-86,0,-69,66
1,1661,1329,332,-1,-10,48
0,1791,1775,16,-4,38,138
1,1571,1501,70,1,157,115
1,1888,1703,185,-13,-191,53
-1,1611,1407,204,-6,-355,96
-1,1685,1360,325,-2,-252,90
-1,1676,1826,-150,-12,-35,40
1,1491,1759,-268,4,357,93
1,1555,1379,176,-1,6,43
1,1363,1416,-53,3,97,55
1,1696,1894,-198,1,529,111
1,1804,1756,48,1,21,71
1,1572,1590,-18,-1,-39,61
-1,1687,1415,272,1,-186,99
1,1692,1508,184,0,6,65
-1,2065,2082,-17,1,64,72
-1,1753,1892,-139,-2,-326,128
-1,1548,1556,-8,1,-39,108
-1,1681,1877,-196,0,-133,88
-1,2098,2052,46,0,-23,142
1,1790,1928,-138,0,-32,65
-1,1685,1500,185,0,-261,76
1,1530,1561,-31,1,113,173
-1,1523,1864,-341,-3,-339,86
-1,1645,1496,149,0,-10,56
1,1355,1238,117,6,248,53
-1,1418,1593,-175,0,-67,62
1,1788,1846,-58,-1,-34,63
-1,1553,1791,-238,1,-12,48
-1,1643,1858,-215,-1,-126,88
-1,1365,1561,-196,-2,-350,78
-1,1740,1560,180,0,30,60
-1,1888,2095,-207,0,-305,120
1,1791,1775,16,-1,60,63
1,1900,1746,154,0,151,129
1,1500,1435,65,2,168,73
-1,1304,1359,-55,3,218,80
-1,1385,1792,-407,-1,2,46
-1,1708,1950,-242,-1,-86,80
-1,2155,1668,487,-2,-24,52
-1,1155,1806,-651,-9,-367,71
1,1502,1698,-196,4,293,107
-1,1566,1883,-317,-12,-294,58
-1,1756,1688,68,-2,-205,86
1,1581,1217,364,-1,124,77
-1,2101,1823,278,-1,-31,60
1,1675,1669,6,-1,-107,69
-1,1500,1500,0,-3,-381,96
-1,1404,1620,-216,-8,-191,46
1,1690,1165,525,6,299,89
1,1612,1480,132,0,49,79
1,2040,2084,-44,2,569,147
1,1910,1912,-2,0,8,59
1,1786,1528,258,2,87,67
1,1616,1657,-41,-2,-31,59
-1,1686,1662,24,-15,-289,42
1,1886,2054,-168,1,21,43
-1,1212,1504,-292,-15,-787,86
1,1431,1407,24,-3,-27,43
0,1412,1599,-187,-1,-219,92
0,1754,1790,-36,0,-10,87
-1,1610,1667,-57,-1,-49,46
1,1703,1708,-5,1,7,65
1,1635,1715,-80,4,258,77
-1,1903,2071,-168,-1,-153,91
-1,1337,1677,-340,-1,-286,108
-1,1720,2149,-429,-15,-517,64
1,1628,1814,-186,-1,-33,55
1,1863,1638,225,0,33,85
1,1774,2006,-232,0,-17,81
-1,1425,1746,-321,-1,-65,74
1,1340,1364,-24,2,2,83
-1,1464,1523,-59,5,309,70
-1,1397,1579,-182,1,4,46
1,1560,1251,309,6,147,46
1,2163,1718,445,3,158,63
1,2079,1896,183,1,441,99
-1,1263,1519,-256,-4,-14,42
-1,1290,1644,-354,-2,-29,54
1,1652,1680,-28,-3,320,83
0,1686,1811,-125,-4,-943,142
-1,1700,1649,51,3,239,88
1,1800,1586,214,2,202,81
-1,1583,1593,-10,-1,-26,62
1,1796,1548,248,6,70,47
-1,1532,1454,78,-9,-468,70
0,1890,2086,-196,-2,-594,110
1,1716,2176,-460,-2,-53,67
-1,1284,1203,81,-5,-216,66
-1,1647,1642,5,-1,-147,60
1,1567,1102,465,9,277,53
1,1469,1519,-50,5,316,65
1,1601,1253,348,0,55,59
1,1703,1681,22,-1,-1,63
1,1524,1791,-267,-1,-5,43
-1,1896,2079,-183,-1,-50,54
1,1743,1635,108,0,-417,115
-1,1669,1653,16,-5,-538,100
1,2028,1736,292,8,312,63
-1,1662,1686,-24,-5,-151,48
-1,1988,1792,196,-1,-175,102
-1,1507,1483,24,-1,-507,84
1,1594,1522,72,0,99,63
-1,1924,2071,-147,1,-30,80
1,1807,1690,117,6,354,65
1,1508,1489,19,0,-166,81
-1,1930,2086,-156,-5,183,102
-1,1570,1658,-88,-2,-188,92
1,1612,1677,-65,1,183,65
1,1797,1749,48,-5,23,101
-1,1657,1579,78,10,264,56
1,1802,1869,-67,0,8,52
-1,1732,2051,-319,-6,-135,68
-1,1496,1496,0,5,415,86
1,1678,1890,-212,0,317,105
-1,1697,1651,46,-3,-261,106
1,1633,1398,235,1,73,101
-1,1061,1574,-513,-4,-131,52
1,1503,1330,173,-1,57,73
1,1391,1585,-194,-2,-221,103
-1,1691,1500,191,-4,-35,44
-1,1682,1815,-133,-5,-130,68
1,1769,1544,225,0,7,51
1,2069,1728,341,6,97,45
1,1791,1520,271,11,389,109
1,1634,1151,483,1,155,99
1,1506,1484,22,-1,-142,71
1,1923,1872,51,3,256,71
1,1868,1317,551,5,193,53
1,1508,1206,302,18,1075,87
1,1667,1472,195,-3,-181,59
1,1809,1971,-162,0,10,47
0,1434,1408,26,2,-47,128
-1,1725,2085,-360,0,-321,124
1,1664,1684,-20,0,314,98
-1,1615,1797,-182,-5,-82,44
1,1473,1516,-43,1,165,57
-1,1544,1800,-256,-1,-79,72
-1,1955,1826,129,-2,-55,72
1,1469,1500,-31,7,296,65
-1,1326,1394,-68,0,1,62
-1,1417,1610,-193,-5,-267,81
1,1665,1672,-7,3,113,51
-1,1504,1486,18,3,-85,80
1,2098,1722,376,0,230,75
-1,1854,1977,-123,1,44,64
1,1863,1677,186,0,16,57
-1,1661,1467,194,-6,-202,70
-1,1498,1493,5,0,720,84
1,2078,1916,162,3,322,93
-1,1538,1775,-237,-1,-160,74
-1,1743,1701,42,1,45,66
-1,1617,1680,-63,0,-80,76
-1,1719,2109,-390,-9,-316,66
1,1676,1608,68,1,35,45
1,1870,1609,261,5,105,45
1,2159,1883,276,2,60,67
0,1561,1667,-106,1,122,132
1,1868,1989,-121,0,-253,105
1,1343,1063,280,-3,-234,71
-1,1739,1659,80,-1,-39,56
-1,1603,1355,248,-4,-417,134
-1,1486,1488,-2,0,4,52
1,1439,1598,-159,3,493,151
0,1806,1829,-23,1,99,118
-1,1409,1433,-24,1,-6,74
1,1685,1671,14,1,6,41
1,1974,1884,90,0,438,85
-1,1534,1485,49,-1,22,86
-1,1561,1716,-155,-1,10,54
-1,1249,1218,31,-2,-126,68
1,1454,1519,-65,14,858,117
-1,1725,1940,-215,0,-88,150
1,2163,1879,284,0,-83,219
-1,1908,2084,-176,-1,-223,106
-1,1568,1512,56,0,-207,128
-1,1811,1692,119,1,-33,72
1,1362,1256,106,-1,-36,51
-1,1672,1725,-53,-10,-323,106
-1,1696,1675,21,5,159,70
1,1797,1526,271,2,86,63
1,1501,1515,-14,3,329,85
1,1322,1690,-368,0,-16,105
1,1523,1505,18,-2,189,83
1,1635,1677,-42,0,24,115
1,1448,1525,-77,0,-2,41
-1,1754,1947,-193,0,-6,53
-1,1633,1777,-144,1,68,88
1,1463,1433,30,3,195,71
1,2012,1817,195,3,132,73
-1,1317,1528,-211,-15,-245,42
1,1804,1762,42,-3,293,76
-1,1602,1654,-52,-6,-126,40
1,1512,1539,-27,-1,294,113
1,1610,1626,-16,4,235,87
-1,1701,1626,75,0,-13,52
-1,1661,1533,128,-4,-163,78
-1,1718,1410,308,-2,-40,62
1,1640,1407,233,1,36,67
-1,1483,2128,-645,0,-37,144
-1,1346,1590,-244,-7,-250,118
-1,1749,1588,161,-1,-50,56
-1,1589,1701,-112,-4,-113,54
-1,1752,1814,-62,-1,-367,202
-1,1613,1650,-37,0,3,54
-1,1731,1691,40,1,212,90
1,1578,1608,-30,1,148,115
1,1322,1411,-89,-1,-10,77
1,1029,1211,-182,-2,-15,47
-1,1730,1682,48,3,31,40
1,1877,1653,224,2,189,107
-1,1821,1775,46,1,-25,98
1,1511,1685,-174,0,-22,62
1,1754,1862,-108,1,86,95
0,1462,1557,-95,-4,-703,106
1,1527,1604,-77,0,27,74
-1,1533,1494,39,0,9,76
1,1058,1500,-442,5,319,73
1,1585,1733,-148,0,108,97
-1,1424,1707,-283,-4,-2,45
-1,1666,1589,77,0,1,56
1,1872,2065,-193,1,-200,105
0,1711,1419,292,-1,-115,103
-1,1474,1423,51,-3,-559,128
-1,1677,1500,177,0,-7,51
0,1591,1541,50,0,-118,125
-1,1668,1528,140,1,321,126
1,1676,1602,74,7,174,65
1,2128,1482,646,2,98,59
1,1315,1427,-112,4,96,55
-1,1639,1687,-48,-1,-14,44
-1,1304,1475,-171,-8,-96,42
-1,1953,1663,290,0,-33,78
1,1683,1159,524,1,-6,45
-1,1550,1505,45,-1,-14,40
-1,1190,1761,-571,-1,-64,54
1,1843,1733,110,0,37,65
-1,1546,1647,-101,-1,-118,56
1,1672,1583,89,-1,0,55
1,1716,1319,397,2,51,45
0,1823,1803,20,0,357,108
-1,1627,1461,166,1,2,46
1,1787,1809,-22,-3,61,151
-1,1735,1553,182,0,-56,63
1,1941,2048,-107,2,364,79
-1,1611,1818,-207,-1,-19,110
-1,1479,1541,-62,0,242,126
-1,1482,2129,-647,-1,-73,78
-1,1721,1764,-43,1,17,54
-1,1648,1883,-235,0,-143,154
-1,1147,1784,-637,-3,-257,66
-1,1790,1956,-166,-2,-307,138
-1,1822,1653,169,-10,-317,64
-1,1187,1473,-286,0,-17,46
-1,1658,1724,-66,-1,-72,60
1,1666,1606,60,2,31,49
1,1762,1538,224,0,33,93
-1,0,1178,-1178,-6,-176,50
1,2033,1956,77,0,-2,61
0,1402,1330,72,-1,-133,102
-1,1804,1822,-18,0,-23,68
1,1726,1402,324,-4,-207,83
1,1596,1590,6,0,128,157
-1,1712,1680,32,0,-22,54
1,1671,1466,205,0,129,65
1,1297,1611,-314,6,1009,117
-1,1303,1450,-147,1,-113,110
-1,1341,1870,-529,-1,-250,112
0,1598,1623,-25,0,-260,131
1,1602,1653,-51,2,144,99
-1,1261,1525,-264,-2,-61,50
1,1436,1459,-23,4,46,49
-1,1669,1806,-137,-1,-10,68
-1,1548,1597,-49,-3,-34,46
1,1611,1481,130,0,1,55
-1,1947,2042,-95,1,115,94
-1,1560,1690,-130,0,-22,70
1,1665,1519,146,0,275,113
1,1897,1465,432,3,85,63
1,1178,1146,32,5,135,59
-1,1590,1685,-95,-2,-165,88
-1,1832,1794,38,1,91,76
1,1710,1500,210,2,116,59
1,1398,1730,-332,3,486,87
-1,1533,1768,-235,-2,-220,100
1,1534,1611,-77,-1,15,49
-1,1213,1177,36,-3,-301,86
1,1849,1733,116,-3,3,111
1,1867,1692,175,3,188,93
-1,1550,1469,81,0,-178,80
-1,1451,1283,168,-6,-344,76
1,1618,1549,69,-1,-25,51
1,1835,1669,166,4,34,43
1,1708,1422,286,1,-91,73
1,1813,1662,151,0,24,65
1,1781,1709,72,-4,-75,45
-1,1405,1151,254,-7,-592,118
1,1169,1256,-87,0,202,76
-1,1506,1582,-76,-20,-790,64
1,1719,1538,181,1,4,43
1,1695,1716,-21,-3,-46,83
1,1852,1607,245,1,201,88
1,1633,1446,187,-1,-141,105
1,2050,1789,261,1,20,45
-1,1457,1784,-327,-1,-31,48
1,1785,1358,427,0,-18,59
1,1770,1685,85,-3,-99,71
1,1627,1610,17,0,160,56
1,1339,1677,-338,1,132,128
0,1774,1528,246,0,-31,94
0,1655,1820,-165,0,8,56
1,1483,1536,-53,3,98,45
1,1806,1873,-67,0,13,113
0,1453,1500,-47,0,-3,44
-1,1599,1790,-191,3,-174,116
-1,1677,1587,90,2,112,56
-1,1320,1563,-243,1,31,134
-1,1302,1435,-133,-4,-239,56
1,1659,1561,98,-1,114,81
1,1627,1341,286,2,321,109
-1,1637,1842,-205,-1,33,80
-1,1190,1401,-211,-5,-168,68
1,1857,1799,58,2,38,67
-1,1844,1602,242,1,-78,88
1,1815,1660,155,0,-90,79
1,1524,1496,28,0,74,65
-1,1697,1796,-99,-5,-111,86
1,1477,1454,23,2,75,47
1,1699,1539,160,2,649,117
-1,1705,1541,164,-4,-138,62
-1,1808,1789,19,4,-55,70
-1,1994,1927,67,1,47,80
1,1860,1818,42,1,12,55
-1,1472,1452,20,-2,-411,76
-1,1489,1500,-11,-4,-605,116
1,1721,1524,197,-1,23,119
1,1848,1800,48,-5,-102,41
-1,1442,1294,148,-9,-259,52
-1,1620,1819,-199,-6,-638,98
-1,1919,1964,-45,0,-11,50
1,1428,1209,219,5,116,51
1,1198,1263,-65,-1,-44,53
1,1534,1378,156,-1,893,141
-1,1569,1791,-222,-1,-5,40
-1,1654,1822,-168,0,-61,66
-1,1809,1870,-61,-1,-181,72
-1,1632,1858,-226,-2,-185,98
1,1554,1487,67,-4,-90,71
-1,1877,1781,96,-2,-43,62
1,1371,1325,46,-1,-5,59
1,1535,1766,-231,0,65,87
0,1782,1698,84,0,-25,109
1,1500,1613,-113,4,32,43
-1,1558,1801,-243,0,-92,88
0,1299,1653,-354,-3,-173,111
1,1543,1453,90,1,29,51
1,1750,1875,-125,0,3,53
-1,2007,2130,-123,-3,-19,72
1,1579,1488,91,12,214,43
-1,1311,1426,-115,-3,-151,56
-1,1607,1525,82,-4,-173,66
-1,1627,1552,75,-1,-35,54
1,1582,1553,29,0,118,87
-1,1605,1663,-58,0,-94,68
-1,1809,1681,128,0,-64,96
1,1276,1500,-224,9,325,47
-1,1828,1740,88,-1,-256,108
-1,1704,1353,351,-5,-128,52
-1,1762,1472,290,4,88,50
1,1787,1882,-95,0,-67,141
-1,1659,1879,-220,-5,-40,40
1,1827,1614,213,-1,107,145
1,1505,1439,66,2,210,85
1,2139,1935,204,3,117,55
-1,1928,1926,2,-2,-169,84
-1,1858,1765,93,-1,-15,54
-1,1557,1568,-11,0,-5,68
1,1744,1509,235,0,99,65
1,1434,1303,131,1,167,97
1,1509,1553,-44,-1,-31,77
-1,1456,1478,-22,-5,-138,50
0,1750,1795,-45,-3,-77,178
1,1551,1532,19,7,325,65
1,1867,1801,66,-1,-18,56
1,1894,1817,77,6,49,51
-1,1638,1678,-40,0,-292,152
1,1648,1621,27,0,204,101
1,1792,1876,-84,0,184,73
1,1631,1396,235,-2,80,67
-1,1482,1444,38,-1,-157,110
1,1179,1291,-112,1,165,63
-1,1582,1633,-51,-4,-354,84
1,1500,1671,-171,1,204,97
-1,1806,1568,238,-3,5,52
1,1603,1332,271,5,192,61
-1,1809,1967,-158,-2,-77,58
-1,1562,1719,-157,3,16,62
-1,1509,1602,-93,-5,-192,52
1,1609,1834,-225,0,-55,107
-1,1306,1666,-360,-2,-154,68
-1,1750,1614,136,0,-12,72
-1,1771,1863,-92,-2,-367,126
1,1504,1473,31,1,-3,47
-1,1540,1521,19,-1,-98,112
-1,1810,1500,310,-2,-397,110
1,1742,1500,242,6,264,67
1,1803,1621,182,0,-1,79
1,1917,1937,-20,-2,-42,55
-1,1629,1705,-76,-3,-133,62
1,1658,1621,37,-2,-37,45
-1,1835,1673,162,-4,-114,98
-1,1704,1779,-75,-3,-36,50
1,1276,1356,-80,7,-1,42
-1,1595,1425,170,0,-116,78
1,2152,1863,289,-3,-15,45
0,1672,1614,58,2,535,133
-1,1898,1906,-8,2,-13,116
1,1457,1500,-43,3,94,47
-1,1380,1372,8,-3,-155,60
1,1555,1514,41,0,13,109
-1,1662,1447,215,-3,-523,106
1,2012,1926,86,1,-261,107
1,1607,1725,-118,0,32,47
1,1778,1695,83,2,76,55
-1,1479,1568,-89,-8,-184,48
1,1809,1603,206,0,-13,47
-1,1578,1542,36,-7,-422,64
-1,1840,2157,-317,0,-11,56
1,1645,1510,135,3,498,97
0,1710,1623,87,1,110,112
1,1533,1528,5,2,18,49
-1,1545,1773,-228,-4,-95,48
-1,1731,1629,102,0,-108,114
-1,1522,1500,22,2,148,80
-1,1549,1439,110,3,78,48
-1,1801,1643,158,0,227,130
1,1581,1590,-9,-1,-38,67
1,1758,1514,244,-3,107,101
-1,1594,1815,-221,-1,-37,58
-1,1722,1637,85,1,79,64
-1,1631,1637,-6,1,20,45
1,1540,1543,-3,-3,-56,51
-1,1459,2060,-601,0,-33,100
1,1459,1465,-6,-1,-156,109
-1,1709,1693,16,-2,-18,46
0,1414,1514,-100,1,19,138
-1,1552,1532,20,-4,-67,44
-1,1234,1292,-58,-7,-145,48
-1,1565,1311,254,2,197,86
1,1565,1453,112,0,28,63
-1,1253,1395,-142,-4,-244,84
1,1709,1843,-134,1,47,45
1,1593,1550,43,-9,-50,83
1,1330,1340,-10,3,50,47
-1,1406,1508,-102,-4,-183,56
-1,1521,1642,-121,0,-456,98
-1,1778,1715,63,0,37,52
1,1820,1595,225,2,10,113
-1,1790,1812,-22,-10,-402,68
-1,1503,1626,-123,-2,-121,84
1,1688,1628,60,9,182,44
1,2166,2219,-53,9,288,65
-1,1314,1676,-362,-9,-194,88
1,1705,1701,4,3,91,61
-1,1662,1651,11,0,5,52
1,1718,1775,-57,1,-1,51
-1,1453,1470,-17,-3,-8,42
-1,1471,1341,130,-3,-929,132
1,1503,1410,93,0,236,93
1,1621,1489,132,0,59,75
1,1713,1643,70,0,181,105
1,1394,1339,55,-2,165,101
1,1787,1607,180,3,519,140
1,1762,1729,33,3,528,113
1,1731,1667,64,5,476,137
1,1612,1259,353,0,135,73
1,1935,1544,391,2,115,87
-1,1708,1690,18,1,60,72
-1,1580,1566,14,-4,51,54
-1,1871,1662,209,-1,-90,84
-1,1509,1518,-9,-1,-176,84
-1,1772,1718,54,1,12,54
1,1633,1383,250,3,416,97
-1,2130,2181,-51,0,13,66
-1,1714,1761,-47,2,56,62
-1,1534,1661,-127,0,-521,144
1,1619,1697,-78,0,160,155
-1,1732,1759,-27,2,68,120
1,1487,1540,-53,7,264,67
-1,1126,1313,-187,0,-107,106
-1,1377,1424,-47,-4,-615,88
-1,1825,1894,-69,-4,-115,94
-1,1328,1350,-22,-13,-325,56
1,1791,1535,256,1,10,49
1,1686,1854,-168,2,339,135
-1,1166,1747,-581,-5,-193,58
-1,1721,1769,-48,0,-257,114
-1,1454,1562,-108,0,-3,52
1,1542,1531,11,-1,-68,55
-1,1591,1948,-357,0,-4,68
1,1904,1527,377,8,268,57
1,1652,1847,-195,1,-21,57
-1,1500,1609,-109,-18,-117,42
1,1800,1685,115,0,197,131
-1,1402,1586,-184,-1,15,112
-1,1500,1313,187,-5,-72,50
-1,1346,1661,-315,0,-439,122
-1,1488,1543,-55,1,-4,90
1,1404,1330,74,-1,68,83
1,1908,1711,197,1,-3,51
1,1902,1815,87,3,37,45
-1,1725,1696,29,0,29,120
-1,1412,1335,77,-5,-151,56
-1,1443,1402,41,-7,-7,42
1,1461,1617,-156,6,243,49
0,1708,1694,14,-3,83,163
-1,1716,1796,-80,-2,-46,56
0,1884,1793,91,0,1,116
-1,1698,1845,-147,1,34,40
1,1480,1488,-8,2,379,95
-1,1596,1655,-59,-1,-104,70
1,1670,1594,76,0,-206,171
-1,1406,1633,-227,0,-87,60
-1,1635,1748,-113,-1,-102,74
-1,1807,1911,-104,0,6,44
1,1852,1689,163,2,-2,43
-1,1303,1724,-421,0,-71,64
-1,2097,1825,272,-1,1,40
1,1692,1687,5,0,366,139
-1,1522,1451,71,1,82,74
1,1918,1799,119,2,140,97
1,1916,1501,415,-1,-83,79
-1,1222,1615,-393,-7,-171,50
1,1650,1513,137,1,70,55
1,1349,1464,-115,0,94,77
-1,1864,1673,191,-6,-241,58
-1,1554,1638,-84,1,44,134
1,1672,1615,57,-3,-76,65
1,1679,1311,368,5,167,49
1,1694,1848,-154,-1,30,63
1,1329,1404,-75,2,86,157
-1,1584,1564,20,0,-251,94
-1,1667,1604,63,0,-21,102
1,1668,1526,142,-1,33,89
0,1367,1316,51,0,-133,119
1,1919,1498,421,-1,-21,59
-1,1562,1853,-291,-4,-363,120
1,1726,1601,125,1,41,55
-1,1553,1413,140,-1,-16,56
-1,1500,1588,-88,4,92,100
-1,1796,1881,-85,0,-31,88
-1,1782,1985,-203,-1,-44,60
1,1832,1714,118,1,41,67
-1,1301,1726,-425,-3,-284,96
-1,1785,1517,268,3,50,62
1,1791,1926,-135,-3,4,53
-1,1570,1854,-284,-5,-341,96
-1,1618,1196,422,2,183,104
-1,1921,1496,425,-4,-22,44
-1,1777,1991,-214,-1,-353,124
1,1665,1807,-142,0,193,71
0,1684,1668,16,2,81,90
1,1533,1593,-60,5,773,103
0,1705,1839,-134,-2,-19,84
1,1434,1367,67,8,263,59
1,1756,1538,218,3,129,75
-1,1299,1642,-343,0,-13,52
-1,1832,1577,255,-1,-97,68
1,1806,1716,90,-1,-20,53
1,1889,1788,101,0,62,61
0,1647,1469,178,0,27,137
-1,1626,1963,-337,-2,-37,61
1,1727,1406,321,-5,443,107
1,1710,1835,-125,1,165,77
-1,1821,1522,299,-3,-56,82
-1,1550,1505,45,0,-80,56
1,1892,1382,510,2,52,51
1,1569,1396,173,-1,2,79
1,1489,1296,193,-4,185,93
1,1519,1675,-156,-1,47,141
1,1676,1772,-96,-1,-5,45
1,1538,1579,-41,-1,-8,57
0,1450,1314,136,-2,403,138
-1,1876,1770,106,5,293,150
-1,1446,1638,-192,-1,-22,70
1,1616,1075,541,5,1037,127
1,1667,1366,301,2,138,65
1,1893,1807,86,-3,-51,81
1,1786,1961,-175,1,16,57
-1,1483,1704,-221,-2,10,58
1,1928,1684,244,5,247,79
-1,1780,1897,-117,0,-26,70
-1,1558,1711,-153,-1,-41,64
-1,1369,1480,-111,-12,-388,58
-1,1397,1436,-39,-2,-45,46
-1,1331,1624,-293,-4,-416,110
1,1905,1526,379,2,35,49
-1,1617,1650,-33,0,17,46
1,1768,1757,11,-1,-46,77
1,1606,1570,36,3,90,63
-1,1815,1793,22,0,-19,68
-1,1390,1532,-142,2,-18,68
-1,1703,1781,-78,-2,-91,58
-1,1599,1677,-78,-2,-167,92
-1,1514,1358,156,-6,-8,40
-1,1812,1747,65,0,-396,90
-1,1358,1443,-85,-5,-235,66
-1,1721,1385,336,-1,-245,78
-1,1905,1773,132,-2,-30,54
1,1641,1582,59,2,17,51
1,1908,1764,144,-1,23,83
1,1099,1057,42,8,635,67
1,1550,1500,50,-4,-16,43
1,1462,1679,-217,-2,175,81
1,1373,1390,-17,-1,-107,105
1,1580,1566,14,-2,31,61
1,1787,1890,-103,0,55,75
-1,1403,1730,-327,-6,-547,108
-1,1500,1465,35,-13,-319,54
1,1762,1572,190,-1,44,73
1,1918,1741,177,0,76,69
1,1446,1103,343,1,-11,91
1,1311,1318,-7,12,507,69
1,1792,1695,97,0,197,73
-1,1323,1509,-186,-6,-172,48
-1,1772,1905,-133,-6,-97,44
-1,1588,1679,-91,3,103,56
-1,1804,1911,-107,0,320,108
-1,1440,1598,-158,-4,-202,72
-1,1926,1723,203,1,-269,152
-1,1458,1651,-193,1,73,116
-1,1616,1793,-177,-9,-45,60
1,1291,1540,-249,4,195,65
-1,1876,1801,75,-5,-269,114
-1,1529,1781,-252,0,-105,98
-1,1620,1647,-27,0,-285,120
1,1539,1382,157,-1,-95,83
1,1323,1432,-109,3,431,87
-1,1658,1718,-60,1,-44,72
1,1807,1904,-97,3,175,51
-1,1557,1500,57,0,39,62
-1,1771,1741,30,-2,-44,46
-1,1567,1500,67,-1,-95,82
1,1734,1363,371,8,245,47
1,1768,1041,727,27,1204,61
1,1771,1759,12,-3,-80,69
0,1804,1797,7,4,443,88
1,1449,1353,96,-1,-82,63
1,1812,1679,133,0,270,107
1,1310,1378,-68,-3,-278,116
-1,1434,1854,-420,-8,-155,46
1,1605,1651,-46,-1,-142,116
1,1479,1189,290,-1,343,117
-1,1204,1755,-551,-5,-140,52
0,1886,1796,90,-5,-280,175
-1,1742,1918,-176,-2,-65,68
1,1733,1349,384,6,927,105
1,1486,1106,380,15,222,43
-1,1595,1237,358,-10,-343,56
-1,1348,1737,-389,-13,-520,60
1,1606,1561,45,0,-6,61
1,1549,1616,-67,0,45,63
1,1814,1863,-49,0,249,105
1,1797,1804,-7,-5,-241,91
0,1525,1671,-146,-9,-287,155
1,1768,1586,182,0,120,73
1,1659,1610,49,-3,100,83
1,1662,1482,180,-5,-73,43
-1,1882,1802,80,-2,-121,70
-1,1269,1201,68,3,17,58
-1,1339,1515,-176,-3,-225,68
1,2015,1719,296,-2,153,115
-1,1310,1615,-305,-1,-108,60
-1,1688,1515,173,3,67,42
-1,1860,1525,335,4,87,90
1,1701,1358,343,6,215,63
-1,1441,1496,-55,0,17,58
1,1489,1618,-129,5,181,55
-1,1377,1500,-123,-3,-10,40
-1,1309,1486,-177,-3,-16,42
1,1865,1651,214,-6,-145,55
-1,1440,1610,-170,-2,3,56
1,1799,1230,569,2,40,49
-1,1829,1657,172,-6,-201,90
1,1506,1430,76,-1,123,45
1,1828,1666,162,-2,133,91
0,1494,1512,-18,1,-13,112
-1,1185,1482,-297,-1,-9,40
-1,1375,1380,-5,-4,-107,54
-1,1594,1568,26,2,-5,90
1,1953,2011,-58,-2,-45,57
-1,1617,1519,98,-3,-72,52
-1,1354,1679,-325,-10,-149,52
1,1348,1055,293,10,177,47
1,1625,1398,227,-5,35,65
-1,1464,1234,230,-1,-163,60
-1,1886,1685,201,0,-3,64
1,1996,1968,28,0,33,63
-1,1348,1499,-151,-9,-477,70
1,1335,1216,119,-6,-313,71
1,1956,1526,430,0,-434,117
-1,1580,1719,-139,-8,-202,56
-1,1826,1759,67,-8,-412,84
1,1403,1396,7,0,111,95
-1,1487,1553,-66,-3,-105,64
1,1333,1531,-198,2,15,43
-1,1958,2008,-50,0,-639,130
1,1635,1384,251,0,317,83
-1,1050,1355,-305,-3,-154,56
-1,1282,1500,-218,0,-136,90
-1,1349,1523,-174,-1,-145,88
1,1237,1503,-266,1,130,111
-1,1479,1580,-101,-2,-42,48
1,1263,1500,-237,17,442,45
1,1739,1655,84,-1,20,81
-1,1603,1558,45,1,6,44
1,1469,1337,132,0,155,63
-1,1947,2019,-72,1,-164,116
1,1778,1810,-32,1,276,81
-1,1338,1530,-192,-4,-354,110
1,1162,0,1162,2,444,65
-1,1702,1772,-70,1,32,50
1,1719,1587,132,2,298,99
-1,1276,1212,64,4,70,50
-1,1628,1640,-12,0,-31,67
-1,1533,1937,-404,1,5,60
1,1526,1388,138,7,62,43
1,1593,1278,315,-6,-24,83
1,1477,1621,-144,-3,-73,121
-1,1328,1500,-172,-2,-54,60
1,1647,1760,-113,3,106,57
-1,1568,1395,173,-5,-128,65
-1,1693,1939,-246,1,-41,60
-1,1703,1866,-163,-3,-288,116
1,1318,1240,78,-7,-189,53
1,1305,1401,-96,-6,-379,79
1,1383,1366,17,1,34,45
-1,1944,1688,256,-1,-34,54
-1,1333,1222,111,-8,-382,64
1,1627,1500,127,-1,-54,67
-1,1707,1924,-217,1,69,70
-1,1627,1588,39,0,53,88
-1,1273,1600,-327,-1,-692,120
1,1627,1497,130,-2,-47,47
1,1309,1250,59,2,55,57
-1,1997,1803,194,0,-149,130
1,1726,1661,65,-11,-46,41
-1,1929,1702,227,-1,-99,62
1,1589,1464,125,0,145,123
-1,1625,1814,-189,-5,-5,54
-1,1324,1477,-153,-2,-919,148
-1,1379,1413,-34,0,-18,70
1,1452,1406,46,5,268,78
-1,1623,1486,137,1,52,78
1,1652,1746,-94,6,144,49
1,1333,1358,-25,0,22,53
1,1338,1257,81,0,63,65
1,1284,1278,6,2,26,55
1,2037,1909,128,0,19,49
1,1423,1378,45,0,-1,45
-1,1490,1634,-144,-3,-10,54
1,1274,1639,-365,-7,-85,57
-1,1300,1260,40,0,-413,88
1,1977,1762,215,-3,95,161
-1,1619,1819,-200,-10,-63,84
1,1745,1756,-11,-1,106,103
1,1717,1665,52,4,171,69
1,1282,1280,2,1,-25,53
1,1675,1601,74,-4,157,107
-1,1651,1397,254,-3,-81,46
1,2044,1813,231,4,188,51
0,1298,1607,-309,-4,-318,60
1,1745,1757,-12,0,-63,79
1,1361,1348,13,5,665,105
-1,1263,1500,-237,-4,-110,52
1,1825,1613,212,-1,95,75
-1,1808,1720,88,0,-36,94
-1,1261,1683,-422,-5,-170,50
1,1309,1500,-191,0,-23,47
-1,1656,1736,-80,-1,-76,86
-1,1278,1482,-204,-9,-24,42
1,1588,1256,332,2,721,121
1,1473,1530,-57,4,17,40
1,1890,1590,300,2,-61,107
1,1756,1729,27,0,-9,47
-1,1576,1726,-150,-1,10,66
1,1735,1795,-60,3,150,57
1,1515,1411,104,0,444,79
-1,1608,1830,-222,-4,-80,68
-1,1766,1748,18,5,100,52
-1,1500,1290,210,-2,-396,114
1,1421,1575,-154,-2,-85,59
1,1731,1760,-29,-1,60,61
-1,1752,1648,104,3,95,68
1,1452,1367,85,2,66,59
1,1626,1914,-288,-1,3,57
-1,1901,2049,-148,4,-285,96
1,1769,1931,-162,1,16,41
-1,1460,1581,-121,-1,-14,94
-1,1766,1749,17,-1,-201,72
1,2056,1893,163,1,74,55
1,1748,1749,-1,0,56,75
-1,1886,2062,-176,-1,-215,86
1,1789,1271,518,-1,39,59
1,1432,1455,-23,-2,-28,43
-1,1662,1591,71,1,-3,60
1,1601,1542,59,6,188,49
-1,1508,1418,90,-1,-43,64
1,2068,1880,188,2,-7,47
-1,1350,1760,-410,-7,-232,60
-1,1758,1718,40,-4,-446,158
1,1485,1505,-20,0,2,45
-1,1792,1732,60,-8,-137,52
-1,1492,1625,-133,-1,63,80
-1,1830,1909,-79,-4,-72,54
-1,1432,1494,-62,0,-44,94
-1,1873,2074,-201,-1,-294,94
-1,1532,1441,91,-14,-345,49
-1,1632,1895,-263,-1,-225,114
-1,2080,1867,213,-3,-122,68
1,1691,1217,474,8,368,61
-1,1744,1741,3,4,112,50
-1,1569,1214,355,1,50,108
-1,1509,1456,53,0,-4,50
1,1608,1649,-41,0,69,67
-1,1287,1500,-213,-2,-142,94
1,1919,1822,97,-1,72,73
-1,1444,1790,-346,-8,-45,42
-1,1886,1762,124,-6,-548,80
1,1498,1295,203,3,245,73
1,1780,1733,47,0,-18,53
-1,1333,1500,-167,-3,-212,76
1,1562,1502,60,0,-163,103
-1,1506,1552,-46,2,68,64
-1,1891,1685,206,0,5,60
-1,1778,1870,-92,4,198,78
-1,1359,1451,-92,3,186,64
1,1637,1625,12,0,18,59
-1,1631,1425,206,-1,-71,90
-1,1400,1789,-389,-4,-227,96
-1,1879,1769,110,-2,-479,78
1,1952,1899,53,2,257,109
-1,1868,1793,75,3,-108,90
-1,1441,1362,79,-2,-481,132
1,1724,1811,-87,1,141,69
-1,1497,1467,30,-3,-193,96
-1,1290,1189,101,-5,-539,98
1,1572,1411,161,2,101,91
-1,1820,1916,-96,-1,-49,44
-1,1479,1561,-82,-1,-150,90
-1,1249,1500,-251,0,37,58
-1,1614,1587,27,0,12,62
1,1666,1807,-141,2,50,71
-1,1575,1874,-299,-3,-80,40
-1,1029,1464,-435,-10,-141,42
-1,1500,1465,35,-8,-9,40
-1,1728,1759,-31,-5,-6,76
-1,1877,1913,-36,-5,-171,76
1,1990,1890,100,-1,-8,61
1,1648,1642,6,0,496,101
1,1601,1601,0,1,-21,79
1,1245,1469,-224,-3,-81,53
1,1867,1907,-40,0,202,111
1,1791,1680,111,-3,-42,47
1,1516,1372,144,0,241,143
-1,1803,1754,49,-2,-215,86
1,1882,2019,-137,1,72,81
-1,1589,1500,89,0,16,72
-1,1728,1798,-70,-4,-42,46
1,1932,1804,128,0,7,69
0,1673,1799,-126,3,34,49
1,1939,1854,85,4,223,71
1,1590,1397,193,-1,-42,51
1,1260,1290,-30,0,33,97
-1,1810,1767,43,2,47,64
-1,1503,1726,-223,-2,-194,70
1,1983,1724,259,1,13,69
-1,1391,1596,-205,0,-194,92
-1,1427,1568,-141,-1,-70,64
-1,1379,1429,-50,-7,-630,84
1,1284,1606,-322,3,307,89
1,1706,1928,-222,0,22,51
-1,1365,1536,-171,1,-275,144
1,1910,1750,160,0,249,75
-1,1580,1778,-198,-4,-128,62
1,1601,1385,216,0,559,133
-1,1636,1715,-79,-3,-9,44
0,1552,1198,354,0,-81,123
-1,1734,1917,-183,-1,-84,69
-1,1493,1821,-328,0,0,40
1,1323,1379,-56,-5,-32,51
1,1880,1720,160,3,50,51
1,1340,1351,-11,-10,-151,79
1,1363,1406,-43,2,105,57
-1,1785,1439,346,0,20,59
1,1923,1721,202,3,40,45
1,2051,1166,885,6,195,49
-1,1355,1362,-7,3,-131,78
0,1579,1626,-47,-2,-47,122
-1,1784,1606,178,-1,8,54
1,1828,1669,159,1,70,71
1,1496,1346,150,0,73,99
-1,1709,1929,-220,-3,-18,40
1,1341,1374,-33,1,51,55
1,1357,1361,-4,-3,-13,49
1,1934,1699,235,2,99,93
1,1992,1620,372,-1,201,145
-1,1210,1543,-333,-4,-166,84
-1,1625,1580,45,-4,-237,66
1,1733,1451,282,-1,-1,43
1,1371,1410,-39,-10,-45,95
0,1337,1503,-166,0,-16,98
-1,1447,1507,-60,-3,-198,86
-1,1389,1643,-254,-3,-314,90
-1,1359,1382,-23,-1,-169,104
1,1780,1500,280,3,114,50
-1,1593,1610,-17,-2,-499,90
-1,1314,1327,-13,-3,-188,68
-1,1498,1343,155,-2,-49,70
-1,1546,1663,-117,-1,-27,50
1,1944,1681,263,2,45,55
-1,1354,1226,128,-4,-521,68
-1,1406,1643,-237,-4,-128,64
-1,1607,1564,43,-4,-536,190
-1,1673,1949,-276,-8,-90,42
-1,1363,1482,-119,0,4,70
-1,1880,1923,-43,0,-2,52
-1,1400,1327,73,-1,-14,48
1,1339,1410,-71,4,794,107
1,1452,1622,-170,0,22,61
-1,1953,1665,288,2,169,76
0,1768,1870,-102,2,35,151
-1,1384,1648,-264,-9,-278,54
1,1489,1354,135,0,40,59
-1,1671,1538,133,-1,-63,108
1,1617,1668,-51,3,196,83
-1,1379,1652,-273,-5,-131,60
-1,1497,1384,113,-2,21,40
-1,1604,1468,136,-3,-88,102
-1,1784,1686,98,-4,-396,98
-1,1346,1307,39,-3,-493,96
1,1469,1350,119,4,118,49
-1,1700,1933,-233,-5,-127,45
-1,1374,1656,-282,-4,34,52
-1,1374,1656,-282,-8,-392,68
-1,1777,1616,161,-12,-19,40
1,1630,1220,410,1,130,59
1,1369,1661,-292,-1,-13,55
-1,1691,1938,-247,-1,-70,60
-1,1324,1536,-212,-5,163,118
1,1725,1736,-11,-1,401,105
1,1640,1392,248,2,103,73
-1,1792,1717,75,-5,145,42
1,1652,1656,-4,2,76,41
-1,1554,1503,51,-5,-210,92
1,1217,1553,-336,6,166,40
-1,1587,1582,5,-7,-326,68
1,1943,1703,240,1,64,97
-1,1804,1595,209,0,-49,86
-1,1727,1716,11,-1,-1042,142
1,1762,1633,129,-4,-163,59
1,1731,1773,-42,2,282,79
1,1342,1339,3,3,218,83
-1,1289,1381,-92,0,-108,68
1,1727,1715,12,2,305,81
1,1664,1575,89,-1,35,99
-1,1625,1769,-144,-3,-63,56
-1,1665,1590,75,-1,-107,74
1,2118,1753,365,1,71,137
1,1695,1948,-253,1,25,65
-1,1242,1785,-543,-1,-8,52
-1,1899,1719,180,0,-199,112
-1,1552,1506,46,0,-457,108
-1,1928,1726,202,-1,4,44
-1,1611,1347,264,-1,-35,60
1,1754,1910,-156,0,-10,67
-1,1288,1327,-39,-3,-54,41
0,1786,1240,546,1,343,110
-1,1690,1784,-94,-5,-182,78
1,1373,1592,-219,-2,51,149
1,1604,1651,-47,-5,-300,85
-1,1892,1780,112,-2,-55,56
-1,1828,1776,52,-2,-109,66
-1,1239,1430,-191,6,328,82
1,1279,1338,-59,-7,-312,71
1,1131,1751,-620,1,587,107
-1,1756,1866,-110,0,7,48
-1,1254,1774,-520,0,-191,104
-1,1170,1354,-184,-1,-188,64
-1,1979,1782,197,0,61,64
1,1679,1589,90,-1,-23,69
1,1898,1583,315,1,33,45
1,1749,1842,-93,5,495,109
-1,1056,1485,-429,-3,-303,88
1,1568,1347,221,1,183,109
-1,1481,1613,-132,0,-189,116
-1,1580,1902,-322,-2,-81,62
-1,1573,1637,-64,-4,-100,72
1,1695,1573,122,0,56,65
1,1763,1828,-65,0,80,69
-1,1479,1510,-31,2,97,74
-1,1386,1213,173,-4,-481,116
1,1565,1702,-137,1,29,51
1,1888,1383,505,3,117,79
-1,1421,1500,-79,-6,-35,44
1,1905,1577,328,10,85,45
-1,1328,1214,114,0,-50,54
1,1670,1777,-107,-1,10,47
1,1305,1396,-91,-3,237,69
1,1711,1586,125,2,103,62
1,1685,1762,-77,-5,179,71
-1,1739,1718,21,0,46,92
1,2080,1812,268,0,-19,65
-1,1648,1564,84,-3,-42,67
1,1914,1876,38,-2,-43,41
-1,1581,1687,-106,-6,-179,62
-1,1595,1673,-78,-1,-298,88
-1,1500,1521,-21,-7,-44,110
1,1575,1143,432,5,258,89
-1,1748,1815,-67,0,-56,66
-1,1573,1909,-336,-3,-245,58
-1,1474,1587,-113,-1,-150,74
-1,1739,1824,-85,-6,-383,74
-1,1687,1580,107,-11,-49,46
1,1682,1586,96,9,339,51
-1,1664,1803,-139,0,-95,110
1,2087,2133,-46,0,-10,45
-1,1578,1690,-112,-1,-16,48
-1,1729,1728,1,-2,-51,61
1,1114,1157,-43,0,-23,57
1,1912,1570,342,1,136,75
1,1697,1570,127,2,89,83
-1,1440,1724,-284,-4,-201,64
-1,1466,1595,-129,-1,-80,80
1,1925,1852,73,1,307,131
-1,1491,1408,83,2,325,100
1,1331,1252,79,0,88,55
-1,1529,1335,194,-4,-148,62
-1,1738,1719,19,-2,-263,100
1,1132,1137,-5,4,484,81
-1,1262,1620,-358,-5,-220,113
1,1704,1842,-138,2,411,81
-1,1827,1720,107,-2,23,58
1,1639,1687,-48,0,-99,61
1,1572,1696,-124,-2,-5,41
-1,1563,1704,-141,-6,-171,48
-1,1720,1827,-107,-1,-451,134
1,1632,1395,237,-1,207,99
1,1681,1587,94,6,153,53
-1,1251,1602,-351,-5,-604,104
1,1459,1499,-40,3,181,75
-1,1659,1730,-71,0,38,70
-1,1122,1312,-190,2,45,62
-1,1526,1515,11,1,6,58
1,1771,1612,159,-2,32,61
-1,1711,1556,155,-4,-203,60
0,1835,1712,123,-8,-33,108
1,1730,1727,3,0,15,57
-1,1739,1645,94,1,-93,62
1,1715,1831,-116,-3,-21,131
1,1384,1492,-108,4,159,63
-1,1471,1487,-16,-3,-102,55
-1,1470,1577,-107,-8,-66,40
-1,1725,1667,58,1,113,62
1,1623,1259,364,1,104,101
-1,1816,1731,85,-1,-60,72
1,1719,1740,-21,1,20,55
-1,1318,1233,85,-4,-127,52
-1,1686,1816,-130,0,-129,68
1,1484,1464,20,3,78,65
1,1605,1247,358,5,253,57
1,1802,1675,127,-1,-77,85
-1,1497,1461,36,1,36,64
1,1399,1112,287,1,2,57
-1,1665,1810,-145,-5,-386,90
1,1478,1360,118,1,58,60
-1,1244,1608,-364,-2,-136,60
-1,1525,1500,25,-8,-214,48
1,1513,1383,130,4,242,77
1,1151,1133,18,2,99,63
1,1611,1240,371,-1,228,84
-1,1568,1701,-133,-2,-42,44
1,1708,1775,-67,-4,-91,41
1,1484,1735,-251,-5,191,151
-1,1473,1485,-12,-1,-164,68
-1,1585,1637,-52,-6,-48,122
1,1354,1289,65,-2,46,41
1,1906,1762,144,3,125,63
-1,1162,0,1162,0,-407,94
-1,1719,1789,-70,-4,-76,46
-1,1313,1517,-204,-2,-28,58
-1,1438,1168,270,-5,-7,40
-1,1360,1694,-334,5,175,62
1,1915,1729,186,-1,66,71
1,1697,1355,342,0,68,51
1,2018,1867,151,0,371,137
-1,1349,1700,-351,3,44,72
1,1755,1816,-61,-9,-8,132
-1,1703,1344,359,7,-17,60
-1,1502,1430,72,0,27,72
1,1279,1363,-84,-4,-185,61
1,1443,1507,-64,0,-5,43
1,1528,1446,82,1,22,99
-1,1381,1682,-301,-12,-525,68
-1,1655,1768,-113,1,5,44
-1,1696,1574,122,-7,-627,82
-1,1803,1776,27,-6,-238,64
1,1626,1813,-187,-2,35,91
-1,1516,1522,-6,2,8,72
1,1507,1192,315,0,47,99
-1,1456,1494,-38,-2,-25,50
1,1791,1788,3,11,209,51
-1,1132,1555,-423,-5,-33,44
-1,1467,1405,62,0,15,76
1,1500,1645,-145,-1,-5,79
-1,1777,1802,-25,2,33,132
-1,1567,1766,-199,-2,-147,82
-1,1363,1693,-330,0,-11,68
-1,1250,1357,-107,-1,-228,102
1,1761,1338,423,-1,-33,41
-1,1295,1490,-195,3,7,66
-1,1353,1699,-346,3,113,78
1,1779,1800,-21,1,107,51
1,1703,1348,355,1,119,73
1,1934,1653,281,0,17,91
1,1800,1779,21,-3,-27,91
1,1462,1202,260,1,53,57
-1,1789,1791,-2,-4,-125,74
-1,1343,1706,-363,-5,1,70
-1,1485,1349,136,-13,-323,56
1,1514,1418,96,2,5,43
1,1802,1778,24,-1,12,45
-1,1609,1222,387,0,-233,142
1,1789,1720,69,0,-8,81
1,1709,1339,370,7,434,73
0,1716,1496,220,4,184,79
1,1768,1812,-44,-11,-188,75
1,1781,1561,220,1,167,69
-1,1749,1713,36,-6,-70,60
-1,1880,1586,294,1,5,80
1,1410,1522,-112,0,18,67
1,1534,1502,32,-3,198,85
-1,1335,1711,-376,-9,-161,42
0,1602,1718,-116,6,328,79
1,1693,1605,88,3,196,73
1,1714,1331,383,1,17,65
-1,1438,1536,-98,-7,-427,100
-1,1327,1717,-390,2,126,52
1,1645,1503,142,-3,-1,47
1,1742,1597,145,-1,476,95
1,1425,1385,40,-3,21,46
1,1720,1323,397,1,80,65
1,1196,1466,-270,0,-5,45
1,1507,1524,-17,-5,-54,51
1,1365,1470,-105,7,395,67
1,1769,1653,116,4,168,65
-1,1242,1319,-77,0,-101,53
1,1711,1650,61,3,100,49
0,1938,2070,-132,0,47,121
1,1777,1626,151,0,-5,111
1,1434,1310,124,8,137,42
1,1656,1429,227,3,29,43
-1,1544,1496,48,1,-631,136
1,1345,1019,326,21,532,45
1,1819,1721,98,7,482,93
-1,1661,1575,86,0,-111,118
1,1500,1502,-2,3,-84,131
-1,1456,1379,77,1,-263,99
1,1345,1302,43,1,56,85
0,1674,1713,-39,-7,306,88
-1,1483,1783,-300,-3,-35,44
-1,1606,1943,-337,-2,-71,62
1,1228,1467,-239,-10,-45,47
-1,1256,1417,-161,3,-303,152
1,1807,1475,332,1,85,51
0,1484,1441,43,1,94,100
-1,1645,1777,-132,-1,-35,42
1,1359,1007,352,1,26,54
-1,1754,2047,-293,-7,-233,54
0,1613,1494,119,2,4,89
-1,1603,1946,-343,-5,-171,54
1,1423,1552,-129,-3,421,107
0,1946,2066,-120,0,33,101
1,1645,1480,165,0,39,70
-1,1490,1593,-103,-7,-102,57
1,2063,1950,113,0,32,59
-1,1275,1328,-53,0,-2,64
1,1474,1556,-82,-2,10,97
0,1498,1609,-111,1,16,90
1,1784,1638,146,0,5,61
-1,1740,1712,28,0,22,52
-1,1435,1709,-274,0,12,40
-1,1724,1729,-5,-26,-355,40
-1,1535,1734,-199,0,-78,76
1,1800,1736,64,10,137,45
-1,1736,1800,-64,-6,17,48
1,1544,1430,114,10,169,47
1,1647,1480,167,7,199,63
1,1817,1588,229,2,53,43
1,1442,1479,-37,4,7,47
-1,1404,1574,-170,-6,-327,92
1,1537,1437,100,1,70,79
-1,1584,1857,-273,-2,-80,66
-1,1718,1703,15,-10,-121,44
0,1393,1448,-55,-3,-131,73
-1,1480,1650,-170,0,-74,66
1,1631,1791,-160,0,22,73
1,1365,997,368,5,132,51
-1,1465,1455,10,-1,-43,58
1,1488,1523,-35,4,148,57
1,1119,1182,-63,-3,-310,73
-1,1698,1454,244,-9,-553,90
-1,1474,1657,-183,-5,-360,74
-1,1405,1776,-371,5,149,64
-1,1307,1589,-282,-3,-140,40
1,1429,1545,-116,-2,45,81
-1,1161,1140,21,3,76,76
0,1307,1475,-168,0,-68,103
1,1500,1652,-152,2,208,83
1,1499,1501,-2,0,-14,77
1,1579,1703,-124,-4,-63,47
-1,1511,1362,149,-1,-150,86
0,1688,1595,93,4,49,63
1,1230,1403,-173,-3,-21,47
0,1654,1497,157,0,-63,64
1,1395,1283,112,8,438,73
-1,1158,1144,14,-9,-294,90
1,1446,1473,-27,9,429,81
-1,1469,1663,-194,-3,-78,118
1,1303,1293,10,-1,50,70
1,1742,1821,-79,3,67,47
1,1471,1363,108,-8,-614,73
1,1348,1593,-245,-4,-47,43
-1,1767,1941,-174,0,-23,60
1,1131,1496,-365,1,107,53
-1,1654,1585,69,-7,-316,60
-1,1372,1520,-148,-2,-96,56
-1,1342,1303,39,1,-575,158
1,1530,1444,86,6,191,53
-1,1275,1386,-111,-2,-80,52
1,1695,1403,292,-1,154,71
-1,1808,1751,57,-9,-75,40
1,1130,1363,-233,-5,-83,41
1,1463,1319,144,0,3,65
1,1552,1586,-34,1,5,55
-1,1345,1159,186,6,59,52
0,1919,1967,-48,1,-2,58
1,1756,1243,513,-12,-1119,105
1,1329,1686,-357,10,145,55
-1,2026,1906,120,0,26,107
1,1531,1268,263,4,235,71
-1,1948,1695,253,2,16,44
1,1479,1226,253,7,261,67
-1,1435,1539,-104,-2,-130,68
1,1595,1562,33,-2,-62,59
1,1569,1350,219,-2,72,69
-1,1748,1763,-15,-2,-63,80
1,1518,1574,-56,12,365,59
1,1958,1920,38,0,13,58
-1,1669,1462,207,1,98,68
0,1640,1625,15,-1,4,128
1,1483,1206,277,3,181,55
1,1552,1613,-61,3,367,103
1,1738,1773,-35,-1,-54,55
-1,1364,1539,-175,4,174,90
1,1901,1547,354,2,61,65
1,1234,1378,-144,10,473,59
-1,1333,1458,-125,-1,104,76
-1,1762,1750,12,0,2,58
1,1554,1250,304,-1,-154,55
1,1750,1762,-12,1,-17,57
-1,1697,1585,112,-2,-12,50
1,1751,1761,-10,4,130,53
1,1750,1762,-12,0,17,81
-1,1272,1493,-221,4,141,44
-1,1558,1614,-56,-1,-87,63
0,1454,1603,-149,0,15,107
1,1642,1801,-159,-2,8,51
1,1234,1791,-557,-1,-13,41
1,1498,1262,236,3,145,57
-1,1549,1422,127,-7,-237,54
1,1301,1344,-43,-4,-89,43
-1,1683,1608,75,-9,-358,76
-1,1646,1818,-172,-11,-175,70
1,1332,1343,-11,0,36,47
1,1691,2051,-360,0,-182,81
-1,1658,1783,-125,1,-66,114
1,1770,1229,541,4,67,43
-1,1223,1771,-548,-5,-62,44
-1,1291,1524,-233,-1,-342,64
-1,1500,1578,-78,0,-70,90
1,1584,1458,126,-3,54,57
1,1500,1792,-292,0,-65,85
1,1816,1942,-126,3,72,45
-1,1703,1272,431,-6,-94,59
1,1641,1368,273,1,27,49
-1,1495,1511,-16,-1,-92,62
-1,1524,1500,24,-6,86,40
-1,1219,1394,-175,0,-87,76
-1,1758,1710,48,0,-47,74
1,1891,1713,178,12,394,65
1,1947,1687,260,2,117,89
1,1664,1825,-161,3,214,97
-1,1710,1725,-15,-1,-411,146
-1,1307,1609,-302,-1,-54,52
-1,1925,1831,94,-1,-41,56
1,1645,1442,203,0,-37,67
1,1510,1247,263,3,409,89
-1,1784,1713,71,0,-19,108
-1,1287,1345,-58,-10,-543,68
1,1744,1467,277,3,191,65
1,1623,1462,161,7,334,63
0,1322,1416,-94,-1,-272,141
1,2089,1753,336,2,8,41
-1,1846,1910,-64,0,-11,74
1,1794,1735,59,4,130,51
1,1439,1641,-202,0,-104,77
1,1514,1390,124,1,187,71
-1,1780,1849,-69,1,226,138
-1,1746,1900,-154,-1,-177,98
1,1480,1621,-141,1,55,45
1,1663,1471,192,0,-63,63
-1,1920,1837,83,-9,-227,68
-1,1484,1601,-117,-2,-199,76
1,1681,1402,279,0,59,69
1,1879,1489,390,0,-14,55
-1,1723,1681,42,-8,-644,80
-1,1440,1405,35,1,36,50
-1,1690,1976,-286,-6,-149,46
1,1437,1513,-76,0,12,61
0,1746,1723,23,-1,-332,127
-1,1480,1806,-326,-4,-379,79
1,1851,1905,-54,1,46,73
1,1401,1480,-79,-1,-29,63
-1,1682,1820,-138,0,-68,70
-1,1538,1719,-181,-2,-1456,156
-1,1778,1739,39,-9,-199,90
1,1727,1304,423,-6,-56,43
-1,1545,1447,98,-3,-134,54
1,1891,1864,27,0,124,81
-1,1636,1640,-4,0,-186,116
-1,1477,1699,-222,-2,-101,50
1,1526,1437,89,4,277,97
1,1455,1544,-89,1,213,95
-1,1612,1700,-88,0,-432,114
1,1708,1173,535,1,319,138
-1,1657,1561,96,-5,-757,98
1,1675,1515,160,0,140,93
0,1605,1495,110,2,-55,131
1,1526,1354,172,4,528,75
-1,2102,1771,331,0,-23,90
1,1497,1074,423,-1,-34,43
-1,1854,1902,-48,0,281,88
1,1688,1593,95,0,75,55
1,1750,1500,250,-1,95,103
1,1627,1552,75,9,157,49
1,1541,1521,20,5,405,79
-1,1754,1780,-26,-5,-1,46
1,1584,1697,-113,-4,-54,55
-1,1009,1795,-786,-3,-329,84
-1,1693,1921,-228,0,7,46
-1,1327,1729,-402,0,-59,74
1,1686,1398,288,0,-2,53
-1,1704,1888,-184,-1,-36,112
-1,1912,1844,68,-9,-12,42
1,1875,1804,71,3,161,73
1,1796,1981,-185,-2,94,95
-1,1649,1661,-12,0,-38,72
1,1772,1827,-55,0,244,105
-1,1601,1286,315,-5,-109,46
-1,1857,1898,-41,2,79,64
1,1693,1389,304,-1,-5,43
1,1398,1299,99,-3,-43,123
-1,1732,1647,85,-1,-69,72
-1,1415,1328,87,3,142,103
1,1675,1795,-120,-1,12,53
1,1486,1525,-39,6,508,95
-1,1751,1766,-15,-2,2,44
1,1681,1387,294,3,39,43
-1,1630,1485,145,0,-21,136
-1,1531,1533,-2,-6,-711,114
-1,1724,1785,-61,0,-5,58
-1,1790,2078,-288,-2,-117,98
-1,1994,2175,-181,-2,21,56
1,1908,1847,61,-4,-198,63
-1,1413,1926,-513,0,-59,80
1,1685,1289,396,2,89,51
1,1648,1623,25,-1,32,63
1,1525,1400,125,1,86,71
1,2006,1809,197,0,-5,53
1,1576,1689,-113,0,-13,73
-1,1450,1388,62,0,-93,60
1,1509,1513,-4,-11,-64,55
-1,1515,1455,60,2,-42,104
-1,1838,1918,-80,0,30,82
1,1431,1530,-99,4,299,87
-1,1573,1527,46,-4,-438,104
-1,1804,2012,-208,0,13,80
1,1899,1323,576,4,825,101
-1,1427,1376,51,14,319,48
-1,1340,1687,-347,0,-2,74
-1,1451,1532,-81,-2,-149,82
1,1794,1715,79,6,775,111
1,1895,1698,197,-1,275,135
1,1988,2069,-81,0,61,67
-1,1815,1784,31,0,-298,132
1,1685,1927,-242,2,621,103
1,1739,1568,171,-2,-3,91
0,1499,1376,123,1,240,113
1,1928,1732,196,-1,-16,41
-1,2062,1939,123,-1,-175,76
1,1322,1570,-248,0,63,89
-1,1397,1741,-344,-1,-22,44
1,2082,1786,296,0,-11,45
-1,1514,1725,-211,-6,-89,50
-1,1342,1400,-58,0,-31,48
1,1872,1612,260,0,106,97
1,2184,1366,818,0,484,136
-1,1542,1441,101,-5,-292,78
1,1909,1704,205,1,382,77
-1,1611,2044,-433,-2,5,44
1,2002,2054,-52,-1,-9,91
1,1621,1726,-105,0,247,147
1,1672,1639,33,4,78,49
-1,1332,1357,-25,1,84,58
-1,1699,1914,-215,-5,-125,64
1,1223,1486,-263,-1,58,79
1,1511,1461,50,0,224,73
-1,1783,2087,-304,-1,-50,56
1,1603,1163,440,8,200,43
-1,1457,1526,-69,0,-309,100
1,1401,1279,122,2,71,51
-1,1919,1798,121,-7,-235,62
1,1902,1301,601,-3,-25,51
-1,1500,1641,-141,-1,33,82
-1,1919,1693,226,-1,-339,130
-1,1660,2093,-433,0,-166,112
-1,1688,1537,151,-7,-72,56
1,1726,1487,239,-1,5,55
-1,1767,1650,117,0,-170,94
-1,1795,1803,-8,-1,1,90
-1,1635,1901,-266,-1,-168,59
-1,1409,1835,-426,1,-77,52
-1,1629,1682,-53,-1,-88,82
1,1564,1547,17,-9,18,79
-1,1495,1601,-106,-2,-29,52
1,1730,1544,186,0,21,67
-1,1536,1447,89,1,-197,94
1,1779,1834,-55,0,191,177
0,1776,1690,86,0,110,224
1,1433,1360,73,2,2,43
-1,1892,1976,-84,0,-87,70
-1,1724,1658,66,0,-47,52
1,1951,1911,40,0,0,67
-1,1631,1906,-275,0,-16,54
1,1535,1148,387,10,226,51
1,1796,1008,788,8,486,69
0,1578,1671,-93,-3,-21,107
-1,1410,1481,-71,-1,-49,66
1,1745,1622,123,-3,-155,77
1,2239,1472,767,0,-8,41
-1,1910,1627,283,2,162,96
1,2014,1953,61,2,32,61
1,1542,1538,4,-1,-10,55
-1,1500,1606,-106,-7,-756,112
-1,1328,1407,-79,2,-149,129
1,2239,1469,770,1,187,93
1,1194,1343,-149,3,818,96
1,2040,1698,342,8,98,41
-1,1867,1871,-4,0,14,68
1,1718,1500,218,-1,480,117
1,1984,1884,100,0,-7,59
0,1468,1789,-321,0,-15,102
1,1904,1900,4,-9,-10,45
1,1611,1731,-120,0,13,54
1,1370,1481,-111,0,151,93
1,1795,1695,100,5,561,99
1,1814,1785,29,1,19,65
1,1883,1854,29,0,-43,83
-1,1651,1752,-101,0,-59,128
0,1516,1543,-27,1,-52,120
-1,1442,1408,34,1,-173,108
-1,1563,2240,-677,-3,-233,100
0,1521,1709,-188,-1,-131,75
1,1710,1575,135,0,187,135
-1,1555,1907,-352,-3,-58,64
1,1992,1876,116,1,38,61
1,1477,1461,16,4,103,47
1,1510,1326,184,3,132,77
1,1602,1626,-24,5,195,65
-1,2095,1842,253,-1,-309,102
1,1492,1401,91,-1,46,55
1,1893,1462,431,9,449,65
-1,1554,1571,-17,-1,-171,76
-1,1469,1431,38,0,-36,64
1,1499,1453,46,0,66,59
-1,1518,1786,-268,0,-313,104
1,2241,1562,679,-1,-47,65
1,1738,1322,416,8,179,45
-1,1740,1599,141,1,75,82
1,1932,1416,516,2,408,97
-1,1346,1411,-65,-5,-127,66
1,1538,1130,408,2,98,51
0,1715,1614,101,-1,-102,101
-1,1460,1895,-435,-5,-843,100
-1,1802,1869,-67,0,-117,86
0,1282,1232,50,7,725,133
1,1687,1803,-116,-1,-11,63
-1,1537,1300,237,0,-87,92
1,1711,1575,136,4,326,111
1,1642,1716,-74,3,123,65
-1,1507,1445,62,0,-3,54
1,1392,1138,254,2,170,55
-1,1606,1456,150,-1,-24,42
1,2184,1792,392,1,11,45
1,1897,1458,439,0,185,73
-1,1448,1491,-43,-3,-192,59
-1,1668,1585,83,1,25,47
-1,1323,1790,-467,-4,-31,62
1,1526,1132,394,2,400,107
1,1723,1888,-165,0,-3,51
1,1593,1642,-49,2,198,59
0,1776,1823,-47,-1,-108,120
-1,1788,1702,86,1,-63,72
1,1823,1501,322,0,230,107
1,2188,1790,398,0,80,95
1,1562,1786,-224,4,13,41
-1,1456,1899,-443,-15,-608,74
1,1341,1259,82,5,190,59
-1,1515,1614,-99,0,-185,110
1,1530,1527,3,1,38,51
-1,1687,1623,64,-1,-39,58
-1,1934,1944,-10,1,36,54
1,1516,1449,67,2,59,43
1,1326,1331,-5,2,53,73
0,1345,1415,-70,-2,-310,100
-1,1657,1769,-112,-1,-16,58
1,1901,1454,447,1,11,59
1,1794,1678,116,-1,-5,87
-1,1542,1517,25,-5,-126,68
-1,1716,1775,-59,0,-88,68
-1,1581,1705,-124,-7,-98,52
-1,1452,1903,-451,-9,-91,82
1,2018,2073,-55,-3,-44,71
1,2191,1788,403,0,38,83
1,1397,1212,185,-2,-80,51
-1,1447,1494,-47,1,-19,66
1,1641,1644,-3,-2,58,65
-1,1624,1627,-3,0,-4,48
1,1840,1500,340,8,496,67
1,1503,1437,66,-2,-41,67
1,1341,1316,25,1,9,45
1,2043,1877,166,1,171,107
1,1781,1511,270,7,749,155
-1,1543,1594,-51,-4,-91,54
1,1822,1777,45,0,101,77
-1,1590,1697,-107,7,121,50
-1,1698,1640,58,-5,-205,78
1,1511,1258,253,5,94,47
1,1756,1616,140,-1,-40,55
0,1630,1606,24,0,-122,127
1,1618,1711,-93,0,12,85
0,1298,1439,-141,0,49,106
1,1801,1785,16,-4,-343,129
-1,1410,1468,-58,-1,-49,70
1,1831,1271,560,1,218,77
1,1528,1907,-379,-2,-18,133
-1,1288,1480,-192,-1,-817,144
1,1794,1574,220,0,137,93
1,1791,1844,-53,-1,-5,45
-1,1540,1306,234,-4,-274,96
1,1656,1285,371,1,133,85
-1,1412,1347,65,1,247,110
-1,1581,1338,243,-3,-3,44
1,1705,1581,124,0,73,93
1,1636,1500,136,-1,21,85
1,1765,1871,-106,-3,-3,119
-1,1350,1886,-536,-1,-106,76
1,1619,1372,247,3,125,51
-1,1760,1637,123,0,-9,54
-1,1568,1719,-151,-5,-75,42
-1,1599,1722,-123,-2,-41,66
1,1844,1533,311,8,142,47
1,1718,1604,114,-3,156,99
-1,1838,1730,108,-5,-602,112
1,1961,2195,-234,0,-5,81
1,1784,1653,131,-2,-22,115
-1,1567,1696,-129,-3,-106,54
1,1507,1397,110,-4,-96,83
1,1774,1811,-37,-5,-23,121
1,1454,1568,-114,0,58,71
1,2023,1781,242,-7,74,85
1,1528,1530,-2,0,73,79
1,1429,1438,-9,-4,-62,47
-1,1514,1423,91,6,280,80
1,1358,1427,-69,1,-17,46
1,1697,1589,108,0,-19,69
1,1927,1824,103,4,81,51
-1,1635,1568,67,2,53,72
0,1430,1511,-81,0,227,136
-1,1312,1382,-70,-5,-828,96
1,1704,1653,51,-3,-161,63
1,1845,1893,-48,-3,-557,121
-1,1971,1924,47,0,37,80
1,1488,1404,84,1,75,75
1,1887,1818,69,0,-196,97
-1,1467,1459,8,-2,-39,42
1,1714,1644,70,5,42,45
1,1684,1679,5,1,197,107
-1,1544,1864,-320,-2,-134,86
1,1319,1401,-82,0,25,53
1,1881,1858,23,0,11,99
-1,1816,1936,-120,-9,-9,40
-1,1723,1635,88,2,67,82
-1,1573,1596,-23,1,44,78
0,1808,1895,-87,1,400,120
-1,1709,1649,60,-7,-579,70
-1,1847,1891,-44,-2,-50,48
-1,1500,1379,121,-5,-257,116
1,1812,1621,191,0,11,53
1,1465,1489,-24,2,19,47
-1,1893,1811,82,-6,-485,78
1,1696,1661,35,-4,-81,83
1,1943,1808,135,0,-66,77
-1,1558,1868,-310,-6,-94,44
-1,1541,1790,-249,-1,-192,68
1,1828,1909,-81,0,-282,109
-1,1286,1497,-211,-16,-708,78
0,1880,1826,54,-4,-386,85
-1,1706,1652,54,-13,-266,52
1,1818,1616,202,-5,-196,85
-1,1669,1695,-26,0,0,88
-1,1896,1842,54,1,2,74
1,1828,1878,-50,4,154,54
-1,1368,1769,-401,0,4,46
1,1828,1417,411,-1,19,79
1,1333,1392,-59,10,571,75
1,1866,1581,285,1,31,67
1,1855,1884,-29,0,-43,85
1,1606,1620,-14,2,79,69
-1,1312,1193,119,-3,-81,96
1,1710,1500,210,-1,436,95
-1,1872,1867,5,0,-1,98
-1,1801,1951,-150,-1,-16,42
-1,1536,1809,-273,-5,-79,52
-1,1957,1824,133,-1,-78,74
1,1280,1432,-152,-5,-93,55
1,1878,1861,17,0,-34,107
-1,1551,1874,-323,-6,-520,82
-1,1610,1659,-49,1,42,66
1,1234,1256,-22,9,556,71
1,1871,1554,317,0,300,113
1,1285,1477,-192,3,298,118
1,1851,1888,-37,-1,37,85
1,1830,1415,415,1,107,65
-1,1532,1502,30,-1,-8,64
-1,1427,1500,-73,0,-49,60
1,1760,1660,100,2,66,55
1,1940,1733,207,0,19,79
-1,1460,1310,150,0,-45,66
-1,1877,1937,-60,1,54,143
-1,1520,1543,-23,-5,-90,56
1,1476,1431,45,0,109,92
-1,1600,1794,-194,0,-15,76
1,1617,1113,504,4,454,80
1,1581,1622,-41,2,89,44
-1,1653,1769,-116,-2,-52,52
1,1863,1835,28,-3,-178,83
-1,1590,1689,-99,-3,-181,88
1,1548,1824,-276,-4,-245,145
0,1841,1738,103,-2,-164,118
1,1777,1645,132,4,167,71
1,1873,1824,49,-1,-48,59
1,1540,1479,61,6,229,67
-1,1813,1882,-69,-2,-194,92
1,1638,1785,-147,0,412,115
1,1618,1214,404,2,532,111
1,1890,1898,-8,2,131,65
1,1595,1554,41,1,158,97
-1,1698,1800,-102,1,43,114
1,1609,1593,16,5,301,81
-1,1886,1901,-15,1,-75,62
-1,1486,1550,-64,-1,-166,80
1,1838,1741,97,0,-12,57
1,1911,1804,107,0,3,59
-1,1768,1653,115,-1,-779,92
-1,1544,1605,-61,-1,-134,64
-1,1612,1361,251,4,108,102
1,1500,1500,0,6,234,45
1,1620,1344,276,2,252,103
1,1482,1614,-132,3,40,53
-1,1510,1733,-223,1,21,48
-1,1443,1705,-262,-1,10,50
1,1919,1795,124,0,25,105
-1,1847,1958,-111,-3,-408,124
-1,1662,1772,-110,0,-235,124
-1,1752,1667,85,-11,-797,100
1,1787,1926,-139,-1,37,65
-1,1160,1291,-131,-3,-129,56
1,1911,1804,107,-2,9,61
1,1737,1681,56,0,-2,53
1,1391,1074,317,8,129,45
-1,1445,1496,-51,-2,-57,56
1,1456,1482,-26,0,361,111
-1,1505,1802,-297,-3,16,56
-1,1795,1919,-124,-3,29,74
-1,1627,1739,-112,0,10,54
1,1747,1672,75,-1,-45,45
-1,1919,1795,124,-6,-56,46
-1,1339,1624,-285,-1,-21,50
1,1904,1812,92,-2,-58,57
1,1757,1663,94,-3,58,89
-1,1812,1904,-92,1,21,48
1,1710,1439,271,-2,127,77
-1,1501,1810,-309,-2,-83,62
1,1803,1354,449,1,7,57
-1,1078,1399,-321,-8,-110,72
-1,1838,1714,124,-1,-129,100
-1,1765,1655,110,-3,-96,60
-1,1498,1544,-46,-1,-59,54
1,1725,1819,-94,0,-7,67
1,1818,1213,605,3,615,143
1,1750,1669,81,0,333,66
1,1059,1107,-48,0,322,77
-1,1435,1454,-19,-9,-795,130
1,1628,1396,232,0,9,51
-1,1759,1661,98,0,-49,54
-1,1424,1511,-87,-3,-26,60
0,1069,1171,-102,4,-983,112
1,1895,1912,-17,-2,11,67
-1,1488,1515,-27,-10,-351,52
1,1744,1729,15,1,97,83
1,1121,1353,-232,0,56,102
1,1387,1095,292,8,764,83
1,1901,1877,24,4,123,51
-1,1402,1293,109,0,62,70
1,1211,1308,-97,3,449,117
-1,1477,1757,-280,-5,-172,80
-1,1867,1911,-44,-3,-32,60
-1,1821,2076,-255,-1,-94,94
1,1755,1736,19,0,-224,121
1,1531,1068,463,11,271,47
1,1857,1351,506,0,42,55
1,1465,1776,-311,-2,183,127
1,1881,1421,460,3,333,117
1,1920,1859,61,-3,-114,101
1,1718,1517,201,3,112,65
-1,1473,1777,-304,0,45,64
-1,1386,1500,-114,0,-37,41
-1,1500,1645,-145,0,8,40
1,1378,1555,-177,0,14,67
1,1500,1525,-25,-5,-66,45
-1,1850,1794,56,-3,-31,76
-1,1220,1326,-106,-9,-278,56
1,1651,1384,267,12,69,43
1,1278,1500,-222,9,1557,101
1,1808,1837,-29,0,21,55
-1,1054,1535,-481,-3,-252,88
1,1397,1688,-291,9,238,47
-1,1766,1726,40,0,8,48
-1,1656,1929,-273,-3,-144,60
1,1825,1821,4,-5,-262,93
1,1933,1651,282,2,35,45
-1,1470,1724,-254,-6,-50,59
-1,1419,1882,-463,-3,-197,84
-1,1647,1936,-289,-1,-21,70
1,1467,1403,64,-1,-33,109
1,1738,1754,-16,0,194,55
1,1936,1647,289,7,464,77
1,1809,1836,-27,2,120,75
1,1326,1192,134,1,671,113
-1,1322,1399,-77,0,-324,104
-1,1643,1940,-297,-6,-357,80
1,1824,1822,2,0,21,113
-1,1334,1211,123,-13,-860,117
-1,1825,1944,-119,-1,-33,64
-1,1742,1749,-7,-3,-12,62
1,1523,1420,103,1,709,120
1,1728,1871,-143,-2,57,97
-1,1811,1835,-24,-9,-64,128
-1,1418,1469,-51,1,-77,98
-1,1731,1759,-28,-4,-109,66
-1,1294,1102,192,3,-260,111
-1,1285,1456,-171,-1,2,42
-1,1393,1477,-84,0,-30,62
-1,1851,2082,-231,1,15,72
1,1507,1400,107,0,553,113
1,1845,1949,-104,0,139,97
1,1769,1721,48,4,150,61
-1,2089,1846,243,-3,-112,56
1,1935,1859,76,7,152,55
1,1077,1074,3,3,204,89
1,1744,1808,-64,0,-80,73
1,1850,1944,-94,1,-173,151
-1,1215,1344,-129,1,-49,88
-1,1800,1951,-151,0,84,114
-1,1697,1755,-58,-1,-135,74
1,1227,1459,-232,1,215,97
1,1716,1453,263,-1,-1,45
-1,1930,1864,66,0,23,62
-1,1958,1793,165,-3,-185,60
1,1470,1674,-204,-2,58,55
-1,1194,1391,-197,5,-78,93
1,1877,1918,-41,-1,-14,83
0,1720,1419,301,0,110,212
-1,1764,1635,129,1,-8,88
-1,1809,1942,-133,0,1,74
-1,1374,1553,-179,-2,-100,70
-1,1884,1766,118,0,-23,82
1,1906,1889,17,-3,48,69
0,1563,1802,-239,-4,-264,81
-1,1292,1658,-366,-4,-131,58
-1,1864,1811,53,0,-49,80
-1,1878,1916,-38,1,-58,100
1,1720,1750,-30,1,168,79
1,1795,1570,225,0,328,71
1,1486,1462,24,1,105,75
-1,1396,1586,-190,-2,-18,40
-1,1565,1800,-235,-1,-34,50
-1,1925,1869,56,-2,-54,58
1,1805,1560,245,1,-7,43
1,1714,1661,53,0,324,139
-1,1634,1857,-223,-1,-151,82
1,1881,1913,-32,1,43,55
1,1913,1881,32,0,179,115
1,1782,1868,-86,-1,40,91
-1,1551,1814,-263,-4,-35,42
1,1496,1360,136,5,161,61
1,1584,1354,230,1,70,50
-1,1500,1449,51,-13,-473,54
1,1872,1923,-51,1,14,47
1,1543,1823,-280,-2,-81,55
-1,1177,1718,-541,5,-31,72
-1,1911,1884,27,2,62,46
1,1803,1562,241,5,142,51
1,1724,1057,667,5,103,45
-1,1739,1779,-40,-4,-93,58
-1,1477,1600,-123,0,-34,74
-1,1895,1900,-5,0,-23,48
-1,1932,1772,160,0,-113,128
-1,1557,1808,-251,-10,-208,49
0,1822,1457,365,-4,-233,77
1,1813,1553,260,4,99,57
-1,1174,1345,-171,-3,-491,110
1,1224,1500,-276,5,886,103
1,1503,1486,17,-2,-60,157
1,1910,1885,25,0,-15,101
1,1817,2018,-201,-3,31,55
1,1852,1324,528,1,59,63
-1,1875,1920,-45,0,27,60
-1,1750,1829,-79,-1,-55,58
-1,1839,1719,120,0,-358,120
0,1157,1223,-66,-2,-37,99
-1,1480,1339,141,0,-480,88
-1,1929,1866,63,-3,-158,72
1,1406,1332,74,-2,-36,41
-1,1837,1656,181,2,53,80
-1,1681,1814,-133,-2,-19,50
1,1410,1365,45,-1,-39,111
-1,1920,1820,100,-3,20,44
1,1907,1917,-10,0,316,117
1,1878,1916,-38,-4,271,148
1,1633,1476,157,-2,404,103
-1,1796,1823,-27,-1,-49,62
1,1352,1484,-132,-6,-202,75
1,1564,1544,20,3,44,45
1,1854,1048,806,14,655,67
-1,1221,1162,59,-9,-833,136
-1,1587,1532,55,3,78,56
-1,1833,1726,107,-2,-48,70
1,1323,1416,-93,-2,213,65
1,1905,1890,15,3,151,61
1,1560,1546,14,3,122,61
1,1890,1905,-15,-6,23,51
0,1819,1808,11,2,182,126
1,1894,1880,14,0,31,51
-1,1425,1719,-294,-1,-219,74
1,1581,1534,47,0,36,71
1,1809,1733,76,0,-90,89
-1,1870,1904,-34,0,-390,124
-1,1272,1519,-247,0,-13,45
-1,1338,1724,-386,-8,-258,62
1,1365,1190,175,3,14,47
1,1194,1207,-13,6,488,79
1,1632,1615,17,-1,395,91
-1,1419,1573,-154,-6,-232,62
-1,1854,1782,72,-2,-206,86
1,1779,1838,-59,1,29,67
1,1906,1786,120,0,-121,119
-1,1323,1348,-25,-8,-104,54
-1,1810,1830,-20,-2,-70,58
-1,1816,1827,-11,-8,-32,40
-1,1650,1972,-322,2,92,72
1,1723,1421,302,3,-194,95
1,1729,1580,149,1,384,95
1,1500,1465,35,0,326,109
1,1825,1820,5,1,45,45
0,1237,1151,86,11,1026,85
-1,1412,1534,-122,-1,-203,76
1,1518,1560,-42,1,59,71
-1,1298,1679,-381,4,-57,71
1,1417,1413,4,-4,-109,63
-1,1570,1659,-89,-2,-77,58
1,1738,1394,344,1,61,52
0,1652,1444,208,-5,-559,96
-1,1665,1739,-74,0,32,64
1,1434,1313,121,4,1033,143
1,1519,1326,193,9,180,51
-1,1369,1463,-94,-3,-174,70
-1,1507,1516,-9,-8,-260,70
1,1923,1967,-44,-4,-51,47
0,1656,1472,184,-2,-103,106
1,1448,1584,-136,4,428,83
1,1380,1236,144,0,25,51
1,1639,1742,-103,2,245,107
-1,1411,1727,-316,-11,-373,102
1,1265,1299,-34,7,81,42
1,1667,1561,106,-1,-55,59
0,1391,1741,-350,-1,97,191
-1,1480,1669,-189,-7,-85,58
-1,1750,1681,69,0,-28,56
-1,1654,1462,192,-1,-309,104
-1,1828,1459,369,0,-18,64
-1,1719,1610,109,-11,-431,62
1,1198,1500,-302,17,603,57
-1,1529,1529,0,-2,-220,90
1,1637,1481,156,-1,1,47
-1,1624,1703,-79,2,21,56
1,1991,1768,223,0,-45,79
-1,1473,1644,-171,0,13,46
1,1713,1615,98,-1,5,41
1,1338,1177,161,0,-44,77
1,1650,1466,184,-2,-53,51
1,1607,1722,-115,1,741,105
1,1656,1460,196,0,-20,55
-1,1812,1739,73,0,-2,66
1,1407,1595,-188,11,615,77
1,1734,1458,276,2,11,47
1,1623,1624,-1,-6,-142,85
-1,1277,1274,3,3,159,40
-1,1662,1454,208,0,11,66
-1,1705,1622,83,-1,-123,72
1,1454,1662,-208,6,766,117
1,1636,1690,-54,1,94,69
-1,1216,1474,-258,-1,-736,105
-1,1604,1711,-107,0,-495,186
1,1649,1614,35,2,271,73
1,1790,1843,-53,0,53,81
1,1763,2025,-262,2,91,57
-1,1652,1405,247,-2,-30,42
-1,1126,1316,-190,-7,-5,40
1,1473,1644,-171,0,63,55
-1,1659,1677,-18,-4,-221,168
1,1265,1687,-422,-1,379,177
-1,1530,1528,2,-5,-56,50
1,1627,1491,136,-3,-139,57
1,1491,1627,-136,3,262,71
-1,1451,1771,-320,-9,-113,40
1,1979,1300,679,6,214,53
0,1265,1040,225,3,284,133
1,1711,1649,62,-1,372,87
-1,1256,1212,44,1,64,54
0,1688,1814,-126,0,-321,125
-1,1499,1620,-121,1,20,54
-1,1722,1570,152,0,-136,68
1,1912,1779,133,1,91,85
1,1653,1710,-57,-2,-76,85
1,1628,1491,137,0,-63,75
1,1640,1536,104,9,596,95
-1,1385,1406,-21,-7,-311,69
-1,1417,1692,-275,-8,-209,64
1,1704,1586,118,0,45,97
-1,1483,1635,-152,3,80,40
-1,1647,1528,119,-7,-496,70
-1,1732,1401,331,-2,-329,122
1,1574,1697,-123,2,389,137
1,1696,1402,294,4,114,43
1,1600,1867,-267,-1,-52,85
1,1476,1642,-166,23,582,43
1,1712,1579,133,-1,-21,53
-1,1641,1534,107,0,-193,76
-1,1625,1469,156,-5,-411,106
-1,1519,1548,-29,-10,-160,46
1,1548,1168,380,0,-5,91
1,1571,1720,-149,-2,75,61
1,1627,1550,77,-7,-797,103
1,1478,1617,-139,-1,-36,43
1,1738,1659,79,0,-16,43
-1,1772,1950,-178,0,61,114
1,1601,1494,107,-4,-51,63
-1,1572,1719,-147,0,44,40
1,1636,1614,22,2,216,121
1,1448,1452,-4,-2,-60,53
-1,1596,1798,-202,-2,-771,108
-1,1727,1565,162,-2,119,46
-1,1375,1640,-265,-12,-300,54
-1,1486,1609,-123,-6,-60,46
1,1544,1371,173,4,75,51
-1,1497,1651,-154,-8,-749,104
-1,1478,1617,-139,-3,-116,68
1,1807,1604,203,13,489,61
-1,1590,1701,-111,0,-15,48
1,1441,1327,114,3,209,69
-1,1509,1516,-7,-3,-164,80
1,1624,1471,153,-2,-198,91
1,1709,1582,127,0,202,107
1,1646,1599,47,-2,-42,83
-1,1756,1817,-61,0,-40,76
1,1365,1169,196,-3,-105,79
1,1464,1630,-166,1,-72,47
1,1260,1243,17,-2,-50,63
1,1655,1590,65,5,258,99
1,1614,1481,133,-1,-22,45
-1,1468,1676,-208,-1,-43,67
1,1473,1621,-148,2,115,75
-1,1746,1832,-86,0,89,66
1,1979,1766,213,-1,92,61
1,1546,1491,55,-2,-41,59
1,1459,1223,236,-1,-75,57
1,1518,1194,324,-2,-15,63
-1,1422,1712,-290,-3,-202,78
1,1664,1581,83,0,158,87
-1,1482,1613,-131,8,134,44
1,1738,1820,-82,2,455,105
-1,1482,1613,-131,1,20,52
-1,1449,1544,-95,0,-333,94
1,1705,1462,243,1,-6,79
-1,1474,1621,-147,8,290,40
-1,1881,2001,-120,-2,-33,60
1,1627,1577,50,-2,-24,47
1,1259,1275,-16,-1,-36,55
1,1164,1277,-113,7,915,149
1,1271,1177,94,-1,104,49
1,1696,1846,-150,-1,-97,93
-1,1498,1523,-25,-3,-152,58
1,1637,1575,62,1,8,43
1,2030,1874,156,1,224,93
1,1657,1658,-1,0,69,77
-1,1646,1566,80,8,318,64
1,1507,1559,-52,0,9,57
1,1621,1457,164,-1,-7,91
0,1665,1690,-25,8,579,71
-1,1633,1579,54,0,-137,184
1,1279,1232,47,-3,-96,65
-1,1868,2053,-185,-1,-33,64
-1,1328,1289,39,0,3,56
1,1716,1418,298,3,647,127
1,1546,1520,26,1,426,111
-1,1488,1671,-183,1,114,80
-1,1464,1754,-290,-6,-308,64
1,1975,1646,329,1,164,101
-1,1540,1655,-115,0,-454,106
1,1261,1180,81,1,-8,47
-1,1844,1895,-51,2,40,62
1,1255,1159,96,10,643,139
-1,1634,1443,191,0,-20,68
1,1398,1211,187,7,528,63
1,1872,1575,297,2,67,59
-1,1566,1576,-10,0,-15,58
1,1336,1575,-239,-18,-506,43
1,1700,1558,142,3,106,85
0,1461,1617,-156,0,495,105
-1,1289,1271,18,-7,-74,42
1,1522,1556,-34,2,87,73
1,1912,1708,204,1,47,49
1,1318,1315,3,-3,-269,63
1,1755,1551,204,0,21,47
1,1573,1643,-70,2,53,67
-1,1496,1546,-50,-4,-81,60
0,1509,1557,-48,-2,27,172
1,1600,2072,-472,0,-106,95
-1,1702,1546,156,1,-235,74
-1,1793,1728,65,2,-493,120
1,1362,1460,-98,4,781,145
1,1680,1561,119,6,363,62
-1,1338,1596,-258,0,-132,92
1,1482,1677,-195,3,159,67
1,1619,1466,153,2,135,75
1,1690,1371,319,4,129,60
1,1630,1480,150,2,38,47
-1,913,0,913,-13,-136,40
-1,1665,2064,-399,-3,-102,54
1,2006,1264,742,0,49,55
0,1433,1487,-54,2,253,131
1,1440,1304,136,-1,-84,81
1,1918,1630,288,-1,19,83
0,1355,1458,-103,-5,2,136
1,1511,1423,88,-1,-26,57
1,1575,1637,-62,5,377,108
1,1763,1269,494,7,278,51
1,1846,2046,-200,2,113,63
-1,1996,1478,518,0,34,98
-1,1587,1799,-212,-1,-33,50
-1,1663,2088,-425,-5,-114,56
-1,1555,1569,-14,-3,-315,98
-1,1752,1760,-8,-5,-19,42
1,1413,1519,-106,2,68,53
1,1626,1693,-67,0,118,65
1,1581,1465,116,1,63,93
-1,1472,1636,-164,-7,-18,62
-1,1624,1588,36,-2,-144,70
1,1921,1626,295,0,2,49
1,1741,1771,-30,0,5,117
-1,1622,1925,-303,3,-55,46
-1,1485,1434,51,-6,-317,76
-1,1619,1929,-310,-1,8,82
1,1765,1447,318,7,433,87
1,1447,1450,-3,0,150,59
-1,1818,1798,20,0,-70,88
1,1690,1781,-91,-5,-4,125
-1,1600,1611,-11,0,82,116
1,1932,1615,317,0,63,71
-1,1505,1430,75,0,-247,100
-1,1442,1528,-86,2,41,56
-1,1281,1535,-254,-4,-235,68
-1,1612,1936,-324,0,-121,52
-1,1544,1580,-36,-1,-64,72
-1,1459,1472,-13,2,-459,150
-1,1198,1429,-231,-14,-527,54
1,1233,1392,-159,2,48,46
-1,1703,1590,113,-5,-455,90
1,1538,1378,160,0,415,119
1,1711,1582,129,1,78,49
-1,1609,1500,109,2,-31,62
-1,1753,1715,38,-5,-26,51
1,1607,1554,53,-2,-42,57
1,1715,1753,-38,0,26,53
-1,1660,1569,91,-3,-795,150
-1,1304,1367,-63,2,-158,94
-1,1680,1640,40,-1,-351,114
1,1698,1719,-21,-2,-59,57
-1,1475,1500,-25,-2,-126,77
1,1741,1727,14,0,499,123
1,1544,1491,53,0,60,83
1,1753,1704,49,1,-7,91
1,1483,1478,5,-2,-84,79
-1,1717,1751,-34,2,92,48
-1,1878,1802,76,0,10,46
-1,1595,1523,72,-1,-304,110
1,1481,1558,-77,-2,27,53
-1,1231,1539,-308,-1,-51,58
-1,1614,1414,200,-5,-327,80
-1,1741,1708,33,1,6,110
-1,1819,1815,4,4,103,74
1,1453,1360,93,2,109,49
1,1825,1811,14,0,59,85
-1,1291,1447,-156,-4,-141,66
-1,1538,1495,43,0,-624,94
-1,1700,1554,146,1,-758,112
1,1461,1338,123,3,183,65
1,1683,1569,114,0,41,59
-1,1573,1590,-17,0,-55,100
-1,1776,1665,111,0,0,56
1,1500,1318,182,4,151,55
1,1433,1516,-83,-2,8,67
-1,1682,1770,-88,-4,-162,78
1,1493,1285,208,2,38,45
1,1778,1673,105,-2,113,59
-1,1551,2114,-563,-10,-396,128
1,1701,1720,-19,2,78,67
1,1615,1454,161,7,253,51
1,1503,1447,56,4,114,49
1,1665,1786,-121,1,-16,63
1,1432,1597,-165,-2,51,72
1,1786,1665,121,12,158,49
1,1725,1075,650,3,-16,45
1,1499,1508,-9,-1,-23,47
1,1597,1554,43,2,73,67
1,1763,1250,513,1,28,51
-1,1657,1794,-137,-3,6,74
1,1248,1767,-519,4,31,43
1,1500,1653,-153,0,74,75
-1,1801,1649,152,3,17,46
-1,1079,1497,-418,1,44,100
1,1699,1281,418,-4,-87,51
1,1666,1785,-119,-2,-3,71
1,0,1200,-1200,11,378,101
0,1496,1664,-168,-3,-7,134
-1,1373,1574,-201,-1,-324,84
-1,1771,1681,90,1,-176,80
1,1279,1316,-37,0,69,57
-1,1444,1225,219,1,31,60
1,1741,1321,420,4,142,57
1,1535,1764,-229,-3,-80,47
-1,1437,1521,-84,1,64,86
-1,1696,1757,-61,0,-85,88
-1,1766,1686,80,0,11,54
1,2123,1548,575,-2,338,127
-1,1314,1371,-57,-4,-175,58
-1,1854,1702,152,-11,-254,60
1,1201,1302,-101,4,45,41
-1,1406,1471,-65,-1,-652,100
-1,1700,1753,-53,3,-102,64
1,1753,1700,53,-2,213,67
1,1622,1736,-114,1,172,99
-1,1659,1501,158,-1,-87,112
1,1838,1476,362,-1,-64,77
-1,1447,1499,-52,-3,-19,70
-1,1245,1485,-240,-9,-408,62
1,1762,1690,72,-1,243,101
1,1541,1548,-7,9,129,43
-1,0,1475,-1475,1,8,44
0,1586,1733,-147,0,63,108
-1,1369,1601,-232,-3,-517,106
-1,1814,2174,-360,0,-28,74
-1,1353,1497,-144,2,162,62
-1,1789,1851,-62,2,214,78
1,1689,1469,220,0,116,87
1,1805,1640,165,1,-41,75
1,1613,1715,-102,-1,-21,47
-1,1812,2047,-235,-8,-65,40
1,1722,1651,71,0,-55,139
1,1797,1639,158,-1,21,135
-1,1665,1567,98,-1,-238,106
-1,1540,1561,-21,5,157,58
1,1503,1118,385,3,94,43
-1,1363,1488,-125,2,12,44
1,1651,1415,236,18,503,49
-1,1733,1868,-135,0,-3,40
1,1430,1438,-8,0,216,103
1,1495,1355,140,-3,36,55
1,1641,1687,-46,-7,-121,133
-1,1410,1656,-246,-2,-30,56
-1,1502,1529,-27,2,-40,52
-1,1633,1811,-178,1,46,52
-1,1593,1881,-288,0,25,56
-1,1808,2052,-244,0,-30,80
1,1575,1730,-155,2,169,65
-1,1504,1536,-32,4,88,43
-1,1674,1888,-214,-1,-93,60
1,1817,1627,190,1,70,65
-1,1716,1897,-181,-3,-635,110
1,2178,1811,367,0,3,49
-1,1530,1344,186,1,1,54
1,1621,1823,-202,6,552,107
-1,1604,1698,-94,-1,-92,76
-1,1539,1815,-276,-2,-136,82
-1,1724,1775,-51,-1,12,104
-1,1809,1710,99,-2,-57,56
1,1867,1309,558,0,-2,65
-1,1827,1916,-89,3,-77,136
1,1577,1716,-139,0,-48,71
-1,1514,1490,24,-11,-557,66
-1,1806,1982,-176,-1,-446,84
0,1333,1380,-47,0,111,127
1,1624,1318,306,-6,-51,65
-1,1412,1825,-413,-1,-64,64
1,1427,1443,-16,-7,-56,41
1,1101,1412,-311,7,895,79
-1,1550,1541,9,-2,-196,80
-1,1625,1679,-54,-2,-329,90
-1,1314,1710,-396,-1,-30,50
1,1376,1293,83,0,107,53
1,1208,1788,-580,0,208,145
1,1702,1364,338,7,349,61
1,1549,1254,295,5,273,61
-1,1642,1675,-33,-2,-103,68
1,1001,1408,-407,1,122,57
1,1634,1538,96,4,496,89
1,1591,1537,54,15,415,51
1,1642,1408,234,-1,-82,67
-1,1454,1302,152,-1,-76,72
-1,1657,1728,-71,-2,-80,56
-1,1727,1529,198,-3,23,42
-1,1650,1958,-308,0,-22,44
1,1799,1634,165,1,-384,89
-1,1616,2129,-513,-3,-235,76
1,1985,1646,339,1,96,95
-1,1812,1716,96,0,76,106
1,1804,1725,79,0,55,117
-1,1546,1709,-163,0,-13,54
-1,1613,1812,-199,1,55,72
-1,1403,1358,45,2,37,60
1,1748,1450,298,2,57,57
-1,1214,1351,-137,-4,-207,112
-1,1625,1553,72,-5,-10,72
-1,1924,1714,210,-1,-80,66
1,1895,1459,436,4,107,45
1,1619,1530,89,0,332,135
0,1818,1492,326,3,-357,154
-1,1545,1588,-43,-2,-329,70
1,1708,1716,-8,1,293,97
-1,1312,1391,-79,-2,-132,78
-1,1739,1647,92,6,237,116
1,1514,1500,14,10,162,41
1,1898,1505,393,2,66,47
1,1643,1988,-345,0,-51,107
1,1413,1773,-360,-1,-11,75
-1,1311,1503,-192,-2,-32,56
1,1809,1787,22,0,2,45
1,1719,1493,226,2,35,53
-1,1552,1319,233,1,13,46
-1,1395,1613,-218,-4,-385,88
-1,1503,1900,-397,-1,-8,46
1,1731,1798,-67,1,55,53
1,1836,1572,264,-1,-8,93
-1,1820,1991,-171,-5,-237,68
-1,1307,1695,-388,0,0,60
-1,1364,1635,-271,-2,-55,84
-1,1766,1903,-137,-1,-14,44
1,1716,1843,-127,-1,697,151
0,1125,1349,-224,-2,-379,118
1,1813,1418,395,2,130,97
1,1508,1633,-125,0,65,55
1,1924,1925,-1,0,43,79
-1,1487,1724,-237,-4,-36,50
1,1912,1758,154,0,-67,105
0,1414,1527,-113,14,1078,88
1,1816,1436,380,2,122,65
-1,1704,1606,98,-4,-215,94
-1,1522,1531,-9,-3,-523,88
1,1840,1744,96,0,-19,123
0,1622,1568,54,0,-2,43
-1,1601,1653,-52,-1,-31,64
1,1304,1362,-58,4,105,41
-1,1640,1480,160,-2,-93,63
0,1793,1813,-20,-1,117,165
1,1493,1115,378,0,-21,45
1,1704,1625,79,2,213,121
1,1854,1662,192,-1,81,83
-1,1547,1797,-250,1,36,57
-1,1751,1920,-169,-2,-117,96
-1,1649,1510,139,-1,-43,52
-1,1663,1499,164,-3,-220,74
1,1496,1542,-46,3,279,117
-1,1876,1698,178,0,-14,62
-1,1407,1304,103,-3,-90,84
1,1729,1482,247,1,277,73
-1,1555,1511,44,1,-235,180
-1,1322,1747,-425,0,-27,54
1,1415,1622,-207,-1,59,101
-1,1500,1521,-21,0,-463,118
-1,1405,1885,-480,3,77,58
-1,1557,1377,180,1,-725,122
-1,1535,1594,-59,-1,-55,86
1,1446,1287,159,-4,-62,99
1,1814,1501,313,-1,-27,57
1,1724,1777,-53,0,-32,123
1,1928,1744,184,3,80,51
1,1432,1491,-59,0,35,53
-1,1736,1849,-113,0,-22,66
-1,1628,1677,-49,-3,-166,122
-1,1738,1935,-197,-5,-111,54
1,1497,1649,-152,4,179,55
0,1265,1431,-166,-3,-98,114
-1,1500,1835,-335,-1,-35,64
1,1817,1601,216,-1,-72,107
1,1975,1786,189,-2,107,159
-1,1477,1733,-256,-9,-387,110
0,1564,1761,-197,-1,-67,119
1,1633,1514,119,-1,-90,89
-1,1719,1475,244,-12,-765,114
1,1318,1461,-143,3,197,73
-1,1383,1478,-95,5,24,50
1,1728,1652,76,1,133,95
1,1823,1998,-175,0,144,63
1,1882,1435,447,1,86,57
1,1731,1800,-69,0,96,89
1,1620,1655,-35,0,-14,67
-1,1335,1802,-467,3,100,40
1,1278,1364,-86,11,209,47
-1,1525,1816,-291,-1,-98,94
-1,1476,1493,-17,2,-84,66
1,1738,1472,266,-1,50,61
1,1798,1572,226,3,114,61
-1,1840,1732,108,-5,-841,136
1,1656,1099,557,0,192,71
1,1271,1513,-242,-4,-80,79
1,1717,1643,74,0,56,80
1,1414,1383,31,4,315,79
1,1517,1373,144,1,65,43
1,1887,1382,505,0,1,43
-1,1498,1811,-313,-1,36,88
-1,1528,1603,-75,-8,-473,78
-1,1787,1745,42,-3,-44,40
-1,1098,1315,-217,-4,-108,46
-1,1325,1522,-197,0,44,68
1,1825,1980,-155,2,201,79
-1,1780,1891,-111,0,-110,136
1,1620,1334,286,0,-16,74
-1,1758,1774,-16,-1,-37,44
-1,1643,1889,-246,-3,-34,84
1,1619,1746,-127,-4,-67,101
-1,1742,1803,-61,0,-427,128
0,1365,1268,97,0,-182,97
-1,1314,1125,189,-2,-49,82
-1,1312,1748,-436,-2,-316,98
-1,1534,1521,13,-5,-141,52
-1,1481,1372,109,0,-99,98
-1,1607,1500,107,0,-12,56
-1,1785,1747,38,0,-222,118
1,1450,1447,3,0,7,49
-1,1821,2132,-311,-2,-48,46
-1,1591,1816,-225,-3,-289,84
1,1860,1586,274,0,28,83
-1,1090,1320,-230,-1,-496,88
-1,1375,1562,-187,-3,-133,74
-1,1570,1464,106,-1,12,58
-1,1582,1891,-309,-2,-195,68
-1,1899,1773,126,0,-159,92
-1,1816,2057,-241,1,-52,88
1,1568,1494,74,1,276,111
1,1914,1579,335,-3,-112,97
1,1895,1636,259,0,-14,95
1,1436,1588,-152,0,93,75
1,1760,1773,-13,0,-12,55
1,1533,1522,11,3,142,57
1,1270,1336,-66,10,493,69
-1,1307,1486,-179,0,-97,98
0,1530,1319,211,-1,-91,101
1,1601,1366,235,19,531,47
-1,1293,1583,-290,-6,-229,74
-1,1787,1801,-14,0,3,88
-1,1495,1500,-5,-10,-252,74
1,1821,1724,97,0,2,55
-1,1410,1541,-131,0,-347,160
1,1309,1753,-444,6,312,63
1,1804,1503,301,5,68,45
1,1813,1732,81,3,33,41
1,1487,1540,-53,-4,11,61
-1,1473,1672,-199,-6,-317,80
1,1913,1629,284,0,-9,59
-1,1146,1332,-186,-4,-152,66
1,1761,1664,97,0,57,59
-1,1761,2066,-305,0,23,76
1,1333,1933,-600,-2,-88,85
0,1526,1541,-15,-2,-412,124
1,1412,1500,-88,0,326,123
1,1833,1586,247,0,9,41
1,1328,1348,-20,-7,-10,83
1,1402,1452,-50,0,-10,51
1,1555,1501,54,5,148,56
1,1812,1777,35,0,49,69
-1,1656,1800,-144,0,-349,138
1,1814,1457,357,1,78,79
1,1345,1342,3,0,-15,97
1,1758,1581,177,-6,-11,85
-1,1454,1829,-375,0,-53,58
1,1962,1500,462,4,334,73
1,1742,1463,279,11,373,67
-1,1500,1408,92,2,23,42
1,1289,1168,121,4,157,49
1,1747,1963,-216,-1,14,63
-1,1153,1563,-410,-8,-116,40
1,1841,1451,390,3,-47,83
1,1830,1533,297,5,80,51
-1,1439,1439,0,0,-73,80
-1,1484,2181,-697,-4,-232,106
1,1651,1715,-64,-1,-4,67
-1,1837,1822,15,0,-73,100
-1,1767,1735,32,-3,-52,86
-1,1515,1809,-294,1,10,68
-1,1486,1491,-5,-2,-160,64
1,1575,1565,10,3,97,53
1,1829,1649,180,0,8,93
1,1458,1746,-288,1,28,45
-1,1449,1488,-39,-2,53,66
-1,1157,1276,-119,-3,-3,54
-1,1483,1476,7,-2,-290,124
1,1500,1632,-132,1,41,75
-1,1297,1439,-142,1,61,78
1,1833,1826,7,1,79,117
-1,1764,1657,107,0,-55,60
1,1734,1862,-128,-3,-4,67
1,1475,1502,-27,0,121,169
-1,1530,1642,-112,-4,-603,108
1,1732,1761,-29,1,14,43
-1,1553,1586,-33,0,12,60
1,1970,1748,222,0,-5,99
1,1815,1844,-29,0,-20,99
-1,1351,1357,-6,-2,-425,120
-1,1749,1727,22,-8,-175,56
1,1703,1500,203,-1,-53,83
1,1291,1335,-44,0,359,73
-1,1299,1571,-272,-1,-117,68
1,1365,1493,-128,-1,-217,97
1,1408,1123,285,13,617,73
-1,1301,1500,-199,8,193,92
-1,1513,1472,41,4,68,50
-1,1841,1463,378,-3,-189,82
1,1651,1522,129,2,325,117
-1,1077,1360,-283,-4,-321,80
-1,1744,1500,244,0,-28,74
1,1527,1465,62,1,288,129
1,1822,1766,56,-1,312,101
-1,1817,1843,-26,1,-64,75
-1,1428,1713,-285,-1,-338,92
1,1543,1406,137,5,67,41
-1,1702,1840,-138,0,136,134
1,1426,1237,189,3,31,41
-1,1495,1533,-38,-5,-344,108
1,1788,1733,55,0,35,75
1,1638,1421,217,0,18,49
1,1705,1500,205,0,70,75
1,1832,1756,76,-1,-61,111
-1,1853,1807,46,0,-2,50
1,1717,1423,294,-2,-19,61
-1,1565,1417,148,1,-89,101
-1,1105,1421,-316,-8,-268,54
-1,1501,1557,-56,2,63,104
-1,1398,1550,-152,-2,-496,114
-1,1339,1478,-139,-3,-85,64
1,1809,1395,414,1,334,94
1,1322,1353,-31,6,351,79
1,1745,1562,183,-3,134,87
1,1488,1313,175,-6,-244,67
1,1784,1563,221,3,452,89
1,1718,2067,-349,3,-15,109
-1,1471,1947,-476,-2,-13,152
1,1618,1588,30,-1,-109,105
-1,1324,1370,-46,-1,21,50
0,1555,1789,-234,-2,227,183
1,1643,1771,-128,3,218,81
-1,1544,1541,3,1,18,52
1,1751,1556,195,0,-141,105
-1,1610,1717,-107,0,-77,78
-1,1500,1822,-322,0,-60,112
-1,1682,1569,113,1,112,112
1,1633,1471,162,0,136,80
1,1619,1699,-80,0,73,99
1,1730,1566,164,1,126,99
1,1351,1405,-54,2,382,107
-1,1737,1771,-34,8,130,48
1,1809,1816,-7,3,209,86
1,2045,1824,221,0,225,125
1,1276,1308,-32,15,438,47
1,1734,1714,20,-7,-27,41
-1,1667,1800,-133,0,-49,68
1,1208,1328,-120,4,76,53
1,1516,1547,-31,5,725,95
-1,1639,1727,-88,-2,-53,44
1,1400,1332,68,4,148,55
1,1819,2050,-231,7,727,103
-1,1654,1662,-8,-4,-193,66
-1,1735,1630,105,-7,-364,70
1,1467,1333,134,6,229,63
1,1726,1602,124,0,183,133
-1,1686,1649,37,1,-15,81
1,1696,1745,-49,-1,25,45
-1,1294,1289,5,3,-93,80
-1,1130,1417,-287,-15,-1272,128
-1,1314,1787,-473,-4,-347,74
-1,1879,1890,-11,0,-13,62
1,1533,1575,-42,3,537,115
1,1626,1669,-43,0,23,53
-1,1895,1605,290,1,-19,110
-1,1321,1597,-276,-1,-103,68
-1,1658,1500,158,-7,-96,46
1,1805,1819,-14,1,137,71
-1,1611,1670,-59,0,-157,152
1,1312,1392,-80,2,372,107
1,2034,1718,316,5,19,41
1,1864,1584,280,4,60,40
1,1341,1330,11,0,-35,123
-1,1529,1497,32,2,14,56
-1,1380,1507,-127,-10,-156,58
1,1193,1450,-257,1,48,71
-1,1500,1469,31,2,38,48
-1,1531,1574,-43,0,-250,102
1,1542,1628,-86,3,193,73
1,1656,1638,18,1,57,62
-1,1486,1686,-200,-4,-17,40
1,1340,1321,19,1,-3,75
-1,1914,1744,170,0,78,98
1,1732,1717,15,1,25,63
1,1648,1734,-86,3,158,101
1,1646,1457,189,1,63,87
-1,1669,1518,151,-4,-635,174
-1,1628,1674,-46,0,-23,82
-1,1851,1673,178,0,-829,140
-1,1335,1307,28,2,64,46
1,1492,1425,67,6,139,43
-1,1595,1734,-139,-1,-78,120
1,1604,1374,230,0,-126,81
-1,1808,1816,-8,0,-20,66
1,1127,1434,-307,6,336,59
1,1653,1589,64,-1,-56,65
-1,1511,2038,-527,0,27,64
0,1559,1674,-115,0,317,101
1,1808,1497,311,-1,96,65
-1,1554,1556,-2,0,-39,54
-1,1731,1718,13,-9,-19,66
-1,1628,1667,-39,0,-30,78
1,1379,1326,53,-4,-23,57
1,1523,1516,7,4,86,49
1,2176,1117,1059,5,121,53
1,1700,1743,-43,0,51,83
-1,1349,1308,41,-14,-557,82
1,1470,1312,158,-4,-22,75
-1,1419,1480,-61,-1,-42,56
1,1323,1516,-193,10,591,99
-1,1506,2039,-533,-1,-53,54
-1,1561,1491,70,-7,-1140,150
-1,1518,1483,35,-2,-63,74
-1,1758,1482,276,-1,-365,84
1,1826,1798,28,1,315,91
-1,1738,1645,93,-3,-110,58
1,1317,1388,-71,1,453,181
-1,1684,1767,-83,-1,-37,70
1,1327,1072,255,4,158,57
-1,1662,1924,-262,-2,-201,86
1,1638,1684,-46,1,175,185
-1,1431,1257,174,3,86,60
-1,1775,2122,-347,-1,-75,88
1,1652,1715,-63,3,35,61
-1,1540,1510,30,-1,-4,74
-1,1620,1691,-71,-3,-467,100
1,1730,1522,208,-1,-27,51
1,1602,1704,-102,-3,47,141
-1,1677,1615,62,-1,-58,64
1,1402,1501,-99,3,203,133
1,1965,1658,307,-1,-7,40
1,2176,1264,912,2,182,77
-1,1315,1346,-31,-3,-295,68
1,1535,1816,-281,0,473,151
1,1713,1741,-28,0,21,128
-1,1788,1836,-48,0,-62,90
1,1225,1235,-10,-4,-173,47
-1,1662,1432,230,0,66,122
1,1457,1204,253,6,367,79
1,1829,1791,38,1,22,65
1,1369,1420,-51,0,-9,53
1,1548,1499,49,4,292,69
-1,1656,1748,-92,2,-153,104
-1,1868,1863,5,-3,-32,52
-1,1517,1736,-219,-2,-27,66
1,1619,1428,191,3,82,55
-1,1626,1346,280,1,-98,60
-1,1475,1514,-39,0,-67,52
1,1054,1333,-279,3,344,87
1,1680,1422,258,0,9,61
-1,1615,2126,-511,-1,-24,44
1,1845,1779,66,2,30,53
1,1898,1971,-73,-1,3,93
1,2176,1839,337,-1,18,59
1,1451,1651,-200,4,449,103
1,1375,1330,45,-3,91,75
-1,1758,1690,68,0,-107,126
-1,1781,1783,-2,-1,-55,98
1,1304,1291,13,1,-7,61
-1,1683,1640,43,-2,-172,56
-1,1721,1815,-94,-3,-304,80
-1,1637,2128,-491,0,10,70
-1,1461,1522,-61,-1,-436,138
-1,1771,1854,-83,0,10,50
1,2181,1836,345,0,-27,111
-1,1555,1521,34,-8,-901,110
-1,1547,1431,116,-6,-476,94
-1,1741,1723,18,0,38,110
-1,1766,1752,14,-4,-885,104
1,1862,1763,99,-3,18,63
1,1511,1567,-56,1,144,61
-1,1320,1384,-64,1,-106,70
-1,1624,1685,-61,0,-14,50
-1,1498,1579,-81,0,-37,70
1,1833,2186,-353,0,37,85
1,1573,1614,-41,8,539,77
1,1855,1700,155,-1,-31,159
1,1374,1500,-126,0,4,41
1,1710,1770,-60,2,31,43
-1,1272,1279,-7,3,-37,94
1,1592,1730,-138,-1,2,93
1,1310,1128,182,7,338,69
-1,1531,1592,-61,0,-89,80
-1,1794,1676,118,3,86,76
-1,1249,1319,-70,-2,-411,92
1,1789,1743,46,8,65,41
-1,1518,1543,-25,2,-122,118
-1,1477,1757,-280,-3,-102,70
1,1435,1353,82,0,-109,85
1,1870,1755,115,0,306,137
1,1546,1321,225,2,97,71
-1,1399,1652,-253,-11,-454,70
1,1400,1443,-43,1,-277,93
1,1672,1933,-261,6,189,55
1,1759,1729,30,0,4,75
1,1641,1691,-50,0,-5,51
-1,1393,1311,82,1,-63,62
-1,1504,1500,4,0,-7,70
1,1957,1912,45,-1,36,87
1,2152,1733,419,-2,27,61
-1,1685,1505,180,0,10,77
1,1800,1798,2,4,177,73
1,1624,1295,329,-3,569,153
1,1452,1176,276,-2,122,63
1,1730,1733,-3,0,6,51
1,1733,1545,188,0,-67,93
-1,1914,2130,-216,0,-89,144
-1,1780,1696,84,-1,-168,138
1,1345,1332,13,14,885,67
1,1654,1679,-25,1,91,53
1,1764,1754,10,3,584,107
1,1325,1380,-55,7,611,95
-1,1730,2156,-426,-1,-6,58
0,1690,1719,-29,-3,145,184
-1,2023,1500,523,0,23,114
1,1650,1620,30,0,40,157
-1,1796,1769,27,1,-104,92
-1,1671,1634,37,-3,-34,48
-1,1106,1317,-211,-6,-61,40
1,1744,1784,-40,1,47,47
-1,1286,1527,-241,-2,-89,46
-1,1891,1702,189,3,69,76
-1,1500,1850,-350,0,-80,70
-1,1676,1675,1,0,-357,142
1,1667,1665,2,0,96,71
1,1801,1500,301,0,36,41
-1,1285,1243,42,-10,-574,138
-1,1342,1583,-241,-9,-354,82
1,1254,1291,-37,13,291,43
1,1797,1635,162,8,221,47
1,1874,1718,156,3,362,83
-1,1724,1756,-32,0,-154,68
-1,1318,1317,1,2,117,58
1,1488,1547,-59,2,150,49
-1,1456,1383,73,-1,-23,84
-1,1726,2162,-436,-3,-50,42
1,1473,1513,-40,1,-5,49
-1,1570,1532,38,0,60,72
-1,1781,1784,-3,-3,-145,76
-1,1267,1125,142,3,132,72
1,1811,1877,-66,3,45,43
-1,1805,1784,21,-2,-517,110
-1,1766,1681,85,0,-114,80
1,1368,1338,30,-1,98,93
1,2041,1826,215,0,8,95
1,1605,1486,119,0,-8,47
-1,1473,1583,-110,0,23,67
-1,1654,1678,-24,1,116,88
-1,1117,1657,-540,-4,-97,96
-1,1774,2053,-279,0,-19,64
1,1472,1161,311,1,169,77
1,1407,1345,62,5,132,51
1,1553,1554,-1,2,82,75
1,1556,1366,190,1,5,49
-1,1533,1440,93,9,398,86
-1,1795,1864,-69,-2,53,86
-1,1542,1336,206,7,175,56
-1,1819,2047,-228,0,-27,74
-1,1485,1396,89,-1,-17,64
-1,1647,1715,-68,2,23,56
-1,1355,1500,-145,3,151,152
1,1614,1715,-101,2,-17,48
1,1791,1559,232,0,38,93
-1,1674,1562,112,2,-290,104
-1,1711,1777,-66,0,16,118
1,1609,1521,88,1,17,53
1,1819,1824,-5,8,541,91
-1,2052,1814,238,0,-157,66
1,1688,1644,44,-1,-21,79
1,1443,1198,245,2,124,49
1,1351,1345,6,1,416,93
-1,1526,1718,-192,0,-138,86
-1,1333,1333,0,-4,-367,76
1,1677,1511,166,0,11,40
1,1799,1688,111,0,23,85
-1,1396,1346,50,-5,-89,54
1,1663,1361,302,0,93,69
-1,1328,1377,-49,0,-13,52
-1,1527,1412,115,-3,-50,44
-1,1790,2013,-223,0,-16,66
-1,1478,1613,-135,-3,-259,92
1,1415,1306,109,6,217,59
1,1647,1525,122,-1,-14,61
-1,1757,1786,-29,-4,-113,59
-1,1497,1691,-194,1,-46,110
-1,1354,1523,-169,-10,-197,46
-1,1497,1418,79,1,-79,78
1,1402,1447,-45,5,277,81
-1,1461,1421,40,-6,-421,82
1,1554,1430,124,0,17,53
-1,1564,1544,20,-1,-164,137
1,1447,1493,-46,4,86,57
-1,1723,1770,-47,-3,27,80
1,1636,1685,-49,-1,-43,75
1,1824,1167,657,2,508,72
1,1659,1697,-38,0,168,102
-1,1821,1796,25,-6,-309,104
1,1978,1841,137,-3,11,53
-1,1796,1747,49,0,51,94
1,1387,1318,69,1,238,63
1,1809,1712,97,-5,-70,71
1,1701,1507,194,0,-15,65
1,1536,1550,-14,-5,-210,89
1,1714,1588,126,-4,22,139
1,1424,1514,-90,2,121,85
-1,1648,1616,32,0,3,62
-1,1686,1671,15,0,-33,56
0,1923,1970,-47,0,14,81
1,2032,1654,378,0,0,49
1,1548,1539,9,-1,-523,103
1,1532,1550,-18,0,16,49
-1,1460,1671,-211,-1,-70,100
-1,1414,1351,63,0,105,74
1,1470,1464,6,1,64,57
-1,1410,1552,-142,-1,-134,67
-1,1704,2034,-330,-3,-54,52
1,1672,1603,69,1,-37,63
-1,1924,2138,-214,-4,-49,88
1,1810,1610,200,0,-65,77
1,1696,1772,-76,0,0,95
1,1309,1395,-86,5,251,56
1,1650,1639,11,0,200,135
1,1867,1624,243,3,169,73
1,1291,1125,166,-1,590,115
-1,1558,1528,30,-2,-33,44
1,1721,1724,-3,-1,-11,51
-1,1520,1577,-57,-5,-147,57
1,1924,2071,-147,-1,-31,85
1,1485,1450,35,4,217,69
-1,1512,1608,-96,-1,193,88
-1,1223,1481,-258,-1,-45,58
-1,1803,1854,-51,-4,-40,42
0,1728,1760,-32,-2,73,108
-1,1772,1770,2,-3,-166,72
-1,1387,1391,-4,-4,-59,44
1,1707,1502,205,1,77,113
-1,1797,1864,-67,-2,-394,130
-1,1382,1323,59,-3,-398,104
-1,2146,1919,227,0,-48,88
1,1938,2013,-75,-3,-15,63
1,1553,1384,169,0,224,151
-1,1701,1540,161,0,-18,50
-1,1781,2121,-340,-2,-77,56
-1,1434,1480,-46,-4,-128,54
1,1863,1857,6,0,-10,75
-1,1515,1760,-245,-1,-69,56
1,1376,1162,214,1,405,87
-1,1256,1556,-300,-4,-62,42
1,1602,1624,-22,0,-106,103
-1,1218,1602,-384,1,17,64
-1,1739,1500,239,-1,-247,100
1,2165,1909,256,0,-51,103
-1,1455,1392,63,-6,-823,122
-1,1275,1677,-402,-9,-73,46
-1,1951,1967,-16,-1,-231,96
1,1778,1599,179,1,205,79
1,1465,1340,125,4,435,91
-1,1500,1559,-59,1,-18,50
1,1674,1401,273,1,73,91
1,1901,1759,142,-1,23,51
1,1817,1639,178,-1,-22,61
-1,1542,1570,-28,0,-54,52
1,1504,1283,221,-6,-112,51
-1,1458,1480,-22,-6,-305,64
1,1936,2119,-183,-2,-13,43
-1,1440,1596,-156,0,-26,46
-1,1115,1496,-381,-4,-363,106
1,1216,1336,-120,4,-6,75
-1,1873,1785,88,0,17,62
-1,1713,1781,-68,0,12,50
1,1552,1464,88,2,50,53
-1,1661,1721,-60,-2,3,63
0,1784,1969,-185,0,-217,130
0,1710,1679,31,0,91,138
1,1759,1713,46,3,100,55
1,1513,1496,17,-3,-56,107
-1,1760,2172,-412,-2,-49,48
-1,1534,1615,-81,1,75,84
-1,1370,1248,122,0,-380,102
-1,1650,2038,-388,-1,-25,44
1,1727,1273,454,-1,238,73
-1,1429,1904,-475,1,-200,112
-1,1758,1703,55,0,-345,110
1,1584,1681,-97,-1,40,59
-1,2007,1795,212,-3,-474,82
-1,1201,1397,-196,-2,-130,78
-1,1812,1986,-174,-1,-177,152
1,2176,1522,654,2,125,53
-1,1701,1499,202,-3,-302,128
1,1718,1412,306,0,250,98
1,1713,1607,106,1,49,67
-1,1963,1789,174,0,32,146
1,1443,1335,108,4,629,105
-1,1907,1945,-38,0,-15,62
-1,1707,1954,-247,1,35,72
1,1730,1639,91,0,55,82
-1,1580,1532,48,-3,55,58
-1,1801,1492,309,-10,-187,42
1,1685,1566,119,1,59,57
1,1466,1321,145,10,381,59
-1,1535,1665,-130,-14,-198,62
1,1644,1693,-49,0,48,49
1,1707,1693,14,0,134,61
1,1374,1435,-61,-1,-23,47
-1,1646,1803,-157,-6,-250,62
1,1688,1559,129,5,323,61
1,1628,1524,104,3,360,117
-1,1955,1898,57,0,-150,86
1,1682,1718,-36,4,37,47
-1,1798,1695,103,0,27,60
1,1485,1523,-38,-1,573,161
1,1717,1593,124,-2,-30,51
1,1872,1724,148,0,457,141
1,1806,1948,-142,-1,-83,95
-1,1680,1860,-180,0,-16,60
-1,1692,2041,-349,-2,-167,112
1,1706,1694,12,0,124,69
1,1553,1301,252,-4,-196,153
-1,1710,1784,-74,0,-485,136
1,1908,1369,539,3,171,69
-1,1500,1506,-6,-8,-268,58
-1,1520,1766,-246,-1,-67,52
1,1672,1522,150,3,91,63
1,1684,1716,-32,3,416,75
1,1490,1315,175,0,74,73
-1,1646,1551,95,-2,-83,56
1,1702,1814,-112,0,-3,97
-1,1302,1591,-289,0,-45,82
-1,1705,1695,10,-5,-608,92
1,2044,1689,355,2,65,55
-1,1789,1799,-10,0,-17,68
1,1515,1396,119,0,177,75
1,1933,1822,111,0,155,131
1,1865,1673,192,2,49,59
-1,1943,1967,-24,0,-56,60
1,1521,1458,63,0,15,103
-1,1454,1512,-58,-3,-131,64
1,1729,1812,-83,1,42,63
-1,1706,1694,12,0,-53,56
-1,1811,1639,172,5,397,84
-1,1544,1567,-23,0,-7,110
1,1785,1017,768,-4,309,115
1,1604,1842,-238,7,177,53
-1,1315,1570,-255,-9,-194,48
1,1793,1649,144,0,183,93
-1,1980,1701,279,1,-131,90
-1,1909,2105,-196,-1,-184,82
-1,1573,1554,19,-4,-392,66
1,1726,1779,-53,1,-105,149
1,1739,1628,111,0,126,89
-1,1381,1507,-126,-3,-131,86
-1,1814,1940,-126,-4,-649,126
-1,1355,1282,73,-9,-244,60
-1,1667,1871,-204,-3,-18,44
1,1722,1475,247,4,64,52
1,1561,1566,-5,-3,-498,79
1,1610,2008,-398,-4,-9,51
1,1755,1592,163,0,4,51
1,1407,1401,6,2,24,44
1,1483,1500,-17,0,51,53
-1,1573,1555,18,-17,-756,72
1,1716,1772,-56,0,555,105
1,1798,1809,-11,0,21,131
1,1876,1661,215,0,-6,127
1,1761,1613,148,0,74,85
-1,1496,1566,-70,2,54,62
-1,1599,1607,-8,1,34,100
0,2113,1902,211,0,61,131
1,1579,1660,-81,0,-4,49
-1,1511,1374,137,-1,-33,40
-1,1722,1958,-236,-4,-89,138
-1,1561,1575,-14,-1,-50,56
1,1549,1585,-36,-3,-167,65
-1,1654,1336,318,-3,-177,82
-1,1941,2177,-236,0,-73,68
-1,1358,1195,163,-1,-10,58
0,1806,1810,-4,0,-92,115
1,1745,1835,-90,1,346,93
1,1720,1850,-130,4,147,71
-1,1557,1296,261,-3,-242,134
-1,1424,1497,-73,0,-1,48
-1,1352,1573,-221,-14,-539,64
-1,1500,1769,-269,-2,-119,86
1,1372,1106,266,-2,-42,43
1,1297,1419,-122,-2,155,53
-1,1936,2000,-64,0,-13,78
-1,1517,1612,-95,0,-4,85
-1,1346,1350,-4,-5,-56,42
-1,1798,1767,31,-1,-43,78
1,1727,1616,111,6,266,67
1,1591,1523,68,0,59,61
0,1522,1497,25,0,-299,163
-1,1909,2105,-196,-1,7,74
-1,1585,1615,-30,-14,-434,56
-1,1963,1717,246,0,13,54
-1,1729,1910,-181,-2,95,110
1,1817,1578,239,1,37,55
1,1337,1182,155,-2,8,43
-1,1810,1576,234,-8,-246,54
1,1718,1653,65,6,544,85
1,1505,1354,151,-2,-32,71
-1,1747,1861,-114,1,-87,84
1,1509,1156,353,2,800,109
-1,1594,1607,-13,-3,-286,100
-1,1342,1317,25,-8,-215,68
1,2184,1521,663,2,180,61
-1,1942,1881,61,0,-292,106
0,1779,1678,101,0,0,86
1,1645,1790,-145,4,65,47
-1,1604,1792,-188,1,-7,132
-1,1317,1538,-221,-4,-141,74
-1,1482,1643,-161,0,116,84
1,1571,1578,-7,10,547,85
1,1641,1369,272,-1,-32,55
1,1648,1580,68,-2,41,50
-1,1634,1680,-46,-5,-384,88
1,1510,1388,122,-1,22,51
-1,1599,1660,-61,-3,-331,124
-1,1763,2112,-349,0,-63,90
-1,1239,1449,-210,-3,-126,66
1,1757,1644,113,-3,-78,71
-1,1653,1723,-70,1,-139,112
-1,1902,2185,-283,-9,-17,126
1,1737,1776,-39,2,54,55
1,1500,1289,211,0,-61,91
-1,1346,1512,-166,-3,-73,62
-1,1380,1426,-46,2,-234,90
1,1594,1684,-90,0,3,55
-1,1655,1650,5,-3,-58,102
-1,1517,1543,-26,0,-6,106
-1,1386,1422,-36,0,3,42
-1,1893,1916,-23,-3,-88,150
1,1673,1927,-254,3,317,95
-1,1804,1728,76,-3,-124,84
1,1798,1979,-181,1,-12,45
-1,1015,1787,-772,-24,-295,42
1,1764,1751,13,0,10,67
-1,1545,1490,55,-6,-90,42
1,1337,1117,220,9,401,65
-1,1512,1607,-95,0,-29,70
1,1651,1140,511,2,484,97
1,1518,1340,178,1,74,67
1,1711,1497,214,0,46,121
-1,1603,1656,-53,-2,-84,56
1,1792,1352,440,3,247,63
-1,1567,1598,-31,-1,-56,64
0,1309,1200,109,-3,-182,78
1,1637,1766,-129,7,699,97
1,1618,1589,29,0,24,75
1,1749,1656,93,0,204,77
-1,1326,1802,-476,0,171,92
-1,1500,1570,-70,0,0,44
1,1987,1311,676,-2,-50,53
-1,1664,1607,57,-9,-8,40
1,1507,1547,-40,0,181,121
-1,1306,1810,-504,-1,-47,52
-1,1601,1683,-82,0,-53,97
1,1775,1906,-131,0,161,101
-1,1719,1625,94,4,40,44
1,1855,1490,365,6,332,93
1,1609,1845,-236,3,56,79
1,1771,1630,141,4,80,45
1,1529,1758,-229,0,13,71
-1,1468,1513,-45,-1,-101,64
1,1374,1476,-102,0,362,89
-1,1460,1762,-302,-13,-248,46
-1,1775,1608,167,-9,-487,88
1,1896,1874,22,0,-77,91
-1,1505,1562,-57,0,-161,106
-1,1832,1638,194,0,-255,166
-1,1505,1497,8,-11,-165,40
-1,1516,1577,-61,0,-243,116
1,1539,1544,-5,0,121,93
-1,1778,1623,155,0,-369,106
1,1474,1540,-66,1,156,53
-1,1538,1426,112,0,2,56
1,1656,1107,549,6,137,43
1,1624,1758,-134,4,416,123
1,1865,1351,514,2,251,65
-1,1582,1539,43,-6,-160,66
-1,1486,1297,189,-4,-255,94
1,1464,1425,39,0,4,51
-1,1501,1531,-30,-2,-60,49
1,1762,1639,123,6,138,47
-1,1533,1500,33,1,-9,55
-1,1300,1462,-162,-11,-223,46
-1,1691,1558,133,-1,-37,68
1,1491,1733,-242,0,133,91
1,1618,1402,216,-2,277,107
1,1542,1548,-6,0,2,49
1,1548,1368,180,5,584,73
-1,1821,1627,194,-2,-55,74
0,1594,1657,-63,0,5,73
-1,1552,1569,-17,-2,-39,52
1,1741,1639,102,3,318,85
-1,1447,1575,-128,-6,-291,82
-1,1495,1391,104,-2,-38,52
-1,1667,1483,184,-3,-293,88
1,1704,1601,103,-2,-84,79
-1,1524,1557,-33,-4,-527,106
1,1461,1608,-147,0,14,45
-1,1418,1389,29,-12,-385,86
-1,1869,1754,115,0,-229,82
1,1457,1540,-83,4,96,63
1,1747,1449,298,1,60,71
1,1739,1602,137,4,233,77
-1,1533,1567,-34,-3,-33,42
1,2103,1613,490,1,114,65
-1,1665,1486,179,0,-45,70
1,1500,1306,194,-2,-54,47
-1,1631,1750,-119,0,-1,50
-1,1457,1572,-115,-6,-347,72
1,1304,1283,21,-1,541,81
1,1664,1751,-87,0,49,91
1,1758,1624,134,1,219,77
-1,1580,1541,39,2,228,70
1,1485,1573,-88,2,280,107
-1,1104,1654,-550,0,-77,64
1,1906,1623,283,3,231,73
1,1768,1818,-50,0,124,103
1,1515,1620,-105,0,434,79
-1,1617,1765,-148,-6,-121,56
-1,2013,1760,253,0,-16,122
-1,2024,2026,-2,0,5,64
1,1900,1619,281,0,55,155
-1,1644,1799,-155,0,1,68
1,1590,1524,66,2,39,81
-1,1554,1437,117,4,20,40
-1,1595,1475,120,-2,-383,142
1,1589,1468,121,1,194,93
1,1772,1610,162,1,239,65
-1,1406,1445,-39,-1,-80,104
-1,1299,1379,-80,0,-237,74
-1,1647,1778,-131,-3,223,86
1,1570,1530,40,-8,-329,79
1,1780,1604,176,3,177,79
-1,1481,1408,73,0,66,140
-1,1554,1567,-13,-4,-371,74
-1,1746,1864,-118,-6,-68,66
-1,1619,1909,-290,-2,-61,44
1,1603,1515,88,3,343,91
-1,1501,1329,172,-1,-212,74
1,1588,1810,-222,-2,56,65
1,1799,1640,159,0,70,73
-1,1605,1529,76,4,165,58
1,1786,1564,222,-1,-9,41
-1,1996,1777,219,1,93,92
1,1377,1500,-123,0,164,101
-1,1563,1839,-276,-1,-26,50
1,1539,1103,436,-2,-91,55
-1,1618,2036,-418,-1,-182,70
-1,1491,1236,255,0,-54,50
1,1839,1528,311,2,238,105
1,1791,1557,234,1,7,47
-1,1454,1291,163,0,-76,80
-1,1507,1585,-78,-6,-183,51
0,1823,1645,178,0,-547,117
1,1724,1497,227,0,-6,73
0,1637,1654,-17,0,10,96
-1,1316,1719,-403,-2,-23,54
1,1905,1615,290,0,263,151
-1,1532,1528,4,-1,-61,82
0,1750,1604,146,-4,-70,54
1,1276,1405,-129,2,516,107
-1,1552,1796,-244,-5,-45,48
-1,1650,1810,-160,-1,-80,94
-1,1979,1794,185,-9,-116,84
1,1671,1766,-95,-5,-60,49
-1,1801,1546,255,-3,-52,70
1,1476,1468,8,-2,158,65
1,1499,1502,-3,3,54,51
-1,1644,1826,-182,-2,-49,50
1,1534,1479,55,2,301,131
1,1598,1746,-148,-1,183,96
-1,1604,1500,104,0,-99,100
-1,1638,1839,-201,-3,-231,90
1,1568,1782,-214,-1,417,85
1,1731,1622,109,1,226,75
1,1516,1527,-11,12,498,61
1,1730,1500,230,17,548,57
1,1721,1653,68,0,387,139
1,1748,1774,-26,-1,93,69
0,1541,1365,176,4,-356,161
1,1488,1396,92,9,519,83
1,1567,1621,-54,-6,-128,57
-1,1500,1724,-224,-2,-39,42
-1,1401,1241,160,-3,-30,44
1,1313,1144,169,1,56,41
-1,1601,1643,-42,2,21,44
1,1851,1633,218,1,29,83
1,1765,1628,137,3,187,55
-1,1611,1910,-299,-2,-143,124
1,1862,1487,375,0,10,59
-1,1313,1579,-266,-3,-274,92
-1,1524,1437,87,-3,-771,102
1,1484,1867,-383,0,17,45
1,1390,1447,-57,0,41,65
1,1605,1335,270,2,422,123
1,2047,1612,435,2,91,53
1,1086,1447,-361,-1,-20,41
1,1636,1687,-51,0,112,61
-1,1447,1552,-105,0,47,50
1,1621,1772,-151,0,563,121
1,1826,1506,320,-1,-21,59
1,1640,1412,228,2,302,67
-1,1414,1686,-272,-1,-207,82
1,1385,1483,-98,9,557,67
1,2112,1948,164,0,-30,89
-1,1751,1810,-59,6,147,48
-1,1481,1317,164,-1,71,84
-1,1447,1732,-285,-3,-71,48
-1,1496,1730,-234,0,-63,113
-1,1388,1421,-33,0,-4,62
1,1832,1582,250,0,5,97
1,1810,1761,49,3,136,61
1,1914,1251,663,1,45,49
-1,1293,1844,-551,-7,-229,56
-1,1387,1324,63,0,-251,82
1,1560,1435,125,-4,-146,53
1,1613,1870,-257,0,-13,91
-1,1728,1607,121,0,-274,138
1,1859,2038,-179,0,3,63
-1,1756,1636,120,-4,-109,52
1,1709,1819,-110,-2,-40,49
-1,1630,1730,-100,0,-287,80
-1,2020,1875,145,1,22,66
1,1674,1676,-2,0,46,67
-1,1963,2038,-75,2,20,48
-1,1187,1254,-67,-3,-288,94
-1,1737,1424,313,0,-165,86
-1,1651,1741,-90,0,15,56
-1,1591,1785,-194,1,37,48
1,1841,1640,201,6,445,61
1,1960,1575,385,0,63,71
1,1805,1767,38,4,57,43
1,2119,1646,473,0,321,135
-1,1762,1631,131,-2,-73,50
1,1749,1643,106,2,381,83
1,1726,1616,110,5,361,93
-1,1424,1567,-143,-1,-9,48
1,1570,1635,-65,3,211,65
-1,1389,1218,171,-15,-171,42
-1,1735,1491,244,0,-484,108
-1,1732,1815,-83,1,0,64
1,1369,1388,-19,7,107,49
1,1572,1963,-391,-1,-108,95
-1,1247,1369,-122,-4,-91,52
-1,1481,1441,40,-1,-206,114
-1,1492,1444,48,1,12,86
-1,1622,1584,38,-2,-99,76
-1,1635,1757,-122,-2,-57,52
1,1695,1442,253,-1,147,67
-1,1795,1737,58,-1,-154,78
1,1644,1619,25,1,21,51
-1,1796,1792,4,-3,-86,110
-1,1636,1843,-207,1,-76,92
-1,1486,1382,104,-1,-568,142
1,1487,1500,-13,-1,-31,57
1,1853,1632,221,0,95,93
-1,1897,1938,-41,0,-70,62
1,1765,1627,138,1,38,81
1,1574,1414,160,2,19,53
-1,1622,1597,25,1,167,70
-1,1692,1410,282,-4,-145,74
-1,1292,1517,-225,-1,81,114
-1,1377,1503,-126,0,-20,44
1,1639,1767,-128,0,93,83
1,1628,2121,-493,0,67,109
-1,1503,1564,-61,-1,-172,62
1,1950,1887,63,0,113,71
0,1621,1772,-151,-2,-63,100
1,1472,1327,145,-2,207,81
-1,1500,1259,241,-3,-357,136
-1,1500,1685,-185,0,-97,52
-1,1252,1373,-121,-13,-877,74
-1,1180,1197,-17,-1,-32,58
1,1387,1500,-113,2,67,41
1,1879,1961,-82,-4,-122,63
1,1530,1715,-185,11,267,55
-1,1813,1804,9,-2,-98,64
-1,1622,1435,187,-2,-293,140
-1,1426,1734,-308,5,63,94
1,1405,1580,-175,0,407,107
1,1945,1630,315,0,3,67
1,1737,1596,141,1,38,53
1,1618,1774,-156,-1,43,77
1,1742,1374,368,0,31,49
-1,1610,1658,-48,0,-84,60
-1,1369,1601,-232,-10,-244,52
-1,1758,1634,124,-3,-69,58
-1,1386,1562,-176,-1,-25,46
1,1429,1665,-236,0,61,79
1,1735,1545,190,2,185,109
1,1474,1382,92,1,419,125
1,1457,1403,54,-1,311,123
-1,1627,1858,-231,0,-11,102
-1,1532,1690,-158,-1,-99,72
1,1481,1387,94,4,122,69
-1,1397,1378,19,-1,-146,64
-1,1649,1743,-94,-2,-36,48
-1,1668,1746,-78,0,-12,50
1,1949,1248,701,0,56,57
-1,1752,1640,112,-10,-161,72
1,1479,1579,-100,3,128,67
1,1568,1380,188,0,205,145
1,1370,1332,38,-1,73,57
-1,1509,1744,-235,0,-146,68
1,1713,1745,-32,0,80,57
-1,1449,1550,-101,0,-215,120
1,1358,1422,-64,0,20,43
1,1505,1286,219,0,184,74
1,1705,1500,205,3,197,57
-1,1641,1653,-12,0,22,90
-1,1540,1742,-202,3,9,54
1,1839,1823,16,-3,16,56
1,1525,1395,130,0,371,117
-1,1482,1381,101,5,104,68
1,1409,1373,36,9,397,95
-1,1422,1801,-379,-5,-74,40
-1,1393,1466,-73,-4,-171,70
1,1438,1285,153,0,99,65
1,1392,1263,129,12,865,73
1,1733,1725,8,1,268,85
1,1710,1754,-44,-4,-121,75
1,1564,1741,-177,-2,-160,95
1,1497,1371,126,-3,-104,75
-1,1863,1622,241,-3,-115,70
1,1654,1746,-92,-4,-20,89
-1,1542,1525,17,1,21,102
-1,1359,1421,-62,1,12,58
1,1494,1500,-6,1,86,67
-1,1723,1742,-19,-7,-304,58
1,1580,1374,206,12,512,69
-1,1527,1786,-259,-3,-72,50
0,1428,1533,-105,-1,-194,116
-1,1728,1734,-6,-9,-130,46
1,1949,1752,197,-2,-69,69
-1,1749,1416,333,2,19,58
1,1712,1452,260,-1,-115,63
-1,1527,1279,248,-5,52,40
1,1779,1585,194,1,75,97
-1,1641,1845,-204,-9,-126,58
-1,1200,1403,-203,0,-6,52
-1,1445,1523,-78,4,54,58
1,1853,1790,63,7,93,43
1,1425,1248,177,19,466,53
-1,1471,1898,-427,-6,-424,80
1,1714,1744,-30,-2,-223,107
1,1416,1581,-165,1,226,95
0,1516,1679,-163,-6,-429,88
1,1501,1321,180,9,114,43
-1,1430,1468,-38,-6,-600,74
-1,1588,1813,-225,0,-1,52
-1,1866,1872,-6,0,18,62
-1,1529,1781,-252,0,25,90
1,1749,1325,424,0,28,51
-1,1510,1357,153,6,84,40
-1,1254,1149,105,4,291,122
-1,1275,1574,-299,-2,-76,60
-1,1369,1549,-180,-2,-83,52
1,1710,1549,161,0,487,145
-1,1350,1674,-324,-1,-54,62
1,1956,1747,209,0,46,69
-1,1507,1431,76,0,-285,94
1,1500,1531,-31,1,74,65
-1,1242,1431,-189,-1,-353,124
-1,1850,1635,215,0,-18,136
1,1717,1673,44,0,0,65
1,1727,1496,231,9,395,87
-1,1544,1785,-241,0,4,48
-1,1251,1346,-95,0,-290,80
1,1724,1580,144,-2,-107,91
-1,1431,1500,-69,-1,-78,80
1,1962,1502,460,2,677,127
1,1732,1816,-84,2,201,75
-1,1433,1564,-131,1,52,77
1,1544,1391,153,-2,20,60
1,1744,1578,166,5,319,85
1,1437,1235,202,-6,-64,51
1,1790,1804,-14,-5,-11,47
-1,1383,1436,-53,3,50,65
1,1200,0,1200,5,24,41
-1,1554,1755,-201,-5,-911,104
-1,1543,1853,-310,0,-223,84
-1,1609,1935,-326,-2,-60,54
-1,1817,1707,110,-4,-58,50
1,1848,1515,333,4,74,45
1,1451,1319,132,0,-98,67
1,1402,1241,161,0,48,83
-1,1653,1833,-180,-2,-36,60
-1,1477,1445,32,-3,-44,44
1,1456,1437,19,-4,-277,107
1,1938,1606,332,0,82,67
-1,1793,1801,-8,1,-14,80
-1,1493,1523,-30,-3,-7,50
1,1407,1247,160,0,-37,61
-1,1179,1186,-7,-4,-149,54
-1,1510,1500,10,3,0,46
-1,1542,1683,-141,-3,-250,70
1,1540,1858,-318,-1,-22,79
-1,1802,1745,57,1,-23,118
1,1513,1337,176,6,170,49
0,1432,1409,23,6,174,155
-1,1426,1468,-42,-8,-492,71
-1,1747,1578,169,-3,-48,64
0,1839,1647,192,0,-203,151
1,1554,1436,118,4,112,49
1,1697,1550,147,7,492,65
1,1457,1465,-8,-1,-6,51
-1,1751,1663,88,-5,-364,68
-1,1727,1852,-125,0,24,86
1,1479,1416,63,0,51,60
-1,1771,1645,126,-2,-779,120
1,1964,1465,499,1,33,55
1,1453,1331,122,4,89,51
-1,1229,1238,-9,-10,-633,126
-1,1500,1733,-233,-1,-534,114
-1,1232,1157,75,0,-15,86
-1,1522,1804,-282,-4,-150,50
1,1532,1549,-17,-3,-287,89
1,1737,1501,236,3,369,77
-1,1507,1366,141,-6,-164,64
-1,1680,1557,123,-3,-38,48
-1,1499,1500,-1,3,-92,88
-1,1702,1731,-29,-2,-95,46
1,1746,1490,256,2,168,67
-1,1485,1678,-193,0,-59,62
-1,1523,1812,-289,0,-237,146
-1,1475,1809,-334,-5,-40,46
0,1613,1629,-16,0,-114,127
-1,1485,1692,-207,-3,-46,52
1,1428,1539,-111,4,116,41
1,1538,1548,-10,-2,-243,109
1,1758,1430,328,0,57,79
1,1697,1479,218,4,80,53
1,1812,1472,340,2,362,89
-1,1297,1250,47,-7,-121,44
-1,1300,1406,-106,-1,-122,60
1,1323,1460,-137,0,-9,63
1,1653,1834,-181,0,76,115
-1,1751,1545,206,5,263,66
-1,1519,1578,-59,-1,83,98
-1,1473,1703,-230,-7,-390,90
1,1512,1224,288,-1,182,71
-1,1473,1064,409,1,54,42
-1,1516,1465,51,-4,-436,82
-1,1562,1733,-171,-5,-210,66
1,1742,1706,36,3,60,113
1,1367,1410,-43,1,83,95
1,1733,1562,171,6,695,139
-1,1347,1597,-250,-2,-149,76
-1,1507,1623,-116,0,-385,96
1,1966,1468,498,0,48,54
0,1499,1607,-108,0,41,77
-1,1455,1426,29,-4,-164,68
-1,1704,1798,-94,0,-8,94
1,1549,1458,91,0,376,127
1,1510,1534,-24,0,23,77
-1,1568,1589,-21,-1,-31,118
-1,1375,1660,-285,1,-3,50
1,1445,1339,106,3,325,93
-1,1396,1404,-8,-2,-828,90
-1,1439,1634,-195,0,-30,94
1,1761,1617,144,0,9,57
-1,1500,1357,143,2,-176,96
-1,1909,1877,32,0,5,51
1,1803,1659,144,0,-5,77
-1,1416,1569,-153,-10,-576,68
1,1577,1190,387,1,441,101
1,1662,1481,181,1,27,47
-1,1595,1610,-15,-2,-167,56
1,1755,1556,199,2,477,125
-1,1652,1804,-152,-5,-18,60
1,1321,1591,-270,0,512,101
-1,1522,1613,-91,-4,-75,48
1,1924,1854,70,1,198,126
-1,1761,1891,-130,-1,-488,100
1,1398,1401,-3,0,-2,97
1,1432,1397,35,0,237,107
1,1898,1754,144,2,55,48
-1,1900,1806,94,-2,-13,44
-1,1671,1768,-97,-1,-44,56
1,1499,1414,85,0,-29,55
1,1747,1905,-158,-3,-62,59
-1,1584,1514,70,-4,-28,42
1,1557,1738,-181,1,-37,79
-1,1166,1331,-165,0,-92,78
1,1347,1621,-274,-1,-68,71
1,1890,1763,127,-6,-288,83
-1,1433,1512,-79,-1,-12,46
1,1576,1408,168,-4,13,43
1,1619,1711,-92,-3,-123,55
1,1374,1410,-36,2,256,105
1,1811,1235,576,0,18,45
1,1387,1340,47,-7,-122,41
-1,1755,1897,-142,4,255,78
-1,1646,1810,-164,-1,-58,76
-1,1146,1393,-247,7,-148,90
1,1522,1577,-55,0,18,67
1,1903,1748,155,5,284,97
-1,1742,1910,-168,2,-17,50
-1,1720,1500,220,0,-18,96
0,1639,1812,-173,-1,33,108
-1,1967,1825,142,0,264,106
1,1424,1377,47,2,314,111
1,1731,1504,227,0,-31,59
-1,1110,1337,-227,-1,2,40
1,1551,1582,-31,-3,72,101
1,1615,1521,94,-3,-291,83
-1,1441,1345,96,-3,-223,78
-1,1948,1806,142,-1,30,42
1,1402,1297,105,2,41,47
-1,1342,1073,269,-9,-525,82
1,1364,1317,47,11,405,67
-1,1728,1763,-35,-3,-291,90
1,1516,1448,68,3,170,59
1,1714,1599,115,3,53,45
1,1929,1489,440,8,389,85
-1,1637,1696,-59,-2,-341,110
1,1408,1428,-20,7,403,87
-1,1834,1949,-115,1,-46,59
-1,1931,1727,204,0,-91,98
-1,1744,1910,-166,-1,3,40
1,1709,1819,-110,0,12,75
1,1910,1744,166,-2,-30,73
1,1718,1635,83,-6,-76,45
1,1749,1432,317,3,169,55
-1,1473,1533,-60,-8,-89,52
-1,1738,1918,-180,-7,-556,94
1,1281,1565,-284,-1,-47,71
1,1610,1627,-17,0,-42,77
-1,1517,1379,138,-12,-211,66
1,1500,1744,-244,5,147,52
1,1373,1214,159,2,424,77
-1,1925,1712,213,0,-52,60
-1,1514,1663,-149,-3,-179,108
1,1994,2127,-133,0,242,121
-1,1712,1537,175,-4,-327,78
-1,1731,1761,-30,-9,-342,86
1,1571,1615,-44,0,23,91
1,1843,1693,150,1,63,65
-1,1569,1330,239,0,-11,42
-1,2106,2029,77,0,13,75
-1,1478,1542,-64,1,-252,80
0,1334,1160,174,0,425,180
1,1904,1722,182,0,12,55
1,1396,1498,-102,-2,-18,59
-1,1301,1187,114,-4,-198,70
1,1618,1451,167,6,77,43
-1,1508,1306,202,-7,-505,136
-1,1473,1800,-327,-2,-85,56
1,1716,1413,303,4,119,54
1,1798,1667,131,-4,-58,63
-1,1405,1288,117,0,-114,72
1,1645,1339,306,3,65,53
1,1735,1719,16,1,401,119
-1,1379,1442,-63,-2,-19,44
1,1911,1717,194,9,852,85
-1,1551,1804,-253,-3,-312,78
-1,1708,1746,-38,3,-387,110
1,1575,1397,178,4,149,73
-1,1803,1876,-73,-3,-397,116
1,1874,1787,87,3,968,111
1,1767,1514,253,7,308,63
1,1623,1651,-28,0,103,107
-1,1798,1961,-163,-1,-58,76
-1,1389,1581,-192,-1,-79,78
1,1348,1616,-268,-1,6,57
1,2122,1799,323,0,-137,97
1,1776,1253,523,4,175,55
1,1886,1789,97,-1,-60,85
1,1385,1440,-55,0,35,115
-1,1792,1738,54,0,-58,56
-1,1497,1587,-90,-1,-28,52
-1,1431,1310,121,0,187,122
1,1863,1932,-69,-1,117,85
1,1407,1245,162,-4,-101,51
-1,1595,1488,107,-8,-269,76
-1,1895,1777,118,0,64,70
1,1768,1763,5,1,15,41
-1,1919,1877,42,0,51,58
1,1482,1442,40,0,501,123
1,2126,1974,152,1,224,93
-1,1484,1249,235,2,-245,98
1,1388,1638,-250,-1,-39,51
1,1891,1908,-17,0,-4,47
-1,1438,1594,-156,-1,-255,112
1,1779,1618,161,0,66,73
1,1801,1834,-33,6,233,63
1,1897,1903,-6,3,359,87
1,1368,1336,32,6,183,64
1,1772,1756,16,0,276,143
1,1799,1879,-80,-1,-65,81
-1,1785,1696,89,0,-21,70
1,1891,1908,-17,0,-122,87
-1,1304,1346,-42,-2,-409,69
-1,1891,1908,-17,9,428,74
1,1432,1492,-60,0,215,89
-1,1771,1779,-8,-9,-260,64
1,1326,1390,-64,9,630,65
0,1897,1903,-6,-1,-153,135
0,1865,1818,47,0,-121,172
1,1398,1669,-271,8,217,51
0,1761,1789,-28,2,223,157
1,1903,1897,6,-1,-427,131
-1,1272,1500,-228,-5,-380,69
1,1932,1488,444,0,56,75
-1,1897,1903,-6,-3,-150,78
1,1681,1844,-163,1,62,69
-1,1477,1297,180,-9,-532,68
-1,1914,1887,27,2,154,106
-1,1788,1762,26,-2,-65,78
1,1619,1022,597,7,243,57
1,2134,1942,192,0,-209,107
-1,1820,1863,-43,-2,-64,64
1,1902,1898,4,1,1,43
-1,1293,1356,-63,-4,-186,64
1,1888,1891,-3,5,80,47
1,1773,1611,162,-5,-122,55
0,1808,1697,111,-2,-137,72
-1,1880,1898,-18,0,5,50
-1,1873,1807,66,4,56,82
1,1590,1267,323,4,37,43
1,1898,1880,18,0,179,93
1,1392,1312,80,7,343,65
0,1869,1908,-39,1,514,144
1,1779,1745,34,1,139,113
1,1994,1632,362,0,198,103
-1,1700,1801,-101,1,21,44
-1,1617,1437,180,-10,-526,70
-1,1424,1624,-200,-1,-557,112
1,1735,1789,-54,1,28,81
-1,1206,1303,-97,2,-181,150
-1,1777,1748,29,-1,-77,50
1,1539,1642,-103,0,22,73
1,1517,1558,-41,0,115,121
-1,1760,1765,-5,0,-7,54
-1,1279,1416,-137,-1,-121,84
1,1778,1848,-70,-6,32,43
-1,2121,1995,126,1,-60,90
-1,1327,1503,-176,-12,-253,52
1,1539,1714,-175,0,135,97
-1,1776,1749,27,-3,-183,74
-1,1557,1628,-71,1,-82,84
-1,1195,1311,-116,-5,-139,44
1,1740,1789,-49,1,36,49
1,1637,1548,89,8,739,89
-1,1308,1483,-175,-2,-6,92
-1,1453,1600,-147,-1,-457,84
-1,1773,1969,-196,-3,-168,72
1,1539,1645,-106,-1,32,79
1,2103,1699,404,-5,-9,47
-1,1539,1645,-106,-3,-905,164
-1,1185,1337,-152,3,104,78
-1,1277,1470,-193,1,-32,44
-1,1574,1817,-243,0,-45,92
1,1653,1531,122,2,286,81
-1,1509,1259,250,-1,70,58
-1,1271,1546,-275,0,-43,96
-1,1531,1653,-122,-8,-307,70
1,1820,1761,59,-7,-258,71
1,1523,1660,-137,-4,128,91
1,1645,1698,-53,-1,37,49
1,1764,1761,3,1,15,109
-1,1344,1176,168,-17,-284,42
1,1997,1769,228,-4,-7,47
-1,1630,1697,-67,0,-125,68
-1,1539,1645,-106,0,-17,86
1,1826,1570,256,1,209,107
-1,1687,1690,-3,-2,-113,62
1,1323,1437,-114,1,88,83
-1,1752,1775,-23,0,-15,58
1,1197,1327,-130,5,164,61
-1,1785,1742,43,-3,-58,46
1,1431,1437,-6,3,39,49
0,1705,1621,84,0,-31,126
-1,1216,1311,-95,-6,-105,48
-1,1312,1258,54,1,7,42
1,1868,1565,303,2,180,63
1,1822,1778,44,1,20,65
-1,1442,1401,41,0,-70,64
-1,1741,1959,-218,0,-86,88
1,1205,1320,-115,-3,113,81
1,1320,1580,-260,0,35,119
-1,1877,1703,174,0,-93,74
-1,2082,1891,191,-2,-104,58
0,1271,1291,-20,1,159,63
1,1546,1758,-212,-7,-68,41
-1,1435,1574,-139,-2,-203,78
1,1772,1754,18,3,14,55
-1,1726,1677,49,1,-10,62
-1,1685,1968,-283,-1,-36,88
-1,1125,1476,-351,-6,-107,44
-1,1695,1737,-42,-15,-102,42
1,1773,1770,3,0,-28,104
-1,1562,1773,-211,-2,-50,80
-1,1653,1531,122,0,-104,76
-1,1710,1778,-68,0,14,50
-1,1575,1825,-250,-5,-9,42
1,1744,1782,-38,6,178,45
1,1770,1756,14,0,6,53
1,1825,1575,250,-1,-12,43
-1,1740,1576,164,4,50,42
0,1667,1796,-129,0,91,117
-1,1474,1697,-223,3,-89,132
1,2063,1908,155,0,35,55
1,1748,1747,1,0,102,75
-1,1337,1662,-325,-3,-114,52
-1,1255,1304,-49,2,284,90
-1,1682,1623,59,0,-295,108
-1,1381,1745,-364,-19,-320,42
-1,1500,1965,-465,0,-84,101
-1,1387,1599,-212,0,-162,74
-1,1479,1563,-84,-2,-17,72
1,1290,1272,18,6,608,129
-1,1674,1593,81,-3,-428,114
1,1314,1244,70,5,157,45
-1,1381,1604,-223,-13,-603,60
1,1609,1375,234,4,103,45
1,1901,2085,-184,-1,-25,71
-1,1669,1958,-289,-2,-46,74
1,1736,1760,-24,2,37,47
-1,1919,1792,127,1,26,62
-1,1345,1680,-335,-4,-84,46
-1,1731,1639,92,2,32,50
-1,1249,1309,-60,-13,-59,40
1,1544,1480,64,5,112,59
-1,1627,1718,-91,-2,-7,50
0,1319,1239,80,-1,-227,152
-1,1655,1666,-11,0,-398,166
-1,1726,1619,107,4,243,74
1,1841,1413,428,-3,-29,59
0,2225,1870,355,1,262,152
-1,1369,1625,-256,-7,-163,44
-1,1619,1726,-107,-3,-97,58
0,1317,1227,90,5,234,67
-1,1741,1625,116,4,174,84
1,1412,1843,-431,0,39,67
-1,1633,1734,-101,0,-16,52
1,1592,1446,146,4,150,61
-1,1623,1743,-120,1,10,48
1,1968,1910,58,0,7,67
1,1655,1382,273,23,608,49
1,1643,1501,142,-1,1,53
-1,1621,1887,-266,1,105,60
1,1962,1676,286,-1,13,61
-1,1750,1616,134,-3,-106,68
1,1433,1500,-67,14,184,43
-1,1629,1879,-250,-5,23,52
-1,1433,1822,-389,0,-14,68
1,1895,1856,39,4,160,45
1,1604,1500,104,29,598,45
-1,1076,1426,-350,2,-46,59
-1,1189,1178,11,-15,-424,92
1,1846,1905,-59,-1,57,67
-1,1564,1574,-10,-2,16,96
1,1824,1430,394,4,76,45
1,1891,1617,274,1,38,65
-1,1701,1488,213,-1,-122,124
-1,1452,1793,-341,-1,-54,60
1,1631,1736,-105,0,-54,57
1,1722,1645,77,1,191,87
-1,1530,1439,91,4,106,54
-1,1330,1664,-334,-8,-440,72
1,1892,1859,33,-4,-45,93
1,1566,1473,93,0,50,57
1,1350,1108,242,12,484,55
-1,1636,1730,-94,-6,-128,52
-1,1651,1588,63,1,28,70
1,1730,1636,94,-1,-4,47
-1,1849,1902,-53,0,-2,62
-1,1673,1850,-177,0,-12,82
1,1615,1428,187,-1,-97,69
-1,1202,1161,41,1,73,72
-1,1912,1839,73,0,4,76
-1,1738,1972,-234,1,-26,64
-1,1548,1463,85,1,33,60
1,1977,1734,243,0,-228,79
1,1834,1596,238,0,-63,40
1,1899,1628,271,0,4,57
1,1903,1737,166,0,-15,77
1,1588,1688,-100,1,7,41
-1,1983,1601,382,-6,-211,68
-1,1624,1903,-279,0,-324,108
1,1505,1306,199,2,378,171
-1,1910,1982,-72,-1,-142,76
-1,1189,1177,12,0,-419,86
1,1587,1516,71,-2,-5,49
-1,1731,1667,64,1,28,70
-1,1780,1729,51,-1,-49,58
-1,2067,1893,174,0,-12,58
-1,1477,1617,-140,2,49,72
1,1901,1787,114,14,249,49
1,1909,1967,-58,0,84,73
1,1065,1392,-327,1,509,103
1,1601,1355,246,2,120,57
-1,1165,1018,147,-13,-417,56
-1,1774,1909,-135,3,169,74
-1,1948,2050,-102,-4,-21,44
-1,1909,1774,135,-1,69,60
-1,1339,1588,-249,-3,-177,114
-1,1688,1677,11,-2,-7,82
-1,2058,1908,150,-1,-190,146
1,1445,1671,-226,-5,915,131
-1,1800,1916,-116,0,-209,76
1,1469,1430,39,-1,14,79
-1,1621,1367,254,-2,-21,48
1,1583,1665,-82,0,121,135
1,1769,1859,-90,0,18,55
-1,1924,1787,137,0,-13,76
-1,1570,1283,287,-2,-33,44
1,1715,1746,-31,0,-14,59
-1,1787,1924,-137,-2,-34,82
-1,1373,1463,-90,-3,-64,90
1,1718,1422,296,-6,-78,103
1,1555,1500,55,4,527,115
-1,1483,1487,-4,-6,-767,106
-1,1865,1928,-63,0,14,56
-1,1675,1507,168,-4,-179,64
-1,1364,1485,-121,2,308,74
-1,926,1127,-201,-8,-432,78
1,1852,1686,166,7,187,57
1,1816,1849,-33,-1,76,65
1,1649,1721,-72,0,-25,75
-1,1518,1649,-131,1,19,50
0,1474,1499,-25,6,684,99
1,1504,1357,147,3,186,71
-1,1531,1665,-134,0,-98,74
1,1500,1821,-321,1,48,63
-1,1777,1538,239,-1,-13,86
-1,1746,1853,-107,0,147,170
1,1991,1776,215,-3,30,59
-1,1265,1597,-332,0,-120,70
0,2042,1924,118,0,-93,127
1,1502,1427,75,0,504,87
1,1973,1803,170,7,105,51
-1,1684,1523,161,1,35,46
1,1938,1963,-25,0,-14,83
1,1649,1520,129,-1,61,67
-1,1680,1861,-181,-1,-25,44
1,1106,1350,-244,-1,-31,59
1,1869,1629,240,2,150,85
-1,1400,1264,136,-1,-87,52
-1,1738,1860,-122,-8,-29,40
-1,1592,1473,119,5,162,51
1,1805,1902,-97,0,2,53
-1,1873,1814,59,-2,-125,64
-1,1555,1756,-201,-2,-55,60
-1,1367,1508,-141,-4,-242,62
1,1672,1725,-53,1,16,45
1,1660,1385,275,-5,333,113
0,1690,1613,77,1,-5,146
1,1468,1402,66,0,43,63
-1,1500,1572,-72,-1,-54,80
1,1332,1144,188,-5,19,119
1,1868,1860,8,-1,-54,85
-1,1580,1562,18,-10,-442,76
0,1488,1577,-89,-11,-539,99
-1,1578,1663,-85,-1,-189,146
-1,1879,1849,30,-3,-76,56
1,1713,1680,33,0,-2,59
-1,1861,1867,-6,0,8,86
1,1870,1927,-57,-1,46,63
1,1476,1296,180,0,37,63
1,1762,1550,212,2,-1,63
1,1685,1708,-23,0,-32,69
1,1370,1417,-47,-3,-82,45
1,1357,1505,-148,14,639,61
-1,1483,1500,-17,-1,-84,62
-1,1850,1625,225,0,-193,105
0,1393,1383,10,-4,-246,64
1,1474,1291,183,-10,-499,69
1,1915,1888,27,-2,-240,93
0,1529,1479,50,1,815,99
1,1526,1360,166,-1,217,79
-1,1833,1642,191,1,-97,58
-1,1670,1722,-52,-1,-69,72
-1,1301,1622,-321,-3,-546,100
1,1578,1544,34,1,218,95
-1,1601,1950,-349,2,15,58
1,1481,1383,98,3,29,47
1,1487,1245,242,3,218,77
1,1562,1500,62,19,286,43
-1,1950,1831,119,1,86,84
1,1516,1138,378,4,436,83
-1,1570,2213,-643,-4,-128,58
-1,1616,1569,47,-1,-208,112
1,1375,1281,94,-3,-106,95
1,1491,1557,-66,-3,-104,59
-1,1569,1831,-262,-1,-249,112
-1,1722,1659,63,-3,-175,80
1,1673,1709,-36,0,27,65
0,1564,1271,293,-4,325,105
1,1378,1495,-117,1,22,51
-1,1471,1838,-367,-1,-311,120
1,1696,1500,196,-4,56,81
-1,1550,1874,-324,-1,-58,66
-1,1697,1878,-181,0,4,76
-1,1426,1542,-116,-1,-92,60
1,1841,1458,383,2,146,79
-1,1479,1505,-26,-3,-123,64
0,1929,1618,311,-1,247,107
-1,1586,1418,168,4,200,74
-1,1553,1476,77,7,82,51
-1,1446,1844,-398,-1,-549,116
1,1686,1301,385,1,70,47
1,1556,1397,159,1,134,67
-1,1884,1980,-96,0,-63,94
1,1516,1588,-72,0,141,99
-1,1422,1384,38,-3,-61,52
-1,1311,1603,-292,-2,-24,44
-1,1563,1702,-139,-6,-256,74
1,1878,1547,331,3,11,45
1,1409,1574,-165,3,80,53
1,1875,1674,201,0,42,81
-1,1545,1701,-156,1,-86,74
-1,1042,1455,-413,-1,-31,92
1,1772,1456,316,-3,34,73
-1,1709,1989,-280,0,19,72
1,1613,1881,-268,-4,-85,45
-1,1575,1569,6,0,93,162
-1,1489,1540,-51,-7,-448,92
-1,1607,1770,-163,0,2,48
1,1555,1669,-114,-1,123,83
1,1689,1435,254,2,67,51
-1,1602,1538,64,-4,-171,60
-1,1626,1867,-241,2,92,102
1,1571,1500,71,4,155,91
1,1867,1626,241,-2,-6,53
-1,1775,1670,105,1,-4,46
-1,1622,1872,-250,1,32,72
1,1244,1390,-146,-2,0,91
-1,1705,1654,51,-1,-25,96
1,1579,1622,-43,-1,60,113
0,1476,1474,2,0,287,177
1,1694,1598,96,10,145,47
-1,1454,1511,-57,-3,-52,48
-1,1420,1481,-61,0,-41,64
-1,1687,1600,87,-3,-358,88
-1,1285,1418,-133,4,124,54
1,1539,1501,38,0,24,51
1,1768,1766,2,-1,-65,55
1,1500,1293,207,4,131,43
-1,1690,1760,-70,-3,125,90
-1,1636,1582,54,-3,-559,152
1,1739,1581,158,3,85,81
-1,1609,1667,-58,-5,-40,50
-1,1373,1264,109,1,-258,76
-1,1349,1393,-44,1,-8,42
1,1409,1500,-91,4,47,43
1,1676,1599,77,-1,-15,51
1,1598,1337,261,17,1245,81
1,1549,1499,50,-9,-13,65
-1,1282,1358,-76,1,2,96
-1,1935,1770,165,2,32,60
1,1822,1702,120,-8,-199,100
1,1613,1545,68,1,16,49
-1,1512,1500,12,-4,-150,56
1,1549,1560,-11,-1,-43,69
-1,1745,1797,-52,-2,-468,162
1,1273,1153,120,2,156,57
-1,1708,1567,141,-13,-186,50
-1,1489,1558,-69,-7,-333,62
-1,1367,1271,96,0,-1,54
1,1431,1394,37,-2,-36,43
1,1536,1622,-86,-4,-26,47
1,1714,1582,132,5,136,57
1,1919,1786,133,1,158,93
-1,1382,1622,-240,-1,-45,44
1,1678,1674,4,0,66,69
-1,1614,1594,20,-1,-20,54
-1,1575,1721,-146,-4,-170,56
1,1648,1462,186,7,82,43
1,1721,1575,146,3,-1,63
1,1567,1480,87,0,-112,98
0,1504,1383,121,1,49,64
-1,1728,1568,160,-3,-358,88
1,1682,1500,182,4,167,53
-1,1535,1560,-25,-10,-451,62
1,1442,1352,90,2,133,87
1,1662,1474,188,1,33,45
-1,1500,1386,114,-2,-18,68
-1,1396,1687,-291,-13,-303,44
1,1480,1540,-60,0,23,59
-1,1821,1845,-24,-1,-38,70
1,1576,1402,174,0,61,59
1,1553,1500,53,4,97,55
1,1684,1475,209,1,73,59
-1,1663,1693,-30,0,-58,102
-1,1350,1513,-163,0,-9,42
1,1694,1652,42,-1,63,109
-1,1601,1734,-133,-5,0,62
-1,1551,1325,226,2,-213,116
1,1806,1431,375,11,304,53
1,1396,1582,-186,4,398,81
1,1479,1564,-85,-2,85,109
-1,1152,1830,-678,-3,-117,62
1,1340,1353,-13,0,295,95
1,1692,1593,99,0,-13,63
-1,1454,1682,-228,-3,-217,72
-1,1350,1537,-187,0,44,60
-1,1428,1809,-381,0,-27,84
1,1953,1772,181,1,204,105
1,1689,1470,219,-1,-44,81
-1,1668,1968,-300,-1,-100,76
1,1700,1741,-41,5,62,45
0,1570,1337,233,-5,-227,128
-1,1565,1708,-143,1,29,62
-1,1297,1464,-167,-2,-513,122
1,1813,1426,387,2,574,81
-1,1713,1646,67,0,-4,50
-1,1491,1500,-9,-6,-390,126
1,1597,1456,141,-2,-53,75
1,1791,1543,248,3,479,97
-1,1266,1466,-200,-9,-527,65
-1,1694,1464,230,-4,-399,128
1,1700,1738,-38,0,106,71
1,1558,1423,135,2,223,73
1,1921,1735,186,3,129,77
-1,1766,1960,-194,1,51,96
-1,1686,1449,237,-2,-123,48
-1,1712,1726,-14,0,-82,64
1,1682,1590,92,-4,-31,63
1,1602,1729,-127,0,86,81
-1,1259,1462,-203,-6,-398,61
-1,1388,1527,-139,-3,3,40
1,1344,1564,-220,0,47,97
-1,1253,1467,-214,-6,-495,98
-1,1415,1831,-416,7,161,80
-1,1926,2038,-112,0,10,46
-1,1415,1565,-150,1,133,60
-1,1290,1526,-236,1,-101,68
-1,1676,1684,-8,-5,-119,86
1,1534,1380,154,4,123,53
-1,1467,1668,-201,-3,-138,126
-1,1646,1642,4,-4,-326,104
1,1643,1491,152,-1,75,59
-1,1247,1472,-225,-1,-36,80
0,1606,1471,135,11,1787,151
-1,1427,1520,-93,-5,-202,54
-1,1629,1761,-132,-2,-69,66
1,1418,1319,99,8,299,61
1,1483,1411,72,1,384,121
1,1664,1547,117,7,568,103
-1,1918,2046,-128,0,11,42
-1,1706,1966,-260,0,5,70
-1,1691,1729,-38,-2,-71,64
1,1697,1465,232,-1,-68,89
1,1572,1429,143,2,73,57
-1,1553,1781,-228,0,-3,54
-1,1284,1473,-189,-13,-679,86
1,1433,1241,192,8,119,40
1,1485,1650,-165,0,-10,65
-1,1314,1418,-104,-2,-56,47
1,1438,1268,170,1,193,67
-1,1500,1422,78,-11,-256,50
-1,1341,1266,75,0,-152,56
-1,1610,1611,-1,2,13,40
-1,1475,1602,-127,-3,-513,110
-1,1411,1973,-562,-7,-230,60
1,1634,1501,133,0,-23,101
1,1965,1768,197,0,7,61
-1,1235,1439,-204,1,41,44
1,1690,1971,-281,-2,245,135
-1,1500,1379,121,-10,-20,40
-1,1925,1796,129,9,49,50
-1,1172,1546,-374,-1,-338,82
1,1460,1701,-241,1,21,51
-1,1683,1762,-79,1,-46,122
1,1322,1234,88,3,19,41
-1,1695,1677,18,0,-11,52
-1,1266,1351,-85,-2,-317,104
1,1772,1218,554,7,165,49
-1,1965,2162,-197,0,2,106
1,1789,1194,595,11,499,55
1,1530,1360,170,-1,6,51
-1,1213,1774,-561,0,-442,94
1,1955,1791,164,0,46,71
1,1361,1257,104,1,110,69
-1,1481,1379,102,1,9,88
-1,1542,1353,189,0,-193,86
1,1775,1208,567,-1,-22,49
-1,1549,1640,-91,1,37,58
-1,1740,1796,-56,1,7,44
1,1415,1394,21,3,421,109
-1,1606,1717,-111,1,-88,118
-1,2008,1961,47,1,59,154
-1,1731,1959,-228,-3,-139,68
1,1248,1370,-122,4,228,47
1,1261,1030,231,36,909,49
1,1731,1401,330,0,5,47
-1,1682,1828,-146,-10,-337,73
-1,1625,1802,-177,-1,-51,104
-1,1639,1670,-31,-8,-173,72
-1,1391,1626,-235,-2,5,44
1,1702,1473,229,1,90,113
-1,1473,1510,-37,4,67,62
-1,1387,1734,-347,0,-2,68
-1,1023,1500,-477,-3,-89,58
-1,1677,1411,266,1,-11,60
-1,1677,1968,-291,-5,-150,50
-1,1879,1819,60,0,-68,102
-1,1378,1524,-146,-3,-159,68
-1,1438,1539,-101,-5,-198,56
1,1994,1503,491,1,28,51
-1,1516,1554,-38,0,132,70
-1,1866,1835,31,0,-50,100
1,1735,1593,142,0,12,53
-1,1786,1681,105,0,-92,84
-1,1397,1656,-259,-1,-120,88
1,1922,1633,289,-3,37,109
-1,1397,1656,-259,1,-20,80
1,1750,1728,22,10,537,85
-1,1466,1428,38,-1,-42,54
1,1534,1371,163,3,48,61
-1,1632,1736,-104,-6,-91,90
1,1670,1552,118,0,3,45
1,1736,1632,104,2,81,55
1,1512,1651,-139,8,98,48
-1,1544,1511,33,0,-4,60
-1,1628,1656,-28,-11,-298,46
1,1796,1796,0,5,219,73
1,1796,1796,0,0,370,105
1,1805,1624,181,-1,-3,45
-1,1388,1727,-339,0,20,64
-1,1624,1727,-103,-1,-105,86
-1,1182,1153,29,-7,-617,78
-1,1502,1653,-151,0,2,56
-1,1446,1603,-157,2,283,106
1,1725,1637,88,1,62,77
1,1617,1744,-127,-3,-48,83
-1,1135,1164,-29,4,354,88
-1,1811,1789,22,-5,-261,92
1,1654,1498,156,-1,-6,43
1,1683,1617,66,0,48,47
-1,1771,1948,-177,0,-23,74
-1,1628,1733,-105,1,-322,104
-1,1839,1929,-90,-9,-86,50
-1,1692,1800,-108,0,-299,78
-1,1278,1485,-207,-9,-238,62
1,1613,1440,173,3,90,59
-1,1660,1494,166,0,-50,84
-1,1807,1659,148,0,-103,72
1,1937,1829,108,-1,-52,47
1,1807,1712,95,2,70,53
-1,1704,1815,-111,0,-6,84
-1,1820,1945,-125,-1,-135,60
-1,1433,1623,-190,1,183,98
1,1815,1704,111,0,-27,69
-1,1583,1676,-93,0,-7,42
-1,1978,2064,-86,0,44,74
-1,1697,1823,-126,-1,6,74
1,1810,1549,261,3,144,79
1,1262,1235,27,1,70,63
-1,1512,1643,-131,0,26,82
-1,1661,1644,17,0,-19,54
1,1401,1297,104,7,269,69
1,1830,1690,140,-1,-132,115
1,1995,1812,183,0,28,59
1,2219,1717,502,-4,441,99
-1,1690,1830,-140,-2,-42,84
-1,1631,1428,203,0,-53,60
-1,1800,1713,87,1,-19,68
1,1836,1683,153,0,226,101
-1,1500,1759,-259,-9,-62,44
1,2221,1761,460,1,22,103
1,1272,1551,-279,-3,16,75
0,1649,1815,-166,0,112,109
-1,1352,1567,-215,-6,-71,54
1,1650,1504,146,2,48,63
1,1843,1772,71,-1,613,133
1,1866,1707,159,1,169,99
1,1597,1451,146,1,155,67
0,1615,1438,177,-4,-129,94
-1,1207,1189,18,0,12,50
1,1577,1346,231,-6,40,49
-1,1788,1758,30,3,107,54
1,1734,1491,243,-3,181,155
1,1704,1815,-111,3,109,65
1,1369,1491,-122,0,46,69
-1,1443,1608,-165,-4,-289,82
-1,1381,1189,192,1,-1,54
-1,1287,1221,66,5,97,48
-1,1776,1790,-14,0,4,64
-1,1604,1516,88,-1,-5,44
-1,1793,1611,182,-4,-4,93
-1,2002,1659,343,1,2,80
1,2014,1817,197,-1,12,41
1,1662,1425,237,1,543,157
1,1647,1956,-309,2,197,115
1,1607,1468,139,0,18,47
1,1409,1596,-187,-7,278,127
-1,1590,1537,53,0,19,80
1,1379,1630,-251,2,472,135
1,1811,1561,250,3,280,71
1,1617,1437,180,2,0,125
1,1214,1199,15,7,336,73
1,1363,1550,-187,3,135,71
-1,1413,2020,-607,-5,-143,48
1,2020,1413,607,5,96,41
-1,1400,1181,219,8,238,44
1,1721,1548,173,0,340,109
-1,1777,1764,13,2,12,50
-1,1625,1640,-15,5,-11,56
-1,1557,1577,-20,-4,-368,90
-1,1777,2021,-244,0,-439,94
-1,1611,1815,-204,1,32,52
1,1229,1249,-20,2,111,55
-1,1506,1687,-181,0,17,66
1,2026,1772,254,10,940,81
1,1733,1616,117,0,30,65
-1,1539,1583,-44,-2,-109,82
-1,1767,1766,1,-22,-688,54
1,1546,1399,147,1,0,47
1,1559,1588,-29,2,58,55
-1,1239,1325,-86,-2,-18,42
-1,1754,1776,-22,-8,-848,76
1,1585,1476,109,2,52,47
-1,1731,1812,-81,-2,-130,60
-1,1605,1192,413,-1,-123,60
0,1609,1787,-178,-1,26,120
1,1979,1609,370,0,17,49
-1,1585,1392,193,-16,-471,46
1,1274,1355,-81,-1,115,59
1,1935,1952,-17,1,36,67
1,2031,1427,604,1,65,57
-1,1658,1604,54,-2,-283,144
1,1580,1151,429,7,361,67
-1,1424,2032,-608,-3,-64,60
1,1381,1426,-45,10,989,107
1,1704,1485,219,0,39,59
-1,1601,1515,86,-2,-68,66
-1,1633,1425,208,-6,-474,82
1,1756,1613,143,8,274,65
-1,1462,1734,-272,1,-106,125
1,1500,1617,-117,1,21,45
1,1334,1227,107,0,12,43
-1,1338,1455,-117,-1,-495,136
-1,1443,1610,-167,-1,-38,56
1,1640,1468,172,-3,39,67
-1,1572,1395,177,4,86,50
1,1606,1792,-186,2,139,89
1,1323,1429,-106,0,1,45
-1,1732,1500,232,0,-21,120
-1,1356,1195,161,-3,-469,114
1,1820,1799,21,-6,-53,95
1,1360,1340,20,11,280,51
1,1662,1497,165,0,5,57
1,1618,1436,182,2,66,83
1,1739,1458,281,0,39,67
-1,1434,1387,47,-4,-77,62
1,1982,1507,475,0,-3,89
-1,1399,1789,-390,-1,-164,86
1,1337,1363,-26,-1,-21,119
-1,1628,1646,-18,0,-16,112
1,1796,1577,219,9,138,45
1,1818,1830,-12,-3,291,129
1,1554,1562,-8,-4,-90,67
1,1500,1229,271,4,282,71
-1,1291,1300,-9,-1,-217,108
1,1819,1829,-10,-5,-242,127
0,1453,1743,-290,-2,-31,66
1,1778,1601,177,3,17,45
1,1394,1201,193,7,478,82
-1,1674,1503,171,-4,-174,138
1,1669,1509,160,3,54,53
1,1348,1275,73,0,-3,47
-1,1445,1614,-169,1,-141,78
-1,1633,1424,209,0,-97,128
1,1734,1173,561,-1,3,55
-1,1424,1570,-146,-5,-37,46
0,1936,1813,123,0,42,83
1,1717,1791,-74,0,-10,65
1,2033,1840,193,5,404,75
-1,1500,1355,145,1,43,70
-1,1596,1861,-265,-2,-23,44
1,1581,1468,113,0,544,119
1,1400,1193,207,1,223,99
0,1502,1675,-173,-1,-4,79
-1,1600,2039,-439,-6,-91,52
-1,1007,1834,-827,-11,-38,40
-1,1984,1718,266,-1,-159,88
-1,1376,1361,15,-9,-225,46
1,1467,1518,-51,20,451,47
1,2042,1835,207,0,707,101
1,1236,1396,-160,4,289,67
-1,1442,1611,-169,-3,-15,100
-1,1584,1587,-3,-7,-170,54
-1,1829,2048,-219,-4,-815,120
1,1645,1609,36,0,1,69
-1,2054,1824,230,1,1,62
0,1670,1507,163,0,68,208
-1,1621,1439,182,-7,-311,62
1,1500,1471,29,3,951,87
1,1579,1593,-14,0,174,71
1,1723,1680,43,1,76,71
1,1842,2033,-191,0,-91,87
-1,1406,1186,220,-2,-767,104
-1,1594,1846,-252,-10,-444,66
-1,1400,1702,-302,0,6,44
1,1777,1707,70,1,49,57
-1,1584,1721,-137,0,-43,86
1,2014,1859,155,5,144,51
-1,1599,1486,113,-1,-16,58
1,1749,1582,167,8,101,45
-1,1852,2021,-169,0,-160,72
1,1962,1752,210,0,108,91
-1,1506,1610,-104,-5,-330,80
1,1785,1577,208,1,57,67
1,1846,1705,141,-1,76,71
-1,1429,1626,-197,0,-38,82
-1,1705,1846,-141,-9,-276,112
-1,1731,1805,-74,1,-19,48
-1,1811,1316,495,-17,-465,44
1,1373,1329,44,-1,-10,49
1,2028,1698,330,4,214,89
-1,1464,1569,-105,-2,-97,68
1,1706,1588,118,10,141,41
-1,1413,1500,-87,-5,-226,62
-1,1576,1772,-196,-6,-39,44
1,1808,1864,-56,0,287,173
-1,1695,2032,-337,0,7,66
-1,1581,1748,-167,-1,-597,138
1,1665,1647,18,1,92,59
-1,1500,1513,-13,-3,44,92
1,1928,1964,-36,0,61,89
-1,1743,1969,-226,0,-56,62
1,1792,1571,221,4,-28,81
-1,1692,2035,-343,0,-25,68
1,1500,1549,-49,0,352,129
1,1636,1566,70,0,216,113
1,1850,1821,29,0,18,53
-1,1502,1581,-79,-1,2,52
-1,1744,1931,-187,0,84,70
1,1633,1456,177,-1,-90,73
1,1811,1861,-50,2,66,65
-1,1400,1689,-289,-1,-9,54
-1,1772,1416,356,1,-101,74
1,1952,1655,297,8,177,53
-1,1848,1823,25,4,-59,142
1,1779,1574,205,5,181,61
-1,1571,1786,-215,-3,-314,112
1,2224,1693,531,-5,-9,77
1,1420,1341,79,0,127,89
1,1835,1836,-1,0,108,53
1,1817,1734,83,0,133,57
-1,2225,1803,422,3,-1,56
1,1623,1473,150,8,414,89
-1,1825,1846,-21,-1,-59,70
1,1471,1345,126,-1,-28,53
-1,1540,1634,-94,0,-103,96
-1,1445,1701,-256,-1,-207,126
-1,1692,2039,-347,2,8,56
0,1890,2196,-306,0,337,120
1,1521,1331,190,-1,-14,51
1,1663,1406,257,-1,-1,65
-1,1955,1952,3,2,67,60
1,1425,1676,-251,0,117,79
-1,1577,1455,122,-1,137,100
-1,1689,2042,-353,-2,-35,54
1,1722,1599,123,-1,32,51
1,1455,1440,15,0,197,99
1,1589,1460,129,0,554,108
1,2185,1921,264,0,-12,57
-1,1402,1693,-291,-1,-435,116
-1,1825,1952,-127,-1,-185,98
-1,1277,1591,-314,-6,-307,78
1,1641,1531,110,3,485,143
-1,1974,2088,-114,0,7,64
-1,1644,1753,-109,-3,-350,86
-1,1670,1791,-121,1,-94,156
1,1757,1770,-13,4,191,99
1,1905,2191,-286,3,266,79
1,1630,1716,-86,-1,-22,43
1,1607,1433,174,-5,7,85
1,1936,1716,220,0,222,85
-1,1710,2165,-455,-3,-11,82
-1,1273,1456,-183,-1,-99,62
1,1398,1333,65,1,85,69
0,1497,1337,160,-1,-153,93
-1,1658,1817,-159,-4,59,82
1,1810,1339,471,3,325,93
1,1636,1522,114,0,-12,45
1,1702,1643,59,0,83,59
-1,1444,1599,-155,-1,-257,125
1,1591,1459,132,9,369,59
1,1688,1751,-63,0,-128,87
1,1759,1770,-11,-1,93,95
1,2168,1971,197,0,-117,117
1,1837,1984,-147,0,73,111
1,1971,2168,-197,0,24,79
-1,1668,1423,245,-3,-66,50
-1,1407,1752,-345,0,8,106
-1,1739,1944,-205,-1,-30,54
1,1632,1729,-97,0,23,89
-1,1644,1815,-171,-1,-65,66
1,1661,1500,161,11,376,49
-1,1634,1712,-78,-2,-130,96
-1,1686,2176,-490,0,12,62
-1,1350,1400,-50,-6,-855,108
0,1824,1765,59,1,139,94
0,1651,1366,285,0,32,121
1,1442,1598,-156,0,10,78
-1,1266,1512,-246,-2,-245,98
1,1462,1201,261,4,117,53
-1,1692,2178,-486,0,-20,92
1,1958,1853,105,-1,12,113
1,1738,1757,-19,-1,101,71
1,2180,1691,489,-4,-168,89
0,1646,1593,53,-1,-166,102
1,1626,1963,-337,-2,-99,79
-1,1773,1822,-49,-2,-505,98
-1,1373,1615,-242,-2,-74,52
1,1721,1626,95,2,21,43
-1,1690,2182,-492,0,98,122
1,1541,1081,460,0,72,56
1,1661,1479,182,7,272,65
-1,1614,1453,161,-2,-56,62
-1,1490,2058,-568,0,-93,84
1,1635,1368,267,4,44,45
-1,1327,1734,-407,-15,-276,44
1,1620,1350,270,1,130,55
1,1645,1652,-7,-1,101,119
1,1685,1704,-19,0,55,75
-1,1661,1738,-77,-1,-239,100
1,2184,1688,496,-9,-41,45
-1,1663,1618,45,0,-572,104
-1,1700,1934,-234,-1,-60,92
-1,1363,1651,-288,-8,-299,64
-1,1487,1394,93,-2,-275,110
-1,1687,2186,-499,0,1,46
1,2186,1687,499,0,-7,55
1,1692,1698,-6,1,16,49
1,1572,1632,-60,-1,-7,81
0,1731,1489,242,0,-23,106
-1,1667,1833,-166,-7,-393,77
1,1653,1473,180,1,-20,57
1,1767,1700,67,0,8,66
1,1745,1528,217,-1,-10,67
-1,1213,1321,-108,4,41,66
-1,1703,2188,-485,0,-26,70
-1,1151,1141,10,-5,-176,52
1,1543,1557,-14,1,-42,97
-1,1589,1562,27,0,10,88
-1,1685,1685,0,0,8,46
-1,1851,1753,98,-2,10,48
-1,1336,1441,-105,-2,-135,62
1,2190,1702,488,-9,-15,73
1,1585,1334,251,0,245,63
1,1697,1673,24,-9,-34,63
-1,1662,1708,-46,0,3,50
-1,1700,2192,-492,-1,56,92
1,1656,1616,40,2,268,101
-1,1719,1652,67,0,-409,118
1,1625,1096,529,5,236,55
-1,1330,1204,126,0,385,116
1,2194,1699,495,-1,-39,65
-1,1558,1614,-56,0,-129,89
-1,1556,1513,43,0,-113,96
-1,1323,1467,-144,-1,-16,48
-1,1726,1730,-4,-3,-242,84
-1,1607,1470,137,-6,-312,68
0,1939,1715,224,1,-6,84
1,1091,1152,-61,0,853,143
-1,1950,1845,105,4,24,74
-1,1764,2149,-385,-2,-43,62
1,1845,1971,-126,1,123,85
-1,1573,1509,64,1,-33,102
1,1719,1313,406,-5,-190,69
-1,1728,1631,97,0,40,64
-1,1542,1477,65,0,-34,66
1,1651,1473,178,0,8,51
1,1656,1742,-86,2,33,49
1,1666,1606,60,-8,191,123
-1,1726,1601,125,2,5,50
-1,1666,1527,139,0,24,73
1,1738,1959,-221,8,97,49
1,1558,1303,255,0,6,45
-1,1481,1303,178,0,50,70
1,1591,1759,-168,-4,-88,65
-1,1486,1463,23,-2,-35,64
-1,1810,1932,-122,-2,-22,42
-1,1543,1650,-107,1,-180,124
1,1947,1860,87,0,43,87
1,1491,1527,-36,2,17,41
1,2111,1669,442,-1,-8,49
0,1658,1535,123,0,-37,130
-1,1500,1807,-307,0,-17,54
1,1740,1514,226,1,34,89
1,1221,1159,62,12,697,77
-1,1848,1942,-94,0,-82,130
1,1589,1663,-74,-1,138,81
-1,1318,1521,-203,-5,-94,46
1,1675,1623,52,0,104,99
-1,1565,1467,98,0,-25,64
1,1936,2073,-137,-1,-25,61
1,1484,1526,-42,-13,14,75
1,1851,1960,-109,0,-1,77
1,1662,1522,140,1,31,61
-1,1492,1625,-133,-1,-409,94
-1,1539,1654,-115,0,12,78
1,1735,1504,231,0,57,131
-1,1129,1231,-102,-1,-11,42
1,1727,1588,139,0,513,144
-1,1359,1406,-47,1,7,68
1,1577,1311,266,3,72,47
-1,1312,1509,-197,-6,-308,122
1,1668,1527,141,1,187,131
-1,1502,1546,-44,2,121,72
-1,2057,1951,106,1,56,58
1,1239,1104,135,7,144,45
-1,1347,1465,-118,-2,-623,106
-1,1649,1711,-62,0,18,44
-1,1272,1562,-290,0,-159,118
-1,1554,1662,-108,-5,-11,58
-1,1927,1939,-12,3,-245,146
-1,1705,1929,-224,0,-66,104
1,1084,1247,-163,2,18,41
-1,1497,1481,16,0,-36,72
1,1669,1705,-36,0,3,49
1,1715,1564,151,-1,-45,81
1,1342,1457,-115,0,177,89
-1,1546,1551,-5,-3,-324,92
0,1685,1614,71,2,-327,100
1,1306,1478,-172,-1,-50,61
1,1700,1489,211,3,151,69
-1,1230,1127,103,0,-80,78
1,1950,1866,84,-3,-18,77
-1,1624,1645,-21,-3,-208,88
0,1741,1714,27,0,-45,93
1,1658,1130,528,-2,1,43
1,1597,1512,85,-7,241,71
1,1735,1832,-97,2,355,133
-1,1515,1652,-137,0,-246,118
1,1756,1601,155,5,837,141
-1,1562,1535,27,-1,83,74
-1,1268,1298,-30,-3,-135,130
-1,1574,1678,-104,0,-10,116
-1,1569,1705,-136,-2,-61,62
-1,1682,1948,-266,-4,-253,98
0,1675,1519,156,-1,-68,90
1,1915,1954,-39,0,54,55
-1,1507,1214,293,-2,-17,46
-1,1604,1561,43,-1,-58,160
-1,1682,1445,237,1,-6,114
-1,1686,1565,121,-4,27,44
1,1581,1671,-90,0,28,47
0,1740,1715,25,-3,-10,83
-1,1473,1493,-20,0,94,80
1,1671,1581,90,1,287,159
-1,1857,2113,-256,0,-68,70
0,1802,1792,10,0,38,175
-1,1689,1529,160,-2,21,46
-1,1467,1462,5,1,14,61
-1,1752,1829,-77,0,-30,80
-1,1550,1606,-56,-3,-670,135
1,1941,1799,142,2,16,45
1,1256,1309,-53,4,130,55
1,1541,1541,0,-2,27,121
0,1595,1657,-62,0,31,156
-1,1581,1606,-25,-1,-69,56
-1,1562,1499,63,-4,-68,50
1,1461,1365,96,-1,96,93
1,1832,1580,252,0,8,69
1,1396,1739,-343,-5,96,94
0,1524,1670,-146,-1,-63,131
1,2118,1853,265,0,25,65
-1,1487,1716,-229,-9,-264,53
1,1625,1610,15,1,85,54
-1,1687,1684,3,-4,-163,58
-1,1681,1790,-109,0,94,72
-1,1545,1395,150,-1,-260,92
1,1462,1512,-50,-5,-163,57
1,1933,1982,-49,4,100,49
1,1444,1398,46,9,242,49
1,2038,1751,287,-5,306,107
-1,1735,1663,72,-6,-154,128
-1,1394,1601,-207,-1,17,62
-1,1554,1723,-169,-2,-232,80
-1,1528,1738,-210,-5,-128,60
1,1696,1970,-274,-2,-5,67
1,1900,973,927,15,254,41
1,1716,1499,217,0,-4,57
-1,1720,1828,-108,4,-261,110
1,1546,1647,-101,4,82,65
-1,0,1196,-1196,1,-120,58
0,2090,1876,214,0,15,178
-1,1420,1595,-175,-4,-158,58
1,1355,1484,-129,2,88,59
1,1722,1494,228,-3,-129,53
-1,1387,1454,-67,-3,-207,88
-1,2051,2055,-4,0,19,90
1,1668,1133,535,8,363,69
-1,1728,1951,-223,2,42,48
-1,1808,1752,56,0,-273,172
0,1455,1539,-84,2,77,121
-1,1714,2042,-328,-2,-140,66
-1,1567,1510,57,-6,-169,210
1,1482,1387,95,5,129,49
-1,1568,1494,74,-1,-49,48
1,1956,1909,47,-1,557,153
1,1555,1507,48,-1,-36,53
-1,1498,1522,-24,-3,-2,40
-1,1731,1847,-116,0,37,74
-1,1676,1721,-45,-1,11,78
1,1419,1412,7,7,462,65
1,1632,1561,71,-5,-58,57
1,1805,1646,159,3,454,141
1,1186,973,213,10,471,51
1,1807,1542,265,0,36,59
1,1647,1671,-24,1,138,97
-1,1126,1670,-544,-8,-129,48
-1,1711,1686,25,0,-16,60
1,1573,1520,53,-1,-121,95
-1,1899,1966,-67,0,-4,58
1,1734,1665,69,1,10,76
1,1461,1302,159,-4,-4,41
-1,1399,1730,-331,-4,-59,45
-1,1654,1451,203,3,142,74
1,1975,1890,85,-1,9,57
1,2041,1882,159,0,16,71
-1,1700,1699,1,-3,-200,136
-1,2058,2084,-26,0,-160,90
-1,1602,1587,15,-1,-46,52
-1,1807,1836,-29,0,3,60
-1,1656,1744,-88,-12,-363,68
-1,1815,1565,250,-1,-131,80
-1,1232,1233,-1,0,-2,58
-1,1497,1671,-174,-3,-35,42
-1,1602,1626,-24,-2,-102,72
-1,1564,1666,-102,-11,-168,44
1,1606,1388,218,3,125,50
0,1895,2112,-217,0,382,100
-1,1945,2167,-222,0,-19,70
1,1788,1582,206,-3,-25,63
1,1912,1695,217,-3,-113,83
0,1403,1518,-115,-4,148,118
0,1731,1667,64,-1,378,146
1,1386,1145,241,3,541,105
-1,965,1224,-259,1,40,40
-1,1500,1507,-7,-14,-276,48
-1,1568,1612,-44,-4,-678,120
1,1733,1396,337,2,293,115
-1,1469,1530,-61,5,197,74
1,1577,1515,62,7,130,41
-1,1201,1416,-215,0,-373,98
1,1678,1489,189,1,202,96
-1,2047,1875,172,1,44,80
1,1710,1586,124,0,73,81
1,1584,1779,-195,-2,33,91
1,1526,1555,-29,2,157,87
1,1670,1582,88,-8,119,155
-1,1429,1367,62,-1,-34,48
1,1681,1556,125,2,307,65
-1,1539,1713,-174,-11,-140,44
1,1791,1505,286,0,280,85
-1,1802,1746,56,0,17,116
1,1566,1374,192,5,321,59
1,1754,1579,175,10,261,91
-1,1718,2045,-327,-4,-177,74
-1,1590,1592,-2,0,-25,92
1,1806,1795,11,0,-29,59
1,1580,1587,-7,0,8,46
1,1812,1502,310,3,72,51
1,1765,1659,106,-1,-27,49
0,1558,1454,104,-3,-95,66
-1,1648,1900,-252,0,10,88
1,1383,1611,-228,11,264,49
-1,1665,1649,16,-5,-279,84
1,1685,1602,83,6,261,65
-1,1573,1761,-188,1,36,64
-1,1762,1829,-67,-6,-197,110
-1,2031,1891,140,0,-288,122
1,1379,1416,-37,1,161,115
-1,1934,1729,205,2,68,82
-1,1400,1616,-216,-1,-14,72
-1,1715,1827,-112,0,-134,86
1,1591,1614,-23,0,-190,109
-1,1394,1482,-88,0,-377,132
1,1649,1504,145,1,44,49
-1,1767,1567,200,-4,-333,86
1,1719,1533,186,6,196,57
0,1855,1818,37,0,-90,115
1,1636,1590,46,0,102,87
-1,1870,1751,119,0,-33,100
-1,1418,1447,-29,-5,-679,116
1,1656,1497,159,2,28,49
1,1457,1503,-46,-3,23,41
-1,1714,1689,25,0,-19,58
-1,1468,1568,-100,-6,-12,50
1,1683,1611,72,0,2,53
-1,1662,1452,210,2,22,100
-1,1584,1748,-164,0,-205,84
-1,1573,1678,-105,0,-30,96
1,984,1144,-160,5,60,49
-1,1835,1707,128,0,-30,66
1,1498,1628,-130,-1,89,51
-1,1393,1736,-343,-2,-136,162
1,1554,1434,120,-5,-246,87
1,1296,1251,45,3,214,63
1,1270,1500,-230,0,102,49
1,1769,1811,-42,2,26,47
-1,1457,1555,-98,0,37,86
-1,1307,1571,-264,-9,-123,52
1,1576,1460,116,-3,-9,85
1,1380,1490,-110,3,-5,51
-1,1404,1611,-207,-5,10,42
-1,1600,1592,8,1,22,74
1,1722,1819,-97,-1,-18,65
-1,1714,1650,64,0,18,122
1,1784,1755,29,0,-201,97
-1,1565,1520,45,0,-33,48
1,1723,1658,65,0,266,121
-1,1663,1651,12,-1,-97,64
-1,1175,1376,-201,8,360,72
1,1552,1533,19,2,-11,41
-1,1397,1617,-220,-1,17,47
1,1744,1686,58,0,-2,47
-1,1621,1503,118,-5,-263,82
1,1694,1853,-159,2,123,75
-1,1744,1797,-53,-3,-383,88
1,1563,1522,41,1,22,57
0,1818,1785,33,0,100,124
1,1064,1006,58,8,99,51
1,1875,1804,71,0,-55,83
1,1572,1512,60,0,24,63
1,1576,1267,309,-2,237,79
1,1808,1734,74,0,24,55
-1,1452,1584,-132,-6,-38,74
-1,1622,1954,-332,-3,-55,46
1,1807,1712,95,0,157,95
1,1581,1503,78,0,1,49
0,1533,1635,-102,0,21,117
0,1724,1819,-95,-3,-213,80
-1,1450,1505,-55,-1,-110,56
0,1657,1794,-137,-4,-94,135
-1,1696,1799,-103,-5,-192,62
-1,1500,1534,-34,-1,-75,88
-1,1555,1247,308,-1,88,120
-1,1837,1712,125,-3,-161,79
1,1736,1590,146,2,359,75
-1,1551,1359,192,1,-75,82
-1,1512,1538,-26,6,184,60
1,1643,1803,-160,-1,-87,63
1,1706,1618,88,-2,-37,57
1,1816,1728,88,1,223,85
-1,1358,1280,78,0,-27,64
-1,1563,1796,-233,0,-119,82
-1,1543,1692,-149,0,-54,74
1,1500,1584,-84,0,43,51
-1,1500,1494,6,-8,-267,68
-1,1539,1459,80,0,-222,90
1,1740,1690,50,2,160,130
-1,1533,1392,141,-12,-179,44
1,1445,1066,379,-6,49,49
-1,1719,1826,-107,1,95,72
-1,1296,1642,-346,-8,-239,50
-1,993,1105,-112,-7,-362,62
-1,1743,1577,166,-5,-424,90
-1,1654,1797,-143,-3,-328,72
-1,1669,1719,-50,-5,-7,46
1,1715,1626,89,-1,188,93
1,1835,1710,125,1,323,85
-1,1304,1561,-257,-3,-66,53
1,1522,1482,40,5,285,73
-1,1535,1612,-77,-1,-50,82
-1,1558,1376,182,-8,10,46
1,1601,1535,66,-7,-53,59
1,1534,1500,34,-5,-169,47
-1,1739,1390,349,0,-9,44
1,1821,1635,186,1,74,125
-1,1714,1773,-59,-3,-73,60
1,1805,1648,157,0,252,99
1,1606,1489,117,-1,95,81
-1,1712,1976,-264,0,-55,100
1,1518,1416,102,10,262,49
-1,1703,1843,-140,-8,-559,86
-1,1635,1725,-90,-2,-197,73
-1,1386,1854,-468,-7,-260,54
1,1254,1502,-248,0,44,69
1,1448,1530,-82,2,172,67
1,1851,1695,156,-1,155,73
1,1438,1152,286,2,119,53
-1,1685,1500,185,-1,-349,116
-1,1703,1817,-114,-2,-132,126
-1,1641,1812,-171,-2,-92,66
-1,1681,1750,-69,-1,6,40
1,1445,1487,-42,-1,54,59
1,1136,1164,-28,-6,-37,61
1,1720,1532,188,-2,-298,129
-1,1688,1818,-130,1,-139,88
1,1786,1614,172,4,98,51
-1,1615,1660,-45,-3,-92,98
1,1545,1476,69,-2,-44,57
1,1749,1502,247,1,507,123
1,1437,1139,298,-4,249,81
-1,1526,1676,-150,-2,-58,68
1,1580,1495,85,2,222,53
1,1681,1468,213,-7,-330,53
1,1526,1551,-25,-7,-42,49
1,2002,1708,294,2,80,61
-1,1674,1729,-55,0,-473,130
-1,1461,1445,16,-12,-54,40
1,1729,1500,229,9,403,77
1,1602,1549,53,3,253,85
-1,1286,1500,-214,2,8,44
1,1605,1792,-187,-3,20,55
-1,1596,1540,56,-2,-409,92
-1,1796,1659,137,-4,-157,112
1,1566,1544,22,1,128,109
-1,1732,1856,-124,-1,-88,60
-1,1688,1732,-44,-10,-122,54
1,1824,1463,361,2,2,85
1,1131,1293,-162,1,585,113
-1,1541,1388,153,4,-14,92
1,1645,1574,71,-1,73,145
-1,1754,1765,-11,0,2,46
1,1519,1528,-9,0,64,99
1,1548,1500,48,6,450,81
1,1542,1412,130,0,250,75
1,1629,1827,-198,0,118,87
1,1453,1476,-23,4,181,61
1,1741,1679,62,0,2,65
-1,1588,1560,28,1,46,58
1,1663,1670,-7,2,25,43
-1,1739,1460,279,-4,-186,96
1,1816,1481,335,7,262,87
-1,1775,1629,146,3,70,58
1,1539,1538,1,1,282,84
-1,1743,1743,0,0,-125,76
-1,1539,1612,-73,0,-141,80
-1,1139,1164,-25,-6,-416,64
-1,1789,1782,7,-3,-80,74
1,1440,1211,229,-7,-265,77
-1,1397,1367,30,-3,9,70
1,1720,1479,241,2,200,72
-1,1673,1603,70,-5,-70,50
1,1670,1750,-80,2,40,43
-1,1500,1734,-234,2,278,134
1,1826,1695,131,-3,-2,49
1,1358,1606,-248,-2,-58,65
-1,1732,2048,-316,0,31,52
1,1886,1550,336,1,164,95
1,1724,1475,249,1,148,67
-1,1359,1440,-81,0,-66,102
1,1464,1347,117,1,17,67
-1,1404,1694,-290,1,-68,86
1,1473,1526,-53,-2,16,51
1,1729,1470,259,10,405,65
1,1591,1264,327,-3,9,69
1,1600,1384,216,2,106,57
-1,1737,1683,54,0,-22,132
-1,1536,1759,-223,0,-10,60
1,1705,1807,-102,0,53,49
-1,1485,1532,-47,1,26,64
1,1650,1760,-110,-1,-66,57
-1,1288,1500,-212,-5,-90,48
1,1728,1827,-99,1,13,63
1,1178,1109,69,7,108,41
1,1755,1527,228,1,84,71
-1,1636,1799,-163,0,10,66
1,1777,1550,227,1,59,83
1,1644,1465,179,0,-121,89
1,1327,1134,193,2,331,71
-1,1558,1733,-175,-1,-1,92
-1,1846,2073,-227,-1,-35,58
-1,1627,1700,-73,1,-4,98
1,1558,1733,-175,-2,-82,73
-1,1282,1630,-348,-1,-31,50
1,1909,1658,251,-1,-56,69
-1,1484,1530,-46,0,-33,60
-1,1748,1617,131,1,-13,79
-1,1629,1884,-255,6,226,108
-1,1510,1549,-39,1,-79,78
1,1674,1572,102,0,231,77
-1,1719,1719,0,-2,67,58
1,1547,1576,-29,2,458,103
1,1812,1743,69,0,25,59
1,1651,1459,192,1,98,99
1,1476,1411,65,5,146,48
-1,1688,1835,-147,2,-64,80
-1,1378,1504,-126,-1,-64,64
1,1604,1510,94,-2,-129,61
-1,1605,1864,-259,-1,-23,63
1,1888,1625,263,11,277,51
1,1746,1670,76,3,36,41
-1,1552,1542,10,1,330,106
-1,1540,1889,-349,-1,-449,102
1,1190,1542,-352,3,253,73
-1,1881,1740,141,-4,-112,58
1,1657,1453,204,8,800,97
-1,1587,1390,197,2,7,170
-1,1696,1586,110,0,-665,224
1,1734,1647,87,1,31,67
1,1764,1531,233,-1,-72,69
-1,1534,1500,34,1,-58,116
-1,1621,1893,-272,-5,-284,114
1,1764,1775,-11,3,55,45
1,1484,1457,27,0,51,57
-1,1663,1447,216,-1,-37,58
1,1658,1755,-97,2,107,85
-1,1764,1776,-12,1,-213,114
1,1865,1686,179,0,12,61
1,1669,1619,50,-4,28,83
1,1522,1198,324,3,1,41
1,1595,1281,314,-10,160,107
1,1897,1617,280,0,65,117
-1,1680,1871,-191,0,-365,108
-1,1270,1474,-204,-5,-131,52
-1,1371,1519,-148,3,133,58
-1,1400,1449,-49,0,-123,188
-1,1633,1782,-149,0,-66,90
1,1540,1466,74,-2,-115,55
1,1919,1629,290,-4,58,99
1,1613,1531,82,-1,-254,91
-1,1601,1678,-77,-1,35,66
-1,1580,1538,42,0,10,63
-1,1613,1901,-288,-3,-91,59
1,1397,1330,67,-1,22,49
0,1818,1739,79,0,-113,156
1,1525,1436,89,-1,6,55
-1,1549,1622,-73,-1,-199,102
1,1877,1674,203,2,397,81
1,1525,1363,162,9,142,44
-1,1494,1663,-169,-3,-44,64
1,1601,1682,-81,-1,-37,111
-1,1549,1544,5,-3,-589,102
-1,1136,1228,-92,1,57,46
1,1494,1225,269,2,43,49
1,1869,1607,262,0,27,107
1,1904,1609,295,6,44,103
-1,1356,1532,-176,-3,-86,70
1,1759,1456,303,0,55,63
-1,1781,1878,-97,0,-18,68
-1,1882,1786,96,-1,-320,98
-1,1628,1948,-320,0,-177,78
-1,1525,1768,-243,-10,-305,56
-1,1458,1521,-63,2,-151,120
1,1741,1676,65,-2,46,61
1,1538,1350,188,-9,-277,51
-1,1606,1908,-302,1,12,41
1,1237,1372,-135,0,38,75
1,1621,1612,9,0,-21,109
1,1912,1602,310,-4,-257,105
-1,1668,1614,54,-3,-232,76
1,1952,1440,512,0,28,63
-1,1624,1511,113,-10,-118,41
-1,1343,1544,-201,1,-116,66
-1,1524,1560,-36,0,39,72
1,1500,1165,335,3,137,64
-1,1352,1477,-125,2,69,134
-1,1486,1674,-188,2,21,106
-1,1789,1625,164,0,-1,110
0,1681,1816,-135,0,23,113
-1,1741,1703,38,-9,-176,58
-1,1419,1817,-398,0,-12,108
1,1499,1728,-229,0,77,65
-1,1565,1654,-89,0,-165,98
1,1545,1670,-125,-1,-33,111
-1,1520,1483,37,-2,-158,76
1,1549,1337,212,0,-7,71
1,1667,1541,126,-5,439,171
1,1277,1125,152,7,506,121
-1,1656,1724,-68,-1,-464,160
-1,982,1531,-549,5,88,48
-1,1773,1819,-46,0,-218,228
0,1555,1516,39,0,29,156
-1,1276,1641,-365,-1,-20,70
1,1851,1872,-21,4,21,41
-1,1526,1608,-82,2,88,72
-1,1397,1582,-185,-4,-177,46
1,1526,1314,212,-2,-36,107
1,1537,1351,186,-1,-346,97
1,1928,1758,170,1,27,43
1,1710,1517,193,0,83,93
-1,1119,1335,-216,-8,-861,88
-1,1599,1915,-316,-3,-191,68
-1,1547,1841,-294,0,-61,70
-1,1467,1730,-263,0,-48,64
1,1953,1906,47,6,369,73
-1,1461,1564,-103,-2,-162,80
-1,1344,1543,-199,2,823,90
1,1558,1873,-315,-1,-9,53
1,1543,1533,10,-3,-207,101
0,1595,1756,-161,-1,75,143
1,1389,1505,-116,0,0,55
1,1548,1338,210,-4,-145,51
1,1941,1609,332,1,329,123
-1,1648,1752,-104,-3,-368,92
0,1812,1775,37,0,-46,79
-1,1632,1694,-62,-4,-69,50
-1,1253,1387,-134,-17,-424,47
1,1858,1896,-38,1,360,131
-1,1751,1600,151,-3,-337,116
1,1789,1463,326,-1,67,61
-1,1332,1554,-222,1,26,44
-1,1272,1411,-139,-8,-80,42
1,1259,1306,-47,-2,-48,61
1,1885,1924,-39,0,37,97
-1,1554,1641,-87,-1,-300,96
1,1617,1735,-118,4,144,63
1,1522,1554,-32,-6,-304,81
1,1536,1609,-73,-1,423,141
-1,1947,1606,341,-1,-7,54
-1,1194,1295,-101,11,474,62
1,1599,1581,18,0,86,81
1,1760,1640,120,1,33,47
1,1511,981,530,13,1013,79
-1,1439,1453,-14,-1,-38,64
-1,1634,1511,123,-4,-190,104
-1,1607,1753,-146,-1,22,68
1,1719,1632,87,-3,258,73
-1,1777,1811,-34,-9,-111,122
-1,1736,1865,-129,4,-171,110
-1,1424,1334,90,-10,-132,42
1,1551,1561,-10,6,751,111
1,1633,1767,-134,-2,11,61
1,1680,1480,200,4,60,43
1,1480,1405,75,5,176,51
-1,1515,1404,111,0,-163,122
-1,1760,1600,160,-2,-187,78
1,1867,1464,403,-2,12,83
1,1500,1248,252,-11,-488,59
1,1644,1693,-49,-2,74,113
-1,1623,1728,-105,-6,-260,100
-1,1531,1570,-39,1,-28,84
1,1705,1623,82,0,68,61
0,1060,1553,-493,-1,-12,46
1,1470,1234,236,9,321,75
1,1427,1462,-35,0,225,91
-1,1419,1603,-184,5,529,82
-1,1736,1615,121,0,-297,152
1,1752,1647,105,0,44,51
-1,1512,1463,49,-8,-386,114
1,1306,1357,-51,18,650,46
-1,1395,1494,-99,-1,-134,72
-1,1515,1624,-109,0,8,48
-1,1362,1359,3,-1,-43,66
-1,1640,1760,-120,-1,-30,54
-1,1441,1458,-17,-6,-92,46
1,1919,1828,91,-1,49,53
-1,1452,1639,-187,1,-4,60
-1,1856,1856,0,0,-97,88
1,1661,1721,-60,6,90,43
-1,1574,1345,229,-6,-48,50
1,1553,1523,30,1,34,55
-1,1821,2227,-406,2,15,130
-1,1370,1571,-201,-4,-36,48
-1,1475,1405,70,0,-320,86
1,1286,1469,-183,5,271,75
1,1708,1674,34,2,155,93
-1,1648,1773,-125,-1,-109,78
-1,2052,1928,124,2,153,86
1,1568,1751,-183,0,-5,67
-1,1768,1632,136,2,102,86
1,1500,1113,387,18,1152,75
-1,1545,1665,-120,0,-33,56
-1,1615,1715,-100,-1,-255,84
-1,1116,1311,-195,-3,-331,78
-1,1382,1452,-70,-2,-19,48
1,1965,1314,651,15,212,45
-1,1664,1718,-54,-2,-137,82
1,1642,979,663,19,836,61
1,1507,1387,120,0,260,98
1,1873,1727,146,1,354,87
-1,1772,1943,-171,0,104,66
-1,1371,1461,-90,-1,-76,58
1,1674,1723,-49,-6,19,47
-1,1501,1576,-75,2,-373,118
-1,1728,1654,74,-4,-234,80
1,1513,1563,-50,5,161,53
-1,1362,1470,-108,-4,89,68
-1,1191,1466,-275,0,-61,74
-1,1950,1765,185,1,-195,60
-1,1549,1557,-8,0,2,60
-1,1580,1521,59,2,29,48
-1,1271,1219,52,2,-7,148
1,1647,1753,-106,0,-21,81
1,1764,1710,54,0,42,79
-1,1604,1562,42,1,74,66
1,1499,1401,98,2,67,73
1,1352,1478,-126,-2,38,57
1,1968,1418,550,1,369,97
1,1976,1958,18,0,-73,103
-1,1782,1932,-150,0,8,74
1,1646,1445,201,-2,-23,43
1,1643,1565,78,0,-32,83
1,1710,1687,23,-7,-80,83
-1,1537,1476,61,0,-376,98
-1,1370,1463,-93,-15,-358,56
1,1486,1440,46,1,757,167
0,1532,1294,238,-4,-307,101
1,1395,1151,244,11,318,49
1,1537,1538,-1,-3,122,67
1,1939,1775,164,2,33,65
1,1747,1420,327,6,252,57
-1,1337,1109,228,-2,-466,154
-1,1360,1471,-111,-5,-191,58
-1,1645,1379,266,1,-26,48
-1,1660,1533,127,0,9,54
1,2057,1863,194,0,4,103
-1,1335,1350,-15,0,-119,58
0,1858,1779,79,0,100,141
1,1478,1500,-22,7,137,43
1,1624,1282,342,-1,83,67
1,1644,1484,160,4,106,45
1,1799,1787,12,0,140,79
-1,1360,1500,-140,-4,-143,60
-1,1477,1400,77,-3,-328,92
1,1709,1762,-53,2,620,113
1,1796,1407,389,8,854,97
-1,1727,1561,166,0,-78,78
-1,1524,1658,-134,-1,-56,52
-1,1764,1496,268,2,44,46
1,1581,1704,-123,-1,48,69
1,1656,1736,-80,-4,-83,71
1,1745,1785,-40,-5,-65,59
0,2027,2112,-85,0,-64,111
-1,2167,1977,190,0,-98,136
-1,1441,1704,-263,-2,-159,90
1,1349,1234,115,7,1002,105
-1,1352,1546,-194,-4,-370,63
-1,1781,1855,-74,2,55,68
-1,1529,1609,-80,0,-16,58
-1,1411,1372,39,-10,-89,43
1,1515,1497,18,-1,239,83
-1,1355,1531,-176,-8,-345,68
1,1377,1324,53,3,124,69
-1,1776,1810,-34,-4,-35,84
-1,1560,1773,-213,0,3,50
1,1508,1292,216,-1,-136,73
1,1690,1597,93,0,112,79
1,2064,1757,307,-1,-70,125
-1,1060,1189,-129,1,-5,60
-1,1676,1794,-118,0,-49,104
1,1864,1773,91,0,8,59
-1,1665,1687,-22,-2,-48,52
-1,1509,1422,87,-4,-176,70
1,1490,1708,-218,0,62,81
-1,1459,1557,-98,-1,-83,120
1,1437,1613,-176,0,37,51
1,1511,1558,-47,0,-8,55
-1,2068,1754,314,1,-46,76
1,1631,1685,-54,-5,-117,45
1,1654,1694,-40,-1,-60,101
1,1386,1398,-12,2,98,74
1,1627,1327,300,0,1,43
1,1554,1905,-351,7,340,73
-1,1271,1513,-242,-2,0,54
0,1348,1317,31,1,64,55
-1,1765,1872,-107,0,-83,106
1,1860,1520,340,0,-9,43
-1,1090,1396,-306,-3,-4,94
-1,1698,1672,26,1,-45,70
-1,1628,1433,195,-12,-437,118
-1,2109,2036,73,0,-3,52
-1,1819,1765,54,-3,-284,104
0,1520,1539,-19,4,95,127
-1,1722,1508,214,0,-12,76
1,1438,1504,-66,3,129,69
1,1662,1720,-58,2,157,81
1,1377,1612,-235,-5,-297,79
1,1883,1586,297,3,175,65
-1,1291,1277,14,-12,-273,52
-1,1828,2045,-217,-2,-2,48
-1,1426,1473,-47,-4,-135,84
0,1799,1760,39,-2,23,104
1,1476,1591,-115,1,341,109
-1,1517,1253,264,-10,-258,54
1,1684,1686,-2,2,270,131
-1,1646,1554,92,0,-407,162
1,1536,1464,72,-3,93,111
1,1513,1596,-83,5,191,67
1,1655,1630,25,5,45,45
1,1537,1348,189,-1,38,53
-1,1288,1305,-17,0,-46,54
1,1385,1398,-13,1,92,59
1,1742,1184,558,13,597,57
1,2049,2096,-47,-2,0,71
-1,1726,1660,66,-3,-46,54
-1,1757,1910,-153,-1,-203,58
1,1596,1670,-74,0,164,95
-1,1130,1741,-611,-3,-76,44
1,1577,1707,-130,0,82,72
1,1778,1807,-29,0,51,99
-1,1319,1500,-181,2,125,54
-1,2062,1813,249,-5,-292,132
-1,1603,1675,-72,-3,-120,64
1,1614,1454,160,-1,-19,61
1,1373,1433,-60,0,515,231
1,1695,1335,360,0,5,53
-1,1476,1682,-206,1,-95,70
1,1773,1536,237,0,-10,45
-1,1314,1516,-202,-4,-225,70
1,1868,1517,351,-1,94,103
1,1729,1591,138,2,142,93
1,1323,1698,-375,2,108,73
1,1599,1643,-44,-5,57,87
-1,1548,1590,-42,0,-32,124
1,1778,1881,-103,1,228,91
1,1802,1898,-96,-4,238,134
-1,1492,1639,-147,-3,-479,194
1,1506,1299,207,-1,-23,43
-1,1342,1557,-215,-6,-128,46
1,1744,1555,189,5,168,125
-1,1684,1594,90,1,29,90
-1,1437,1499,-62,1,-92,62
-1,1397,1665,-268,0,-59,144
1,1471,1479,-8,1,323,96
1,1572,1569,3,-3,110,85
-1,1641,1440,201,-2,-65,42
1,1796,1791,5,0,-103,89
-1,1831,2041,-210,-3,-373,90
1,1521,1372,149,2,156,89
-1,1693,1680,13,-1,-473,114
1,2061,1999,62,-1,13,59
-1,1346,1588,-242,-3,-226,104
-1,1679,1750,-71,0,-205,72
1,1370,1379,-9,-1,40,65
-1,1707,1522,185,1,59,54
-1,1793,1866,-73,0,-645,120
1,1687,1450,237,20,585,41
1,2047,1826,221,2,187,75
-1,1452,1596,-144,-5,-173,60
1,1357,1153,204,2,304,81
-1,1451,1464,-13,-2,-33,42
1,1587,1496,91,1,25,46
-1,1608,1670,-62,1,64,54
-1,1692,1445,247,2,142,76
-1,1673,1650,23,0,-11,68
1,1494,1386,108,-2,18,59
1,1848,1320,528,0,119,155
1,1500,1523,-23,1,12,104
1,1875,1784,91,0,-2,99
1,1821,2053,-232,-2,-206,93
-1,1427,1482,-55,0,87,82
1,1689,1592,97,1,120,87
-1,1780,1806,-26,0,19,80
-1,2074,2145,-71,-3,-156,92
1,1670,1758,-88,4,119,69
1,1679,1599,80,0,-14,45
-1,1546,1431,115,3,32,58
-1,1451,1662,-211,-4,-101,48
-1,1883,1963,-80,-3,-453,116
1,1440,1520,-80,-1,90,71
-1,1673,1466,207,2,152,68
-1,1368,1502,-134,0,2,56
1,1884,1918,-34,1,131,131
1,1990,1610,380,2,42,57
1,1407,1271,136,-1,-9,67
1,1640,1446,194,0,90,101
1,1839,2032,-193,2,54,101
-1,1745,1775,-30,1,-11,130
-1,1590,1688,-98,1,-13,50
1,1613,1496,117,4,249,61
1,1973,1875,98,4,25,41
-1,1501,1648,-147,-5,-261,76
0,1538,1393,145,1,-158,180
-1,1357,1584,-227,-11,-272,52
-1,1982,1867,115,2,138,84
-1,2013,1856,157,-6,-1373,138
-1,1509,1353,156,-1,-45,90
1,1723,1826,-103,0,-40,55
-1,1582,1668,-86,-1,-179,88
-1,1542,1767,-225,-3,-146,70
1,1881,1966,-85,-5,-71,79
-1,1684,1783,-99,0,-214,82
1,1751,1604,147,-2,-123,85
-1,1368,1472,-104,0,28,72
1,2141,1993,148,-3,-274,97
-1,1582,1696,-114,0,64,76
1,1479,1630,-151,2,-10,45
1,1813,1727,86,-2,56,63
-1,2154,2065,89,-3,-125,52
-1,1347,1485,-138,3,45,66
-1,1491,1413,78,-2,-221,128
0,1791,1769,22,-1,-131,110
1,1595,1409,186,-2,412,111
1,1885,1831,54,-4,-212,101
-1,1678,1447,231,0,-455,108
-1,1751,1500,251,-3,-13,102
1,1895,1994,-99,0,147,69
-1,1762,1786,-24,-1,-6,68
-1,1657,1610,47,-2,-122,52
1,1676,1707,-31,0,-64,83
1,1624,1412,212,-1,59,47
-1,1703,1574,129,-2,230,96
1,1978,1909,69,-1,87,67
1,1655,1528,127,8,422,75
-1,1597,1757,-160,-1,-130,76
-1,1751,1486,265,-1,-98,70
-1,2091,1879,212,0,-30,102
1,2151,1773,378,0,43,91
-1,1409,1986,-577,-1,-32,42
1,1448,1181,267,11,286,45
1,1480,1453,27,3,200,77
1,1395,1342,53,3,118,61
-1,1721,1749,-28,2,267,136
1,1988,1951,37,0,-3,81
1,1643,1822,-179,-1,-27,73
-1,1398,1534,-136,3,245,84
1,1513,1686,-173,6,99,40
-1,1488,1621,-133,-4,-564,110
-1,1468,1478,-10,1,-329,146
1,1437,1499,-62,2,239,133
1,1688,1695,-7,3,156,85
1,1744,1546,198,0,165,73
-1,1589,1688,-99,0,-123,78
-1,1415,1174,241,-4,-48,72
1,1558,1586,-28,-5,-19,82
1,1764,1591,173,0,-7,87
1,1621,1599,22,-6,265,121
0,1762,1693,69,0,-1,74
-1,1437,1403,34,0,-21,50
0,1708,1576,132,-2,-163,198
-1,1904,1896,8,-1,-44,68
1,1744,1691,53,0,229,77
-1,1999,1856,143,-2,-48,64
0,1798,1866,-68,0,98,191
-1,1676,1493,183,-3,19,86
-1,1312,1580,-268,-5,-21,40
1,1696,1581,115,2,28,87
-1,1896,2069,-173,0,-135,92
1,1741,1615,126,-2,25,41
1,1699,1684,15,1,434,97
1,1601,1915,-314,0,33,43
1,1655,1493,162,8,522,93
1,1333,1405,-72,-1,530,99
-1,1894,2079,-185,0,-135,114
-1,1348,1186,162,-7,-313,92
1,1173,1408,-235,2,50,53
1,1466,1500,-34,0,18,47
1,1659,1511,148,0,146,123
0,1736,1876,-140,0,6,109
-1,1584,1770,-186,-1,-11,72
-1,1662,1662,0,-5,-121,56
1,1553,1458,95,-1,144,67
-1,1340,1415,-75,-2,-469,94
-1,1535,1715,-180,-2,6,76
-1,2242,1982,260,0,-362,112
1,1732,1719,13,-1,-58,69
-1,1642,1540,102,-11,-673,90
-1,1573,1704,-131,-10,-176,72
0,1750,1550,200,-2,-121,118
-1,1489,1429,60,-4,-155,72
1,1660,1657,3,-2,-96,65
1,1547,1531,16,3,184,77
-1,1504,1674,-170,-1,-258,131
1,2077,1770,307,2,71,63
-1,1323,1352,-29,0,-70,72
-1,1940,1836,104,1,22,42
1,1889,1987,-98,0,-39,93
1,1890,1908,-18,-1,-17,51
1,1743,1709,34,0,-1,65
1,1666,1521,145,6,845,117
-1,1583,1541,42,0,-45,82
-1,1307,1459,-152,-3,-194,70
1,1734,1726,8,1,97,58
1,1775,1670,105,3,154,71
1,1561,1452,109,-4,-62,47
-1,1851,1925,-74,-1,-47,48
1,1474,1500,-26,1,46,53
-1,1574,1768,-194,0,-113,72
1,1711,1566,145,1,3,105
-1,1486,1589,-103,1,29,48
-1,1874,2002,-128,4,255,76
1,1532,1425,107,6,302,63
-1,1644,1514,130,-4,79,64
-1,1680,1497,183,-10,-128,44
1,1896,1901,-5,-1,-156,179
1,1699,1842,-143,0,2,71
1,1619,1754,-135,0,1,63
-1,1491,1483,8,1,-205,104
1,1871,1666,205,-2,55,75
1,1638,1593,45,5,762,125
1,1722,1629,93,-2,179,67
1,1711,1539,172,1,22,49
-1,1743,1735,8,-6,-684,82
-1,1607,1753,-146,-2,-152,126
1,1858,2018,-160,5,67,45
-1,1559,1717,-158,-1,-65,62
1,1707,1740,-33,0,-10,67
-1,1760,1756,4,1,7,48
-1,1620,1666,-46,-1,58,56
1,1996,1973,23,-1,15,67
-1,1621,1732,-111,-7,-621,86
-1,1629,1682,-53,-3,-146,80
1,1783,1552,231,0,342,97
-1,1208,1608,-400,-6,-422,75
-1,1854,1713,141,2,65,62
-1,1500,1659,-159,-1,-214,82
-1,1643,1749,-106,0,-102,112
1,1544,1132,412,9,309,79
1,1643,1632,11,-1,-25,71
1,1478,1545,-67,0,22,69
1,1740,1719,21,4,165,55
1,1709,1651,58,-1,-64,57
1,1753,1754,-1,1,238,115
1,1512,1468,44,-1,223,101
-1,1724,1552,172,1,30,84
1,1557,1346,211,1,133,61
1,1717,1532,185,0,-11,77
1,1443,1500,-57,0,521,141
1,1780,1568,212,6,198,55
0,1809,1709,100,-4,-474,103
-1,1752,1665,87,0,-33,80
-1,1786,1688,98,0,3,64
1,1389,1203,186,5,647,83
1,1714,1664,50,4,97,55
-1,1501,1748,-247,-3,-94,60
1,1317,1275,42,-1,-27,71
-1,1788,1804,-16,-5,-161,62
-1,1435,1252,183,1,-41,80
1,1645,1611,34,0,307,111
-1,1797,2000,-203,-1,-14,68
1,1679,1737,-58,1,60,121
1,1569,1708,-139,2,192,91
-1,1466,1530,-64,-1,-300,88
1,1526,1399,127,6,91,41
-1,1576,1565,11,-2,-264,68
-1,1778,2006,-228,-4,-125,64
1,1745,1820,-75,-4,160,77
1,1777,1728,49,0,23,95
1,1723,1710,13,-14,-223,67
-1,1896,1901,-5,0,12,102
1,1364,1209,155,1,903,129
-1,1460,1417,43,-2,-433,74
1,1827,1626,201,-3,-39,43
-1,1693,1584,109,-1,2,48
-1,1406,1688,-282,-5,-167,68
-1,1515,1758,-243,-1,-139,102
-1,1762,2012,-250,0,-1,64
0,1700,1734,-34,-1,308,132
1,1275,1390,-115,-1,71,77
1,1500,1677,-177,-2,-79,65
-1,1398,1420,-22,1,-242,114
-1,1671,1388,283,-6,-202,72
-1,1286,1470,-184,-3,-80,54
-1,1550,1500,50,0,-41,135
-1,1563,1537,26,-13,-533,88
-1,1533,1666,-133,2,19,42
1,1748,1742,6,-1,-19,47
-1,1576,1538,38,-2,-115,68
0,1723,1526,197,0,104,132
-1,1664,1681,-17,-2,-470,116
1,1718,1787,-69,1,188,121
1,1764,1546,218,0,247,123
1,1628,1365,263,-2,-61,49
1,1780,1731,49,-4,126,129
-1,1521,1586,-65,0,-131,100
-1,1613,1701,-88,0,26,62
-1,1733,1796,-63,-8,-104,50
-1,1778,1810,-32,0,-119,116
1,1707,1269,438,-1,20,71
1,1752,1497,255,0,116,83
1,1723,1591,132,4,626,119
1,1709,1530,179,-5,-90,57
-1,1805,1723,82,2,122,78
1,1835,1762,73,-1,75,111
-1,1912,1885,27,-3,13,50
-1,1779,1811,-32,0,62,100
-1,1524,1715,-191,-9,-632,60
1,1806,1722,84,3,114,79
0,1681,1505,176,1,-566,169
1,1738,1792,-54,0,81,81
-1,1389,1381,8,-7,-313,56
-1,1717,1728,-11,-1,-293,168
1,1720,1518,202,2,627,117
1,1768,1666,102,0,37,77
1,1591,1561,30,1,21,61
-1,1584,1738,-154,0,-349,92
1,1375,1304,71,5,116,47
-1,1774,1731,43,-2,-49,50
1,1897,1619,278,0,379,149
-1,1763,1511,252,-1,-8,44
1,1713,1604,109,-1,-38,59
-1,1779,1751,28,-6,-525,86
1,2155,1900,255,4,129,53
-1,1343,1785,-442,-6,-70,42
-1,1353,1613,-260,-2,-76,66
-1,1231,1500,-269,-1,-63,94
-1,1770,1540,230,3,4,76
1,1356,1441,-85,2,81,53
1,1541,1409,132,1,120,59
1,1744,1762,-18,3,85,57
-1,1596,1721,-125,7,782,86
-1,1462,1676,-214,0,51,86
-1,1751,1577,174,1,61,116
-1,1620,1691,-71,-4,-12,52
-1,1726,1646,80,-1,-16,46
-1,1632,1629,3,-11,-592,84
1,1583,1619,-36,-1,-42,65
-1,1500,1881,-381,-1,-79,65
-1,1750,1755,-5,0,-112,134
-1,1820,1768,52,-1,-4,42
-1,1628,1701,-73,-7,-128,52
-1,1709,1464,245,-1,-92,62
1,1647,1314,333,2,74,47
1,1488,1340,148,5,164,55
1,1441,1325,116,-1,100,113
-1,1589,1612,-23,5,-70,56
1,1482,1531,-49,1,189,67
-1,1770,1790,-20,2,18,51
-1,1380,1450,-70,-12,-88,40
-1,1455,1652,-197,-2,-210,62
-1,1593,1720,-127,-1,-67,60
-1,1604,1729,-125,-3,-550,108
1,1601,1572,29,1,168,111
-1,1618,1341,277,0,63,52
-1,1510,1628,-118,-7,-85,54
-1,1622,1578,44,0,-5,118
-1,1671,1876,-205,-7,-115,44
-1,1712,1322,390,-4,-264,106
1,1797,1681,116,5,72,45
1,1601,1736,-135,-3,-17,65
1,1759,1801,-42,1,19,45
0,1733,1586,147,-2,23,114
-1,1759,1738,21,-3,-132,62
1,1816,1776,40,2,119,81
-1,1407,1252,155,-3,-12,48
1,1766,1740,26,1,92,97
1,1551,1642,-91,0,-1,93
1,1679,1500,179,3,182,89
-1,1717,1703,14,4,100,50
-1,1392,1598,-206,-4,-144,54
1,1721,1610,111,0,161,105
-1,1569,1378,191,-4,-677,118
1,1591,1644,-53,2,52,65
-1,2030,2161,-131,0,10,54
-1,1430,1272,158,2,109,74
1,1573,1242,331,-1,126,61
-1,1590,1726,-136,0,-231,134
1,1598,1375,223,1,117,61
1,1730,1776,-46,0,18,73
-1,1395,1684,-289,0,-332,98
-1,1421,1370,51,3,53,62
-1,1696,1729,-33,-1,-98,68
1,1582,1561,21,-3,353,155
1,1393,1593,-200,0,557,121
1,1257,1214,43,-5,-17,79
-1,1440,1521,-81,-1,-27,40
1,1541,1658,-117,-1,28,88
-1,1611,1771,-160,-6,-639,168
1,1546,1149,397,2,128,85
1,1780,1639,141,0,-66,115
-1,1739,1859,-120,-7,-140,48
-1,1710,1887,-177,-1,-4,52
-1,1738,1583,155,-2,-114,66
1,1542,1572,-30,3,119,67
-1,1576,1628,-52,-10,-266,67
1,1530,1686,-156,0,55,83
-1,1792,1705,87,-9,-133,102
-1,1688,1346,342,0,92,70
1,1882,1887,-5,0,157,85
1,1867,1731,136,-2,-40,59
1,1371,1181,190,4,137,47
-1,1579,1782,-203,-3,-144,76
0,1764,1742,22,0,14,78
-1,1714,1706,8,-5,-214,57
-1,1502,1569,-67,0,-39,52
1,1823,1749,74,-1,326,97
-1,1724,1874,-150,-3,-192,88
-1,1599,1712,-113,2,-17,62
-1,1874,1895,-21,-1,-49,54
-1,1567,1672,-105,-1,-115,52
-1,1823,1784,39,-2,-483,108
-1,1650,1493,157,1,40,70
-1,1500,1670,-170,-1,-32,56
1,1605,1500,105,4,-25,45
-1,1370,1603,-233,-1,-225,86
-1,1553,1555,-2,-1,18,58
-1,2023,1477,546,0,111,126
-1,1616,1862,-246,0,11,42
-1,1700,1672,28,-7,-361,122
1,1367,1004,363,8,115,41
1,1739,1749,-10,0,13,43
0,1880,1724,156,0,557,234
-1,1332,1500,-168,-4,-221,58
-1,1679,1499,180,0,-338,84
-1,1184,1601,-417,0,-23,58
1,1742,1763,-21,0,-8,114
-1,1449,1462,-13,-7,-140,58
-1,1903,1825,78,-5,5,44
1,1675,1717,-42,1,217,81
-1,1224,1576,-352,0,-86,55
1,1529,1263,266,-1,-21,67
-1,1872,2132,-260,-3,-84,54
1,1741,1637,104,3,288,91
-1,1332,1401,-69,1,-379,110
1,1882,1721,161,-1,-18,57
-1,1384,1554,-170,0,40,68
-1,1591,1665,-74,0,-65,70
-1,1493,1531,-38,-4,-284,110
1,1438,1042,396,9,519,79
-1,1781,1788,-7,-2,-130,80
1,2137,1867,270,3,150,59
1,1693,1727,-34,-2,-6,49
-1,1603,1595,8,-3,-205,142
1,1838,1889,-51,-4,-86,67
-1,1711,1889,-178,-1,-1245,180
-1,1827,2211,-384,-1,-32,52
-1,1489,1612,-123,-1,13,116
1,1526,1468,58,0,7,51
1,1752,1754,-2,0,108,113
1,1787,1701,86,-1,-32,55
-1,1772,1750,22,-1,-73,76
1,1422,1426,-4,4,186,45
0,2009,2172,-163,0,218,136
1,1863,1746,117,-1,13,49
1,1731,1509,222,-2,71,83
-1,1111,1322,-211,-1,-63,68
-1,1688,1767,-79,0,-62,81
1,2040,1740,300,12,301,55
1,1554,1424,130,5,96,47
-1,1674,1582,92,-1,-23,62
-1,1895,1702,193,-3,-176,108
-1,1821,1871,-50,-4,-118,50
-1,1502,1384,118,-11,-283,52
0,1719,1763,-44,2,-19,117
1,1575,1535,40,4,166,85
-1,1370,1362,8,2,-41,76
-1,1679,1776,-97,0,-95,74
1,1799,1607,192,13,221,51
1,1472,1386,86,12,171,45
-1,1604,1490,114,3,132,56
1,1877,1850,27,0,36,71
1,1672,1527,145,1,98,53
1,1280,1322,-42,1,369,73
-1,1882,1878,4,0,-108,78
-1,1743,1763,-20,-2,-159,86
-1,1470,1491,-21,-12,-145,44
-1,1596,1660,-64,0,-290,80
1,1260,1399,-139,2,40,47
1,1776,1786,-10,0,18,55
1,1812,1671,141,2,57,81
-1,1784,1895,-111,-2,55,92
1,1504,1693,-189,1,77,109
-1,1288,1280,8,3,-313,80
-1,1622,1469,153,-3,-125,76
-1,1517,1644,-127,0,-4,50
1,1429,1438,-9,2,109,59
1,1867,1597,270,0,3,43
-1,1601,1587,14,0,-110,108
-1,1681,1939,-258,-1,-63,66
1,1651,1510,141,0,42,45
-1,1288,1277,11,-10,-189,48
-1,1322,1729,-407,-1,5,62
1,1943,1677,266,1,33,61
1,1500,1349,151,8,673,79
1,1599,1461,138,2,-149,147
-1,1878,1571,307,-9,-1055,154
1,1948,1673,275,2,110,57
1,1500,1510,-10,-3,-198,69
1,1363,1204,159,-10,-325,61
0,1503,1590,-87,0,282,127
-1,1520,1490,30,-1,-5,50
-1,1310,1340,-30,2,25,168
-1,1590,1500,90,-2,-67,54
1,1424,1329,95,5,343,111
-1,1590,1370,220,0,-2,68
-1,1620,1581,39,-2,-230,72
1,1306,1436,-130,5,699,121
1,1740,1421,319,0,20,45
1,1599,1679,-80,1,20,59
1,1581,1620,-39,-1,178,78
0,1587,1505,82,-2,-159,112
1,1315,1432,-117,0,-34,105
1,1618,1583,35,1,32,53
1,1583,1618,-35,-2,23,43
1,1725,1577,148,4,364,71
1,1833,1649,184,-1,-46,81
1,1606,1595,11,-1,87,55
1,1519,1500,19,0,249,101
1,1606,1595,11,-4,109,73
-1,1227,1385,-158,3,-91,134
-1,1571,1802,-231,0,20,52
-1,1607,1595,12,1,38,46
1,1696,1454,242,2,114,63
-1,1595,1606,-11,3,81,54
-1,1606,1595,11,-2,-756,104
1,1687,1566,121,0,157,79
-1,1508,1585,-77,0,-42,64
1,1607,1617,-10,-3,-21,41
-1,1695,1558,137,-2,-357,102
1,1610,1679,-69,0,-21,69
1,1224,1381,-157,0,22,65
-1,1618,1606,12,-10,-88,48
1,1606,1521,85,2,106,63
1,1662,1337,325,13,963,77
1,1363,1258,105,4,486,89
1,1617,1607,10,0,-12,57
1,1449,1606,-157,-3,-3,43
1,1680,1574,106,0,311,121
1,1637,1586,51,0,-53,71
1,1593,1499,94,-1,-23,55
-1,1646,1720,-74,-3,-128,82
-1,1586,1637,-51,-9,-414,64
1,1566,1687,-121,2,2,45
1,1646,1577,69,-2,-135,79
1,1687,1621,66,1,67,73
-1,1357,1298,59,-11,-359,136
1,1655,1581,74,-2,-151,139
1,1665,1503,162,-2,24,45
1,1542,1848,-306,-3,135,83
1,1491,1601,-110,-6,36,113
-1,1836,1748,88,0,-102,72
-1,1673,1852,-179,-1,-334,104
-1,1572,1663,-91,1,84,58
1,1841,1599,242,0,135,101
1,1663,1572,91,1,141,41
-1,1564,1671,-107,-1,-237,100
1,1279,1720,-441,2,158,85
-1,1705,1853,-148,1,5,46
1,1679,1555,124,5,90,41
-1,1625,1531,94,-7,-167,58
1,1672,1568,104,1,34,49
-1,1249,1377,-128,-12,-881,92
-1,1555,1679,-124,-9,-470,100
1,1676,1399,277,3,590,89
1,1859,1693,166,-3,6,47
1,1686,1560,126,1,-43,45
1,1743,1738,5,-7,-61,45
1,1553,1693,-140,2,67,47
1,1474,1379,95,8,134,45
-1,1678,1568,110,-4,-54,40
-1,1309,1248,61,-3,-212,58
1,1582,1664,-82,4,133,53
1,1757,1771,-14,0,115,85
-1,1680,1548,132,-4,-125,68
-1,1664,1582,82,-4,-66,54
-1,1615,1647,-32,-1,-79,64
1,1595,1651,-56,4,210,83
1,1529,1417,112,0,-827,151
-1,1715,1395,320,5,-525,124
1,1708,1709,-1,4,99,45
-1,1735,1698,37,-3,22,50
1,1754,1865,-111,0,-23,45
1,1952,1830,122,2,514,103
1,1580,1429,151,6,406,73
-1,1374,1363,11,0,15,56
-1,1589,1657,-68,-2,78,102
-1,1823,1960,-137,-1,-297,92
1,1666,1580,86,2,560,101
-1,1851,1605,246,-5,-219,81
1,1723,1612,111,2,14,43
1,1682,1564,118,-3,22,83
-1,1472,1483,-11,-1,-31,72
1,1564,1682,-118,3,347,83
1,1875,1761,114,1,120,97
-1,1624,1833,-209,-9,-229,54
-1,0,1594,-1594,0,-21,58
1,1668,1578,90,-4,37,61
1,1578,1668,-90,-1,-46,55
-1,1638,1603,35,0,-1,52
-1,1654,1570,84,-2,-82,58
1,1839,1841,-2,0,239,85
-1,1466,1643,-177,-1,-142,62
-1,1641,1583,58,-5,-67,51
-1,1629,1596,33,0,-63,98
1,1565,1500,65,0,28,59
-1,1690,1917,-227,-1,-41,62
1,1650,1494,156,0,-18,61
-1,1608,1617,-9,-2,-305,81
1,1268,1256,12,-5,61,53
-1,1829,1850,-21,0,-9,86
1,1713,1500,213,0,27,53
1,1771,1832,-61,4,124,55
1,1628,1597,31,0,-6,51
1,1832,1771,61,1,469,123
1,1468,1405,63,0,42,68
-1,1983,1815,168,-4,-255,88
1,1588,1637,-49,3,431,125
1,1718,1923,-205,6,831,131
1,1806,1795,11,-3,-10,59
1,1860,1818,42,11,474,59
1,1649,1459,190,6,207,55
-1,1635,1611,24,0,-89,58
1,1594,0,1594,-3,52,69
-1,1611,1635,-24,8,115,60
0,1297,1479,-182,-3,-269,96
-1,1535,1712,-177,3,137,60
1,1587,1389,198,7,316,59
-1,1645,1622,23,-5,-159,56
0,1904,1735,169,1,-591,203
-1,1622,1645,-23,-1,7,58
1,1785,1910,-125,2,205,107
-1,1655,1612,43,3,-88,74
0,1500,1339,161,0,-350,153
-1,1612,1655,-43,1,-19,40
-1,1778,1710,68,-4,-172,64
-1,1664,1603,61,2,-144,70
1,1603,1664,-61,11,341,61
1,1895,1799,96,0,387,161
-1,1753,1779,-26,-5,-80,70
-1,1652,1616,36,-1,-599,110
-1,1738,1503,235,0,-234,118
1,1419,1505,-86,2,764,103
-1,1380,1593,-213,-2,-408,76
1,1640,1627,13,-6,-162,45
1,1791,1903,-112,0,151,71
1,1741,1898,-157,-1,71,131
0,1473,1345,128,0,127,149
-1,1739,1649,90,0,-18,68
1,1617,1650,-33,12,305,45
1,1650,1617,33,-3,20,63
1,1396,1589,-193,0,5,63
1,1641,1610,31,1,37,65
-1,1888,1805,83,-2,-378,114
-1,1629,1639,-10,-1,8,62
-1,1819,1822,-3,-3,-89,60
1,1649,1618,31,6,189,47
1,1618,1649,-31,9,288,57
1,1726,1617,109,2,115,67
-1,1627,1743,-116,-1,12,120
-1,1638,1609,29,-3,-252,64
1,1819,1874,-55,0,310,91
1,1884,1621,263,3,225,83
1,1620,1626,-6,-2,692,91
-1,1681,1887,-206,0,-81,112
-1,1616,1631,-15,-7,-42,44
1,1861,1831,30,0,75,83
1,1617,1629,-12,-4,-102,45
-1,1876,1490,386,-1,-112,152
1,1628,1618,10,4,62,51
-1,1307,1635,-328,-8,-296,56
1,1821,1872,-51,7,36,45
-1,1628,1692,-64,0,-354,98
1,1638,1608,30,-3,-39,55
1,1757,1997,-240,0,-50,71
-1,1859,1833,26,-1,-809,112
1,1599,1648,-49,6,291,63
-1,1240,1297,-57,2,-104,68
1,1733,1663,70,-3,-2,77
1,1893,1676,217,-5,22,85
-1,1636,1611,25,-8,-287,60
1,1845,1847,-2,-1,-7,67
1,1652,1488,164,1,117,70
-1,1645,1601,44,-22,-281,40
1,1414,1622,-208,0,-36,93
1,1592,1655,-63,4,169,77
-1,1856,2041,-185,-1,-12,58
-1,1776,1979,-203,0,2,64
1,1663,1583,80,-3,-199,67
1,1469,1507,-38,5,394,77
1,1575,1671,-96,0,131,71
-1,1707,1618,89,1,22,48
1,1850,2048,-198,0,-19,51
-1,1588,1658,-70,3,37,66
-1,2028,1866,162,1,26,74
1,1654,1914,-260,7,125,53
1,1765,1689,76,-3,11,41
-1,1561,1629,-68,0,1,42
1,1666,1580,86,-1,-57,43
-1,1598,1684,-86,-4,-163,60
1,1572,1674,-102,-7,-101,45
1,1882,2010,-128,-5,136,113
-1,1674,1572,102,-8,-325,103
-1,1656,1685,-29,-1,-186,100
1,1993,1896,97,-6,59,63
-1,1598,1648,-50,-8,-193,50
1,1632,1684,-52,5,86,63
-1,1888,2002,-114,0,-55,64
-1,1657,1589,68,-3,-519,88
1,1680,1751,-71,1,74,61
-1,1601,1645,-44,0,56,62
-1,1654,1613,41,-8,-256,56
1,2011,1591,420,-1,39,71
-1,1371,1217,154,-2,-18,52
0,1482,1350,132,0,148,110
-1,1500,1698,-198,-1,-49,66
-1,1416,1280,136,1,105,64
-1,1589,2013,-424,0,-46,50
1,1621,1142,479,7,145,53
1,1615,1631,-16,1,67,55
0,1785,1686,99,-1,-27,46
1,1693,1589,104,0,551,151
1,1621,1626,-5,-3,118,84
1,2015,1587,428,1,72,81
-1,1467,1676,-209,-1,-156,66
1,1738,1693,45,-3,-134,89
0,1716,1664,52,2,106,81
1,1984,1770,214,1,166,73
-1,1641,1605,36,-9,-149,48
0,1500,1679,-179,4,-133,193
1,1793,1764,29,0,10,113
1,2017,1585,432,0,112,69
-1,1622,1646,-24,0,-13,74
1,1630,1617,13,0,190,91
-1,1583,2019,-436,0,-71,68
1,1312,1398,-86,0,65,75
-1,1607,1640,-33,-3,-82,44
1,2021,1581,440,-1,225,115
1,1990,1756,234,-1,-16,57
-1,1580,2023,-443,0,-583,92
-1,1617,1662,-45,-4,-206,70
-1,1446,1475,-29,6,70,46
-1,1483,1439,44,1,-233,120
1,1611,1576,35,0,22,48
1,1623,1133,490,0,37,51
1,1653,1500,153,11,1126,103
1,1461,1625,-164,-2,20,43
1,1585,1500,85,-1,4,67
1,1814,1656,158,0,286,99
1,1484,1505,-21,-2,59,85
1,1756,1269,487,-1,45,51
-1,1515,1621,-106,0,6,42
1,1618,1643,-25,-3,0,67
-1,1620,1659,-39,0,-618,112
-1,1677,1538,139,-1,-224,108
-1,1478,1715,-237,-3,-85,48
1,1500,1549,-49,0,216,69
1,1658,1576,82,-1,-53,57
1,1346,1385,-39,0,-29,77
1,1754,1807,-53,2,48,81
-1,1496,1658,-162,-1,-771,138
1,1650,1826,-176,0,-48,81
-1,1667,1566,101,-1,-51,66
1,1616,1630,-14,3,46,49
1,1582,1653,-71,-1,390,121
1,1653,1582,71,0,393,149
1,1464,1489,-25,-1,125,69
1,1809,1666,143,0,67,61
-1,1288,1474,-186,0,-131,66
0,1572,1662,-90,0,-468,84
1,1618,1641,-23,1,351,79
1,1473,1540,-67,-7,-221,81
1,1575,1659,-84,8,903,125
-1,1979,1453,526,0,-305,110
-1,1550,1472,78,1,-35,74
-1,1646,1590,56,-13,-447,72
-1,1701,1774,-73,1,-198,93
1,1816,1534,282,0,42,65
0,1634,1603,31,1,-41,155
1,1603,1634,-31,12,654,57
1,1633,1604,29,5,124,57
-1,1624,1768,-144,-9,-170,52
-1,1528,1820,-292,-4,-45,48
1,1594,1642,-48,8,195,51
-1,1649,1641,8,0,-52,66
0,1642,1594,48,-9,-69,157
1,1689,1579,110,1,-23,45
-1,1400,1898,-498,-1,-54,100
-1,1833,1834,-1,0,-6,46
1,1630,1595,35,2,281,81
-1,1546,1285,261,-1,-34,74
1,1585,1619,-34,-7,94,95
1,1954,1825,129,-1,95,109
-1,1648,1665,-17,0,-4,82
1,1850,1592,258,0,-190,91
-1,1653,1638,15,0,1,112
-1,1607,1598,9,-10,-482,62
1,1631,1665,-34,-3,-51,41
-1,1348,1935,-587,-4,-237,70
1,1596,1609,-13,0,12,49
1,1855,1793,62,1,43,59
-1,1609,1596,13,-3,-84,70
-1,1607,1598,9,0,-177,86
1,1866,1783,83,3,247,89
1,1972,1722,250,0,3,91
-1,1598,1607,-9,-8,-219,66
-1,1475,1571,-96,-13,-282,46
-1,1876,1774,102,0,-483,148
1,1588,1596,-8,0,179,105
1,1518,1175,343,9,354,53
1,1649,1641,8,0,2,61
-1,1599,1606,-7,-2,-55,46
1,1789,1717,72,0,279,97
1,1626,1578,48,1,45,60
1,1415,1494,-79,0,415,107
-1,1610,1529,81,-7,-467,148
1,1642,1308,334,-3,-43,53
-1,1568,1635,-67,-1,-284,66
-1,1362,1469,-107,-10,-185,52
-1,1618,1587,31,0,3,82
1,1587,1541,46,1,41,53
1,1687,1817,-130,4,95,45
1,1434,1536,-102,2,58,57
-1,1644,1559,85,-1,-428,88
-1,1708,1799,-91,-2,-55,42
1,1808,1700,108,1,147,119
-1,1573,1631,-58,1,67,70
1,1810,1480,330,-3,-22,43
-1,1562,1537,25,-1,-95,98
-1,1408,1512,-104,0,-15,46
1,1639,1564,75,0,-120,101
-1,1487,1597,-110,0,133,108
-1,1555,1648,-93,5,178,84
1,1585,1599,-14,2,145,51
-1,1717,1741,-24,-1,-30,61
1,1476,1458,18,8,776,117
1,1656,1547,109,-2,-59,77
-1,1692,1816,-124,-2,-22,82
1,1813,1647,166,-4,-42,67
1,1428,1373,55,0,145,69
1,1382,1669,-287,1,29,45
1,1663,1540,123,-2,-167,79
-1,1671,1698,-27,0,16,106
1,1800,1702,98,0,-14,73
1,1497,1587,-90,-2,-2,47
-1,1824,1684,140,2,-142,84
1,1532,1670,-138,3,515,83
1,1531,1051,480,1,60,55
1,1960,1808,152,4,461,89
-1,1675,1751,-76,0,29,76
-1,1700,1977,-277,-1,-47,56
1,1665,1435,230,-1,555,159
1,1823,2001,-178,-1,191,87
1,1540,1642,-102,4,269,57
1,1427,1484,-57,-3,-128,45
1,1515,1676,-161,4,881,131
1,1801,1967,-166,-1,-18,43
-1,1543,1596,-53,-3,-213,148
-1,1628,1553,75,-4,-174,54
1,1532,1049,483,-5,-176,57
1,1951,1818,133,3,117,61
-1,1446,1420,26,0,-27,48
1,1566,1615,-49,4,442,73
1,1480,1442,38,1,72,64
-1,1810,1958,-148,0,97,104
-1,1585,1661,-76,-1,-17,68
-1,1562,1769,-207,0,-90,66
-1,1400,1575,-175,0,7,60
1,1490,1229,261,4,586,109
1,1658,1771,-113,1,37,51
-1,1820,1949,-129,-3,-325,90
0,1817,1845,-28,-5,-214,159
-1,1595,1808,-213,-1,-238,100
-1,1696,1981,-285,-9,2,120
1,1956,1812,144,-6,66,69
-1,1965,1803,162,2,-22,82
1,1870,1708,162,1,296,105
-1,1474,1551,-77,1,130,98
1,1702,1876,-174,1,206,123
-1,1669,1576,93,1,128,74
1,1813,1590,223,9,348,53
1,1570,1282,288,3,76,45
-1,1805,1963,-158,-1,-243,86
-1,1458,1490,-32,0,-5,60
-1,1585,1818,-233,-10,-299,112
1,1487,1210,277,5,266,65
-1,1757,1672,85,-2,-144,104
1,1969,1798,171,0,-33,67
-1,1579,1818,-239,-1,-327,110
1,1443,1331,112,5,108,43
1,1798,1969,-171,-1,-25,65
-1,1559,1569,-10,0,-188,70
1,1494,1540,-46,-1,-13,41
1,1822,1574,248,2,70,103
1,1593,1394,199,-1,-88,154
1,1953,1815,138,9,374,61
1,1561,1637,-76,1,31,73
-1,1598,1692,-94,-4,-106,58
-1,1808,1960,-152,0,-47,86
1,1570,1827,-257,1,348,119
-1,1733,1772,-39,0,39,64
-1,1760,1666,94,0,-172,108
1,1412,1572,-160,1,85,55
-1,1500,1632,-132,-7,-241,56
-1,1588,1700,-112,-1,-169,172
1,1841,1599,242,2,152,85
-1,1603,1836,-233,4,500,130
-1,1778,1557,221,-1,79,98
1,1967,1801,166,0,60,89
1,1580,1588,-8,1,20,57
-1,1642,1603,39,-5,-174,64
-1,1794,1973,-179,-3,-114,64
1,1765,1434,331,-2,19,137
1,1400,1374,26,-5,14,83
0,1556,1612,-56,0,337,173
-1,1498,1447,51,5,357,84
-1,1325,1181,144,-5,-807,108
1,1979,1788,191,2,160,53
1,1818,1744,74,2,54,40
1,1450,1357,93,-2,159,77
-1,1782,1985,-203,-1,-110,66
1,1514,1500,14,0,13,51
1,1609,1638,-29,-1,-22,45
-1,1610,1558,52,-10,-111,42
1,2027,1580,447,-1,16,59
1,1735,1827,-92,-3,-133,61
-1,1439,1347,92,-1,-31,58
-1,1990,1777,213,-2,4,50
1,1607,1560,47,8,239,81
-1,1578,2029,-451,-1,-48,62
1,1844,1819,25,0,36,65
1,1685,1625,60,4,93,53
-1,1551,1617,-66,12,245,40
1,1630,1615,15,-2,54,129
1,1984,1768,216,1,37,51
1,1782,1641,141,0,5,61
-1,1556,1612,-56,8,273,68
-1,1855,1500,355,0,4,46
1,1349,1459,-110,-2,1,58
-1,1501,1500,1,0,4,68
1,1907,1718,189,0,55,75
-1,1388,1478,-90,0,159,132
1,1986,1504,482,1,-13,45
1,1619,1332,287,-1,-23,67
-1,1496,1438,58,-3,-539,118
-1,1712,1913,-201,0,-104,142
-1,1671,1694,-23,-2,-156,79
0,1987,2113,-126,0,-5,99
1,1692,1564,128,0,109,107
1,1506,1591,-85,1,7,45
-1,1538,1630,-92,-2,-9,66
-1,1659,1613,46,2,21,70
1,1610,1217,393,0,128,83
-1,1363,1470,-107,-3,-53,60
1,1638,1530,108,-1,62,49
-1,1623,1283,340,0,-145,164
-1,1631,1790,-159,0,-48,168
1,1621,1547,74,6,155,43
1,1574,1332,242,2,154,63
-1,1362,1479,-117,8,384,88
1,1704,1661,43,7,217,63
-1,2108,1992,116,0,-47,72
1,1631,1537,94,2,244,85
1,1520,1370,150,8,429,69
-1,1587,1823,-236,-3,-19,48
1,1993,1681,312,5,20,45
-1,1529,1639,-110,4,141,48
-1,1645,1949,-304,-1,13,66
-1,1617,1625,-8,0,6,90
-1,1243,1500,-257,4,-55,80
-1,1788,1836,-48,2,55,58
1,1361,1312,49,1,129,44
-1,1524,1952,-428,-5,-38,76
1,1777,1571,206,0,0,55
0,1846,1763,83,0,-21,73
1,1593,1422,171,1,465,127
1,1744,1576,168,-3,6,49
-1,1407,1304,103,-4,-119,46
1,1220,1405,-185,4,991,137
1,1763,1965,-202,2,20,45
1,1302,1372,-70,7,252,53
-1,1569,1757,-188,2,-155,96
-1,1674,1800,-126,2,3,104
-1,1852,1749,103,-1,-52,76
0,1795,1839,-44,-1,-121,132
1,1562,1784,-222,0,18,79
1,1945,1781,164,5,455,107
1,1780,1838,-58,0,-1,65
1,1918,1914,4,0,102,81
-1,1582,1239,343,-2,-92,58
-1,1316,1226,90,0,-40,106
1,1522,1956,-434,-1,-12,77
1,1825,1807,18,0,33,79
-1,1167,1557,-390,0,327,104
-1,1416,1607,-191,-9,-483,100
-1,1523,1542,-19,-1,-54,64
-1,1367,1512,-145,-4,-176,70
-1,1545,1934,-389,-5,-59,64
-1,1336,1455,-119,-3,-89,54
-1,1693,1734,-41,-3,12,42
1,1276,1273,3,6,240,51
1,1786,1835,-49,0,1,51
0,1937,1869,68,0,455,114
1,1372,1211,161,6,79,43
-1,1774,1952,-178,-1,-125,96
-1,1233,1297,-64,-9,-369,78
1,1560,1164,396,7,483,97
-1,1903,2065,-162,-3,-178,114
-1,1871,1934,-63,-8,-75,40
1,1944,1863,81,0,6,51
-1,1744,1677,67,-5,-248,84
1,1863,1944,-81,0,-152,103
-1,1379,1202,177,1,18,46
-1,1161,1562,-401,-3,2,40
-1,1223,1360,-137,-1,-10,48
1,1930,1876,54,2,190,83
1,2073,1897,176,0,-36,65
-1,1768,1839,-71,2,-33,138
1,1368,1214,154,0,122,71
1,1243,1513,-270,9,326,69
1,1565,1158,407,5,191,57
-1,1837,1796,41,0,-65,62
1,1638,1651,-13,2,91,55
-1,1156,1567,-411,-4,-356,90
-1,1542,1949,-407,0,-97,76
1,1949,1542,407,0,65,77
-1,1673,1657,16,-1,-123,148
-1,1369,1553,-184,3,-26,56
1,1959,1891,68,1,160,97
1,1640,1649,-9,3,14,41
1,1206,1376,-170,-4,-65,49
1,1358,1226,132,0,1,51
1,1743,1552,191,-1,-17,51
-1,1404,1523,-119,-5,-521,100
-1,1397,1194,203,-2,-382,80
1,1366,1540,-174,-3,-156,75
1,1638,1651,-13,0,21,55
1,1823,1217,606,4,175,65
1,1605,1587,18,5,-10,41
-1,1324,1233,91,-5,-396,66
1,1867,1918,-51,0,-103,97
1,1690,1494,196,0,80,69
1,1521,1384,137,3,91,55
-1,1708,1711,-3,-1,-44,74
1,1380,1550,-170,-1,-23,59
-1,1548,1535,13,-2,-22,70
1,1824,1454,370,4,457,103
1,1529,1376,153,-1,-44,69
1,1882,1900,-18,-4,-21,45
-1,1213,1369,-156,-3,-959,96
1,1852,1929,-77,1,24,71
1,1696,1484,212,-7,86,59
1,1446,1507,-61,0,531,81
-1,1649,1558,91,0,2,54
1,1537,1722,-185,0,31,61
-1,1534,1397,137,-2,-144,71
-1,1546,1551,-5,-3,-55,70
-1,1675,1661,14,-6,-307,64
-1,1705,1556,149,-1,-92,60
1,1495,1482,13,1,272,117
1,1916,1865,51,0,-11,59
-1,1384,1296,88,1,-431,154
-1,1969,1599,370,1,29,106
-1,1973,1893,80,-6,-341,122
-1,1573,1690,-117,0,-41,48
1,1695,1153,542,8,324,65
-1,1576,1360,216,2,83,78
-1,1380,1205,175,-2,-8,71
-1,1749,1701,48,-4,-53,48
1,1951,1858,93,0,507,125
-1,1697,1565,132,-3,-95,120
1,1572,1636,-64,-1,-66,63
-1,1519,1500,19,4,210,64
-1,1925,1855,70,1,6,48
1,1469,1536,-67,-1,-8,41
-1,1850,1960,-110,-4,-581,102
1,1297,1387,-90,11,240,49
1,1968,1843,125,-7,204,96
1,1355,1223,132,3,92,45
-1,1582,1682,-100,-6,-388,87
1,1826,1556,270,3,117,89
1,1868,1805,63,3,171,67
-1,1482,1571,-89,-4,-132,67
-1,1728,1947,-219,-2,-124,92
1,1690,1573,117,2,83,73
1,1501,1505,-4,-3,-56,129
1,1719,1736,-17,0,21,43
-1,1573,1690,-117,-2,-87,110
-1,1860,1836,24,-2,-85,66
-1,1365,1625,-260,-2,-110,56
-1,1730,1724,6,4,178,62
-1,1578,1511,67,0,-101,83
1,1796,1584,212,-1,96,49
1,1432,1691,-259,0,-17,69
1,1630,1359,271,7,228,49
1,1505,1463,42,-1,51,82
-1,1579,1801,-222,0,-96,94
1,1482,1449,33,14,440,53
1,1564,1698,-134,0,-12,45
1,1683,1581,102,0,464,105
-1,1353,1634,-281,-4,-54,42
1,1504,1356,148,12,588,65
1,1518,1347,171,-1,-70,87
1,1847,1570,277,0,2,77
1,1572,1691,-119,3,43,45
1,1831,1482,349,2,30,129
-1,1697,1826,-129,1,24,54
1,1676,1588,88,-4,140,105
-1,1345,1806,-461,-1,-233,72
-1,1377,1333,44,3,-299,128
-1,1351,1386,-35,-1,-208,89
-1,1907,1775,132,0,-15,50
-1,1709,1651,58,0,-24,72
1,1682,1723,-41,1,62,67
1,1579,1506,73,2,8,41
-1,1477,1808,-331,0,-62,78
-1,1164,1320,-156,3,48,67
1,1579,1684,-105,0,59,81
1,1312,1453,-141,0,102,63
1,1745,1502,243,5,531,107
-1,1857,1958,-101,0,7,50
1,1670,1594,76,0,191,89
-1,1346,1570,-224,0,-180,76
1,1966,1851,115,1,133,89
1,1664,1696,-32,2,171,55
-1,1614,1546,68,-1,-479,150
-1,1843,1974,-131,-2,-609,142
1,1397,1449,-52,0,48,63
1,1685,1826,-141,1,32,53
-1,1473,1814,-341,-4,-118,58
-1,1585,1679,-94,-3,-373,134
-1,1683,1677,6,6,180,102
-1,1273,1606,-333,-4,-216,78
1,1719,1671,48,1,136,87
-1,1825,1836,-11,-13,-249,48
1,1735,1464,271,1,35,45
-1,1500,1409,91,-10,-984,94
-1,1500,1818,-318,-4,-177,64
1,1687,1576,111,0,23,63
1,1559,1600,-41,1,57,63
1,1479,1834,-355,0,263,103
-1,1568,1695,-127,0,-52,72
-1,1493,1327,166,-1,-121,104
1,1688,1671,17,0,89,59
1,1821,1571,250,-1,145,59
1,1282,1321,-39,-1,82,87
-1,1206,1772,-566,-5,-593,92
1,1702,1561,141,-1,52,71
-1,1269,1750,-481,-10,-532,70
-1,1709,1650,59,-3,-224,68
-1,1567,1826,-259,0,-16,85
1,1651,1589,62,-1,99,147
-1,1553,1709,-156,-2,-135,74
1,1699,1728,-29,-6,154,69
1,1197,1776,-579,-1,-117,91
1,1663,1696,-33,-5,-565,137
-1,1715,1547,168,-3,-101,64
1,1267,1271,-4,0,136,69
-1,1563,1699,-136,-10,-380,88
1,1811,1392,419,4,327,81
-1,1674,1661,13,3,17,42
1,1752,1500,252,4,139,49
1,1452,1295,157,2,265,71
1,1507,1470,37,-3,-221,89
1,1639,1518,121,0,83,79
-1,1493,1645,-152,-3,-53,48
-1,1592,2043,-451,1,57,78
-1,1460,1761,-301,-1,-453,122
-1,1416,1757,-341,-11,-192,42
1,2043,1592,451,2,94,103
1,1405,1425,-20,-1,-26,115
1,1534,1587,-53,0,-59,53
1,1768,1694,74,-1,-2,45
1,1547,1156,391,-2,65,49
1,1716,1390,326,-5,-57,49
1,1342,1339,3,-2,-21,51
1,1768,1456,312,2,403,85
1,1635,1712,-77,0,78,67
1,1299,1367,-68,0,-41,93
-1,1619,1714,-95,0,-361,122
-1,1575,1660,-85,-6,-336,152
1,1527,1675,-148,0,-10,63
-1,1581,1556,25,-4,-84,54
-1,1281,1598,-317,1,-8,58
1,1100,1232,-132,-2,130,75
-1,1358,1500,-142,-4,-459,178
-1,1550,1568,-18,0,-114,72
1,1760,1497,263,1,24,43
1,1452,1545,-93,-4,106,121
-1,1814,1486,328,-6,-323,56
1,1977,1579,398,0,-4,43
1,1538,1166,372,0,35,77
-1,1659,1500,159,-2,-181,58
1,1541,1577,-36,1,23,53
1,1800,1476,324,-1,59,89
-1,1554,1773,-219,-4,-82,72
1,1722,1480,242,5,421,103
1,1774,1467,307,0,382,149
-1,1350,1617,-267,5,-83,92
1,1500,1386,114,6,668,91
1,1656,1654,2,0,26,73
-1,1441,1500,-59,1,221,98
-1,1265,1377,-112,2,78,70
1,1792,1506,286,2,317,135
0,2045,1706,339,0,-54,140
-1,1473,1803,-330,-2,-243,110
1,1765,1450,315,7,115,51
-1,1731,1873,-142,-1,-200,138
-1,1417,1520,-103,-1,-364,84
1,1953,1780,173,0,11,41
1,1117,1285,-168,-2,465,127
1,1378,1213,165,2,-3,73
-1,1591,1341,250,-1,-53,54
1,1769,1446,323,1,101,69
1,1306,1500,-194,6,179,45
1,1527,1409,118,-1,87,73
1,1634,1554,80,-11,-103,49
1,1881,1725,156,-2,-1,85
1,1530,1405,125,-6,-383,69
1,1806,1470,336,-3,-14,49
1,1960,1769,191,2,33,57
-1,1478,1415,63,3,-106,116
-1,1573,1542,31,-2,-52,64
-1,1538,1381,157,-1,-19,62
1,1381,1517,-136,2,62,59
-1,1912,1778,134,-9,-11,40
1,1609,1680,-71,-2,-147,95
-1,1759,1685,74,1,33,76
-1,1700,1546,154,3,-221,106
-1,1795,1897,-102,0,-17,44
-1,1404,1392,12,0,-15,52
1,1450,1352,98,1,459,127
1,1911,1862,49,0,5,55
1,1378,1626,-248,3,33,43
-1,1905,1888,17,-3,37,92
-1,1490,1515,-25,-4,-543,104
-1,1684,1728,-44,1,45,54
1,1523,1746,-223,4,101,61
-1,1620,1602,18,-1,-37,64
1,1449,1413,36,2,95,69
1,1569,1284,285,3,108,49
-1,1435,1545,-110,-6,-40,40
1,1368,1262,106,-7,-90,51
-1,1446,1625,-179,-1,13,44
-1,1527,1359,168,5,59,64
-1,1542,1738,-196,1,-123,62
-1,1422,1500,-78,3,59,78
-1,1500,1566,-66,1,249,92
1,1569,1500,69,5,56,51
-1,1536,1674,-138,0,-59,72
1,1397,1523,-126,-1,116,99
1,1403,1380,23,-1,-68,65
1,1251,1439,-188,7,91,41
1,1594,1744,-150,2,152,69
-1,1312,1584,-272,-2,-114,96
1,1556,1465,91,0,649,129
1,1663,1458,205,-4,153,79
1,1777,1553,224,2,90,61
-1,1573,1672,-99,-1,-29,42
1,1647,1278,369,0,4,71
-1,1529,1681,-152,-8,-264,72
-1,1727,1612,115,0,-1,70
-1,1640,1415,225,0,-7,54
-1,1636,2006,-370,-1,-36,130
1,1596,1540,56,-2,-106,69
-1,1491,1578,-87,-8,-344,70
-1,1500,1642,-142,-9,-518,76
1,1522,1372,150,4,110,45
1,1621,1465,156,0,-5,43
1,1574,1680,-106,3,72,51
1,1688,1639,49,2,79,81
1,1575,1621,-46,0,-7,73
1,1528,1325,203,2,121,75
1,1681,1384,297,1,164,73
-1,1106,1753,-647,-6,-173,58
-1,1456,1628,-172,1,43,70
1,1629,1712,-83,-3,0,71
1,1639,1604,35,-3,-23,49
1,1416,1280,136,-1,-103,75
1,1746,1698,48,-1,-58,81
-1,1594,1649,-55,-4,-285,74
-1,1534,1756,-222,-1,-50,58
1,1649,1594,55,-2,-108,67
1,1417,1505,-88,-3,22,63
1,1927,1822,105,-4,285,101
1,1797,1368,429,0,58,95
1,1477,1478,-1,2,603,135
-1,1792,1884,-92,0,143,162
1,1645,1668,-23,5,235,85
-1,1935,1814,121,0,-39,112
1,1667,1575,92,5,26,41
-1,1586,1761,-175,-1,-121,104
1,1762,1575,187,0,71,79
-1,1573,2134,-561,-1,-75,53
-1,1584,1658,-74,-1,-41,62
1,1665,1686,-21,0,161,99
1,1480,1352,128,1,41,63
1,1853,1718,135,-1,-28,61
-1,1625,1845,-220,-3,-152,80
-1,1569,1768,-199,0,-21,60
-1,1433,1448,-15,0,-322,112
-1,1634,1530,104,0,-4,66
-1,1829,1921,-92,0,-78,74
1,1529,1266,263,2,42,51
1,1774,1563,211,0,31,47
1,1522,1570,-48,-2,-76,43
1,1558,1779,-221,1,10,59
-1,1580,1489,91,-1,-166,58
-1,1718,1821,-103,0,31,98
1,1799,1451,348,-1,-28,53
-1,1601,1767,-166,-1,-61,66
-1,1761,1576,185,1,92,70
1,1409,1393,16,-3,-413,105
1,1462,1421,41,5,406,89
1,1328,1099,229,1,618,115
-1,1477,1673,-196,0,7,54
1,1534,1468,66,-2,-24,67
-1,1593,1743,-150,-7,-87,43
1,1703,1874,-171,1,4,59
1,1697,1675,22,0,7,53
0,1676,1448,228,0,-62,103
1,1619,1726,-107,0,-18,87
-1,1750,1586,164,0,8,52
-1,1665,1708,-43,0,-87,148
1,1774,1594,180,1,145,85
-1,1533,1688,-155,-7,-220,72
1,1602,1733,-131,-1,-2,51
1,1448,1802,-354,2,45,137
1,1866,1504,362,0,10,63
-1,1929,2116,-187,-1,13,102
1,1319,1338,-19,7,177,55
1,1716,1618,98,2,123,55
-1,1526,1719,-193,-3,-97,76
-1,1422,1373,49,-3,-27,84
1,1695,1655,40,-2,31,53
1,1669,1475,194,0,-23,111
-1,1467,1369,98,-13,-232,52
1,1327,1459,-132,-3,265,75
-1,1510,1562,-52,-3,-56,60
-1,1543,1459,84,-6,-101,48
-1,1520,2035,-515,-3,-237,68
1,1869,1780,89,-3,172,81
1,1800,1786,14,0,105,82
1,1422,1260,162,5,95,59
1,1464,1342,122,-1,100,77
-1,1887,1967,-80,2,36,47
1,1810,1672,138,1,23,103
-1,1391,1634,-243,-2,-212,72
1,1093,1333,-240,4,88,49
1,1424,1572,-148,-2,2,43
-1,1518,1500,18,-6,-56,48
1,1444,1342,102,2,-24,41
-1,1739,1711,28,0,4,112
0,1821,1923,-102,0,-51,123
-1,1779,1469,310,1,21,68
-1,1529,1468,61,-10,-366,60
1,1277,1244,33,5,255,63
1,1878,1775,103,5,112,47
-1,1253,1430,-177,4,105,72
0,1510,1180,330,3,219,75
1,1764,1501,263,-10,-106,79
-1,1674,1677,-3,0,62,84
1,1644,1625,19,2,-90,83
1,1773,1674,99,0,125,121
-1,1638,1386,252,-5,-107,60
1,1727,1471,256,2,-8,73
-1,1489,1756,-267,-3,-247,94
-1,1442,1472,-30,0,-5,66
-1,1453,1556,-103,-1,-115,68
1,1409,1543,-134,-3,-59,47
1,1516,1484,32,-9,-299,87
-1,1655,1614,41,0,-482,108
1,1427,1192,235,5,217,63
-1,1610,1521,89,-7,-102,46
1,1769,1586,183,2,49,53
1,1502,1331,171,2,136,45
1,1631,1566,65,0,69,129
1,1609,1692,-83,8,107,41
1,1920,2123,-203,-2,135,79
1,1428,1394,34,-2,151,76
-1,1626,1709,-83,-7,-122,66
-1,1567,1620,-53,0,-184,78
-1,1317,1471,-154,-3,-449,128
1,1482,1535,-53,1,12,75
-1,1289,1622,-333,-1,-379,78
1,1718,1618,100,0,607,155
-1,1491,1552,-61,-7,-133,48
-1,1325,1508,-183,-2,-78,80
1,1417,1672,-255,-1,-26,53
1,1900,1967,-67,-3,-139,99
-1,1526,1594,-68,-16,-250,47
-1,1718,1472,246,0,-27,96
-1,1761,1948,-187,2,-276,160
-1,1142,1249,-107,-16,-315,46
1,1416,1186,230,4,437,95
-1,1445,1775,-330,-4,-154,68
1,2103,1937,166,-1,-10,49
-1,1689,1978,-289,-5,-18,100
1,1514,1354,160,9,276,49
1,1630,1558,72,1,26,53
1,1432,1500,-68,1,461,91
-1,1556,1641,-85,-1,-82,54
-1,1721,1966,-245,0,-7,52
-1,1931,2110,-179,0,-338,96
-1,1666,1806,-140,-1,-348,98
1,1565,1603,-38,0,-98,89
-1,1473,1439,34,-1,-488,94
1,1642,1371,271,0,29,87
-1,1518,1438,80,-12,-232,58
-1,1779,1887,-108,0,-148,88
1,1649,1548,101,0,21,61
-1,1607,1580,27,-1,-122,100
1,1288,1212,76,12,502,61
-1,1549,1639,-90,0,46,94
-1,1781,1912,-131,0,-98,110
1,1561,1731,-170,3,63,63
-1,1719,1779,-60,-10,-113,46
1,1286,1440,-154,3,48,43
1,1477,1652,-175,0,4,42
0,1514,1319,195,4,101,121
1,1521,1108,413,0,54,51
-1,1884,1925,-41,0,-9,46
-1,1454,1504,-50,-7,-543,72
1,1646,1500,146,-2,-37,55
1,1830,1701,129,-3,-33,57
1,1592,1596,-4,3,327,109
-1,1567,1506,61,0,-4,52
1,1563,1231,332,5,99,40
1,1484,1442,42,3,370,95
-1,1874,2046,-172,-4,-4,96
1,1478,1345,133,5,57,47
-1,1482,1386,96,-1,-83,60
-1,1577,1591,-14,0,-17,70
1,1501,1309,192,-1,43,65
0,1413,1592,-179,0,-182,119
-1,1305,1637,-332,-5,-584,90
1,1523,1357,166,-1,-32,55
-1,1647,1540,107,-5,-101,68
-1,1657,1629,28,0,-218,130
1,1638,1500,138,0,93,61
1,1656,1559,97,-5,745,119
-1,1492,1519,-27,-3,-16,54
1,1606,1522,84,-2,129,97
1,1596,1592,4,3,65,51
-1,1715,1639,76,-5,-305,68
1,1528,1493,35,2,110,74
-1,1575,1862,-287,0,6,40
1,1770,1647,123,0,-10,65
1,1338,1485,-147,0,1,63
-1,1514,1443,71,-1,-69,52
1,1665,1551,114,2,226,83
1,1505,928,577,10,413,59
-1,1300,1555,-255,-6,-83,50
-1,1562,1607,-45,-2,-622,154
1,1530,1401,129,-2,39,89
-1,1208,1566,-358,-3,-415,96
1,1673,1557,116,3,222,82
1,1395,1366,29,4,139,59
1,1754,1577,177,9,131,49
1,1458,1501,-43,-5,-96,81
1,1685,1707,-22,1,43,95
-1,1217,1280,-63,4,-49,88
-1,1431,1536,-105,-2,-150,54
-1,1419,1587,-168,-1,-12,66
-1,1647,1725,-78,-3,-176,92
-1,1680,1538,142,-4,-107,54
1,1206,1206,0,3,286,75
-1,1117,1355,-238,-13,-684,84
-1,1505,1565,-60,-10,-461,108
-1,1643,2026,-383,-2,-601,132
-1,1340,1444,-104,-1,-218,120
-1,1865,1778,87,-2,-85,54
-1,1558,1285,273,3,17,42
-1,1554,1664,-110,0,-564,140
1,1494,1537,-43,-7,113,129
1,1646,1274,372,3,114,55
1,1543,1500,43,0,158,71
1,1530,1341,189,5,69,53
-1,1918,1909,9,1,3,60
-1,1632,1696,-64,0,-8,64
1,1705,1983,-278,1,180,151
1,1519,1543,-24,1,44,63
1,1771,1574,197,1,221,131
-1,1579,1629,-50,0,-148,90
0,1922,2145,-223,9,996,186
1,1672,1546,126,1,3,115
1,1290,1441,-151,-4,-215,95
1,1489,1405,84,-1,-66,55
1,1552,1779,-227,-1,-62,81
1,1623,1650,-27,1,9,62
-1,1524,1506,18,-1,-212,104
-1,1360,1808,-448,0,-222,110
-1,1511,1931,-420,0,-338,82
-1,1484,1490,-6,0,-93,66
-1,1723,1797,-74,1,45,106
-1,1487,1636,-149,0,-150,84
1,1747,1842,-95,2,410,105
-1,1416,1643,-227,0,18,44
0,1467,1646,-179,-1,-155,88
1,1639,1519,120,1,185,87
1,1847,1749,98,1,23,53
-1,1545,1928,-383,-3,-78,92
-1,1823,1667,156,-2,-729,104
1,1438,1425,13,3,343,74
1,1827,1761,66,0,182,107
1,1557,1391,166,9,221,49
-1,1756,1841,-85,1,99,88
1,1641,1473,168,6,111,47
1,1501,1473,28,1,212,73
-1,1611,1645,-34,-1,-44,92
-1,1408,1368,40,1,8,54
1,1378,1389,-11,0,-58,61
-1,1752,1836,-84,-1,28,100
1,1714,1805,-91,3,493,129
1,1384,1563,-179,-3,-218,115
-1,1813,1734,79,0,3,50
-1,1463,1511,-48,-3,-161,64
-1,1845,1743,102,0,-28,98
-1,1747,1799,-52,-3,-6,41
-1,1147,1852,-705,-3,-411,93
-1,1812,1488,324,-1,-10,40
-1,1809,1738,71,-2,-184,66
0,1480,1500,-20,2,540,89
-1,1741,1330,411,0,-12,66
-1,1492,1421,71,-4,5,54
1,1795,1751,44,1,-31,109
1,1588,1502,86,0,-17,75
-1,1758,1831,-73,1,-158,122
1,1886,1849,37,-1,-41,61
1,1480,1490,-10,0,290,97
1,1521,1454,67,-1,0,99
1,1835,1464,371,1,12,55
-1,1432,1647,-215,2,-117,84
1,1792,1728,64,1,90,77
1,1981,1748,233,5,106,47
1,1719,1501,218,0,-107,155
-1,1560,1622,-62,1,29,52
1,1853,1146,707,2,141,87
1,1840,1749,91,0,148,89
-1,1435,1598,-163,1,4,40
-1,1478,1507,-29,-3,-33,64
1,1492,1551,-59,1,1,53
-1,1896,1839,57,-1,-187,114
-1,1391,1452,-61,-7,-1077,112
-1,1627,1547,80,-9,-451,68
0,1477,1282,195,1,102,96
-1,1741,1855,-114,-1,-126,58
1,1445,1530,-85,-2,40,69
-1,1801,1719,82,2,108,134
1,1740,1626,114,0,54,61
1,1720,1625,95,2,80,47
1,1831,1721,110,2,141,71
1,1855,1145,710,-1,44,63
1,1518,1631,-113,-3,-107,79
-1,1226,1305,-79,-5,-257,60
1,1840,1897,-57,0,188,69
-1,1656,1601,55,-5,-351,91
-1,1731,1630,101,-7,-581,124
-1,1743,1986,-243,0,28,62
-1,1855,1442,413,0,14,80
1,1484,1294,190,-4,281,105
1,1396,1138,258,-4,24,55
-1,1458,1561,-103,-3,-115,42
0,1769,1596,173,0,4,82
1,1321,1132,189,9,338,53
1,1733,1856,-123,1,74,85
-1,1465,1375,90,1,-35,162
-1,1839,1809,30,0,-445,136
1,1605,1596,9,-2,-50,61
1,1569,1450,119,4,84,59
1,1728,1617,111,7,297,72
-1,1026,1341,-315,-4,-144,63
1,1422,1429,-7,0,214,79
1,1387,1661,-274,3,54,55
-1,1770,1595,175,0,-1,64
1,1620,1740,-120,3,242,65
-1,1217,1390,-173,-5,-418,68
1,1804,1747,57,0,19,73
-1,1489,1290,199,-5,-262,74
-1,1539,1427,112,0,159,98
1,1640,1305,335,-2,-83,55
-1,1612,1754,-142,0,-5,58
-1,1723,1639,84,-5,-729,98
1,1576,1495,81,0,-4,49
-1,1417,1434,-17,1,-691,122
1,1761,1605,156,0,1,51
-1,1517,1499,18,-4,-180,70
1,1443,1516,-73,6,65,45
1,1124,1151,-27,8,97,49
-1,1765,1805,-40,1,128,72
1,1617,1469,148,0,109,65
1,1598,1767,-169,0,33,53
1,1642,1419,223,5,238,49
-1,1500,1834,-334,-1,-84,74
-1,1828,1941,-113,-4,-61,58
0,1412,1453,-41,2,150,110
1,1815,1826,-11,-4,-14,71
1,1803,1728,75,0,-20,117
-1,888,0,888,-6,-564,98
-1,1511,1506,5,0,-80,82
1,1503,1458,45,2,-6,51
1,1949,1827,122,11,509,63
1,1644,1301,343,2,58,45
-1,1707,2076,-369,-1,-108,64
1,1632,1461,171,0,63,101
-1,1487,1585,-98,0,-71,76
1,1964,1812,152,0,4,51
-1,1948,1828,120,0,-61,68
1,1315,1141,174,-1,4,53
-1,1435,1625,-190,0,6,71
-1,1704,1844,-140,5,40,52
1,1843,1933,-90,-1,-107,97
1,1752,1559,193,0,8,41
1,1751,1615,136,0,6,65
-1,1607,1758,-151,-1,-68,80
1,1352,1445,-93,-2,-17,63
1,1765,1600,165,0,14,53
-1,1452,1413,39,2,-37,42
1,1919,1857,62,0,15,57
-1,1139,1315,-176,-15,-585,62
1,1658,1500,158,1,499,139
-1,1517,1500,17,0,21,44
-1,1326,1634,-308,-14,-138,58
-1,1611,1755,-144,-6,-120,52
-1,1474,1551,-77,-1,-77,74
-1,1447,1508,-61,-2,-168,72
1,1762,1604,158,0,-8,65
1,1696,1689,7,0,53,79
-1,1146,1427,-281,-4,-63,56
-1,1440,1354,86,-4,-35,46
1,1593,1479,114,0,22,57
1,1611,1132,479,-1,-6,77
-1,1322,1340,-18,-3,-150,58
-1,1463,1883,-420,-2,-100,82
-1,1505,1492,13,0,-96,62
-1,1641,1847,-206,1,248,124
0,1582,1703,-121,0,-35,130
1,1596,1533,63,-1,-44,87
-1,1323,1637,-314,0,-276,86
-1,1853,1635,218,-2,-66,50
-1,1325,1553,-228,-1,-213,104
1,1517,1437,80,5,194,59
1,1863,1818,45,0,-3,51
-1,1653,1835,-182,-1,-74,78
1,1416,1070,346,10,276,57
-1,1603,1633,-30,-2,-57,53
-1,1130,1601,-471,-3,56,62
-1,1369,1471,-102,1,0,50
1,1502,1431,71,-3,-60,53
1,1515,1475,40,0,50,59
1,1928,1727,201,0,22,111
-1,1553,1511,42,6,125,120
1,1593,1550,43,-3,-61,53
-1,1700,1586,114,-1,-167,102
1,1569,1319,250,1,126,61
-1,1327,1526,-199,-14,-148,40
1,1295,1279,16,3,107,61
-1,1809,1873,-64,-3,-113,54
1,1643,1585,58,-1,19,69
-1,1848,1934,-86,0,-88,112
-1,1491,1864,-373,1,-39,64
-1,1510,1533,-23,-5,-758,100
0,1293,1413,-120,0,-97,98
1,1813,1320,493,3,119,53
-1,1722,1847,-125,0,-179,174
-1,1511,1372,139,2,84,68
1,1824,1597,227,0,-10,61
-1,1839,1942,-103,-3,-28,56
-1,1428,1871,-443,-1,-581,140
-1,1315,1582,-267,-5,-264,80
-1,1831,1854,-23,5,187,102
-1,1535,1597,-62,-1,16,98
-1,1543,1500,43,0,-32,66
1,1828,1678,150,5,65,77
-1,1865,1821,44,-4,-91,60
1,1181,1604,-423,-2,-3,43
1,1500,2080,-580,0,-11,57
-1,1602,1876,-274,0,-46,66
1,1833,1852,-19,10,378,69
1,1841,1845,-4,0,-81,83
-1,1281,1404,-123,9,316,88
-1,1814,1713,101,0,-38,108
-1,1950,1868,82,2,-36,118
1,1426,1500,-74,1,-127,71
1,1834,1852,-18,-1,-4,41
1,1840,1846,-6,3,140,105
1,1886,1598,288,3,177,87
-1,1511,1352,159,-10,-681,144
-1,1470,1550,-80,-2,-60,66
0,1592,1652,-60,-1,-75,137
1,1937,1881,56,-1,17,69
1,1802,1872,-70,0,493,131
0,1589,1502,87,-5,-24,48
-1,1872,1946,-74,0,-23,48
-1,1851,1834,17,-6,-334,96
-1,1864,1955,-91,-1,-33,40
1,1330,1498,-168,1,44,63
0,1846,1840,6,-2,-99,102
-1,1593,1510,83,-6,-136,79
-1,1761,1815,-54,-1,-58,96
-1,1384,1430,-46,0,12,56
-1,1659,1897,-238,-3,-141,84
1,1409,1321,88,-1,-57,147
1,1840,1846,-6,0,33,87
1,1439,1448,-9,0,-1,53
-1,1368,1594,-226,-7,-333,75
-1,1846,1840,6,-4,-59,50
1,1851,1835,16,2,180,89
1,1697,1777,-80,-4,-297,75
1,1486,1346,140,7,441,77
1,1717,1713,4,1,17,51
1,1662,1588,74,2,52,49
0,1395,1293,102,0,-517,146
1,1594,1606,-12,15,126,41
-1,1226,1450,-224,-3,-14,44
-1,1824,1861,-37,0,-7,76
-1,1469,1774,-305,-7,-88,64
1,1417,1268,149,17,348,45
0,1576,1654,-78,0,-2,146
-1,1433,1488,-55,0,7,64
-1,1815,1791,24,-3,-7,106
-1,1458,1608,-150,-6,-519,92
-1,1500,1531,-31,-1,-192,70
1,1455,1221,234,-6,-97,67
-1,1325,1389,-64,-2,-264,88
-1,1804,1844,-40,-5,-12,46
-1,1339,1423,-84,-8,-94,76
1,1369,1495,-126,7,122,41
1,1615,1538,77,1,374,113
1,1500,1545,-45,2,54,63
-1,1429,1370,59,-2,-811,122
-1,1688,1789,-101,-3,-29,43
1,1497,1409,88,0,28,83
1,1709,1472,237,0,-228,97
1,1669,1339,330,2,298,115
-1,1750,1800,-50,0,9,48
-1,1457,1379,78,-6,-80,76
1,1871,1743,128,-4,61,65
-1,1215,1460,-245,-6,-55,44
1,1400,1505,-105,6,428,91
1,1736,1878,-142,3,48,47
-1,1878,1736,142,0,-11,98
1,1955,1835,120,0,-14,81
1,1561,1428,133,2,101,47
-1,1465,1210,255,0,16,78
-1,1491,1415,76,-1,-135,59
1,1963,1863,100,1,16,47
1,1714,1467,247,1,0,141
1,1612,1691,-79,0,-10,69
1,1432,1315,117,3,147,63
1,1855,1971,-116,-3,579,145
1,1428,1478,-50,0,41,59
-1,1301,1500,-199,0,-499,146
-1,1489,1445,44,-2,5,78
1,1673,1500,173,-6,-59,61
-1,1407,1439,-32,-4,-194,50
-1,1465,1440,25,0,10,48
-1,1384,1450,-66,-2,-63,62
-1,1440,1465,-25,-1,-407,100
-1,1882,1621,261,-2,-187,72
1,1987,1605,382,-1,4,45
-1,1307,1074,233,-4,-141,58
1,1719,1625,94,-1,-9,83
-1,1463,1248,215,-9,-426,72
1,1869,1956,-87,0,24,173
-1,1442,1463,-21,0,-77,114
1,1963,1909,54,-2,121,55
-1,1390,1351,39,0,-163,114
-1,1305,1459,-154,-6,-360,76
1,1780,1652,128,14,202,41
-1,1297,1300,-3,-13,-227,50
-1,1476,1602,-126,-11,-320,42
-1,1473,1432,41,-2,-480,76
-1,1652,1863,-211,0,-5,50
1,1728,2003,-275,0,269,77
-1,1799,1912,-113,-3,-136,70
1,1611,1449,162,6,540,139
1,1699,1374,325,1,137,89
-1,1370,1269,101,-2,-112,92
-1,1806,1943,-137,-2,-190,120
-1,1163,1199,-36,-10,-413,62
1,1950,1640,310,5,103,49
1,1609,1469,140,-1,24,63
-1,1444,1461,-17,0,-616,114
-1,1792,1969,-177,0,-204,88
1,1418,1368,50,5,390,107
0,1330,1053,277,-1,49,90
-1,1747,1902,-155,0,-114,66
1,1711,1614,97,-3,-67,41
-1,1576,1912,-336,1,34,60
1,1868,1643,225,-5,20,41
-1,1786,2007,-221,0,-53,106
-1,1446,1459,-13,-10,-110,42
1,1730,1720,10,1,257,89
1,1915,1573,342,1,153,67
0,1470,1436,34,0,463,121
1,1709,1741,-32,1,-160,89
1,1740,1670,70,0,20,41
1,1454,1285,169,3,244,65
1,1781,2035,-254,-1,-39,67
-1,1603,1934,-331,-1,-114,126
0,1831,1726,105,0,-66,102
1,1533,1322,211,-2,70,83
1,1625,1324,301,0,-34,55
-1,1729,1721,8,5,49,122
-1,1437,1469,-32,3,97,70
1,1749,1320,429,6,108,53
1,1726,1619,107,2,350,63
-1,1798,1944,-146,0,5,92
1,1537,1873,-336,0,8,43
0,1447,1506,-59,2,261,113
1,1733,1717,16,0,50,76
-1,1734,1611,123,-1,-118,58
1,1751,1782,-31,4,138,59
-1,1478,1427,51,4,249,98
-1,1500,1738,-238,-5,-418,78
1,1706,1744,-38,-8,114,87
-1,1791,1974,-183,-1,-46,68
1,1770,1763,7,1,49,59
-1,1731,1719,12,-7,-233,64
-1,1321,1454,-133,-2,-47,50
1,1785,1998,-213,7,67,49
1,1364,1228,136,10,1036,91
-1,1455,1450,5,-4,-65,70
-1,1496,1557,-61,-7,-34,44
1,1828,1353,475,7,181,55
1,1709,1741,-32,-2,-11,79
-1,1753,1781,-28,-1,-32,44
1,1802,1934,-132,-2,-366,101
1,1856,1470,386,-2,67,111
1,1786,1405,381,-1,167,71
-1,1443,1522,-79,-2,-469,134
1,1721,1729,-8,1,319,97
-1,1461,1444,17,-4,-109,62
-1,1816,1918,-102,0,-81,144
-1,1487,1566,-79,0,61,106
-1,1718,1720,-2,-3,-93,64
-1,1509,1632,-123,-1,-144,110
1,1450,1455,-5,0,32,49
1,1730,1707,23,0,-29,99
-1,1619,1860,-241,0,4,48
0,1427,1556,-129,0,-22,123
-1,1313,1397,-84,6,-98,74
-1,1696,1740,-44,-6,-489,112
1,1817,1928,-111,-2,-42,65
-1,1750,1687,63,-2,-95,66
-1,1831,1911,-80,-1,-583,126
0,1583,1483,100,-3,-59,154
-1,1471,1434,37,-1,-184,84
0,1594,1703,-109,-4,18,117
-1,1464,1858,-394,-2,-82,50
-1,1444,1461,-17,-1,-56,64
-1,1830,1737,93,0,3,72
1,1700,1448,252,3,149,61
1,1921,1823,98,0,196,115
-1,1434,1647,-213,-4,-216,70
1,1883,1653,230,0,12,49
1,1446,1459,-13,-2,23,81
1,1501,1082,419,10,141,43
1,1814,1930,-116,1,232,77
1,1748,1614,134,3,407,69
-1,1596,1887,-291,-6,-149,58
1,1751,1814,-63,0,170,91
1,1448,1457,-9,2,44,49
-1,1438,1459,-21,0,-34,97
1,1500,1270,230,-1,257,139
1,1829,1914,-85,-2,-217,91
-1,1961,1900,61,0,-324,102
-1,1503,1446,57,-3,-135,60
0,1607,1743,-136,0,-23,61
1,1657,1678,-21,-5,-73,117
1,1863,1891,-28,2,40,49
1,1644,1500,144,-2,-5,67
1,1575,1457,118,8,862,112
1,1808,1728,80,-3,-48,51
-1,1459,1490,-31,0,-271,238
-1,1429,1401,28,2,-43,68
0,1500,1861,-361,-2,-8,44
1,1879,1763,116,2,-58,85
-1,1843,1500,343,0,-218,96
1,1241,1403,-162,2,32,47
1,1856,1388,468,1,22,45
1,1799,1756,43,3,71,55
1,1973,1912,61,-1,-83,79
1,1923,1831,92,0,-12,61
-1,1824,2033,-209,-7,-795,94
1,1953,1875,78,0,-23,57
1,1431,1501,-70,0,-6,61
-1,1667,1679,-12,-1,-16,47
1,1485,1419,66,0,167,75
-1,1866,1962,-96,0,-1,66
1,1970,1858,112,-1,109,101
-1,1818,1871,-53,-10,-264,64
1,1698,1603,95,-2,-25,45
1,1850,1977,-127,0,-14,45
1,1343,1621,-278,0,467,193
1,1809,1616,193,-2,74,49
-1,1484,1568,-84,1,71,104
-1,1558,1582,-24,0,-102,100
-1,1814,1560,254,0,-49,70
-1,1275,1420,-145,-14,-1166,90
-1,1501,1500,1,-1,-25,52
1,1814,1880,-66,3,387,71
0,1814,1393,421,-1,-343,233
1,1903,1929,-26,-3,-4,59
1,1732,1887,-155,0,165,155
-1,1868,1828,40,0,-60,76
-1,1445,1966,-521,-5,-233,72
-1,1891,1914,-23,-2,-217,96
-1,1320,1311,9,-5,-33,40
-1,1493,1671,-178,-3,-99,60
1,1426,1198,228,-2,-34,59
1,1841,1856,-15,7,259,53
1,1563,1547,16,7,286,73
1,1856,1841,15,1,57,57
1,1911,1699,212,-2,-22,49
-1,1694,1728,-34,0,15,56
-1,1576,1464,112,-6,56,124
1,1603,1371,232,3,565,119
-1,1584,1711,-127,0,80,56
0,1487,1319,168,0,-1031,148
1,1756,1866,-110,5,405,97
-1,1462,1290,172,2,-82,136
-1,1452,1744,-292,-8,-662,80
-1,1309,1803,-494,2,61,58
1,1857,1616,241,0,757,139
1,1531,1702,-171,1,-5,73
0,1443,1340,103,0,35,115
1,1700,1712,-12,0,43,61
-1,1611,1861,-250,1,111,74
1,1358,1387,-29,3,155,71
1,1865,2060,-195,1,-23,123
1,1777,1644,133,1,28,51
1,1380,1325,55,0,92,131
0,1774,1975,-201,-11,-365,60
1,1602,1546,56,4,571,85
1,1805,1307,498,0,103,61
1,2048,1875,173,0,31,53
-1,1875,2048,-173,0,-75,120
1,1496,1565,-69,3,111,75
1,1678,1500,178,0,76,65
1,1375,1375,0,4,509,133
-1,1882,2040,-158,-1,-189,80
1,1685,1547,138,0,19,81
1,1482,1464,18,-1,-17,49
1,1869,1607,262,0,3,73
1,1607,1869,-262,-5,-90,53
1,1390,1536,-146,-1,-100,117
-1,1603,1873,-270,-2,-268,96
-1,1544,1637,-93,-7,-342,76
-1,1924,1866,58,0,-21,84
1,1344,1531,-187,2,110,71
1,1360,1386,-26,2,42,71
1,1877,1599,278,-1,-16,89
-1,1493,1860,-367,0,-173,90
-1,1440,1562,-122,-5,-169,60
-1,1595,1881,-286,-1,-256,110
1,1540,1693,-153,0,73,57
-1,1878,1828,50,0,-11,74
-1,1304,1806,-502,4,45,74
1,1500,1551,-51,2,43,51
-1,1606,1394,212,-4,-230,98
-1,1320,1521,-201,-2,-31,50
1,1646,1536,110,-1,-26,59
0,1374,1376,-2,-3,-755,100
1,1885,1591,294,1,1069,137
-1,1634,1520,114,-4,-100,50
-1,1866,1840,26,1,204,122
1,1782,1617,165,4,579,125
-1,1449,1567,-118,-5,-131,60
1,1621,1301,320,7,633,93
-1,1376,1374,2,0,292,106
1,1542,1702,-160,5,77,43
-1,1529,1654,-125,-8,-388,76
-1,1537,1525,12,-3,-578,114
-1,1442,1768,-326,-5,-467,84
-1,1852,1854,-2,-1,-116,82
1,1599,1568,31,-1,189,71
-1,1535,1584,-49,-8,-287,58
1,1587,1714,-127,0,13,75
1,1422,1474,-52,-1,-41,57
-1,1610,1788,-178,-6,-259,102
-1,1433,1775,-342,2,161,86
1,1722,1580,142,10,437,61
1,1714,1587,127,9,262,71
1,1441,1438,3,1,174,101
0,1572,1729,-157,-3,-216,107
1,1517,1438,79,3,112,51
1,1832,1498,334,-3,395,153
-1,1662,1521,141,2,131,58
-1,1481,1677,-196,1,-47,56
-1,1614,1525,89,-6,-113,42
-1,1736,1891,-155,-3,-94,106
1,1616,1726,-110,0,3,67
1,1580,1363,217,-3,259,89
-1,1774,1602,172,-1,-1510,140
1,1420,1515,-95,-1,5,61
-1,1346,1736,-390,-4,-82,50
-1,1567,1756,-189,0,61,90
-1,1709,1690,19,0,-90,56
-1,1850,1826,24,0,-146,85
0,1957,1997,-40,0,-31,90
-1,1600,1671,-71,-1,3,44
1,1074,1639,-565,-5,-317,83
-1,1200,1359,-159,-5,-234,56
-1,1501,1436,65,1,100,54
-1,1434,1584,-150,0,-53,70
-1,1523,1617,-94,-3,271,94
-1,1326,1570,-244,0,-437,132
1,1727,1841,-114,1,117,129
-1,1714,1807,-93,-10,-512,100
-1,1370,1505,-135,-2,-17,44
-1,1679,1508,171,3,-80,112
-1,1659,1836,-177,-6,-43,48
-1,1451,1487,-36,0,-36,50
1,1546,1385,161,4,46,107
-1,1531,1672,-141,-2,-268,86
-1,1838,1839,-1,-3,-89,56
1,1742,1808,-66,-3,30,47
1,1740,1574,166,0,67,87
1,1498,1433,65,-3,31,77
-1,1486,1441,45,-5,85,40
1,1246,1214,32,7,395,83
-1,1843,1653,190,0,0,42
1,1619,1617,2,6,150,55
1,1819,1706,113,6,120,51
-1,1641,1507,134,-1,-12,42
-1,1403,1364,39,-8,-364,80
-1,1436,1544,-108,-1,-31,66
-1,1475,1668,-193,-3,-67,50
1,1666,1961,-295,-6,-66,57
1,1795,1767,28,1,69,55
0,1850,1603,247,4,-566,305
1,1738,1344,394,6,547,115
1,1365,1492,-127,-7,124,99
-1,1453,1473,-20,-3,-281,128
1,1591,1495,96,5,259,73
-1,1670,1824,-154,-6,-70,40
1,1850,1827,23,1,212,91
1,1606,1630,-24,5,266,71
-1,1340,1661,-321,-1,-103,78
-1,1626,1947,-321,-4,-95,70
1,1182,0,1182,8,445,81
-1,1756,1829,-73,-3,-61,56
1,1922,1823,99,0,2,63
-1,1554,1811,-257,-6,-47,88
0,1980,1967,13,0,-122,146
1,1618,1618,0,0,-15,47
-1,1535,1800,-265,-2,-447,116
1,1831,1663,168,2,400,107
-1,1413,1553,-140,0,31,56
1,1258,1219,39,5,228,57
1,1516,1448,68,-5,-180,63
-1,1795,1609,186,-14,-39,40
-1,1767,1939,-172,-1,-134,82
1,1442,1437,5,0,375,107
0,1987,1775,212,0,-12,175
-1,1562,1603,-41,0,-6,56
1,1176,1279,-103,-6,-242,71
1,1893,1572,321,2,252,82
1,1607,1629,-22,-2,196,101
1,1673,1468,205,2,122,69
1,1950,1622,328,0,133,83
-1,1560,1712,-152,-7,-264,58
-1,1370,1343,27,-1,-50,46
-1,1476,1188,288,0,-118,60
-1,1470,1599,-129,-12,-344,80
-1,1554,1380,174,-4,42,122
-1,1565,1897,-332,-10,-102,70
1,1484,1443,41,-2,230,87
1,1657,1838,-181,-5,-171,73
1,1734,1540,194,-1,18,55
-1,1408,1266,142,-8,-152,50
1,1791,1666,125,-1,59,63
-1,1814,1730,84,0,-419,136
1,1500,1453,47,6,59,41
1,1830,1531,299,11,489,62
1,1561,1477,84,1,257,111
1,1426,1561,-135,6,284,63
1,1601,1733,-132,-3,-172,71
1,1688,1552,136,3,56,48
-1,1585,1711,-126,-1,19,122
1,1885,1545,340,1,47,63
-1,1552,1712,-160,-5,-71,44
1,1551,1427,124,0,38,63
-1,1805,1576,229,0,-1,112
1,1494,1433,61,2,255,103
1,1618,1480,138,2,545,123
-1,1528,1606,-78,1,-78,60
-1,1548,1577,-29,8,269,50
1,1648,1527,121,5,266,93
-1,1543,1580,-37,0,-34,90
-1,1740,1657,83,0,-176,100
-1,1820,1673,147,3,21,40
-1,1336,1452,-116,-11,-289,50
1,1546,1403,143,0,259,113
-1,1701,1769,-68,-1,-476,106
-1,1866,1714,152,0,-222,84
1,1606,1450,156,2,443,127
1,1727,1430,297,1,10,93
1,1781,1981,-200,1,23,47
1,1756,1840,-84,1,178,121
-1,1719,1670,49,0,-233,96
-1,1612,1728,-116,-7,-261,84
1,1500,1535,-35,1,273,85
1,1288,1149,139,3,346,85
1,1900,1562,338,0,84,87
-1,1478,1841,-363,3,108,112
-1,1467,1555,-88,-1,-249,116
1,1600,1849,-249,0,12,89
1,1716,1615,101,5,32,45
-1,1747,1649,98,1,54,42
-1,1618,1790,-172,0,1,82
-1,1136,1446,-310,-2,-81,62
-1,1237,1225,12,-1,3,46
1,1396,1537,-141,-2,13,97
1,1357,1283,74,0,157,87
1,1158,1200,-42,6,149,49
1,1774,1861,-87,-1,-83,63
1,1355,1464,-109,-2,-41,49
1,1802,1597,205,-4,-26,59
1,1604,1878,-274,1,112,85
1,1560,1512,48,-6,-156,123
-1,1839,1832,7,1,11,44
-1,1516,1573,-57,-2,-20,44
1,1295,1129,166,4,48,63
-1,1964,1800,164,0,6,108
-1,1779,1808,-29,0,-121,80
-1,1729,1851,-122,-2,2,50
1,1553,1438,115,0,16,93
0,1889,1502,387,2,292,204
1,1500,1802,-302,-3,-117,47
-1,1607,1725,-118,-1,-1,50
-1,1817,1724,93,-4,164,98
1,1774,1623,151,0,283,79
1,1610,1490,120,-4,290,137
1,1731,1732,-1,1,-19,111
1,1590,1533,57,-1,172,123
1,1569,1702,-133,0,-9,63
-1,1599,1764,-165,0,-160,102
-1,1747,1853,-106,-1,-26,66
1,1465,1616,-151,0,58,57
-1,1463,1503,-40,-11,-103,70
-1,1472,1729,-257,-2,-70,55
1,1858,1722,136,0,-11,67
-1,1817,1948,-131,0,-5,98
1,1163,1365,-202,-6,-163,65
-1,1715,1341,374,-1,-91,102
-1,1751,1854,-103,-3,-241,136
1,1788,1887,-99,1,61,51
1,1866,1524,342,5,333,81
1,1482,1298,184,0,5,45
-1,1654,1583,71,-2,-80,51
-1,1671,1726,-55,-5,-95,40
-1,1689,1809,-120,-1,-166,80
1,1563,1383,180,11,214,53
1,1301,1420,-119,2,70,55
0,1504,1544,-40,-1,202,179
-1,1734,1600,134,1,95,62
1,1488,1522,-34,0,498,89
-1,1715,1865,-150,-1,-85,114
1,2153,2077,76,0,8,79
-1,1056,1500,-444,-13,-246,46
-1,1501,1521,-20,-1,-448,76
1,1545,1042,503,-3,39,65
-1,1524,1729,-205,0,-96,88
-1,1573,1442,131,-2,-24,46
-1,1584,1625,-41,-3,-70,54
0,1663,1616,47,-1,-67,123
-1,1516,1452,64,-2,-136,90
-1,1790,1967,-177,0,-76,100
1,1879,1737,142,0,-146,71
1,1182,1541,-359,4,389,115
1,1626,1032,594,4,213,49
-1,1377,1569,-192,-12,-337,62
1,1816,1500,316,7,265,61
-1,1510,1575,-65,0,-235,68
-1,1433,1613,-180,0,158,68
-1,1375,1628,-253,-6,-204,75
1,1570,1619,-49,0,25,75
1,1864,1729,135,-3,15,61
1,1663,1559,104,0,-18,67
-1,1739,1467,272,0,1,74
-1,1565,1509,56,0,-97,72
1,1692,1502,190,0,8,57
1,1357,1565,-208,0,47,53
1,1809,1596,213,0,51,92
-1,1292,1491,-199,-4,-30,42
-1,1792,1817,-25,0,-141,82
1,1544,1583,-39,1,95,134
1,1316,1387,-71,8,442,71
-1,1872,1709,163,0,-6,78
1,1733,1886,-153,5,3,43
1,1500,1087,413,1,148,60
-1,1748,1996,-248,-3,-13,44
1,1558,1414,144,0,405,105
1,1561,1339,222,7,300,57
1,1735,1518,217,0,-5,59
-1,1144,1592,-448,-2,-122,54
1,2001,1711,290,3,361,96
-1,1808,1717,91,1,25,66
0,1594,1662,-68,0,-125,166
-1,1175,1323,-148,-3,-1117,122
1,1593,1488,105,7,217,67
0,1474,1615,-141,0,-87,133
1,1575,1462,113,-8,255,91
-1,1771,1827,-56,-9,-34,43
0,1796,1712,84,1,223,192
1,1829,1497,332,11,335,49
0,1593,1740,-147,1,167,157
-1,1326,1479,-153,1,-169,144
0,1473,1391,82,1,168,100
1,1466,1499,-33,-1,0,59
1,1783,1756,27,-1,-257,91
1,1553,1553,0,8,77,41
-1,1575,1815,-240,0,-112,122
1,1482,1412,70,3,72,43
-1,1494,1832,-338,-6,-310,62
-1,1505,1376,129,-3,-55,84
1,1513,1741,-228,-3,-118,65
-1,1724,1856,-132,0,93,116
1,1594,1142,452,5,180,47
-1,1795,1793,2,-1,-104,72
1,1793,1685,108,0,665,127
-1,1490,1569,-79,-2,-209,69
-1,1708,1570,138,0,9,142
1,1836,1491,345,2,107,51
1,1653,1569,84,3,202,95
-1,1638,1801,-163,3,464,112
-1,1396,1416,-20,0,-92,88
1,1932,1715,217,4,100,47
-1,1527,1331,196,2,31,124
-1,1564,1717,-153,0,-30,60
1,1946,1709,237,-11,-45,45
1,1611,1267,344,0,357,113
-1,1741,1792,-51,-4,-10,40
1,1556,1423,133,-1,105,83
-1,1807,1605,202,-3,-125,66
1,1549,1445,104,1,17,119
-1,1543,1587,-44,-5,-110,108
0,1438,1531,-93,2,452,127
1,1959,1714,245,0,1,43
-1,1801,1728,73,0,-196,86
-1,1684,1791,-107,0,-469,148
1,1433,1154,279,1,186,63
-1,1329,1724,-395,-5,-359,74
-1,1546,1661,-115,-1,-297,82
0,1863,1717,146,0,-13,101
-1,1410,1564,-154,-2,-471,86
1,1925,1606,319,-6,280,93
0,1839,1741,98,-3,-27,98
-1,1236,1683,-447,-3,-324,78
1,1684,1558,126,-2,94,73
-1,1424,1406,18,0,-156,88
1,1393,1480,-87,6,63,41
1,1596,1775,-179,11,130,41
-1,1327,1651,-324,-14,-381,58
1,1441,1129,312,2,462,69
1,1933,1603,330,-2,151,142
1,1571,1399,172,-1,160,117
1,1457,1570,-113,-3,301,189
-1,1563,1683,-120,-1,-55,53
1,1871,1746,125,-2,-78,57
-1,1721,1859,-138,0,6,62
-1,1219,1614,-395,-11,-653,84
1,1201,1437,-236,-15,-243,41
-1,1327,1726,-399,0,-10,54
1,1902,1650,252,0,25,59
1,1622,1605,17,1,116,93
-1,1685,1836,-151,-6,-177,56
1,1612,1557,55,-2,305,107
1,1791,1609,182,0,-38,45
1,1379,1498,-119,5,239,69
-1,1604,1692,-88,-5,-214,94
1,1841,1909,-68,-1,-64,79
-1,1970,1718,252,-5,-100,52
0,1303,1320,-17,-1,-262,102
-1,1566,1453,113,-7,-57,54
0,1616,1708,-92,2,81,70
1,1739,1577,162,5,202,43
1,1555,1472,83,-3,-17,49
-1,1444,1593,-149,-1,-26,56
1,1866,1714,152,0,5,47
1,1437,1590,-153,-4,20,63
-1,1654,1417,237,0,9,58
1,1325,1254,71,4,257,49
-1,1808,1820,-12,0,-30,92
1,1843,1619,224,2,62,41
1,1903,1600,303,0,-4,49
1,1614,1534,80,-1,-44,87
1,1814,2010,-196,-1,-25,43
1,1503,1149,354,21,714,53
-1,1823,1715,108,0,-4,68
1,1501,1456,45,-3,103,165
-1,1486,1716,-230,-9,-71,58
-1,1331,1331,0,-8,-136,46
-1,1474,1581,-107,0,-12,88
1,1898,1376,522,0,-1,57
1,1406,1324,82,-3,-100,53
1,1732,1643,89,2,139,61
-1,1817,2103,-286,0,-1125,184
-1,1621,1557,64,3,159,74
-1,1225,1692,-467,-7,-240,64
-1,1806,1739,67,0,24,44
-1,1661,1643,18,0,34,82
1,1789,1014,775,4,766,99
1,1628,1543,85,6,355,55
-1,1300,1812,-512,-1,-81,58
-1,1926,1883,43,0,-46,68
1,2108,1802,306,3,339,99
-1,1620,1646,-26,0,-16,62
1,1594,1738,-144,0,557,93
1,1344,1213,131,-4,-117,75
1,1793,1721,72,-1,-101,111
1,1596,1498,98,0,36,49
-1,1577,2116,-539,-6,-44,48
0,1477,1465,12,2,-2,167
1,1716,1192,524,-7,-500,73
-1,1789,2112,-323,-1,-287,116
1,1646,1822,-176,0,4,55
1,1356,1458,-102,3,39,65
0,1691,1592,99,-2,-347,134
1,1789,1564,225,4,178,69
1,1504,1368,136,-2,260,83
-1,1052,1323,-271,-2,-51,46
1,2116,1778,338,0,162,85
1,1808,1649,159,0,12,45
1,1535,1441,94,3,-37,43
0,1519,1572,-53,1,117,124
-1,1295,1549,-254,0,-37,46
-1,1638,1668,-30,0,-9,64
1,1802,1712,90,-2,21,97
-1,1579,1637,-58,-6,-1308,164
-1,1379,1333,46,2,204,76
-1,1587,1753,-166,-3,-189,66
-1,1643,1815,-172,0,-25,114
-1,1574,1767,-193,-2,-376,88
-1,1799,1953,-154,-4,-62,42
1,1961,1793,168,0,57,117
1,1696,1550,146,3,67,43
1,1342,1295,47,2,210,75
-1,1679,1610,69,-2,-92,58
-1,1487,1307,180,-3,-787,132
1,1375,1491,-116,-9,108,75
-1,1350,1392,-42,0,169,70
1,1740,1794,-54,0,6,115
1,1656,1783,-127,1,161,73
1,1899,1576,323,1,23,55
1,1976,1781,195,3,309,99
-1,1503,1290,213,1,24,64
1,1895,1914,-19,2,16,69
-1,1568,1786,-218,3,258,84
1,2118,1718,400,2,455,137
-1,1318,1305,13,-7,-791,96
1,1786,1748,38,1,139,89
1,1572,1105,467,2,136,55
1,1433,1766,-333,15,316,49
1,1822,1636,186,1,38,71
1,1792,1570,222,2,234,71
1,1723,1466,257,1,63,107
1,1546,1633,-87,4,157,66
1,1337,1662,-325,4,229,75
-1,1649,1688,-39,0,-236,92
1,1745,1578,167,1,220,67
1,1660,1543,117,2,35,59
1,1524,1133,391,11,278,45
-1,1521,1754,-233,0,-132,76
1,1631,1828,-197,0,48,74
1,1602,1782,-180,0,9,85
1,1401,1322,79,3,61,51
1,1829,1801,28,2,179,111
1,1481,1426,55,-4,-72,45
-1,1609,1565,44,1,102,82
-1,1511,1586,-75,0,149,72
1,1903,1906,-3,3,48,41
-1,1785,1595,190,4,97,62
-1,1903,1715,188,2,-130,112
1,1737,1637,100,-5,-291,75
1,1775,1891,-116,-1,21,107
-1,1448,1446,2,-2,-58,46
-1,1798,1665,133,-2,-113,112
1,1533,1308,225,3,121,55
1,1346,1258,88,1,-350,118
1,1384,1571,-187,-3,-166,61
1,1609,1767,-158,1,105,111
1,1782,1121,661,10,96,41
1,1435,1381,54,-2,-19,43
1,1896,1913,-17,0,100,115
1,1245,1261,-16,5,86,47
-1,1727,1703,24,-4,-11,54
-1,1305,1316,-11,-10,-267,48
-1,1816,1810,6,-5,-834,110
1,1391,1572,-181,1,53,71
1,2122,1476,646,0,12,59
1,1702,1629,73,6,183,62
0,1765,1719,46,0,74,112
-1,903,0,903,-4,-44,52
-1,1578,1817,-239,-9,-82,46
1,1765,1556,209,8,420,69
-1,1516,1620,-104,-10,-427,66
-1,1448,1822,-374,0,11,46
-1,1487,1550,-63,3,82,60
-1,1707,1715,-8,1,47,68
-1,1303,1445,-142,-4,-144,68
-1,1630,1554,76,1,158,82
-1,1574,1411,163,-1,-84,104
-1,1783,1715,68,0,-381,140
1,2123,1883,240,0,44,63
1,1764,1609,155,-3,-171,123
-1,1021,1787,-766,-15,-160,44
-1,1197,1560,-363,0,3,42
-1,1681,1470,211,-3,-4,104
-1,1443,1827,-384,-6,-143,52
-1,1470,1621,-151,0,-11,46
1,1473,1437,36,3,64,47
-1,1012,1791,-779,-5,-39,44
-1,1508,1628,-120,-4,-427,84
-1,1902,1907,-5,-1,-11,78
1,1368,1527,-159,-3,-7,79
-1,1433,1566,-133,-3,-116,72
-1,1617,1663,-46,-6,-43,66
0,1470,1670,-200,-2,-315,165
1,1602,1770,-168,-5,-171,59
-1,1353,1598,-245,-10,-329,58
1,1475,1742,-267,0,2,55
1,1697,1580,117,-1,431,93
1,1573,1212,361,0,10,63
1,1829,1440,389,0,-1,59
1,1296,1236,60,10,270,43
-1,1752,1726,26,0,-75,98
-1,1661,1739,-78,-2,-101,70
1,1712,1607,105,0,-7,57
-1,1691,1755,-64,-3,-64,44
-1,1341,1633,-292,0,-237,96
1,1603,1349,254,-1,347,62
-1,1467,1646,-179,-1,-110,64
-1,1832,1565,267,1,68,48
1,1710,1636,74,-3,-30,59
1,1336,1257,79,1,45,77
-1,1258,1251,7,-1,5,144
1,1595,1877,-282,-1,597,151
1,1742,1586,156,-9,-6,143
1,1156,1355,-199,-5,-98,47
-1,1599,1611,-12,-4,-45,46
1,1917,1892,25,3,35,50
-1,1166,1103,63,0,28,92
-1,1221,1745,-524,0,38,58
1,1357,1535,-178,5,195,61
1,1400,1531,-131,-5,-55,51
-1,1513,1654,-141,0,-25,115
1,1648,1631,17,0,46,181
1,1500,1344,156,3,325,85
1,1527,1485,42,-2,-3,113
-1,1725,1566,159,-1,-105,80
-1,1500,1799,-299,1,-8,60
1,1482,1366,116,2,61,57
-1,1761,1684,77,0,-466,114
1,1410,1493,-83,-9,-179,93
-1,1465,1305,160,-1,-9,48
1,1373,1525,-152,-5,-13,103
-1,1576,1470,106,-2,-376,86
1,1765,1543,222,1,9,43
-1,1746,1741,5,-1,-259,90
1,1753,1764,-11,0,73,116
1,1744,1814,-70,-1,82,65
-1,1738,1692,46,0,-135,104
1,1837,1510,327,0,-43,57
1,1357,1344,13,0,-66,61
1,1246,1338,-92,2,269,107
1,1589,1738,-149,0,49,65
-1,1787,1783,4,2,-333,136
-1,1350,1625,-275,-1,-20,50
-1,1519,1511,8,-6,-246,70
-1,1386,1645,-259,-12,-266,90
1,1791,1500,291,-2,14,61
-1,1563,1506,57,-1,12,58
1,1497,1301,196,9,483,73
-1,1597,1856,-259,1,48,100
-1,1474,1536,-62,-6,-751,140
1,1794,1745,49,10,907,85
1,1663,1748,-85,-1,214,77
1,1865,1593,272,0,93,81
-1,1712,1803,-91,-2,-471,134
1,1590,1327,263,2,71,59
-1,1561,1715,-154,2,37,46
-1,1714,1717,-3,0,-81,114
-1,1518,1797,-279,-1,-10,92
1,1588,1874,-286,0,17,67
1,2191,1927,264,0,-28,101
1,1248,1376,-128,-2,78,75
0,1749,1589,160,-1,-54,67
1,1812,1686,126,9,555,85
1,1337,1391,-54,1,334,97
-1,1365,1809,-444,-3,-135,84
1,1754,1667,87,1,-123,139
-1,1323,1264,59,2,43,58
1,1834,1608,226,1,-132,103
1,1652,1579,73,0,5,71
1,1751,1753,-2,1,93,59
1,1334,1314,20,3,109,55
1,1665,1548,117,0,-90,65
-1,1348,1627,-279,-1,-30,46
1,1359,1381,-22,3,361,71
1,1734,1457,277,2,92,59
-1,1603,1844,-241,-3,-103,72
-1,1227,1500,-273,0,12,46
1,1686,1553,133,1,-49,59
-1,1541,1686,-145,0,17,70
1,1923,2198,-275,1,94,75
-1,1594,1744,-150,1,-1,140
0,1659,1763,-104,-1,-39,140
-1,1311,1458,-147,-7,-225,58
1,1853,1598,255,0,-14,69
-1,1489,1344,145,-3,-142,62
1,1485,1337,148,11,322,45
-1,1703,1534,169,-2,-123,68
1,1977,1762,215,2,264,91
1,2168,1941,227,0,-57,107
-1,1545,1694,-149,-1,-113,142
1,1765,1730,35,1,260,147
-1,1502,1672,-170,-1,-22,56
-1,1593,1862,-269,-4,-113,45
-1,1558,1662,-104,-4,-215,78
1,1550,1664,-114,3,315,67
-1,1870,1589,281,0,-200,72
-1,1760,1662,98,0,-128,74
1,1379,1442,-63,-2,187,113
-1,1310,1383,-73,-1,-83,82
-1,1332,1396,-64,3,92,46
-1,1461,1493,-32,-4,-11,42
1,1698,1578,120,3,775,95
1,1631,1564,67,-7,119,107
1,1738,1513,225,-3,1,49
-1,1609,1834,-225,-1,-20,54
1,1534,1495,39,4,147,63
1,1629,1636,-7,1,36,49
-1,1679,1758,-79,-2,-115,61
1,1351,1303,48,0,98,75
-1,1469,1827,-358,-1,-88,96
1,1880,1908,-28,-6,34,53
1,1676,1746,-70,-2,45,113
-1,1476,1432,44,-5,-76,42
-1,1482,1705,-223,0,-287,128
1,1843,1603,240,3,204,81
1,1361,1474,-113,0,110,53
-1,1525,1753,-228,-5,-111,58
1,1555,1650,-95,8,688,95
-1,1936,2176,-240,0,-1,70
1,1790,1564,226,0,25,63
-1,1605,1325,280,-3,-175,110
1,1852,1433,419,2,170,95
-1,1622,1569,53,-1,-386,118
-1,1237,1502,-265,-3,-350,78
-1,1438,1417,21,0,19,76
-1,1241,1301,-60,2,11,46
-1,1726,1783,-57,-3,-92,60
-1,1679,1743,-64,-1,153,118
-1,1732,1689,43,0,-81,66
1,1481,1405,76,0,-32,117
1,1787,1741,46,0,-128,115
0,1363,1277,86,-1,-120,91
-1,1741,1757,-16,-10,-124,96
-1,1669,1549,120,0,-186,106
1,1477,1527,-50,1,129,99
-1,1273,1804,-531,-5,-192,66
1,1582,1597,-15,0,54,55
-1,1879,1500,379,-1,-211,102
1,1514,1627,-113,0,-11,59
-1,1247,1666,-419,-15,-608,62
1,1856,1546,310,1,74,59
-1,1880,1614,266,0,50,96
1,1575,1593,-18,-1,-58,83
1,1701,1720,-19,1,105,87
-1,1741,1841,-100,-1,-199,124
-1,1510,1796,-286,2,-839,158
-1,1020,1345,-325,-20,-526,46
1,1543,1859,-316,1,114,51
1,1754,1778,-24,-1,9,71
1,1429,1413,16,-3,-142,63
-1,1500,1443,57,-13,-500,60
-1,1581,1596,-15,-8,-278,54
1,1751,1376,375,0,2,71
1,1801,1797,4,0,63,93
-1,1558,1832,-274,-1,-665,104
1,1733,1705,28,1,99,57
-1,1635,1703,-68,0,-58,84
1,1796,1731,65,2,151,73
0,1730,1707,23,-10,-308,190
-1,1734,1620,114,0,-127,158
1,1684,1795,-111,1,82,103
-1,1527,1713,-186,0,-51,94
1,1839,1554,285,1,201,97
1,1431,1321,110,5,308,90
-1,1709,1828,-119,-4,-200,60
1,1468,1350,118,-1,-14,79
1,1648,1533,115,6,234,65
-1,1711,1918,-207,-1,-79,64
1,1545,1510,35,1,153,69
1,1683,1651,32,0,81,67
1,1697,1330,367,-3,-255,69
-1,1800,1631,169,-1,-116,94
1,1375,1271,104,0,8,56
1,1480,1411,69,-3,145,77
1,1705,1924,-219,0,10,49
-1,1372,1327,45,-5,-306,82
-1,1624,1546,78,-1,-669,114
1,1904,1723,181,3,113,51
-1,1386,1486,-100,0,84,56
-1,1422,1435,-13,0,59,40
1,1717,1911,-194,0,-6,49
1,1667,1361,306,0,398,109
1,1911,1717,194,2,51,45
1,1476,1525,-49,3,247,63
-1,1285,1534,-249,-3,-34,44
1,1917,1734,183,1,14,45
1,1829,1487,342,4,95,55
1,1595,1339,256,0,55,99
1,1860,1622,238,0,28,87
-1,1327,1650,-323,4,55,90
-1,1729,1924,-195,-2,-90,58
-1,1395,1915,-520,-2,-50,48
1,1513,1488,25,-2,-255,81
1,1931,1723,208,0,288,99
1,1675,1357,318,0,339,111
1,1434,1500,-66,11,494,64
-1,1479,1555,-76,0,-645,104
-1,1444,1472,-28,-4,-188,62
1,1731,1547,184,0,72,101
-1,1264,1380,-116,-1,188,96
1,1816,1888,-72,4,5,55
-1,1392,1579,-187,4,208,98
-1,1725,1922,-197,-3,-360,88
-1,1347,1888,-541,-10,-220,78
-1,1280,1287,-7,6,56,108
-1,1442,1645,-203,-6,-143,50
-1,1381,1262,119,-5,-84,49
1,1478,1523,-45,1,31,51
1,1873,1830,43,-1,-88,65
-1,1349,1788,-439,-6,-127,52
1,1493,1301,192,-1,-63,123
-1,1584,1763,-179,-3,-119,62
1,1692,1438,254,-5,-9,47
1,1790,1347,443,0,-21,59
1,1901,1556,345,9,128,41
1,1769,1578,191,1,29,43
1,1614,1483,131,-1,-40,63
1,1539,1400,139,8,274,55
1,1683,1345,338,-6,-347,77
-1,1357,1541,-184,-4,-244,92
1,1893,1811,82,-1,-44,67
1,1203,0,1203,7,296,59
1,1901,1345,556,2,90,49
1,1532,1406,126,-3,-63,49
-1,1476,1625,-149,-2,-61,40
-1,1802,1902,-100,-4,-112,56
0,1409,1323,86,2,487,117
1,1768,1827,-59,2,76,63
-1,1498,1434,64,-4,-279,84
-1,1814,1780,34,0,-118,102
1,1911,1794,117,-2,53,63
-1,1792,1802,-10,-4,-1,40
-1,1200,1181,19,-1,-642,106
-1,1386,1495,-109,-1,-150,134
0,1465,1453,12,4,1453,105
-1,1448,1485,-37,1,41,78
1,1787,1918,-131,1,41,73
0,1326,1406,-80,2,565,119
1,1268,1182,86,1,16,45
1,1804,1922,-118,3,311,93
-1,1464,1468,-4,1,22,52
-1,1289,1342,-53,-6,-262,68
-1,1326,1475,-149,-2,-363,92
1,1903,1801,102,-2,-19,49
0,1832,1890,-58,-2,-216,93
1,1535,1386,149,5,160,59
1,1928,1676,252,0,15,101
1,1495,1437,58,-2,-30,65
-1,1575,1794,-219,0,8,70
-1,1888,1834,54,5,418,96
-1,1906,1819,87,-1,-22,72
-1,1794,1911,-117,1,-27,66
1,1265,1294,-29,1,176,99
-1,1328,1404,-76,1,-325,76
1,1847,1874,-27,0,-13,77
1,1453,1479,-26,1,192,99
1,1278,1300,-22,9,298,67
-1,1139,1221,-82,0,-267,82
1,1317,1770,-453,1,25,61
1,1919,1786,133,1,12,57
1,1358,1134,224,-2,-31,127
1,1487,1204,283,2,70,45
1,1861,1871,-10,0,97,71
1,1823,1858,-35,1,430,87
-1,1491,1383,108,0,19,56
-1,1504,1922,-418,-11,-304,58
1,1846,1511,335,-4,-185,65
-1,1511,1846,-335,-5,-116,52
1,1203,1249,-46,2,199,69
-1,1465,1349,116,1,36,54
1,1621,1800,-179,-2,-134,77
-1,1374,1542,-168,1,-187,76
-1,1782,2087,-305,0,35,122
-1,1730,1849,-119,-13,-749,78
-1,1287,1290,-3,4,84,48
-1,1476,1779,-303,-6,-119,132
1,1849,1730,119,-1,-69,91
-1,1248,1494,-246,-1,-48,70
1,1500,1782,-282,2,200,95
-1,1280,1402,-122,-4,-302,76
-1,1386,1576,-190,3,122,46
-1,1302,1274,28,0,63,50
-1,1779,1779,0,0,-60,70
1,1943,1662,281,0,-26,65
1,1737,1570,167,0,-22,67
1,1234,1376,-142,-5,-72,49
1,1427,1271,156,-1,375,119
1,1472,2092,-620,0,-9,71
1,1459,1512,-53,6,135,57
1,1390,1736,-346,4,22,40
0,1178,1319,-141,-2,-466,106
-1,1111,1364,-253,-7,-405,78
-1,1495,2061,-566,-3,-117,56
0,1861,1789,72,-4,364,123
-1,1495,1633,-138,0,-174,100
1,1315,1186,129,4,110,43
1,1369,1361,8,0,-2,49
1,1173,1322,-149,-4,-74,61
-1,1870,1661,209,1,76,98
-1,1758,1700,58,2,13,64
1,1640,1099,541,4,166,56
1,1842,1742,100,0,7,83
-1,1638,1735,-97,-1,11,56
-1,1197,1171,26,-7,-619,94
1,1488,1500,-12,13,289,45
1,1382,1324,58,1,104,97
1,1791,1854,-63,-1,53,57
-1,1466,1267,199,-5,-455,88
1,1307,1201,106,6,178,53
-1,1714,1749,-35,1,-26,72
1,1850,1500,350,0,-101,71
-1,1765,1703,62,0,-181,72
1,1496,1413,83,-2,267,91
1,1791,1717,74,-4,-58,51
-1,1374,1766,-392,-1,-62,52
-1,1092,1592,-500,-5,-99,55
-1,1744,1717,27,-3,-376,90
-1,1440,1854,-414,-1,-51,56
-1,1500,1649,-149,0,-35,50
1,1708,1664,44,0,26,85
-1,1501,1288,213,-13,-375,138
1,1389,1500,-111,0,84,47
-1,1505,1404,101,0,-73,80
1,1593,1278,315,0,140,79
1,1306,1392,-86,2,183,60
1,1430,1500,-70,6,80,43
-1,1632,1717,-85,0,-17,50
1,1857,1524,333,12,248,47
-1,1315,1240,75,-1,-40,62
1,1419,1490,-71,4,107,61
0,1729,1521,208,-2,815,141
1,1698,1655,43,-4,32,65
-1,1436,1873,-437,3,-7,70
-1,1860,1286,574,1,75,90
1,1639,1362,277,1,11,45
1,1648,1887,-239,-1,57,47
-1,1377,1331,46,-4,-236,56
1,1723,1527,196,8,303,59
1,1384,1395,-11,4,1163,125
1,1473,1307,166,16,762,61
-1,1545,1705,-160,-3,-34,44
1,1186,1179,7,15,1206,93
-1,1461,1661,-200,-4,-406,80
1,1725,1701,24,3,197,67
1,1856,1712,144,6,295,55
1,1353,1363,-10,7,333,73
-1,1705,1863,-158,0,4,46
1,1892,1434,458,1,9,49
1,2062,1707,355,1,-15,65
1,1869,1698,171,4,606,111
1,1548,1464,84,0,188,113
1,1691,1875,-184,-3,277,97
1,1104,1127,-23,0,2,51
1,1368,1396,-28,1,248,113
1,1430,1563,-133,3,112,65
1,1705,1735,-30,1,25,51
-1,1344,1646,-302,-1,-82,72
-1,1451,1456,-5,0,-13,66
1,1305,1296,9,-1,108,71
-1,1351,1372,-21,-2,-393,86
-1,1433,1363,70,0,-107,80
-1,1669,1638,31,3,97,86
1,1709,1553,156,-2,-73,71
1,1723,1600,123,0,-3,49
-1,1502,1672,-170,1,-175,84
1,1362,1466,-104,0,26,43
-1,1673,1960,-287,-5,-88,68
1,1546,1716,-170,0,-21,59
-1,1699,1563,136,0,-24,48
1,1833,1964,-131,-3,12,85
1,1338,1594,-256,1,32,73
-1,1578,1683,-105,-5,-233,64
1,1683,1578,105,1,-75,67
-1,1377,1438,-61,-2,-157,116
1,1496,1397,99,3,133,71
-1,1628,1548,80,-4,-203,54
-1,1570,1691,-121,-5,-70,48
1,1546,1668,-122,6,134,47
1,1406,1352,54,-2,68,61
1,1847,1949,-102,-1,-97,79
1,1593,1907,-314,1,134,69
1,1376,1419,-43,1,30,51
1,1601,1476,125,1,112,95
-1,1161,1699,-538,-11,-38,40
1,1504,1453,51,0,-3,73
1,1700,1577,123,12,122,41
-1,1336,1416,-80,-4,-126,64
-1,1935,2066,-131,-2,-54,46
-1,1422,1591,-169,-9,-106,100
-1,1329,1404,-75,-4,-171,66
1,1831,1429,402,1,37,49
1,1609,1536,73,-1,408,101
-1,1546,1438,108,-3,-473,98
-1,1417,1319,98,4,49,50
-1,1455,1277,178,-11,-21,40
1,1425,1322,103,-1,-7,57
1,1562,1614,-52,-3,316,105
1,1476,1928,-452,0,8,41
-1,1706,1433,273,-1,-260,122
1,1701,1574,127,9,298,53
-1,1610,1660,-50,-5,-997,134
-1,1574,1701,-127,2,36,54
-1,1334,1396,-62,-5,-278,70
1,1498,1321,177,0,31,43
1,1709,1567,142,2,83,69
-1,1653,1404,249,-3,-55,64
1,1567,1611,-44,6,214,49
0,1469,1618,-149,2,174,96
-1,1676,1600,76,-5,-266,66
1,1368,1304,64,0,130,93
-1,1504,1583,-79,-1,-82,78
-1,1514,1730,-216,0,-131,164
-1,1618,1595,23,-12,-477,64
-1,1595,1618,-23,1,150,62
1,1598,1621,-23,2,34,59
1,1283,1294,-11,-1,-28,41
-1,1606,1607,-1,-5,-175,56
-1,1495,1721,-226,1,-74,86
-1,1607,1606,1,0,28,72
1,1532,1474,58,0,20,65
-1,1617,1619,-2,-1,-74,92
-1,1606,1630,-24,-2,-80,50
-1,1633,1564,69,-1,-96,80
-1,1601,1882,-281,-4,-220,72
1,1485,1731,-246,3,120,63
-1,1641,1596,45,-2,15,48
-1,1610,1654,-44,-3,-2,46
0,1608,1628,-20,-3,-81,59
-1,1628,1608,20,1,42,58
1,1692,1464,228,1,164,95
-1,1712,1541,171,-1,-126,64
1,1609,1627,-18,-2,-331,77
1,1358,1341,17,0,6,57
-1,1558,1695,-137,-2,-79,72
-1,1612,1488,124,0,-97,84
-1,1495,1677,-182,-5,-16,40
-1,1390,1473,-83,2,1,92
-1,1697,1735,-38,0,24,52
-1,1793,1467,326,5,243,82
-1,1683,1443,240,0,-12,46
1,1298,1108,190,6,144,55
1,1688,1500,188,5,235,55
1,1702,1551,151,3,358,121
-1,1774,1487,287,0,-107,110
1,1280,1524,-244,-3,-58,55
-1,1480,1481,-1,3,515,124
1,1745,1668,77,3,125,67
-1,1754,1823,-69,0,-261,114
1,1547,1506,41,1,311,115
-1,1489,1487,2,-2,-201,86
1,1602,1486,116,0,220,119
1,1746,1275,471,0,-37,59
-1,1500,1473,27,-1,-91,70
-1,1556,1753,-197,-8,-471,122
-1,1500,1652,-152,0,-119,76
1,1500,1481,19,3,119,61
-1,1272,1747,-475,7,161,52
-1,1270,1749,-479,-2,-65,42
1,1747,1272,475,4,101,53
0,1584,1693,-109,-4,-511,115
1,1736,1300,436,2,131,57
0,1659,1660,-1,1,78,89
-1,1268,1750,-482,1,32,66
1,1500,1753,-253,-2,-41,43
1,1377,1253,124,-1,-53,83
1,1665,1709,-44,1,83,69
1,1256,1583,-327,-4,115,49
-1,1595,1575,20,-2,-55,54
1,1463,1564,-101,7,259,50
1,1878,1450,428,7,396,81
-1,1708,1872,-164,1,106,96
1,1620,1513,107,0,307,88
1,1452,1543,-91,-1,-87,71
-1,1701,1595,106,1,32,62
-1,1295,1318,-23,-4,-279,68
-1,1567,1906,-339,-3,3,44
-1,1705,1619,86,0,49,104
1,1245,1334,-89,7,563,95
1,1605,1595,10,0,18,46
1,1888,1704,184,-4,425,87
1,2149,1885,264,2,39,41
1,1569,1518,51,0,86,99
1,1899,1697,202,5,219,57
-1,1460,1890,-430,-10,-321,64
-1,1303,1329,-26,0,-227,112
1,1614,1477,137,1,86,59
-1,1873,2156,-283,-5,-38,64
1,1437,1332,105,8,479,81
0,1178,1415,-237,-3,465,139
-1,1463,1849,-386,-1,-18,48
1,1837,1797,40,-1,50,49
1,1546,1400,146,7,53,43
-1,1457,1893,-436,-2,-433,98
0,1456,1614,-158,-1,-26,65
0,1495,1553,-58,0,171,150
1,1878,1702,176,0,4,61
-1,2168,1878,290,-5,-14,80
-1,1319,1614,-295,-2,-244,92
1,1736,1599,137,1,483,145
1,1470,1621,-151,2,35,45
1,1862,1619,243,0,-7,49
-1,1611,1686,-75,-1,-35,42
-1,1691,1790,-99,-4,-8,68
-1,1640,1600,40,-2,-48,64
-1,1608,1672,-64,2,30,44
-1,1693,1852,-159,0,-162,104
1,1614,1874,-260,0,7,45
1,1846,1740,106,2,75,61
-1,1633,1487,146,1,61,104
1,1560,1574,-14,1,159,74
1,1826,1575,251,1,216,119
1,1787,1852,-65,1,25,91
-1,1828,1632,196,-1,-194,100
1,1591,1216,375,1,480,101
1,1500,1632,-132,3,83,67
-1,1229,1438,-209,-1,-165,100
0,1356,1348,8,1,-45,87
-1,1696,1884,-188,0,-34,94
1,1901,1732,169,0,509,119
-1,1695,1601,94,0,-4,64
1,1556,1505,51,0,85,61
-1,1645,1642,3,0,-225,82
-1,1605,1854,-249,-1,-5,54
1,1649,1788,-139,6,295,61
-1,1191,1320,-129,0,80,54
1,1453,1543,-90,6,519,81
-1,1858,1601,257,-1,-282,114
1,1729,1704,25,-5,63,97
1,1911,1726,185,-1,70,104
1,1752,1665,87,0,-15,55
0,1546,1617,-71,-9,64,152
-1,1908,1746,162,0,-35,70
-1,1243,1519,-276,-1,21,42
1,1840,1691,149,0,-19,63
1,1561,1579,-18,6,569,111
0,1880,1906,-26,0,19,126
1,1684,1847,-163,-1,-11,43
0,1656,1771,-115,0,-66,165
-1,1500,1455,45,0,9,102
-1,1720,1920,-200,-2,-32,46
-1,1496,1566,-70,-9,-264,57
0,1830,1701,129,1,-93,140
-1,1881,1301,580,-1,-43,74
1,1729,1503,226,8,452,73
-1,1775,1517,258,4,319,102
-1,1800,1612,188,-1,77,119
1,1527,1618,-91,-2,-5,105
-1,1853,1541,312,2,320,102
1,1706,1826,-120,0,199,121
-1,1764,1660,104,6,205,56
-1,1701,1929,-228,0,-276,96
1,1467,1342,125,16,342,51
1,1820,1560,260,3,139,87
-1,1320,1459,-139,-1,-7,66
1,1740,1424,316,0,2,61
-1,1674,1735,-61,3,31,50
1,1652,1681,-29,1,42,95
1,1754,1537,217,0,10,45
-1,1827,1556,271,-1,-675,82
1,1148,1334,-186,2,91,85
-1,1753,1665,88,-2,-81,52
1,1992,1773,219,3,24,41
1,1797,1574,223,6,-526,113
-1,1498,1615,-117,0,-89,64
1,1679,1728,-49,-4,-293,115
1,1429,1570,-141,-7,6,54
-1,1843,1836,7,-1,-131,66
1,1521,1771,-250,-5,-267,69
-1,1421,1744,-323,-5,-155,76
-1,1802,2068,-266,0,-48,110
1,1805,1569,236,-4,-319,73
1,1333,1477,-144,11,441,47
-1,1208,1594,-386,-15,-249,48
1,1936,1536,400,4,57,41
0,1628,1494,134,0,29,158
-1,1339,1578,-239,-2,-226,84
-1,1812,1564,248,0,-7,54
1,1706,1692,14,-1,153,85
1,1750,1541,209,4,223,61
-1,1332,1748,-416,-1,-519,160
-1,1525,1583,-58,-5,-107,48
-1,1784,1722,62,-1,19,62
-1,1230,1347,-117,-5,-56,42
-1,1763,1940,-177,-2,-57,60
1,2072,1798,274,1,42,49
1,1686,1623,63,0,120,77
1,1317,1194,123,4,84,57
0,1678,1603,75,0,-93,99
1,1681,1724,-43,0,-22,71
-1,1535,1756,-221,0,-28,58
0,1764,1736,28,6,147,116
1,1551,1497,54,0,45,108
1,1666,1615,51,0,77,105
-1,1794,2076,-282,-1,-89,62
1,1486,1548,-62,3,19,43
-1,1937,1949,-12,0,-52,150
-1,1577,1821,-244,0,-109,118
-1,1747,1544,203,-2,-194,102
1,1762,1530,232,0,6,47
0,1703,1694,9,-1,33,107
-1,1188,1082,106,4,-938,120
1,1527,1467,60,1,11,57
1,1446,1554,-108,-4,-142,90
1,1457,1352,105,8,707,105
1,1551,1548,3,1,77,75
-1,1588,1678,-90,-2,-40,72
-1,1525,1768,-243,-8,-92,60
-1,1763,1551,212,4,45,46
-1,1603,1521,82,-5,31,74
1,1693,1593,100,1,169,65
1,1337,1372,-35,2,576,97
1,1596,1202,394,2,270,115
1,1680,1676,4,0,245,88
1,1694,1703,-9,1,41,65
-1,1175,1325,-150,1,-165,89
1,2003,1965,38,0,4,81
1,1681,1500,181,0,125,104
-1,1500,1407,93,6,222,66
1,1747,1584,163,6,489,97
-1,1520,1773,-253,-3,-44,46
1,1685,1705,-20,2,63,59
1,1756,1578,178,-4,-206,69
1,1950,2013,-63,0,40,87
1,1334,1336,-2,1,-73,71
-1,1566,1209,357,-3,-686,104
-1,1694,1703,-9,-2,-68,56
-1,1477,1571,-94,-6,-103,54
-1,1787,1506,281,0,-7,44
1,1562,1537,25,0,-12,47
-1,1596,1776,-180,-5,-819,92
-1,1708,1569,139,-1,-31,78
1,1718,1683,35,1,34,53
-1,1764,1745,19,1,-10,68
1,1737,1604,133,19,1356,77
1,1483,1278,205,-1,571,109
1,1987,2081,-94,0,-212,93
1,1766,1527,239,5,117,69
1,1748,1394,354,-3,207,155
1,1673,1732,-59,2,23,49
-1,1562,1603,-41,-7,-577,82
1,1691,1798,-107,3,133,65
1,1573,1406,167,-1,1,65
1,1604,1691,-87,0,8,75
-1,1524,1567,-43,-10,-311,64
1,1715,1686,29,2,110,69
1,1459,1500,-41,0,7,71
-1,1391,1436,-45,-1,-107,104
1,2066,2034,32,0,-8,69
-1,1548,1807,-259,-1,-59,112
-1,1676,1728,-52,-1,92,78
-1,1261,1623,-362,-6,-90,48
-1,1734,1455,279,-5,-200,64
1,1569,1200,369,0,62,59
-1,1538,1817,-279,0,-15,60
-1,1342,1467,-125,-14,-259,46
-1,1613,1811,-198,-4,-139,60
-1,1613,1577,36,0,15,58
1,1711,1500,211,0,3,61
-1,1409,1330,79,-2,-342,126
1,1445,1381,64,-1,174,103
1,1757,1811,-54,-2,-27,45
-1,1488,1845,-357,-2,-45,40
-1,1579,1524,55,2,44,72
1,2003,2077,-74,0,3,49
-1,1761,1905,-144,-1,-9,44
-1,1469,1471,-2,2,138,80
1,1371,1454,-83,0,-94,67
1,1757,1696,61,2,21,55
-1,1483,1851,-368,-5,-127,62
1,1521,1385,136,4,160,67
1,1703,1606,97,-1,-113,77
-1,1500,1468,32,1,-226,106
-1,1373,1514,-141,2,26,46
1,1566,1365,201,1,78,59
-1,1790,2041,-251,-8,-61,42
-1,1500,1524,-24,2,34,60
1,1999,1553,446,2,28,43
-1,1795,1665,130,0,-1,80
1,1529,1444,85,0,21,65
-1,1754,1678,76,-2,-74,60
1,1626,1300,326,8,146,49
-1,1552,2001,-449,-3,-188,58
1,1598,1731,-133,1,-39,75
1,1822,1533,289,22,655,49
1,1538,1418,120,4,547,115
0,1385,1506,-121,4,385,167
-1,1777,1977,-200,0,-2,46
1,1783,1528,255,6,312,59
-1,1338,1083,255,-7,-449,114
1,1984,2003,-19,0,64,51
-1,1705,1726,-21,-1,-85,62
-1,1643,1550,93,-2,-21,60
-1,1754,1832,-78,0,-58,104
1,1540,1260,280,0,387,87
1,1529,1827,-298,0,101,77
-1,1547,1524,23,1,-173,116
1,1500,1565,-65,0,421,137
-1,1291,1629,-338,4,168,78
-1,1521,1365,156,-8,-869,86
1,1564,1614,-50,3,56,47
-1,1392,1760,-368,-3,-182,68
0,1682,1773,-91,1,3,73
1,2000,1589,411,0,129,83
1,1572,1439,133,0,6,49
1,1469,1216,253,-2,145,59
1,1578,1551,27,0,2,43
1,1363,1500,-137,12,253,57
1,1739,1695,44,-2,-54,49
-1,1379,1660,-281,-8,-312,66
1,1478,1531,-53,1,143,82
1,1633,1378,255,2,-58,87
1,1799,1374,425,0,14,47
1,1763,1386,377,0,-5,55
1,1538,1040,498,4,697,83
-1,1500,1373,127,1,-159,106
1,1786,1546,240,-2,8,49
1,1802,1375,427,13,142,41
-1,1697,1845,-148,-1,-102,72
-1,1687,2003,-316,-1,-29,58
-1,1535,1557,-22,-4,-302,110
-1,1488,1243,245,-3,-264,124
1,1690,1596,94,-1,53,69
-1,1346,1637,-291,1,27,52
-1,1307,1526,-219,-3,-66,58
1,1587,1698,-111,3,149,75
-1,1539,1491,48,-1,-21,44
1,1531,1696,-165,-1,28,73
1,1677,1859,-182,0,-267,81
1,1854,1136,718,8,180,47
1,1787,1381,406,0,-42,85
1,1683,1602,81,0,-59,65
1,1547,1489,58,3,306,68
1,1384,1686,-302,-1,-82,63
-1,1382,1505,-123,-4,-124,56
-1,1804,1694,110,-8,-178,54
-1,1593,1692,-99,1,-35,62
1,1685,1604,81,8,83,40
1,1593,1527,66,4,86,47
-1,1541,1855,-314,-13,-473,62
1,1700,1585,115,10,191,49
1,1664,1474,190,2,27,41
1,1789,1343,446,0,-45,79
1,1701,1748,-47,-1,4,41
1,1602,1376,226,2,28,45
1,1401,1254,147,1,41,47
1,1859,1538,321,0,-10,43
-1,1583,1465,118,-4,-58,48
0,1736,1714,22,0,-11,107
-1,1518,1546,-28,2,127,52
1,2011,1583,428,2,301,75
1,1564,1404,160,3,309,69
-1,1735,1714,21,-5,-61,42
1,1735,1714,21,-1,14,43
1,1548,1432,116,1,13,45
1,1726,1745,-19,-1,59,67
-1,1512,1374,138,-9,-297,58
-1,1746,1743,3,-6,-160,96
1,1862,1084,778,9,170,41
0,1849,1726,123,-3,-75,127
-1,1256,1373,-117,0,15,48
-1,1700,1734,-34,-4,-170,54
-1,1607,1470,137,-1,-3,62
-1,1508,1805,-297,-3,-229,64
-1,1373,1683,-310,-2,-296,84
-1,1744,1730,14,0,-20,46
1,1786,1890,-104,-2,66,89
-1,1771,1741,30,2,28,42
1,1512,1425,87,2,84,49
1,1556,1500,56,0,107,63
1,2095,1882,213,-4,-189,73
-1,1084,1418,-334,0,-19,46
-1,1210,1419,-209,1,2,42
1,1757,1721,36,0,183,71
-1,1369,1693,-324,-8,-253,62
1,1791,1500,291,-1,113,81
-1,1732,1741,-9,0,-6,74
-1,1547,1540,7,1,-89,136
-1,1744,1800,-56,-1,-141,134
-1,1711,1768,-57,-12,-163,40
-1,1702,1531,171,0,6,88
1,1779,1701,78,4,203,57
1,2053,2025,28,-2,-18,113
1,1567,1525,42,2,223,77
-1,1693,1788,-95,-2,-15,44
1,1641,1445,196,1,109,59
1,1694,1684,10,4,279,67
1,1788,1693,95,0,18,57
1,1511,1520,-9,0,-27,69
-1,1663,1366,297,-2,53,84
1,1685,1797,-112,-1,-46,89
-1,1703,1794,-91,1,-20,86
1,2014,2079,-65,2,284,105
1,1779,1682,97,6,254,67
-1,1500,1416,84,0,4,60
1,1781,1699,82,0,31,59
1,1674,1787,-113,-8,-183,43
1,1804,1695,109,0,10,55
1,1536,1385,151,-5,-56,77
-1,1649,1688,-39,0,26,76
1,1918,1724,194,0,223,101
-1,1690,1791,-101,-6,-461,86
-1,1524,1535,-11,0,-511,96
1,1797,1453,344,1,62,49
-1,1457,1588,-131,-4,-306,70
-1,1601,1706,-105,0,22,60
1,1799,1683,116,1,215,73
1,1639,1814,-175,-3,256,77
-1,1500,1390,110,2,-97,74
1,1769,1598,171,0,6,55
-1,1370,1335,35,0,116,80
1,2017,2071,-54,-1,76,105
-1,1675,1807,-132,-16,-487,60
1,1810,1886,-76,2,72,53
1,1545,1445,100,5,149,55
-1,1543,1504,39,-7,-450,76
-1,1617,1705,-88,-3,-193,70
-1,1794,1607,187,4,88,40
-1,1778,1768,10,-1,-216,86
1,1661,1822,-161,-1,-44,53
-1,1356,1436,-80,-1,-46,78
1,1397,1552,-155,-1,-12,43
1,1765,1854,-89,15,732,85
-1,1562,1714,-152,-1,-4,102
1,1780,1677,103,-1,-33,81
-1,1530,1521,9,0,-285,76
1,1790,1669,121,0,633,145
-1,1734,1977,-243,-9,-227,64
1,1499,1283,216,1,-7,43
-1,1504,1551,-47,0,-409,134
0,1863,1547,316,0,18,80
-1,1530,1652,-122,3,63,46
-1,1799,1662,137,0,-82,68
1,1720,1555,165,1,19,71
1,1472,1641,-169,0,29,57
1,1925,1323,602,0,84,85
-1,1712,1789,-77,-7,-145,73
-1,1519,1536,-17,-2,-108,84
-1,1655,1805,-150,-1,-75,58
-1,1500,1561,-61,-4,-543,118
1,1709,1168,541,18,310,41
-1,1504,1711,-207,-7,-153,58
-1,1548,1727,-179,0,-234,98
1,2044,2030,14,-2,245,84
1,1690,1724,-34,0,23,65
-1,1659,1500,159,0,-21,106
-1,1239,1381,-142,-7,-503,74
1,1705,1823,-118,2,678,105
1,2201,1355,846,2,120,77
-1,1517,1926,-409,-8,-237,56
-1,1508,1716,-208,-3,-425,76
1,1356,1166,190,3,410,87
1,1769,1812,-43,4,151,81
1,1719,1572,147,0,-83,85
0,1733,1735,-2,0,333,128
1,1388,1225,163,0,146,101
1,1450,1458,-8,8,551,75
0,1492,1717,-225,-2,-519,116
1,1715,1695,20,1,25,83
-1,1730,1851,-121,-1,-78,70
-1,1808,1856,-48,-4,-131,64
-1,1633,1773,-140,-1,-48,74
1,1503,1622,-119,9,807,113
1,1492,1561,-69,-2,-64,49
-1,1868,1799,69,0,-9,78
-1,1213,1395,-182,-5,-99,64
-1,1150,1577,-427,-4,-162,52
1,2202,1681,521,0,9,61
1,1592,1575,17,-5,51,85
1,1710,1499,211,-3,-75,45
0,1855,1627,228,0,27,69
-1,1333,1445,-112,-2,-73,42
-1,1556,1574,-18,1,23,68
1,1834,1800,34,-5,-134,41
-1,1515,1566,-51,3,164,62
-1,1678,1735,-57,0,-299,112
0,1773,1698,75,-2,-917,192
1,1493,1716,-223,0,10,47
1,2206,1679,527,1,27,81
-1,1254,1374,-120,-1,-88,52
1,1791,1879,-88,-1,32,53
-1,1374,1613,-239,2,119,58
-1,1824,1804,20,-2,-95,46
1,1575,1505,70,-3,48,107
-1,1678,2207,-529,-4,-210,62
-1,1420,1579,-159,-5,-340,72
-1,1494,2245,-751,-3,-80,48
-1,1816,1782,34,1,63,60
1,1414,1713,-299,2,113,65
-1,1766,1705,61,0,31,60
0,1494,1511,-17,-1,-193,165
-1,2209,1677,532,-3,65,70
-1,1821,1804,17,-8,-564,78
1,1697,1753,-56,0,120,67
1,2246,1490,756,-1,-65,89
-1,1526,1564,-38,8,277,68
1,1742,1729,13,0,399,133
-1,1815,1787,28,0,159,78
-1,1530,1449,81,2,21,56
1,1852,1712,140,1,299,87
-1,2204,2065,139,-4,-98,52
1,2175,1698,477,5,140,59
1,1745,1433,312,0,285,65
-1,1752,1719,33,-7,-216,60
1,1510,1494,16,5,421,81
1,1740,1731,9,1,21,51
1,1475,1426,49,-1,56,53
1,1731,1740,-9,-2,151,75
-1,1584,1886,-302,0,-87,72
-1,1729,1742,-13,4,30,46
-1,1555,1542,13,-1,-43,64
1,1719,1752,-33,-4,166,81
-1,1543,1585,-42,-2,-205,88
1,1646,1516,130,-1,27,59
-1,1719,1752,-33,-4,-10,48
1,1420,1348,72,5,-103,41
-1,1731,1740,-9,0,-76,71
1,1722,1585,137,-3,-70,50
1,1740,1731,9,-1,-38,59
-1,1803,1713,90,0,13,56
-1,1649,1845,-196,-1,19,94
1,1493,1402,91,4,280,81
1,1751,1580,171,-1,-84,81
-1,1734,1829,-95,-1,8,66
-1,1844,2094,-250,0,-240,108
-1,1538,1559,-21,0,4,42
-1,1735,1632,103,1,-98,60
1,1838,1727,111,0,96,110
1,1803,1574,229,0,36,63
1,1496,1302,194,-2,-65,55
-1,1460,1498,-38,-5,-127,54
1,1875,1569,306,-1,64,69
-1,1710,1708,2,0,-40,70
-1,1861,1644,217,0,9,78
-1,1603,1782,-179,1,25,48
1,1724,1803,-79,-1,-35,49
-1,1840,1872,-32,0,-57,114
1,1546,1565,-19,3,101,59
1,2177,1860,317,1,40,87
1,1646,1393,253,-3,-78,99
1,1590,1580,10,0,-48,125
-1,1229,1595,-366,-12,-81,46
-1,1240,1502,-262,0,-304,74
-1,1348,1450,-102,-7,-408,112
-1,1846,1737,109,3,17,52
1,1650,1659,-9,0,2,47
-1,1725,1826,-101,4,16,58
-1,1856,2183,-327,0,41,62
1,1561,1508,53,6,248,49
-1,1371,1278,93,-4,-338,78
1,1750,1831,-81,4,530,81
1,1506,1202,304,-1,-101,85
1,2188,1853,335,0,6,55
1,1729,1402,327,3,240,75
-1,1568,1648,-80,-4,-29,78
1,1763,1757,6,0,-3,51
-1,1697,1561,136,0,18,50
-1,1430,1467,-37,2,40,84
-1,1478,1318,160,-2,-197,92
-1,1797,1849,-52,-12,-41,40
1,1553,1465,88,2,281,89
-1,1493,1434,59,-6,-49,40
1,1996,1738,258,4,227,69
1,1228,1444,-216,1,-275,107
1,1500,1529,-29,-3,-37,65
-1,1500,1472,28,-1,-13,54
-1,1559,1516,43,-2,-146,92
1,1400,1263,137,-1,117,117
1,1636,1974,-338,0,-38,41
-1,1741,1748,-7,1,-50,59
1,1589,1739,-150,-3,-6,73
1,1647,1383,264,-1,-41,52
1,1641,1435,206,8,308,55
-1,1528,1547,-19,-1,-273,120
-1,1709,1950,-241,0,-35,76
-1,1701,1795,-94,0,-1,56
1,1320,1230,90,-9,-299,97
1,1520,1690,-170,0,43,47
0,1759,1771,-12,3,109,133
-1,1674,1397,277,-1,-47,62
1,1471,1426,45,-8,-120,69
1,1500,1419,81,-2,-130,75
-1,1651,1518,133,1,15,62
-1,1609,1468,141,1,64,44
-1,1429,1344,85,1,-98,124
1,1479,1656,-177,3,243,69
1,1563,1618,-55,3,213,121
-1,1658,1983,-325,-2,-312,84
-1,1328,1411,-83,-4,-147,50
-1,1102,1534,-432,-10,-637,110
0,1955,1803,152,0,-28,97
-1,1644,1561,83,-3,-254,66
-1,1532,1635,-103,-2,11,66
1,1684,1690,-6,0,3,55
1,1252,1215,37,-1,45,83
1,1910,1911,-1,3,44,53
1,1656,1734,-78,2,97,87
-1,1771,1759,12,-1,-49,70
1,1416,1459,-43,4,125,53
1,1456,1549,-93,6,703,129
-1,1732,1632,100,-2,-27,40
1,1798,2028,-230,1,174,107
-1,1644,1525,119,0,-152,124
-1,1248,1581,-333,0,-104,66
1,1576,1148,428,17,248,47
1,1429,1497,-68,2,54,51
1,1421,1374,47,2,54,61
1,1808,1625,183,0,30,69
-1,1770,1759,11,-4,-133,76
-1,1588,1550,38,-1,-22,50
-1,1599,1673,-74,-1,-42,70
1,1539,1628,-89,2,164,71
1,1760,1900,-140,0,-107,111
1,1578,1256,322,-9,-262,85
1,1366,1506,-140,0,94,95
1,1285,1158,127,5,63,45
-1,1676,1814,-138,0,60,80
-1,1443,1464,-21,0,-105,66
1,2054,1921,133,0,4,111
1,1263,1390,-127,-1,-2,58
0,1771,1759,12,2,-196,143
1,1670,1726,-56,1,38,75
-1,1884,1721,163,0,5,54
1,1614,1552,62,0,75,121
-1,1563,1575,-12,0,18,76
1,1423,1100,323,4,342,75
1,2128,1715,413,1,-2,41
-1,1483,1736,-253,0,-16,52
-1,1816,1713,103,-2,-6,42
1,1296,1414,-118,13,499,63
-1,1388,1500,-112,-5,-152,46
-1,1424,1821,-397,-3,-64,50
1,1585,1453,132,9,370,60
1,1636,1629,7,6,1463,155
1,1667,1544,123,5,248,81
-1,1291,1423,-132,-9,-249,44
1,2213,1727,486,0,-27,63
1,1824,1422,402,1,37,54
1,1551,1447,104,-1,99,80
0,1590,1449,141,2,83,155
-1,1786,1651,135,-2,-40,48
1,1799,1622,177,-4,-103,103
-1,1445,1593,-148,-6,-275,84
1,1759,1500,259,0,137,81
1,1838,1685,153,-1,-37,45
1,2027,2134,-107,4,418,133
1,1736,1816,-80,-1,-54,55
-1,1280,1284,-4,2,-119,82
-1,1420,1826,-406,-2,-87,77
-1,1245,1354,-109,5,-17,52
1,1624,1487,137,1,44,67
-1,1963,1504,459,1,45,50
1,1655,1363,292,2,213,91
1,1564,1451,113,-2,21,103
-1,1489,1522,-33,2,-381,116
1,1600,1438,162,1,54,73
-1,1682,1596,86,3,54,44
-1,1536,1676,-140,-2,-55,56
-1,1197,1705,-508,-4,-126,50
1,2124,2036,88,1,123,67
1,1624,1382,242,8,376,67
-1,1590,1559,31,-5,-99,40
-1,1319,1563,-244,-3,-49,108
1,1936,1636,300,3,166,71
-1,1432,1606,-174,0,-86,110
1,1703,1401,302,3,313,85
1,1430,1268,162,2,76,95
-1,1559,1941,-382,-1,-51,60
1,1498,1559,-61,0,1,57
-1,1402,1700,-298,-2,-385,102
0,1413,1494,-81,1,-149,124
-1,1268,1578,-310,3,-49,64
-1,1571,1418,153,-10,-410,64
-1,1368,1628,-260,0,29,68
1,1685,1530,155,3,72,47
0,1381,1195,186,3,719,164
1,1537,1443,94,3,62,49
1,1891,1331,560,6,595,87
1,1833,1733,100,0,-25,51
-1,1492,1416,76,-2,-137,76
-1,1260,1491,-231,0,-70,58
-1,1312,1665,-353,-2,-30,46
-1,1532,1466,66,1,32,64
-1,1715,1869,-154,-7,-22,40
-1,1593,1500,93,-3,-173,68
-1,1345,1231,114,1,-141,78
1,1559,1665,-106,6,350,101
-1,1654,1929,-275,3,115,124
1,1710,1633,77,0,12,103
1,1449,1559,-110,3,118,44
-1,1476,1432,44,0,-35,46
-1,1454,1529,-75,0,-3,59
0,1430,1478,-48,0,-55,114
0,1670,1627,43,0,-17,88
1,1356,1497,-141,3,32,41
-1,1659,1632,27,-2,-83,62
1,1604,1255,349,-2,93,93
1,1328,1252,76,-6,-244,79
-1,1583,1892,-309,4,-82,84
1,1875,1722,153,0,8,45
1,1642,1669,-27,0,8,109
-1,1445,1470,-25,-6,-41,88
-1,1545,1694,-149,-1,-84,72
1,1479,1397,82,3,319,83
1,1579,1331,248,-3,-77,49
1,1972,1620,352,-5,114,107
-1,1667,1797,-130,-1,-43,58
1,1574,1564,10,0,119,79
-1,1356,1453,-97,1,-160,88
-1,1477,1432,45,0,-43,98
-1,1841,1651,190,-5,-79,40
-1,1650,1692,-42,0,-67,68
-1,1509,1469,40,-1,-107,72
1,1807,1660,147,0,3,45
-1,1410,1666,-256,0,14,112
-1,1607,1500,107,1,-18,60
0,1702,1538,164,-2,452,160
1,1500,1523,-23,1,77,75
1,1721,1624,97,0,6,115
-1,1704,2061,-357,1,45,96
1,1459,1436,23,0,150,113
1,1654,1816,-162,0,636,147
-1,1975,2117,-142,-2,2,78
-1,1511,1620,-109,0,-32,58
1,1246,1263,-17,-3,-573,75
-1,1845,1709,136,0,-49,86
-1,1223,1488,-265,-2,-545,136
1,1630,1687,-57,0,60,83
-1,1523,1772,-249,0,-6,44
-1,1824,1852,-28,0,-5,46
-1,1328,1500,-172,0,-161,80
-1,1598,1534,64,-1,-117,82
-1,1852,1591,261,-1,-9,62
1,1640,1515,125,0,-39,61
-1,1554,1585,-31,0,-66,74
0,1835,1704,131,0,7,92
1,1463,1256,207,-2,99,85
-1,1630,1249,381,0,-257,106
-1,1348,1338,10,3,182,70
-1,1674,1643,31,-4,-49,40
-1,1744,1607,137,0,-588,82
1,1650,1670,-20,4,144,53
1,1591,1562,29,0,387,141
1,1260,1258,2,-3,-768,79
-1,1576,1610,-34,0,-35,66
1,1701,1950,-249,7,199,63
1,1823,1609,214,1,34,45
1,1482,1568,-86,2,27,43
-1,1731,1616,115,2,17,40
1,1806,1497,309,2,256,71
-1,1694,1779,-85,0,33,110
1,1628,1503,125,6,49,41
1,1312,1435,-123,2,60,67
1,1648,1565,83,0,-7,73
1,1597,1546,51,-2,-188,75
1,1496,1492,4,1,105,71
-1,1655,1692,-37,3,141,70
1,1828,1572,256,0,16,73
1,1660,1544,116,4,19,41
1,1793,1855,-62,3,170,83
1,1250,1484,-234,3,211,73
1,1713,1218,495,7,405,81
1,1787,1664,123,0,409,123
-1,1519,1430,89,5,167,68
-1,1607,1637,-30,0,-66,88
1,1272,1295,-23,-3,-57,47
1,1930,1633,297,-1,-48,93
-1,1500,1497,3,1,9,40
-1,1603,1863,-260,0,-13,44
1,1831,1709,122,0,-2,97
-1,1506,1459,47,-1,-91,74
1,1507,1493,14,-2,-12,45
0,1536,1667,-131,-1,-21,65
1,1760,1805,-45,1,98,63
1,1720,1669,51,-1,18,59
-1,1530,1637,-107,0,-110,68
1,1576,1537,39,5,253,81
-1,1493,1810,-317,-3,-131,90
1,1612,1630,-18,0,-9,95
-1,1556,1657,-101,1,20,74
1,1285,1478,-193,3,209,63
1,1556,1663,-107,-3,-4,81
-1,1359,1818,-459,1,-197,110
-1,1426,1474,-48,-3,-181,96
1,1757,1731,26,-2,32,57
1,1805,1689,116,-1,-9,65
1,1472,1489,-17,0,-58,129
1,1418,1309,109,5,149,41
-1,1835,1793,42,-3,-76,56
1,1660,1444,216,3,58,49
-1,1241,1550,-309,-7,-159,52
1,1656,1389,267,1,365,113
1,1663,1540,123,-1,52,71
1,1465,1590,-125,-1,-5,41
0,1686,1659,27,0,91,171
0,1469,1660,-191,0,33,83
1,2215,1772,443,-1,-94,115
-1,1513,1269,244,-4,193,58
-1,1361,1553,-192,-1,-122,78
1,1650,1627,23,-1,59,73
0,1829,1514,315,5,145,126
0,1551,1609,-58,-1,33,173
1,2130,1864,266,0,54,87
-1,1234,1629,-395,0,-40,64
1,1613,1511,102,-5,-16,81
-1,1519,1554,-35,-1,-51,58
1,1717,1429,288,0,20,53
-1,1324,1421,-97,-7,-338,84
1,1764,1290,474,0,-5,49
-1,1665,1767,-102,0,-33,80
1,1616,1350,266,8,188,49
1,1494,1619,-125,0,-19,73
1,1715,1289,426,0,58,53
1,1681,1813,-132,0,16,81
-1,1439,1388,51,-11,-59,40
-1,1730,1781,-51,-1,-45,76
1,1586,1357,229,2,150,65
1,1771,1362,409,1,40,43
-1,1830,1915,-85,-3,-33,72
-1,1661,1831,-170,0,-82,61
1,1401,1426,-25,-1,29,63
-1,1634,1293,341,0,37,56
1,1655,1424,231,0,187,75
-1,1353,1781,-428,-7,-39,42
-1,1865,1860,5,0,-18,66
-1,1671,1715,-44,1,49,70
1,1660,1685,-25,2,66,63
1,1434,1480,-46,0,-112,91
-1,1304,1475,-171,-2,-76,56
1,1624,1382,242,0,290,107
-1,1510,1572,-62,-2,-101,64
-1,1720,1702,18,0,-154,118
1,1673,1671,2,0,103,89
1,2275,2135,140,1,140,83
-1,1569,1487,82,-3,-188,61
1,1552,1286,266,9,364,49
-1,1297,1071,226,-1,-373,102
1,1853,1722,131,0,-5,54
1,1631,1232,399,0,337,101
-1,1484,1554,-70,1,4,72
-1,1490,1779,-289,2,-80,94
-1,1500,1582,-82,-1,-31,56
-1,1632,1789,-157,-2,-67,62
1,1797,1697,100,0,54,89
-1,1775,2127,-352,-1,-33,86
1,1574,1431,143,-2,-23,53
-1,1651,1663,-12,0,-8,42
1,1852,1654,198,2,146,119
1,1815,1515,300,0,332,69
1,1660,1563,97,2,82,55
1,1772,1473,299,-3,-35,43
1,1604,1490,114,8,174,57
-1,1784,1764,20,0,-36,124
1,1429,1315,114,1,74,87
1,1661,1715,-54,1,26,46
1,1535,1231,304,0,145,85
-1,1878,1786,92,-1,-175,104
1,1629,1532,97,8,105,49
1,1672,1672,0,0,62,107
-1,1517,1828,-311,0,-6,56
-1,1760,1828,-68,-3,-22,66
1,1302,1281,21,9,571,78
-1,1713,1708,5,0,-5,138
-1,1703,1674,29,-1,-2,49
-1,1611,1679,-68,0,-86,120
1,1668,1410,258,1,513,87
1,1969,1335,634,0,13,43
1,1351,1479,-128,3,120,93
-1,1385,1507,-122,-1,-98,108
1,1565,1323,242,-3,120,65
1,1705,1674,31,5,189,61
-1,1342,1422,-80,-3,-111,72
-1,1677,1720,-43,-7,-155,52
-1,1631,1551,80,-8,-589,126
-1,1585,1408,177,-1,-2,42
-1,1368,1464,-96,1,15,42
-1,1523,1691,-168,0,-170,118
-1,1645,1672,-27,-1,-3,40
1,1359,1472,-113,7,-11,63
-1,1585,1803,-218,-4,-232,92
-1,1119,1400,-281,-3,-727,154
1,1437,1419,18,11,172,81
1,1500,1644,-144,13,499,59
1,1682,1635,47,1,16,59
0,1680,1662,18,0,123,135
1,1375,1457,-82,2,162,77
0,1439,1651,-212,-5,-210,118
-1,1567,1617,-50,-5,-161,64
1,1869,1730,139,0,22,89
-1,1494,1506,-12,1,-423,150
1,1645,1591,54,2,29,57
1,1693,1674,19,-2,39,61
-1,1862,1970,-108,0,-22,64
-1,1515,1672,-157,-2,-248,84
-1,1390,1443,-53,-2,366,80
1,1762,1155,607,0,8,59
0,1719,1881,-162,-5,43,96
0,1742,1692,50,0,1,55
-1,1562,1629,-67,0,4,48
1,1425,1425,0,-1,49,62
1,1626,1556,70,0,-78,77
1,1726,1525,201,-3,10,65
-1,1687,1851,-164,0,-3,50
-1,1634,1625,9,-3,-33,68
1,1779,1573,206,1,107,69
1,1380,1453,-73,0,19,59
-1,1397,1601,-204,-1,-308,116
1,1776,1145,631,-2,-42,49
-1,1692,1682,10,-3,-59,52
1,1394,1440,-46,2,238,65
1,1860,1741,119,0,26,71
1,1525,1206,319,-1,-37,43
1,1546,1636,-90,3,68,41
-1,1681,1693,-12,-1,-34,52
-1,1510,1422,88,0,356,136
1,1788,1137,651,-2,11,63
1,1509,1620,-111,1,1,45
-1,1408,1427,-19,-3,-366,64
1,1534,1581,-47,4,172,71
-1,1621,1562,59,0,-216,100
1,1979,1704,275,-1,-47,83
-1,1870,1647,223,-12,-361,58
1,1799,1130,669,-2,-34,49
-1,1663,2051,-388,-4,-82,44
-1,1295,1593,-298,-5,-223,64
0,1837,1784,53,1,10,84
1,1397,1437,-40,-2,-93,85
1,1642,1679,-37,-4,-94,49
-1,1946,1733,213,3,-2,70
1,1638,1650,-12,0,79,70
-1,1808,1847,-39,0,-64,76
-1,1716,1761,-45,-4,-525,116
-1,1700,1500,200,0,-1,46
-1,1413,1436,-23,-2,9,56
-1,1410,1425,-15,2,33,44
1,1579,1583,-4,-1,-29,59
-1,1576,1608,-32,1,-13,74
1,1750,1744,6,-3,9,131
1,1690,1858,-168,0,148,69
1,1713,1429,284,-1,53,73
-1,1399,1436,-37,-2,-143,76
-1,1341,1468,-127,-5,-240,70
-1,1535,1536,-1,-5,12,66
-1,1585,1528,57,-8,-53,40
1,1517,1326,191,0,-80,87
-1,1618,1565,53,0,-319,96
-1,1744,1837,-93,-1,-50,66
-1,1472,1636,-164,-4,-59,44
1,1517,1663,-146,-2,-149,123
0,1435,1444,-9,0,-135,138
-1,1618,1649,-31,-1,-61,56
1,1361,1274,87,-1,-5,63
-1,1760,1859,-99,0,-102,126
-1,0,1200,-1200,3,47,90
-1,1548,1524,24,-2,-239,112
0,1458,1594,-136,0,-16,125
-1,1824,1664,160,-1,-60,58
-1,1625,1562,63,0,-117,118
-1,1579,1606,-27,-5,-74,50
0,2059,1786,273,0,-123,140
-1,1572,1615,-43,4,257,78
1,1876,1723,153,1,59,79
-1,1277,1443,-166,-1,-68,62
1,1727,1466,261,0,146,57
1,1848,1641,207,2,244,49
-1,1557,1574,-17,0,-76,61
-1,1855,1769,86,-2,-364,74
-1,1264,1371,-107,1,96,40
1,1658,1482,176,1,14,81
1,1638,1552,86,3,226,81
1,1828,1468,360,-8,40,65
-1,1460,1663,-203,2,40,56
1,1620,1993,-373,-6,-154,53
-1,1783,1838,-55,0,83,76
1,1483,1597,-114,-2,147,121
1,1643,1533,110,1,109,85
1,1523,1320,203,7,64,41
0,1643,1466,177,-1,-220,98
1,1500,1112,388,0,22,47
-1,1525,1432,93,-3,-265,144
1,1684,1413,271,-3,-8,45
-1,1450,1516,-66,-3,-223,66
-1,1616,1969,-353,1,31,62
1,1849,1773,76,0,-127,95
-1,1717,2023,-306,-2,-59,50
1,1527,1419,108,-1,-137,81
1,1557,1093,464,0,-48,59
-1,1462,1499,-37,-1,-157,164
1,1732,1703,29,0,61,65
-1,1524,1546,-22,-3,-57,48
1,1403,1561,-158,-3,7,69
0,1765,1860,-95,5,325,104
1,1590,1079,511,1,-11,65
-1,1793,2041,-248,-1,-24,50
-1,1650,1829,-179,-1,-18,56
-1,1378,1234,144,-3,-368,110
1,1664,1730,-66,0,241,91
1,1677,1435,242,0,1,59
-1,1528,1765,-237,-5,-148,58
1,1525,1653,-128,2,113,75
1,1340,1507,-167,2,179,66
-1,1487,1500,-13,-3,-85,68
-1,1714,1856,-142,-2,-214,96
-1,1265,1765,-500,-1,37,66
-1,1450,1268,182,1,5,58
-1,1614,1068,546,-2,-33,48
1,2042,1713,329,0,4,55
-1,1369,1582,-213,-1,-111,79
-1,1972,1727,245,0,108,58
-1,1503,1566,-63,0,-138,74
-1,1864,1707,157,1,-60,70
-1,1311,1951,-640,0,-326,72
-1,1406,1535,-129,-1,24,42
-1,1677,1874,-197,0,-236,112
1,2052,1788,264,-3,35,51
-1,1753,1826,-73,-1,-289,110
1,1510,1452,58,1,291,111
1,1723,1445,278,6,349,59
-1,1439,1436,3,-1,-164,144
1,1302,1640,-338,2,526,101
1,1727,1442,285,4,180,75
-1,1099,1297,-198,1,-105,88
-1,1709,2057,-348,0,-8,56
1,1616,1554,62,-4,84,49
-1,1591,1583,8,-5,-131,44
1,1934,1538,396,0,73,103
-1,1243,1361,-118,6,158,62
1,1613,1573,40,1,222,99
-1,1831,1717,114,0,-55,92
-1,1625,1731,-106,-1,-104,62
-1,1544,1438,106,4,38,52
1,1880,1671,209,2,307,77
0,1419,1408,11,0,-229,96
-1,1672,1377,295,-5,-168,68
0,1668,1478,190,-5,-477,152
1,1442,1520,-78,1,43,55
1,1846,1952,-106,0,6,73
-1,1745,1862,-117,-11,-352,66
-1,1739,1617,122,-1,-82,58
1,1871,1535,336,-8,263,103
1,1742,1581,161,2,130,83
-1,1542,1492,50,-1,-152,62
-1,1425,1450,-25,-3,-100,54
-1,1374,1628,-254,1,18,80
-1,1536,1460,76,3,17,52
1,1632,1724,-92,-1,-42,47
1,1666,1886,-220,0,-116,121
-1,1532,1874,-342,-2,-13,90
-1,1532,1716,-184,-1,-43,48
1,1709,1647,62,0,373,90
-1,1381,1532,-151,2,136,66
1,1638,1752,-114,0,4,87
1,1425,1448,-23,1,433,91
-1,1637,1719,-82,3,-74,72
0,1487,1503,-16,-19,-681,70
1,1610,1535,75,0,-26,67
1,1767,1866,-99,-2,-14,49
1,1727,1628,99,-6,-156,119
1,1867,1683,184,0,258,87
1,1739,1684,55,0,59,87
1,1937,1483,454,5,245,73
1,1584,1254,330,14,188,51
-1,1500,1607,-107,-2,-141,76
-1,1620,1736,-116,-11,-971,104
1,1939,1423,516,1,51,49
0,1643,1579,64,2,147,150
1,1587,1454,133,3,163,47
1,1418,1602,-184,1,68,69
-1,1538,1532,6,-1,-98,81
-1,1500,1746,-246,-5,-304,70
-1,1738,1709,29,1,-263,110
1,1743,1612,131,3,131,59
1,1483,1520,-37,-3,8,77
1,1677,1873,-196,0,42,95
1,1727,1682,45,1,269,81
1,1941,1337,604,2,1303,129
-1,1544,1374,170,-8,-162,48
-1,1437,1544,-107,-1,-34,80
-1,1577,1633,-56,-1,-116,74
-1,1605,1750,-145,-2,-72,50
0,1502,1415,87,0,-57,143
1,1868,1619,249,-1,577,131
1,1757,1598,159,7,435,77
1,1615,1488,127,1,436,111
-1,1592,1764,-172,-5,-126,68
1,1671,1737,-66,1,657,123
1,1872,1615,257,0,5,57
-1,1753,1840,-87,2,-72,122
1,1855,1694,161,0,14,47
-1,1748,1785,-37,3,75,50
-1,1770,1585,185,-1,-58,108
1,1904,1606,298,2,198,73
1,1423,1435,-12,0,14,41
1,1527,1435,92,4,609,103
-1,1688,1862,-174,-1,-509,102
1,1881,1685,196,0,320,97
1,1548,1644,-96,1,108,109
-1,1455,1348,107,-4,-195,62
-1,1598,1760,-162,-2,-169,136
1,1557,1414,143,1,121,47
-1,1724,1653,71,0,245,116
-1,1679,1887,-208,-1,-273,180
-1,1750,1737,13,-2,-96,52
1,1356,1409,-53,-1,-62,59
1,1592,1767,-175,2,602,83
1,1613,1370,243,5,428,91
1,1345,1218,127,13,240,45
-1,1868,1682,186,0,-11,64
1,1496,1551,-55,4,175,73
1,1609,1627,-18,-1,6,45
1,1893,1674,219,0,314,123
1,1711,1528,183,10,358,59
1,1942,1334,608,0,6,49
-1,1569,1507,62,0,-48,64
-1,1620,1561,59,0,-217,116
-1,1448,1507,-59,-2,-172,70
0,1525,1435,90,0,18,109
1,1423,1481,-58,1,57,99
1,1315,1427,-112,-1,-13,43
-1,1535,1500,35,-10,-144,50
1,1796,1765,31,3,523,141
1,1780,1627,153,4,191,69
-1,1624,1615,9,-2,-55,56
1,1943,1466,477,0,-2,57
1,1828,1797,31,0,197,85
1,1516,1431,85,-1,-44,65
-1,1210,1358,-148,-10,-648,92
1,1402,1310,92,0,126,65
-1,1716,1704,12,3,134,72
-1,1156,1500,-344,-9,-863,94
-1,1498,1537,-39,-1,-32,44
1,1698,1520,178,-2,15,93
1,1599,1496,103,13,339,43
-1,1500,1566,-66,-9,-137,40
1,1361,1407,-46,2,21,97
1,1527,1539,-12,-2,41,67
1,1944,1472,472,-1,-13,71
-1,1310,1570,-260,0,146,88
0,1591,1732,-141,1,-33,71
-1,1671,1593,78,0,-295,118
-1,1620,1556,64,-1,-37,66
-1,1626,1500,126,6,62,42
-1,1717,1705,12,0,-4,54
1,1616,1584,32,0,-77,97
1,1745,1777,-32,2,152,83
1,1716,1704,12,0,5,95
0,1146,1468,-322,0,-549,140
-1,1514,1704,-190,8,198,74
1,1905,1574,331,3,141,57
1,1908,1416,492,0,-10,53
1,1438,1500,-62,10,164,47
-1,1617,1682,-65,-4,-61,54
1,1315,1441,-126,5,132,61
1,1693,1727,-34,0,98,77
-1,1607,1691,-84,0,64,70
1,1604,1685,-81,0,1701,141
1,1595,1500,95,6,272,69
1,1528,1544,-16,-2,-6,115
1,1565,1554,11,0,393,139
-1,1598,1699,-101,-1,-80,76
-1,1293,1229,64,-1,-72,74
1,1377,1641,-264,4,196,61
1,1715,1706,9,-1,-6,49
-1,1503,1581,-78,0,8,58
1,1599,1617,-18,-4,-63,83
1,1695,1725,-30,-1,-18,55
-1,1509,1422,87,6,146,56
-1,1417,1448,-31,4,51,42
1,2196,1759,437,0,6,59
1,1655,1597,58,0,21,53
1,1672,1521,151,-1,-42,79
1,1271,1511,-240,-2,-27,73
-1,1712,1943,-231,-2,-43,50
1,1956,1707,249,-1,-3,61
1,1675,1698,-23,4,302,83
-1,1493,1617,-124,-1,-90,70
1,2199,1757,442,-1,12,141
-1,1575,1836,-261,-11,-201,136
1,1588,1664,-76,1,14,55
-1,1849,2122,-273,1,11,58
1,1285,1288,-3,5,94,55
1,1651,1601,50,-3,-105,45
-1,1530,1553,-23,-8,-705,90
-1,1720,1855,-135,0,-59,92
1,1616,1540,76,0,13,47
0,1742,1838,-96,0,-63,126
0,1716,1515,201,1,-57,121
1,1428,1537,-109,1,263,117
-1,1561,1859,-298,-3,-58,52
1,1329,1570,-241,-1,-31,61
1,1592,1660,-68,0,1,61
1,2202,1755,447,3,145,77
1,1659,1456,203,0,232,111
-1,1557,1868,-311,0,-2,44
1,1647,1605,42,3,359,101
1,1913,1352,561,1,41,71
1,1678,1325,353,3,418,109
1,1746,1532,214,3,111,57
1,1278,1469,-191,12,592,60
1,1427,1303,124,0,60,77
-1,1657,1539,118,-5,-189,94
-1,1340,1915,-575,-5,-13,60
-1,1552,1703,-151,3,-40,60
-1,1596,1959,-363,-4,-143,66
-1,1595,1657,-62,0,-263,156
1,1863,1713,150,0,30,93
-1,1545,1710,-165,0,17,95
-1,1581,1951,-370,0,-200,76
-1,1745,1835,-90,-3,-49,114
1,1687,1808,-121,1,71,69
-1,1391,1665,-274,0,-36,60
-1,1373,1545,-172,-5,-201,98
1,1666,1586,80,3,301,131
1,1954,1578,376,6,211,57
1,1456,1569,-113,-2,-10,73
-1,1575,1957,-382,1,84,70
1,1965,2046,-81,1,52,47
1,1594,1609,-15,-1,98,71
1,1621,1489,132,-4,-42,59
1,1521,1709,-188,-1,-121,117
-1,1503,1559,-56,-10,-152,52
-1,1707,1870,-163,0,-41,76
1,2045,1916,129,1,191,97
1,1682,1686,-4,0,-115,97
-1,1908,2054,-146,-1,-7,122
-1,1359,1500,-141,-2,-149,116
1,1538,1458,80,7,294,59
-1,1330,1966,-636,1,2,48
-1,1750,1318,432,0,3,42
1,1554,1716,-162,3,352,99
-1,1139,1333,-194,-12,-917,80
1,1329,1481,-152,-4,-39,87
1,1967,1323,644,3,32,43
-1,1876,1701,175,0,-64,88
1,1449,1547,-98,-1,138,81
-1,1742,1513,229,0,-252,92
1,1960,1700,260,-1,14,79
1,2062,2131,-69,-1,87,133
1,1500,1526,-26,-2,-171,123
1,1774,1729,45,0,41,109
1,1624,1628,-4,0,-23,125
-1,1437,1552,-115,0,-177,90
-1,1968,2204,-236,0,-220,114
-1,1404,1763,-359,1,-184,94
1,1533,1464,69,3,172,81
-1,1558,2114,-556,-11,-261,44
1,1581,1383,198,1,-3,60
1,1439,1560,-121,4,111,61
-1,1524,2116,-592,-3,-14,44
1,1717,1860,-143,1,128,95
1,1625,1410,215,2,184,83
1,1571,1962,-391,-3,35,110
1,1629,1500,129,0,287,75
-1,1405,1337,68,0,-189,126
1,1455,1542,-87,-3,225,77
1,2117,1523,594,0,-19,57
-1,1291,1494,-203,-3,-273,70
-1,1603,1402,201,2,164,76
1,1935,1695,240,0,19,59
-1,1771,1730,41,-3,-165,96
1,1528,1469,59,1,77,57
0,1457,1454,3,0,357,157
1,1690,1569,121,3,373,135
-1,1664,1619,45,0,-43,62
1,1463,1606,-143,-1,165,125
1,1844,1732,112,0,109,113
1,2212,1941,271,-4,70,79
1,1638,1604,34,3,277,121
1,1635,1616,19,-2,23,65
0,1934,1806,128,2,-63,76
-1,1359,1390,-31,-1,-554,96
1,1729,1962,-233,0,-2,77
1,1936,2218,-282,-3,-243,93
1,1758,1698,60,1,74,69
1,1843,2119,-276,0,-2,51
-1,1400,1630,-230,-3,-164,64
1,1377,1586,-209,7,286,59
-1,1353,1258,95,-15,-65,40
1,1593,1689,-96,-2,-44,85
-1,1594,1544,50,-6,-167,70
1,1631,1652,-21,-1,-10,43
-1,1606,1645,-39,-1,-200,106
1,1341,1394,-53,0,17,58
1,1338,1289,49,1,557,143
-1,1791,1710,81,0,2,76
-1,1356,1609,-253,3,-153,64
-1,1724,1852,-128,0,-94,76
1,1594,1648,-54,-3,8,45
-1,1674,1906,-232,3,182,74
-1,1327,1617,-290,-4,-200,60
1,2077,1901,176,0,30,97
1,2098,1862,236,2,382,105
1,1701,1500,201,1,444,143
-1,1609,1938,-329,0,-31,84
-1,1466,1585,-119,-3,1,50
1,1636,1607,29,-3,-57,67
1,1396,1285,111,5,190,56
-1,1791,1590,201,-1,7,94
1,1913,1669,244,1,120,109
1,1640,1681,-41,0,-58,43
1,1959,1667,292,0,-18,49
-1,1381,1113,268,-2,-19,52
1,1943,1748,195,0,1,41
1,1810,1633,177,-2,-6,67
-1,1527,1513,14,1,29,44
-1,1577,2084,-507,-3,-453,114
-1,1277,1348,-71,-2,-38,52
1,1750,1555,195,-3,-21,49
-1,1223,1467,-244,-10,-183,50
1,1668,1652,16,1,139,85
1,1388,1575,-187,1,557,113
-1,1466,1349,117,0,3,76
1,1597,1645,-48,0,116,59
-1,1558,1683,-125,-5,-658,102
-1,1375,1342,33,-2,-61,56
-1,1845,2103,-258,0,-6,80
-1,1417,1668,-251,4,133,58
1,1592,1451,141,-7,-32,41
-1,1664,1864,-200,-6,-43,40
1,1633,1609,24,-3,233,75
-1,1658,2085,-427,0,-60,100
1,1832,1500,332,1,37,47
1,1606,1138,468,-2,371,79
-1,1358,1266,92,-5,-298,76
1,1963,1742,221,-1,-63,61
-1,1549,1755,-206,-3,-179,66
1,1815,1942,-127,0,-15,89
1,1283,1343,-60,0,14,93
1,1890,2189,-299,1,255,153
1,1530,1526,4,0,152,73
-1,1642,1679,-37,3,-201,94
-1,1673,1412,261,-9,-1113,136
1,1930,1742,188,3,-2,44
-1,1681,1622,59,2,-381,130
-1,1760,1656,104,2,50,92
1,2163,1970,193,0,5,61
-1,1363,1403,-40,0,24,72
-1,1742,1594,148,-2,-282,130
-1,1653,1589,64,2,27,77
-1,1948,2171,-223,-4,-141,82
1,1672,1496,176,-1,-9,113
1,1302,1218,84,12,755,79
-1,1576,1751,-175,0,40,84
1,1611,1384,227,4,384,81
1,1691,1542,149,1,76,61
-1,1329,1298,31,-8,-226,52
-1,1136,1607,-471,2,-18,78
-1,1393,1369,24,-5,-210,57
1,1496,1565,-69,5,271,83
1,1570,1684,-114,8,533,73
-1,1454,1486,-32,-4,-57,40
-1,1604,1560,44,-6,-464,92
-1,1470,1451,19,-1,161,84
1,1602,1640,-38,-1,13,53
-1,1495,1761,-266,-3,26,46
1,1361,1264,97,1,72,56
0,1735,1936,-201,1,37,129
1,1432,1653,-221,9,543,83
1,1599,1217,382,-8,-405,95
1,1557,1405,152,-2,38,75
-1,1585,1765,-180,-1,-427,136
1,1312,1317,-5,2,300,101
-1,1447,1960,-513,-7,-169,72
-1,1582,1275,307,-8,-373,72
0,1500,1363,137,2,535,144
1,1836,1574,262,-1,36,112
-1,1863,1966,-103,0,-46,86
1,1705,1629,76,-1,515,125
1,1314,1400,-86,-1,-60,55
-1,1628,1614,14,1,-211,92
1,1668,1522,146,0,143,109
1,1624,1513,111,0,88,79
1,1457,1369,88,-1,300,61
-1,1579,1683,-104,8,189,130
0,1635,1792,-157,0,-26,93
1,1350,1515,-165,-1,219,69
1,1710,1840,-130,-7,35,101
-1,1369,1600,-231,1,30,46
1,1305,1325,-20,-2,-33,47
1,1692,1571,121,-1,-24,43
-1,1444,1882,-438,-10,-610,72
-1,1697,1516,181,0,-281,150
1,1965,1605,360,0,13,55
1,1974,1855,119,0,4,63
1,1743,1706,37,0,33,55
-1,1310,1354,-44,-1,-290,112
1,1804,1708,96,1,-37,121
-1,1602,1969,-367,-1,-200,70
-1,1695,1563,132,-10,-114,50
-1,1441,2087,-646,0,-72,52
-1,1501,1886,-385,-1,-90,90
1,1719,1520,199,-4,27,111
1,1680,1578,102,0,580,123
1,1617,1604,13,-2,-161,83
-1,1312,1317,-5,-3,-47,44
-1,1559,1720,-161,-1,-58,86
1,2088,1599,489,-2,88,93
-1,1570,1688,-118,-2,-27,144
1,1675,1249,426,0,136,99
-1,1608,1502,106,1,27,72
1,1978,1825,153,-5,-143,57
1,1848,1981,-133,0,-17,67
-1,1499,1715,-216,1,-44,58
1,1687,1503,184,8,570,85
-1,1524,1892,-368,-4,-21,48
-1,1328,1299,29,-6,-41,40
1,2090,1598,492,1,41,47
0,1640,1620,20,0,-93,131
1,1718,1713,5,1,39,53
0,1831,1776,55,-3,4,80
1,1619,1451,168,-5,-96,91
-1,1431,1365,66,-1,-22,89
0,1628,1641,-13,-4,307,129
-1,1578,1454,124,0,-31,122
1,1500,1458,42,1,23,55
1,1727,1553,174,2,139,63
1,1364,1379,-15,5,328,65
1,1725,1560,165,0,17,63
1,1966,1863,103,0,-1,41
-1,1818,1984,-166,5,123,54
1,1500,1423,77,4,42,41
1,2111,2091,20,-9,315,125
1,1669,1655,14,2,118,71
-1,1500,1765,-265,-1,-43,78
-1,1593,1466,127,0,-477,164
1,1782,1653,129,1,-34,55
1,1787,1640,147,-1,244,90
1,1645,1536,109,1,59,89
-1,1653,1444,209,7,422,106
-1,1991,1974,17,-12,-80,40
1,1498,1307,191,0,7,45
-1,1510,1841,-331,-1,-449,94
1,1788,1626,162,-2,-310,101
1,1811,1979,-168,1,43,75
-1,1497,1636,-139,-6,-285,78
0,1689,2069,-380,0,83,97
-1,1328,1742,-414,-4,-173,56
-1,1544,1497,47,-3,-170,70
-1,1464,1432,32,0,-120,72
0,1495,1619,-124,2,-3,64
-1,1529,1445,84,0,-236,74
-1,1139,1363,-224,-8,-192,49
-1,1542,1678,-136,0,-57,86
1,1620,1664,-44,2,85,63
-1,1752,2079,-327,0,28,80
-1,1288,1604,-316,3,59,80
1,1332,1566,-234,4,170,65
1,1684,1791,-107,-5,-22,111
1,1389,1419,-30,-3,-15,95
1,1732,1666,66,0,13,51
1,1484,1399,85,-2,-101,63
-1,1609,1920,-311,-6,-38,40
-1,1564,1631,-67,-3,-332,126
1,1898,1450,448,5,216,57
-1,1478,1666,-188,0,11,124
-1,1198,1376,-178,-8,-498,70
1,1963,1947,16,1,61,55
-1,1690,1508,182,0,19,59
-1,1509,1531,-22,2,148,62
1,1720,1668,52,0,324,97
-1,1675,1484,191,-1,-44,72
1,1605,1968,-363,0,91,75
1,1368,1559,-191,6,413,75
1,1367,1199,168,5,477,103
-1,1905,2028,-123,0,82,92
1,1636,1313,323,-1,-57,85
1,1500,1056,444,2,177,49
-1,1828,1974,-146,1,75,82
1,1744,1323,421,1,126,73
-1,1777,1698,79,0,51,86
1,1536,1300,236,2,105,71
-1,1742,2031,-289,0,-38,94
-1,1508,1809,-301,-5,-413,100
1,1638,1511,127,-5,390,117
1,1536,1632,-96,3,126,49
-1,1828,1583,245,0,8,44
1,2009,1576,433,1,217,95
-1,1616,1605,11,1,-188,100
1,1549,1619,-70,7,260,57
-1,1738,2092,-354,0,7,104
-1,1688,1746,-58,-2,-8,76
1,1606,1562,44,-3,-111,57
-1,1820,1947,-127,-3,-4,82
-1,1574,2011,-437,0,-251,140
1,1815,1595,220,2,29,49
1,1661,1579,82,2,206,69
1,2196,2036,160,0,78,69
1,1487,1354,133,0,-50,104
1,1751,1203,548,0,3,47
-1,1590,1820,-230,-4,-125,56
1,1660,1486,174,1,26,65
1,1603,1550,53,-3,-215,103
-1,1686,1933,-247,-3,-68,46
-1,1825,1585,240,-4,-266,104
1,1630,1616,14,0,56,73
1,1606,1500,106,0,155,81
1,2104,2003,101,0,1,63
1,1316,1500,-184,25,811,53
0,1511,1385,126,-6,-1135,106
1,1752,1251,501,6,159,55
-1,2013,2095,-82,0,-29,80
1,1490,1295,195,7,312,65
-1,1603,1806,-203,-1,-77,89
1,1380,1532,-152,1,122,73
1,1433,1614,-181,-1,357,145
1,1812,1598,214,1,225,95
1,1541,1528,13,0,361,81
1,1641,1606,35,5,133,57
1,1570,1670,-100,-2,-29,101
1,1622,1797,-175,8,399,75
1,1622,1527,95,0,164,103
-1,1533,1613,-80,-1,7,74
1,1606,1270,336,0,86,61
1,1510,1549,-39,1,-12,73
-1,1860,1959,-99,-1,-51,100
-1,1598,1548,50,2,101,128
-1,1460,1313,147,-4,-290,74
-1,1808,1997,-189,-2,26,90
-1,1740,2113,-373,0,-36,58
-1,1639,1586,53,0,2,64
1,1496,1389,107,4,145,53
1,1429,1617,-188,-1,85,56
-1,1622,1518,104,-9,-161,118
1,1754,1990,-236,3,142,113
1,1586,1749,-163,-3,-69,51
1,1415,1246,169,14,862,77
1,1586,1485,101,1,40,59
1,1779,1289,490,1,142,119
-1,1381,1504,-123,-1,-68,74
-1,1477,1536,-59,-9,-158,48
-1,1598,1626,-28,0,-166,102
-1,1594,1462,132,-4,-110,60
1,1393,1613,-220,2,83,58
1,1522,1608,-86,-1,-21,67
-1,1738,1818,-80,0,-12,62
-1,1669,1677,-8,0,-11,64
-1,1542,1608,-66,2,146,62
-1,2116,1843,273,-8,-465,94
-1,1578,1502,76,-4,-99,60
1,1819,2003,-184,1,4,57
-1,1373,1367,6,-2,-70,48
1,1600,1413,187,4,81,53
1,1409,1154,255,6,246,59
-1,1861,2095,-234,0,-22,45
1,1609,1459,150,-1,16,89
1,1631,1517,114,6,220,59
-1,1652,1812,-160,-6,-106,50
1,1459,1417,42,0,7,61
-1,1593,1508,85,-3,-75,46
1,1564,1535,29,-1,-108,67
-1,1536,1645,-109,1,-83,78
-1,1636,1588,48,0,1,56
-1,1595,1666,-71,-5,-25,40
-1,1835,1965,-130,-1,-50,66
1,1919,1617,302,0,40,64
1,1461,1527,-66,0,-39,129
1,1601,1623,-22,1,305,111
-1,1674,1586,88,-3,112,92
-1,1429,1546,-117,-4,-301,84
-1,1709,1691,18,-1,-41,96
0,1628,1544,84,-2,-76,190
1,1985,1852,133,0,-71,43
-1,1482,1597,-115,-1,267,140
-1,1287,1781,-494,1,-10,66
-1,1421,1262,159,4,662,112
1,1566,1574,-8,0,109,85
-1,1606,1825,-219,-3,-85,55
-1,1468,1561,-93,0,-59,142
-1,1511,1239,272,7,119,70
-1,1452,1616,-164,-3,-119,56
-1,2105,1823,282,-3,-603,112
1,1403,1431,-28,1,134,79
-1,1612,1513,99,-1,-56,84
0,1969,1612,357,0,-15,85
-1,1372,1446,-74,-6,-289,62
-1,1600,1661,-61,0,-99,88
1,1553,1422,131,1,124,65
1,1923,1653,270,1,29,55
-1,1417,1343,74,-6,-100,50
-1,1285,1615,-330,-3,-137,58
1,2084,1842,242,0,275,133
1,1728,1427,301,1,2,49
-1,1418,1416,2,-4,-412,86
-1,1837,2089,-252,-3,-82,66
-1,1423,1733,-310,-1,1,58
1,2089,1837,252,5,32,45
-1,1622,1975,-353,-5,-285,66
-1,1835,1607,228,3,101,44
1,1558,1608,-50,5,274,73
1,1524,1694,-170,2,56,65
-1,2205,2094,111,1,-174,110
-1,1591,1707,-116,0,13,90
1,1861,1976,-115,0,1,63
-1,1461,1610,-149,4,185,114
-1,1828,1500,328,0,9,72
1,2184,2028,156,0,-31,85
-1,1278,1431,-153,-5,-329,78
-1,1552,1626,-74,0,7,74
1,2193,2110,83,0,80,81
1,1978,1620,358,1,63,53
-1,1415,1420,-5,-6,-163,66
1,1374,1363,11,0,-8,59
1,1703,1718,-15,0,-38,71
-1,1846,2020,-174,0,-92,78
-1,1418,1277,141,-7,-232,62
1,1279,1407,-128,0,-8,46
0,1565,1575,-10,0,18,66
-1,1127,1504,-377,1,-19,82
-1,1646,1583,63,-6,-119,52
-1,1737,1641,96,0,0,60
-1,1654,1689,-35,-4,-97,66
1,1701,1714,-13,0,90,85
1,1394,1295,99,6,208,63
-1,1293,1122,171,2,179,90
-1,1520,1699,-179,0,56,106
-1,1406,1438,-32,-2,-124,68
1,1596,1632,-36,0,3,55
-1,1719,1654,65,1,57,102
-1,2137,2034,103,-1,-26,116
-1,1444,1663,-219,0,48,74
-1,1837,2101,-264,0,4,106
1,1525,1634,-109,1,83,61
-1,1588,2027,-439,0,-44,86
1,1703,1718,-15,-7,-73,55
1,1485,1322,163,9,494,81
-1,1815,1982,-167,-1,-26,54
1,1620,1608,12,-3,15,87
1,1787,1705,82,-1,12,135
1,1500,1546,-46,0,108,113
1,2105,1830,275,-8,-714,123
1,1701,1714,-13,-1,220,111
1,1419,1343,76,-2,105,71
-1,1500,1500,0,-1,6,58
-1,2095,1910,185,0,63,66
1,1525,1624,-99,-1,-53,57
-1,1487,1720,-233,-11,-474,62
-1,1697,1799,-102,-1,-144,80
-1,1570,1873,-303,-1,-70,94
-1,1575,2144,-569,-1,-34,68
-1,1667,1961,-294,-8,-281,64
1,1073,1364,-291,0,-24,41
1,1703,1754,-51,2,515,123
1,1810,1689,121,1,13,47
1,1574,1703,-129,1,-14,57
1,1601,1364,237,6,108,45
1,2122,1926,196,-1,2,59
1,1610,1539,71,1,85,65
1,1681,1819,-138,-5,-13,47
1,1496,1471,25,-5,-104,57
1,1337,1286,51,-1,-60,51
-1,1965,1664,301,0,-49,74
-1,1334,1428,-94,-7,-129,52
1,1743,1482,261,5,40,47
-1,1800,1696,104,-2,-122,188
-1,1487,1460,27,-2,-53,104
1,1591,1689,-98,-2,-67,63
-1,1625,1699,-74,-2,-165,82
1,1579,1612,-33,0,-1,65
-1,1711,1459,252,1,157,83
-1,1703,1500,203,0,-19,94
-1,1460,1453,7,-4,229,102
1,1364,1256,108,9,410,75
-1,1503,1444,59,3,79,50
1,1481,1692,-211,-3,-2,55
-1,1622,1836,-214,-6,-697,102
0,1634,1535,99,0,84,122
-1,1619,1717,-98,-7,-150,94
1,1477,1762,-285,-2,456,97
1,1782,1553,229,2,136,101
-1,1682,1945,-263,-1,-17,54
1,1091,1475,-384,0,-62,69
-1,1924,1514,410,0,0,47
1,1889,1953,-64,3,139,73
-1,1620,1550,70,-1,-82,56
-1,1548,1788,-240,0,-119,130
1,1518,1612,-94,8,452,85
-1,1651,1649,2,0,-26,54
-1,1620,1417,203,2,93,86
1,1933,1675,258,-5,-105,65
1,1854,1611,243,2,200,57
-1,1544,1793,-249,2,-141,126
-1,1921,2106,-185,-1,90,82
1,1329,1373,-44,0,2,57
-1,1548,1559,-11,-6,-239,66
-1,1649,1662,-13,-1,-31,62
1,1723,1642,81,4,143,49
0,1528,1506,22,6,310,118
1,1670,1998,-328,-2,29,45
1,1869,1840,29,-1,-47,117
0,1799,1539,260,-19,-468,64
-1,1804,1869,-65,-1,-13,42
1,1728,1611,117,-1,85,43
-1,1296,1288,8,-16,-438,52
1,1776,1856,-80,0,-81,95
1,1546,1790,-244,0,-36,69
-1,1461,1675,-214,0,72,62
1,1418,1277,141,1,40,51
-1,1604,1738,-134,-1,-27,48
-1,1618,1990,-372,-4,-100,46
1,1755,1686,69,0,15,81
1,2113,1915,198,-3,18,91
-1,1751,1719,32,-2,-30,50
-1,1813,1886,-73,-2,14,92
-1,1532,1360,172,-3,-35,74
1,1528,1598,-70,-4,-43,85
-1,1285,1332,-47,-8,-498,82
1,1498,1483,15,2,261,125
-1,1586,1678,-92,-4,-475,98
1,1748,1597,151,4,43,41
-1,1547,1500,47,-4,-127,60
1,1594,1608,-14,3,108,53
1,2122,2049,73,0,11,57
1,1644,1655,-11,0,34,61
1,1541,1622,-81,1,227,73
-1,1590,1756,-166,-1,-17,62
-1,1578,1604,-26,0,-491,106
-1,1678,1815,-137,0,-176,100
-1,1536,1500,36,-2,-544,124
1,1385,1449,-64,-1,-29,43
1,1900,1730,170,1,82,87
-1,1708,1959,-251,-1,-9,44
-1,1681,1697,-16,-1,-44,54
-1,1994,1615,379,0,6,52
1,1615,1568,47,10,214,55
1,1699,1538,161,4,212,67
1,1500,1719,-219,5,40,41
-1,1596,1611,-15,-1,-49,88
1,1837,1527,310,1,-52,89
1,1509,1486,23,0,90,85
-1,1350,1579,-229,2,-17,128
1,1694,1570,124,1,20,59
1,2039,2131,-92,0,913,173
1,2030,1864,166,-1,-20,99
1,1397,1376,21,-1,8,51
-1,1665,1689,-24,0,-4,54
1,1875,1910,-35,0,12,57
-1,1715,2117,-402,0,7,48
1,1610,1638,-28,-2,5,63
1,1822,2037,-215,1,24,51
1,1551,1395,156,12,434,63
1,1529,1548,-19,0,-153,107
-1,1722,1841,-119,1,17,64
1,1500,1524,-24,4,190,53
-1,1627,1712,-85,0,-24,46
-1,1574,1724,-150,-9,-337,56
1,1622,1454,168,1,487,101
1,1651,1678,-27,0,-3,61
1,1587,1766,-179,1,498,139
1,1716,1500,216,1,207,85
0,1553,1392,161,-3,-105,110
1,1856,1554,302,-1,45,81
1,1446,1258,188,4,903,127
1,1017,1281,-264,4,74,45
-1,1276,1426,-150,-3,28,54
1,1721,1615,106,2,159,75
-1,1456,1377,79,0,-37,86
1,1558,1387,171,9,328,53
1,1715,1606,109,-1,-3,47
-1,1425,1628,-203,0,-462,120
-1,1571,1492,79,-7,-48,78
1,1450,1511,-61,0,116,61
-1,1666,2110,-444,-3,-188,72
1,1666,1325,341,5,179,53
-1,1593,1922,-329,0,2,40
0,1550,1449,101,0,-3,165
-1,1582,1881,-299,-4,-125,48
1,1395,1500,-105,1,581,105
-1,1540,1536,4,-1,-23,44
1,1927,1764,163,0,30,70
1,1506,1544,-38,0,228,153
1,1557,1607,-50,-4,-11,51
1,1677,1665,12,1,109,65
1,1570,1634,-64,0,16,101
1,1906,1934,-28,0,-7,79
-1,1503,1736,-233,0,-237,124
1,1716,1705,11,3,569,107
1,1889,1869,20,3,53,51
-1,1483,2049,-566,-1,-497,128
1,1456,1477,-21,0,264,79
-1,1130,1278,-148,-22,-957,70
-1,1995,1751,244,0,-47,60
-1,1933,1664,269,0,5,46
-1,1402,1416,-14,0,-207,123
1,1826,1437,389,0,68,91
-1,1887,1920,-33,0,-28,62
-1,1900,1858,42,0,15,76
-1,1578,1678,-100,0,1,54
-1,1505,1588,-83,-1,13,40
-1,1383,1519,-136,-6,-701,110
-1,1762,1794,-32,-2,-37,40
-1,1553,1649,-96,-9,-215,52
1,1728,1786,-58,6,930,121
1,1769,1974,-205,-1,69,93
1,1517,1541,-24,2,621,129
1,1831,1682,149,0,45,75
-1,1427,1644,-217,0,-73,78
1,1932,1910,22,-1,-12,61
1,1377,1268,109,9,397,52
1,1750,1773,-23,-1,39,87
1,1871,1888,-17,-1,-23,43
-1,1502,1532,-30,0,18,64
1,1787,1718,69,-3,-3,53
1,1760,1762,-2,3,150,70
1,1773,1741,32,1,-1,73
-1,1607,1382,225,1,36,154
1,903,0,903,-2,-18,95
1,2060,1840,220,0,275,105
-1,1876,1884,-8,0,-67,60
1,1435,1564,-129,7,344,57
1,1844,1686,158,2,170,87
-1,1597,1496,101,3,68,42
-1,1481,1545,-64,2,-615,156
-1,1721,1562,159,-6,-191,59
1,1520,1679,-159,-1,316,141
-1,1641,1512,129,-1,20,53
1,1731,1783,-52,1,134,99
1,1895,1866,29,1,58,69
1,1579,1121,458,6,517,85
1,1603,1355,248,6,106,57
1,1650,1879,-229,-5,-305,201
0,1807,1810,-3,0,117,88
-1,1835,1932,-97,0,200,104
1,1804,1530,274,-1,29,69
1,1586,1441,145,4,177,65
1,1520,1631,-111,3,120,57
1,1561,1654,-93,0,44,59
-1,1857,1953,-96,-5,-253,82
1,1856,1906,-50,1,-52,89
1,1242,1385,-143,2,136,121
1,1965,1878,87,4,4,41
1,1422,1443,-21,0,19,71
1,1549,1365,184,-4,133,65
-1,1477,1287,190,-9,-135,68
1,1694,1726,-32,0,-200,97
1,1893,1868,25,-6,-66,45
-1,1842,1962,-120,-3,-421,104
-1,1496,1461,35,-4,-111,178
1,1451,1511,-60,-6,-157,83
1,1494,1451,43,-1,-40,71
1,1549,1450,99,4,628,109
1,1858,1903,-45,1,121,61
-1,1771,1515,256,-2,-48,50
1,1596,1330,266,5,303,65
-1,1551,1403,148,0,-257,86
1,1828,1785,43,4,319,101
-1,1870,1998,-128,0,-23,54
0,1570,1881,-311,-2,209,111
1,1955,1761,194,0,93,71
1,1890,1870,20,-2,-26,61
1,1961,1768,193,0,1,71
1,1888,1744,144,-1,0,91
-1,1860,1901,-41,0,13,48
1,1353,1331,22,1,62,67
1,1828,1684,144,3,138,59
1,1500,1391,109,2,35,51
1,1840,1539,301,0,-31,55
-1,1374,1696,-322,-4,-807,146
-1,1418,1594,-176,-2,41,44
-1,1481,1357,124,0,-115,80
1,1536,1677,-141,-4,-19,69
-1,1771,1778,-7,-1,-691,128
1,1741,1722,19,0,91,135
1,1911,1850,61,0,51,71
-1,1578,1871,-293,-6,-219,52
0,1615,1385,230,3,-163,107
-1,1434,1624,-190,0,-16,59
1,1433,1119,314,7,480,81
1,1846,1239,607,0,15,49
-1,1554,1384,170,1,-4,61
1,1968,1765,203,-3,60,93
-1,1520,1592,-72,-8,-725,96
-1,1729,1743,-14,0,-55,70
1,1842,1920,-78,1,198,69
-1,1876,1575,301,1,-382,102
-1,1762,1964,-202,0,-419,130
-1,1581,1512,69,-3,-569,120
1,1508,1452,56,0,54,81
-1,1515,1652,-137,-4,-351,120
-1,1544,1646,-102,-1,-68,78
-1,1970,2286,-316,-2,-71,56
1,2289,1966,323,0,119,101
-1,1853,2120,-267,-1,-172,98
1,2024,1807,217,0,-21,50
0,1634,1764,-130,0,90,111
1,1907,1855,52,0,31,47
1,1290,1294,-4,-1,-5,79
0,1737,1661,76,-1,81,120
-1,1714,1706,8,0,-218,140
1,1401,1313,88,5,111,71
-1,1500,1528,-28,-1,-438,90
1,1371,1380,-9,0,-49,121
-1,1594,1853,-259,0,-64,124
-1,1925,1837,88,-1,-38,50
-1,1375,1674,-299,-7,-95,44
1,1375,1796,-421,-4,-89,49
-1,1464,1456,8,-2,-270,76
1,1625,1442,183,-4,300,131
-1,1417,1467,-50,0,428,126
-1,1580,1594,-14,-2,-158,72
1,1601,1511,90,2,613,133
-1,1541,1560,-19,-1,-126,88
-1,1858,1590,268,1,-312,114
1,1849,1796,53,0,-108,75
1,1861,1668,193,0,110,119
-1,1850,1911,-61,-3,-729,88
1,1259,1412,-153,-2,169,87
1,1920,1841,79,-1,-40,75
-1,1294,1775,-481,-2,-152,62
1,1370,1483,-113,-2,332,115
1,1372,1255,117,3,70,43
-1,1449,1704,-255,-11,-256,76
1,1299,1409,-110,3,65,47
1,1865,1718,147,-1,-38,61
-1,1833,1929,-96,0,55,64
1,1451,1370,81,3,238,79
-1,2165,2081,84,0,-11,72
-1,1608,1798,-190,-1,255,134
1,1328,1572,-244,7,128,59
-1,1712,1837,-125,-1,-15,42
-1,1319,1438,-119,-3,-106,48
1,1331,1108,223,-2,33,55
1,1763,1812,-49,-1,-17,57
-1,1727,1896,-169,2,5,52
1,1652,1428,224,1,-190,111
-1,1482,1420,62,-1,-43,78
1,1730,1683,47,0,-25,61
1,1537,1446,91,0,25,45
1,1395,1322,73,-2,-35,55
1,1502,1610,-108,-4,-10,69
-1,1804,1603,201,1,-263,100
-1,1274,1780,-506,2,18,56
1,1704,1515,189,0,9,53
-1,1514,1704,-190,-1,-35,56
1,1346,1204,142,1,195,79
-1,1235,1782,-547,1,48,114
-1,1894,1937,-43,-7,-192,54
-1,1756,1708,48,-4,23,95
1,1717,1703,14,-3,-92,51
-1,1605,1568,37,-1,-20,62
1,1880,1964,-84,-1,-4,57
-1,1629,1820,-191,0,-141,142
1,1710,1509,201,-2,41,53
1,1718,2017,-299,-1,75,73
-1,1806,1788,18,2,6,86
-1,1735,1674,61,-2,-84,58
-1,1368,1383,-15,-4,-653,70
1,1445,1425,20,-1,-13,61
1,1308,1404,-96,4,193,55
-1,1331,1547,-216,-7,-474,114
1,1900,1715,185,-4,-96,71
-1,1752,1826,-74,0,-62,106
-1,1510,1459,51,-1,-35,46
1,1949,1553,396,8,244,59
-1,1507,1586,-79,2,235,98
-1,1617,1646,-29,-2,-9,46
1,1996,1902,94,-3,22,69
-1,1536,1436,100,6,126,48
-1,1396,1257,139,1,301,126
-1,1867,1912,-45,0,-64,100
-1,1595,1517,78,4,282,90
1,1518,1529,-11,0,51,55
1,1710,1551,159,2,357,69
1,1353,1186,167,6,204,79
-1,1101,1336,-235,8,74,44
1,1654,1535,119,1,83,77
-1,1446,1469,-23,-10,-68,40
-1,1794,1800,-6,-1,-54,76
-1,1693,1727,-34,-1,20,62
-1,1301,1710,-409,-7,-565,98
-1,1543,1716,-173,-1,-62,46
1,2005,1893,112,0,-2,43
-1,1859,1403,456,-3,-159,78
-1,1472,1496,-24,0,-150,106
1,1722,1536,186,0,198,95
1,1433,1469,-36,4,9,43
1,1456,1609,-153,0,54,129
-1,1688,1722,-34,4,130,70
1,1681,1529,152,7,231,67
-1,1043,1472,-429,-4,59,74
1,1891,2013,-122,-5,-24,97
-1,1397,1563,-166,-10,-741,76
-1,1656,1762,-106,-7,-252,106
-1,1326,1362,-36,-6,-340,88
-1,1468,1508,-40,0,-305,100
-1,1460,1522,-62,0,-217,106
1,1522,1687,-165,0,190,78
1,1664,1751,-87,-1,41,63
1,1426,1355,71,5,112,41
-1,1175,1283,-108,-5,-618,171
-1,1531,1782,-251,0,-619,108
1,1537,1796,-259,11,672,73
-1,1404,1517,-113,0,-9,42
-1,1997,1845,152,0,126,94
-1,1595,1789,-194,-1,-201,130
-1,1736,1684,52,-3,-222,64
-1,1672,1538,134,-2,-37,44
-1,1530,1423,107,-2,-86,74
1,1623,1743,-120,0,57,130
-1,1423,1674,-251,0,-16,53
0,2084,2098,-14,0,-68,108
1,1906,1980,-74,1,236,87
1,1784,1946,-162,-1,41,45
-1,1674,1758,-84,-2,-52,150
1,1473,1036,437,-1,-19,73
1,1665,1546,119,0,41,97
-1,1922,1857,65,0,-5,42
-1,1599,1868,-269,2,-23,76
1,1436,1127,309,3,127,79
1,1845,1095,750,6,299,59
-1,1966,1918,48,3,28,56
1,1721,1787,-66,0,71,85
-1,1800,1931,-131,-3,-142,60
1,1526,1434,92,-1,74,101
1,1787,1885,-98,0,15,65
1,1873,1595,278,3,237,59
-1,1538,1672,-134,3,158,80
1,1931,1952,-21,0,329,125
-1,1737,1783,-46,-3,-213,72
1,1710,1838,-128,2,371,109
1,1732,1678,54,1,116,91
1,1938,1793,145,1,156,61
-1,1488,1619,-131,-2,-227,76
1,1308,1418,-110,6,519,96
1,2146,1516,630,2,143,71
1,1882,1588,294,1,15,45
-1,1679,1531,148,2,-236,118
1,1692,1418,274,0,26,47
1,1500,1351,149,2,101,69
-1,1345,1649,-304,-2,-94,58
1,1298,1411,-113,3,41,43
1,1940,1871,69,0,-26,73
-1,1794,1951,-157,-1,-59,74
-1,1398,1499,-101,-2,-118,62
-1,1279,1528,-249,-1,-72,74
-1,1030,1475,-445,0,-12,110
-1,2098,2085,13,0,29,94
1,1644,1325,319,5,110,40
1,1696,1724,-28,0,374,97
-1,1584,1886,-302,-1,-448,118
-1,1316,1866,-550,-12,-28,40
-1,1957,1788,169,-3,-479,158
1,1535,1358,177,0,6,49
1,1547,1664,-117,0,158,91
1,1435,1403,32,-1,161,69
0,1902,1588,314,1,13,53
1,1579,1547,32,0,24,159
1,1513,1500,13,3,599,99
1,1773,1678,95,3,94,63
1,1890,1580,310,8,269,59
1,1201,1345,-144,-4,-113,87
1,1908,1862,46,0,-9,63
-1,1518,1794,-276,0,-3,60
-1,1578,1576,2,-4,-76,70
1,1650,1562,88,2,84,89
-1,1577,1894,-317,-3,-86,50
1,1846,1476,370,3,84,49
1,1795,1590,205,0,30,85
1,1785,1403,382,2,60,43
1,1326,1622,-296,-2,-96,69
-1,1323,1378,-55,-2,-36,42
-1,1414,1707,-293,1,-65,57
1,2096,2084,12,1,578,111
0,1631,1481,150,-1,-95,137
-1,1220,1509,-289,-6,84,78
-1,1831,1811,20,0,6,50
-1,1541,1831,-290,-2,-87,148
1,1352,1560,-208,1,169,93
-1,1770,1788,-18,-1,-58,66
1,1852,1912,-60,0,10,61
-1,1363,1686,-323,3,108,54
-1,1180,1330,-150,1,49,90
1,1341,1378,-37,-1,167,87
-1,1440,1551,-111,0,-5,42
-1,1401,1313,88,-4,-1,82
-1,1554,1728,-174,-2,-54,60
1,1535,927,608,9,202,47
1,1774,1741,33,1,14,45
-1,1538,1510,28,0,-117,84
-1,1653,1502,151,-1,-182,84
1,1640,1569,71,0,-33,95
1,1794,1852,-58,3,122,69
-1,1509,1933,-424,-2,-7,62
-1,1261,1460,-199,0,29,48
-1,1761,1500,261,-4,-360,94
-1,1193,1217,-24,-10,-208,48
1,1415,1702,-287,-4,0,87
-1,1668,1733,-65,0,-95,102
1,1536,1396,140,-3,-114,59
-1,1691,1512,179,0,3,94
1,1625,1491,134,-2,29,53
-1,1473,1316,157,-4,-11,52
-1,1446,1504,-58,-1,-72,58
1,1517,1470,47,0,-9,57
-1,1571,1337,234,0,-209,100
1,2211,1935,276,0,16,43
-1,1497,1454,43,-3,-82,54
-1,1455,1498,-43,-2,-64,60
-1,1483,1637,-154,-6,-99,44
1,1680,1767,-87,0,6,47
-1,1517,1513,4,-2,-131,80
-1,1452,1405,47,0,95,116
1,1543,1495,48,2,-58,179
-1,1742,1836,-94,-1,-53,60
-1,1760,1593,167,0,-4,50
1,1336,1439,-103,1,49,47
-1,1772,1560,212,0,-20,100
-1,1930,2165,-235,-2,-96,60
-1,1245,1472,-227,-2,-106,48
-1,1553,1483,70,-10,-324,78
-1,1792,1879,-87,4,-26,66
1,1525,1437,88,-3,-20,53
-1,1331,1377,-46,0,58,48
-1,1849,1845,4,-1,-31,40
1,1477,1485,-8,-1,34,74
-1,1500,1500,0,3,107,44
-1,1452,1699,-247,-2,-16,48
1,1640,1560,80,-1,-27,45
-1,1524,1734,-210,-1,-283,120
-1,1662,1337,325,-1,-126,64
1,1589,1510,79,0,36,51
-1,1247,1323,-76,-4,-633,138
-1,1633,1624,9,-4,-86,66
1,1669,1648,21,3,194,81
1,1671,1439,232,2,69,89
-1,1529,1616,-87,0,-631,132
-1,1500,1635,-135,4,-484,92
-1,1552,1649,-97,-5,-76,52
1,1748,1852,-104,0,143,93
-1,1783,1887,-104,-5,-139,80
1,1367,1328,39,7,195,48
1,1857,1838,19,-2,-100,125
-1,1500,1631,-131,4,149,64
1,1657,1544,113,1,250,132
1,1418,1161,257,0,-3,41
1,1888,1484,404,0,10,45
-1,1739,1519,220,0,-68,118
-1,1624,1516,108,0,-137,108
-1,1566,1531,35,-3,-8,48
-1,1388,1322,66,-6,-214,62
-1,1795,1971,-176,0,-100,100
1,1712,1497,215,0,34,63
-1,1275,1724,-449,0,-62,80
-1,1895,1775,120,-2,-26,68
-1,1295,1306,-11,-4,-402,66
-1,1536,1664,-128,0,-15,114
1,1636,1621,15,2,155,109
-1,1474,1500,-26,2,-57,58
-1,1185,1429,-244,-5,-470,88
-1,1238,1641,-403,0,-23,58
1,1671,1529,142,-1,17,47
-1,1538,1610,-72,2,59,116
1,1606,1737,-131,0,106,89
-1,1522,1678,-156,3,99,60
0,1545,1536,9,-4,84,120
-1,1273,1726,-453,-4,-71,46
-1,1285,1396,-111,-3,-623,158
1,1863,2139,-276,1,509,143
-1,1575,1827,-252,0,16,72
1,1752,1433,319,11,186,41
1,1562,1310,252,7,207,53
1,1679,1543,136,0,-8,45
1,1610,1646,-36,6,170,82
1,1566,1453,113,2,338,93
1,2119,1881,238,0,-51,119
-1,1306,1392,-86,-1,-10,48
1,1728,1362,366,7,418,86
-1,1705,1834,-129,0,-71,66
-1,1525,1460,65,-5,-513,84
1,1154,1272,-118,5,138,106
-1,1378,1255,123,-23,-337,42
-1,1433,1158,275,-2,246,142
-1,1581,1496,85,-7,-576,90
-1,1679,1605,74,0,-67,82
1,1925,1681,244,0,51,91
-1,1739,1637,102,-1,-94,86
-1,1423,1500,-77,1,35,60
-1,1536,1545,-9,-5,-52,50
-1,1676,1930,-254,-8,-477,80
1,1817,1491,326,1,21,79
-1,1598,1404,194,-1,-196,114
1,1643,1679,-36,2,80,55
1,1935,1672,263,0,48,55
-1,1556,1526,30,0,49,56
1,1820,1749,71,0,-17,81
1,1453,1273,180,0,456,95
-1,1634,1622,12,-4,-113,54
1,1553,1143,410,-7,-226,57
1,1616,1668,-52,-1,-49,63
-1,1509,1390,119,-3,-44,49
-1,1350,1731,-381,-1,-177,96
1,1287,1332,-45,0,60,61
0,1507,1641,-134,3,347,110
-1,1710,1698,12,-11,-277,60
-1,1862,1943,-81,2,79,86
1,1277,1482,-205,0,42,91
-1,1461,1680,-219,-13,-150,42
-1,1694,1538,156,0,49,112
1,1619,1665,-46,0,126,135
-1,1216,1297,-81,0,136,67
-1,1829,1735,94,0,-591,170
-1,1542,1510,32,1,-285,66
-1,1519,1790,-271,-1,-118,72
1,2124,1856,268,-1,-20,57
-1,1663,1536,127,0,-154,74
-1,1852,2128,-276,-1,-9,124
1,1754,1688,66,12,766,81
-1,1505,1567,-62,1,71,59
1,1822,1667,155,0,504,135
-1,1600,1549,51,-2,-36,78
1,1555,1678,-123,-1,-545,115
1,1702,1647,55,1,49,61
1,2132,1848,284,1,144,77
1,1734,1339,395,10,98,41
1,1636,1634,2,0,33,91
1,1562,1350,212,14,147,41
1,1760,1908,-148,1,24,51
-1,1456,1543,-87,-2,-171,60
-1,1844,2136,-292,0,6,122
1,1657,1763,-106,3,225,77
1,1514,1601,-87,-1,-27,99
1,1662,1495,167,0,-5,65
1,1707,1498,209,1,40,65
-1,1300,1582,-282,-3,-69,46
-1,1432,1737,-305,1,-158,112
1,1472,1393,79,-1,5,97
1,2140,1840,300,2,90,59
1,1695,1570,125,6,973,157
1,1797,1329,468,0,118,117
1,1526,1288,238,8,184,47
1,1551,1586,-35,0,-32,57
-1,1417,1417,0,-5,-108,52
-1,1837,2144,-307,-2,-80,58
-1,1488,1669,-181,0,10,56
-1,1638,1711,-73,-1,-62,56
-1,1446,1568,-122,0,-64,58
-1,1623,1647,-24,0,115,98
1,2148,1833,315,1,23,47
1,1653,1633,20,-1,433,153
-1,1829,2151,-322,-2,-63,92
-1,1815,1756,59,-3,-781,118
-1,1306,1429,-123,-3,-577,108
-1,1675,1482,193,-11,-165,60
-1,1520,1443,77,-7,-95,46
-1,1406,1428,-22,-3,-167,124
1,2155,1826,329,0,91,67
-1,1522,1388,134,0,-17,68
1,1673,1437,236,2,125,97
1,1720,1629,91,1,45,57
-1,1551,1736,-185,-4,-98,58
-1,1112,1708,-596,-4,-219,64
-1,1823,2158,-335,0,-71,84
1,1500,1658,-158,-2,212,109
-1,1800,1813,-13,-1,-160,94
1,2162,1819,343,4,99,55
-1,1635,1320,315,-1,-13,50
-1,1323,1799,-476,-12,-328,60
-1,1500,1653,-153,0,-1,62
0,1415,1500,-85,-5,-34,85
1,1816,2165,-349,1,-25,93
-1,1655,1689,-34,1,18,58
1,1693,1701,-8,0,219,141
1,1642,1517,125,0,-28,75
-1,1457,1498,-41,0,-78,90
1,1748,1715,33,0,17,63
1,1530,1600,-70,-3,-100,47
-1,1668,1549,119,-2,-110,60
1,1658,1386,272,-1,144,105
1,2142,1838,304,0,30,53
-1,1587,1594,-7,0,-107,92
1,1439,1429,10,-4,42,47
-1,1298,1317,-19,-8,-316,79
1,1651,1606,45,1,48,63
1,1379,1277,102,5,11,41
1,1298,1405,-107,4,50,51
-1,1834,2146,-312,-3,1,50
1,1500,1192,308,4,144,51
0,1545,1830,-285,-1,22,74
-1,1333,1323,10,-1,-444,106
-1,1649,1693,-44,2,147,90
1,1456,1384,72,0,76,63
-1,1418,1476,-58,1,47,52
-1,1621,1663,-42,1,-163,116
1,1783,1577,206,0,308,109
-1,1620,1624,-4,0,-283,156
-1,1831,1884,-53,0,-21,74
1,1703,1639,64,-3,-15,85
-1,1431,1678,-247,-4,-377,88
1,1661,1624,37,-1,-118,85
1,1664,1417,247,11,123,43
-1,1283,1785,-502,-8,-398,78
-1,1791,1758,33,-4,-250,95
-1,1500,1705,-205,-2,-163,110
1,1309,1486,-177,3,1051,155
-1,1244,1707,-463,-1,-11,78
1,1820,1552,268,4,23,45
-1,1630,1712,-82,-1,-195,164
-1,1129,1500,-371,-2,-173,78
1,1579,1138,441,15,417,57
1,1281,1250,31,-2,-254,81
-1,1540,1423,117,-3,-40,42
-1,1642,1353,289,0,8,40
1,1350,1306,44,1,16,45
1,1454,1405,49,1,35,73
-1,1548,1825,-277,1,46,80
1,1721,1621,100,2,148,61
1,1779,1920,-141,0,5,45
1,1631,1256,375,5,233,63
1,1367,1221,146,1,44,51
0,1491,1631,-140,1,-217,112
-1,1589,1659,-70,-3,-150,112
1,1789,2089,-300,0,383,135
-1,1613,1729,-116,0,11,76
-1,1575,1506,69,0,-123,56
-1,1596,1428,168,-1,-152,78
0,1711,1495,216,-8,22,105
-1,1255,1275,-20,-3,-676,82
-1,1107,1619,-512,-5,259,104
1,1673,1498,175,-1,-33,53
1,1638,1575,63,1,305,125
-1,1291,1548,-257,-1,-28,58
-1,1546,1683,-137,-11,-214,82
-1,1332,1438,-106,-8,-213,44
1,1671,1869,-198,-1,139,113
-1,1605,1737,-132,-2,-68,60
1,1587,1696,-109,0,14,105
1,1421,1413,8,4,125,57
1,1623,1497,126,2,326,153
-1,1638,1514,124,2,44,50
1,1711,1237,474,1,121,93
-1,1744,1598,146,-1,58,114
-1,1413,1533,-120,0,-628,124
-1,1811,1758,53,-2,-923,148
1,1467,1049,418,1,98,55
1,1125,1313,-188,-2,-24,63
1,1614,1729,-115,0,-48,123
-1,1808,1774,34,0,-132,92
1,1520,1452,68,7,220,59
-1,1708,1904,-196,1,24,62
1,1690,1539,151,0,1,43
-1,1627,1495,132,1,6,54
1,1661,1625,36,-1,80,79
-1,1459,1679,-220,-4,-369,92
1,1830,1544,286,0,24,69
-1,1501,1705,-204,2,81,74
-1,1447,1537,-90,-6,-279,84
-1,1367,1850,-483,0,-28,86
1,1343,1451,-108,14,243,47
-1,1446,1260,186,4,739,103
1,1787,1393,394,0,50,99
1,1714,1628,86,3,389,105
-1,1535,1987,-452,-1,-63,64
1,1702,1572,130,2,49,51
-1,1511,1611,-100,-2,-251,102
1,1449,1425,24,3,351,63
1,1286,1433,-147,2,664,123
1,1542,1650,-108,1,7,43
-1,1435,1358,77,0,-351,106
1,1525,1194,331,0,-5,53
-1,1620,1722,-102,0,-517,128
1,1710,1724,-14,-1,332,91
1,1741,1246,495,2,55,47
-1,1953,1904,49,0,-77,58
1,1696,1358,338,10,133,44
0,1667,1688,-21,1,346,154
0,1687,1989,-302,-3,-75,83
1,1585,1679,-94,-4,-78,59
-1,1365,1236,129,-14,-335,82
-1,1437,1550,-113,-1,-45,60
1,1730,1612,118,4,71,51
1,1541,1714,-173,1,12,61
1,1791,1681,110,1,93,101
-1,1524,1362,162,2,56,82
-1,1640,1699,-59,-2,-10,42
1,2135,1717,418,1,316,87
-1,1607,1678,-71,0,-510,170
1,1410,1309,101,5,1219,159
-1,1311,1274,37,1,36,64
1,1427,1416,11,-2,59,81
-1,1360,1610,-250,-3,-75,94
-1,1550,1846,-296,-4,-412,106
-1,1729,1708,21,2,65,50
-1,1721,1804,-83,0,-54,78
1,1553,1494,59,-1,-25,57
1,1698,1645,53,1,208,69
1,1675,1764,-89,3,225,89
1,1754,1813,-59,1,132,73
1,1476,1612,-136,2,127,61
1,1852,1546,306,6,514,75
1,1497,1195,302,0,37,65
-1,1767,1785,-18,2,56,96
-1,1737,1823,-86,0,-284,112
-1,1257,1461,-204,-5,-56,42
1,1830,1452,378,6,215,65
-1,1310,1564,-254,-3,-62,64
1,1892,1780,112,0,16,85
-1,1543,1857,-314,-5,-372,76
-1,1701,1642,59,0,-78,59
-1,1226,1281,-55,6,84,74
1,1862,1514,348,0,24,97
-1,1500,1298,202,-16,-213,42
1,1718,1618,100,9,407,69
1,1785,1641,144,0,142,93
-1,1695,1836,-141,-5,-214,112
1,1513,1500,13,0,282,79
-1,1730,1665,65,-2,-67,110
-1,1689,1655,34,1,-409,132
1,1438,1726,-288,-2,99,51
1,1777,1699,78,-5,-9,105
-1,1501,1867,-366,-9,-590,116
1,1941,1651,290,0,86,55
-1,1436,1723,-287,0,-38,63
1,1373,1309,64,0,252,109
-1,1690,1854,-164,-10,-34,60
0,1840,1729,111,1,-240,183
1,1547,1680,-133,-3,-143,57
1,1812,1622,190,1,-24,83
-1,1355,1402,-47,-4,-131,52
-1,1875,1857,18,0,-37,74
1,1668,1677,-9,2,322,109
-1,1486,1686,-200,1,76,140
0,1399,1563,-164,-3,-476,125
-1,1654,1568,86,0,6,40
1,1769,1900,-131,5,354,95
1,1306,952,354,4,486,91
-1,1664,1566,98,-6,-67,46
1,1833,1604,229,0,70,72
1,1644,1857,-213,6,198,63
-1,1700,1869,-169,-3,-991,148
1,1540,1590,-50,-1,62,125
-1,1635,1344,291,-6,-243,74
-1,1583,1648,-65,1,29,40
0,1666,1679,-13,0,-215,119
1,1864,1719,145,2,58,67
-1,1290,1583,-293,-7,-319,66
1,1875,1831,44,1,92,83
1,1862,1683,179,2,-13,69
-1,1456,1792,-336,2,-23,48
1,1995,1640,355,-2,-13,53
-1,1761,1851,-90,-2,-278,88
1,2183,1534,649,2,5,41
-1,1500,1643,-143,-7,-765,86
-1,1299,1383,-84,-8,-294,56
-1,1796,1446,350,-3,-44,50
-1,1504,1626,-122,0,-344,116
1,1658,1572,86,-1,-24,67
1,1816,1886,-70,0,24,76
1,1716,1446,270,0,-13,65
1,1624,1694,-70,0,18,67
1,1679,1666,13,12,256,53
-1,1866,1757,109,0,-12,42
1,1690,1788,-98,1,16,43
-1,1398,1534,-136,0,1,46
-1,1512,1772,-260,3,211,60
1,1800,1242,558,15,772,71
1,1345,1500,-155,1,115,51
-1,1859,1872,-13,0,-11,91
1,1835,1752,83,7,345,61
-1,1619,1392,227,-1,20,57
1,1778,1498,280,1,269,101
-1,1562,1667,-105,1,43,52
1,1656,1689,-33,-1,-41,79
0,1585,1721,-136,0,-17,161
0,1742,1540,202,1,-236,132
1,1368,1463,-95,1,10,43
-1,1119,1838,-719,-4,-359,76
1,1638,1703,-65,0,31,67
-1,1819,1848,-29,-3,-240,80
1,1883,1849,34,3,138,58
-1,1487,1783,-296,3,350,100
1,1721,1424,297,2,48,45
1,1290,1357,-67,1,6,43
1,1946,1595,351,1,52,54
1,1676,1552,124,0,-21,53
-1,1675,1647,28,1,-148,104
1,1839,1893,-54,-2,-53,51
1,1851,1613,238,2,144,97
0,1809,1735,74,1,23,138
0,1705,1779,-74,-1,-94,135
1,1546,1220,326,-6,54,59
1,1885,1791,94,0,106,100
-1,1476,1880,-404,-4,21,66
1,1495,1410,85,0,-16,67
-1,1383,1802,-419,-13,-66,42
-1,1544,1683,-139,1,56,52
-1,1664,1806,-142,0,15,62
1,1767,1851,-84,0,409,97
1,1667,1589,78,3,81,51
1,1724,1407,317,0,-214,107
-1,1794,1929,-135,-1,-9,90
1,1882,1813,69,5,622,103
1,1747,1297,450,3,104,61
-1,1396,1482,-86,3,152,54
1,1691,1536,155,1,107,51
1,1575,1676,-101,0,506,93
-1,1804,1892,-88,0,-421,174
1,1309,1322,-13,0,55,51
1,1217,1549,-332,-3,-89,53
1,1875,1743,132,0,358,77
1,1357,1615,-258,2,465,155
-1,1121,1010,111,13,355,46
-1,1255,1470,-215,-5,-65,44
-1,1839,1698,141,1,4,50
1,1465,1327,138,-2,-14,45
1,1662,1597,65,6,339,79
1,1484,1249,235,4,65,41
1,1856,1771,85,1,6,41
1,1905,1651,254,-1,-12,59
-1,1689,1655,34,0,-171,104
-1,1583,1671,-88,1,216,110
0,1776,1707,69,-3,112,128
1,1529,1239,290,4,175,59
1,1410,1430,-20,3,18,42
1,1667,1677,-10,0,1,41
-1,1393,1728,-335,1,-23,61
-1,1491,1912,-421,-5,-52,70
-1,1351,1503,-152,-3,-91,42
-1,1666,1679,-13,-3,-157,132
0,1837,1839,-2,0,62,95
-1,1762,1865,-103,0,-18,76
-1,1633,1506,127,-7,-235,76
-1,1706,1740,-34,3,-315,133
-1,1486,1914,-428,2,42,60
1,1690,1534,156,-1,60,87
-1,1679,1769,-90,-1,10,44
-1,1439,1795,-356,0,3,68
-1,1355,1646,-291,-19,-477,54
1,1662,1893,-231,-3,19,77
1,1690,1656,34,0,-5,43
1,1559,1291,268,1,64,91
1,1777,1671,106,5,250,68
-1,1530,1590,-60,-6,-29,42
-1,1380,1485,-105,-1,-8,100
-1,1573,1725,-152,-2,-299,136
-1,1478,1918,-440,0,-17,48
-1,1656,1949,-293,-6,-226,66
1,1298,1118,180,6,1205,103
1,1663,1785,-122,3,178,81
-1,1036,1596,-560,2,27,40
1,1595,1765,-170,7,142,51
1,1916,1482,434,2,169,121
-1,1824,1920,-96,0,-46,104
-1,1497,1798,-301,-3,-114,56
-1,1931,1913,18,0,-81,79
0,1709,1774,-65,0,-58,107
1,1873,1737,136,3,218,71
1,1770,1678,92,12,329,55
1,1616,1713,-97,-4,-173,87
1,1484,1457,27,-1,88,65
1,1401,1407,-6,8,579,85
1,1796,1564,232,-1,13,53
1,1651,1382,269,12,148,41
1,1351,1123,228,1,3,61
-1,1732,1625,107,-4,-162,76
1,1492,1349,143,0,2,80
-1,1473,1786,-313,-2,-96,68
1,1924,1918,6,1,67,123
1,1409,1428,-19,0,71,89
1,1953,1652,301,2,108,79
-1,1662,1835,-173,-4,-345,94
0,1429,1506,-77,4,231,128
1,1734,1754,-20,-1,-35,49
0,1621,1447,174,6,115,133
-1,1328,1465,-137,1,-282,116
1,1475,1172,303,2,20,49
-1,1589,1597,-8,-1,-78,72
-1,1729,1657,72,0,46,94
1,1880,1894,-14,2,114,62
-1,1500,1500,0,-2,-300,60
-1,1758,1806,-48,-1,-37,68
1,1413,1298,115,1,133,61
0,1772,1711,61,0,-26,159
-1,1656,1688,-32,0,-176,108
-1,1344,1434,-90,1,-48,86
-1,1186,1273,-87,-6,-135,47
-1,1700,1646,54,0,85,102
1,1608,1388,220,4,705,107
1,1881,1624,257,-1,83,69
-1,1469,1482,-13,-2,-50,46
1,1817,1891,-74,-1,-47,57
1,2004,1647,357,3,123,53
-1,1586,1437,149,-2,-163,74
1,1659,1685,-26,-1,-3,41
1,1746,1743,3,1,8,69
1,1505,1457,48,0,-194,97
1,1877,1831,46,0,178,109
-1,1670,1670,0,0,5,56
1,1319,1085,234,3,62,117
-1,1701,1922,-221,-4,-59,42
1,1748,1619,129,1,116,63
-1,1220,1290,-70,-19,-654,62
1,1569,1539,30,-3,143,69
1,1536,1817,-281,0,13,75
-1,1557,1686,-129,-5,-100,56
1,1887,1821,66,1,148,105
1,1533,1558,-25,0,402,133
-1,1520,1588,-68,-2,178,80
1,1632,1340,292,9,179,45
-1,1679,1757,-78,0,-297,94
-1,1771,1713,58,-4,37,74
-1,1603,1504,99,2,-3,98
1,1428,1559,-131,1,75,71
-1,1033,1597,-564,-16,-890,72
-1,1528,1698,-170,-1,167,86
1,1766,1686,80,3,186,75
1,1691,1613,78,1,-60,113
1,1616,1665,-49,0,65,83
-1,1935,2115,-180,-1,-38,74
-1,1785,1651,134,1,50,52
1,1533,1480,53,0,46,75
1,1929,1528,401,1,48,93
1,1962,1551,411,0,-5,51
1,1897,1617,280,-2,82,91
-1,1611,1756,-145,-1,-9,56
1,1525,1931,-406,-1,-118,73
1,1570,1495,75,2,45,44
-1,1540,1640,-100,0,-100,96
1,1154,1281,-127,10,706,67
-1,1545,1548,-3,-3,-222,82
1,1488,1569,-81,-4,-319,61
-1,1727,1953,-226,0,-163,88
-1,1521,1677,-156,-10,-211,54
-1,1612,1901,-289,1,5,57
1,1613,1266,347,-10,-74,63
-1,1560,1514,46,1,352,110
-1,1500,1799,-299,-4,-465,80
1,1570,1542,28,-5,-78,43
-1,1452,1542,-90,-1,-339,98
1,1570,1542,28,-6,-107,41
1,1686,1531,155,-4,-60,53
0,1556,1516,40,3,135,145
1,1466,1338,128,1,683,159
1,1417,1242,175,1,503,119
-1,1645,1738,-93,-12,-353,52
-1,1549,1964,-415,-1,-6,43
-1,1580,1524,56,-17,-203,42
1,1265,1190,75,10,706,95
-1,1337,1662,-325,0,-144,68
1,1320,1423,-103,-7,-162,43
-1,1418,1426,-8,0,-42,56
1,1517,1554,-37,-3,-190,89
-1,1579,1802,-223,2,-98,56
1,1589,1559,30,-3,9,89
-1,1533,1644,-111,0,20,56
1,1514,1801,-287,-2,-24,47
1,1535,1529,6,-1,-373,123
-1,1888,1333,555,-4,1,52
-1,1555,1550,5,-8,-220,58
-1,1633,1784,-151,-1,-721,130
1,1518,1552,-34,8,84,49
1,1763,1605,158,2,201,93
-1,1534,1530,4,-1,98,62
1,1555,1549,6,-3,-13,51
-1,1211,1604,-393,-12,-379,48
-1,1453,2185,-732,-5,-191,110
-1,1535,1979,-444,-2,-62,52
1,1557,1322,235,1,178,83
1,1566,1474,92,-2,-208,69
-1,1312,1682,-370,-3,-101,58
0,1518,1551,-33,1,1437,141
-1,1275,1188,87,2,28,50
1,1967,1727,240,-1,12,95
-1,1321,1334,-13,-5,-161,42
1,1653,1343,310,-1,-18,93
1,1720,1578,142,-1,-24,45
-1,1613,1540,73,-6,-417,92
1,1607,1374,233,6,44,43
1,1550,1520,30,0,91,67
-1,1613,1761,-148,-7,-189,62
-1,1280,1419,-139,0,-117,90
-1,1533,1981,-448,-3,-238,72
-1,1506,1560,-54,5,-99,76
-1,1428,1441,-13,-1,-39,46
1,1684,1310,374,7,286,69
1,1494,1551,-57,1,312,79
-1,1531,1469,62,-4,-161,50
1,1510,1538,-28,-3,51,65
-1,1409,1612,-203,0,6,62
1,1502,1815,-313,0,7,73
1,1698,1603,95,-2,733,125
-1,1716,1808,-92,2,48,44
1,1563,1525,38,9,332,48
-1,1577,1482,95,-2,-172,70
-1,1406,1508,-102,-8,-165,42
1,1513,1572,-59,1,364,89
-1,1350,1598,-248,1,170,130
-1,1722,1589,133,-7,-1055,168
-1,1452,1294,158,-3,-60,58
1,1307,1687,-380,0,73,92
-1,1560,1529,31,-4,-318,90
1,1497,1563,-66,20,651,55
1,1701,1592,109,-3,-10,49
1,1723,1606,117,0,-25,44
-1,1601,1544,57,-1,-216,74
1,1548,1534,14,-5,-64,55
-1,1548,1534,14,0,-25,46
1,1556,1481,75,0,110,87
0,1549,1543,6,-4,497,125
-1,1516,1398,118,1,59,62
-1,1694,1796,-102,-1,-27,60
-1,1322,1027,295,-4,-59,54
1,1548,1534,14,8,175,51
1,1706,1709,-3,7,653,119
-1,1558,1524,34,-6,-7,106
-1,1581,1717,-136,0,-136,126
1,1521,1524,-3,0,64,120
1,1558,1524,34,9,745,95
1,1686,1544,142,-1,16,75
-1,1355,1435,-80,-7,-536,68
1,1706,1075,631,1,23,43
1,1546,1535,11,9,376,61
1,1724,1571,153,1,478,109
-1,1557,1544,13,-3,-323,120
1,1697,1566,131,3,55,45
-1,1388,1806,-418,0,-104,98
1,1603,1571,32,5,262,61
-1,1286,1095,191,0,-84,49
-1,1719,1557,162,-3,-8,46
-1,1557,1719,-162,-2,-267,74
-1,1491,1496,-5,0,-304,106
-1,1563,1731,-168,1,-240,158
1,1885,1712,173,1,419,145
1,1707,1716,-9,4,311,79
1,1704,1576,128,-1,-32,75
1,1567,1711,-144,1,155,105
1,1472,1589,-117,-1,242,102
-1,1530,1964,-434,-4,-103,88
1,1507,1756,-249,1,191,101
-1,1483,1618,-135,2,85,88
-1,1583,1666,-83,0,-119,130
1,1475,1625,-150,3,56,49
-1,1251,1966,-715,-1,26,50
1,1555,1405,150,2,134,81
-1,1613,1422,191,-2,-457,118
-1,1576,1703,-127,0,32,74
-1,1653,1394,259,1,3,50
-1,1332,1336,-4,1,-25,60
-1,1318,1323,-5,-4,-61,54
-1,1719,1774,-55,-1,-137,80
-1,1588,1988,-400,1,12,60
-1,1416,1629,-213,-1,-112,72
1,1546,1539,7,-6,-88,41
1,1398,1563,-165,-4,-291,75
1,1273,1469,-196,10,339,51
-1,1704,1959,-255,3,-43,90
1,1545,1540,5,-1,-47,101
-1,1516,1710,-194,-3,-15,58
1,1804,1571,233,1,78,61
-1,1716,1510,206,2,11,48
1,1815,1585,230,0,-4,61
1,1176,1227,-51,0,0,51
-1,1834,1645,189,3,64,48
0,1555,1568,-13,-1,64,98
-1,1566,1809,-243,0,14,56
-1,1529,1699,-170,3,-5,76
1,1320,1484,-164,7,26,41
1,1499,1201,298,7,14,47
1,1517,1503,14,10,162,49
-1,1555,1567,-12,2,178,148
-1,1963,1700,263,2,14,92
1,1477,1353,124,2,82,59
1,1585,1778,-193,1,-4,89
0,1543,1415,128,-1,-41,130
1,1705,1522,183,-9,-5,61
1,1494,1192,302,-1,-9,51
-1,1813,1579,234,0,21,58
-1,1515,1711,-196,1,110,56
-1,1581,1732,-151,3,62,56
1,1717,1509,208,-5,-99,61
1,1596,1423,173,5,281,77
1,1636,1346,290,0,44,69
1,1529,1415,114,7,101,45
1,1525,1467,58,2,291,85
1,1503,1722,-219,0,-22,65
-1,1738,1944,-206,-1,-90,64
1,1574,1719,-145,0,13,123
1,1500,1145,355,-4,-47,42
-1,1337,1549,-212,0,-7,50
0,1796,1839,-43,0,-93,195
-1,1473,1705,-232,-1,-52,52
-1,1599,1705,-106,0,63,106
-1,1342,1640,-298,-1,-130,58
1,1709,1431,278,1,35,57
-1,1261,1484,-223,-11,-138,42
-1,1417,1470,-53,-2,10,58
-1,1733,1949,-216,0,-3,48
-1,1561,1558,3,-4,-104,58
1,1645,1465,180,0,-5,65
-1,1488,1470,18,3,-475,138
1,1588,1543,45,5,189,55
-1,1366,1353,13,-7,-153,42
-1,1590,1701,-111,-4,-86,44
1,1892,1728,164,0,70,71
1,1479,1407,72,-1,253,115
1,1709,1582,127,0,-13,57
1,1335,1223,112,-5,-182,59
1,1713,1581,132,0,2,45
1,1602,1521,81,-5,-212,61
-1,1574,1716,-142,3,276,108
-1,1574,1686,-112,0,131,90
1,1347,1345,2,5,158,47
-1,1723,1566,157,-2,-184,116
1,1269,1574,-305,-7,-278,63
-1,1583,1707,-124,-2,114,78
1,1765,1617,148,2,13,49
1,1955,1802,153,-3,-116,57
-1,1695,1837,-142,-8,-117,46
-1,1529,1605,-76,-10,-137,54
-1,1334,1560,-226,-1,-13,42
1,1366,1206,160,10,716,83
-1,1611,1490,121,-1,-82,60
1,1385,1367,18,1,197,67
-1,1714,1762,-48,4,-44,63
-1,1535,1700,-165,-1,-127,74
-1,1372,1329,43,-1,-355,122
1,1714,1762,-48,0,116,83
1,1398,1421,-23,1,8,49
1,1415,1427,-12,3,83,47
1,1398,1353,45,2,569,153
-1,1749,1727,22,-7,-246,70
1,1415,1174,241,7,134,51
-1,1575,2135,-560,-1,-23,104
-1,1383,1369,14,-3,-82,118
1,1720,1732,-12,4,58,51
-1,1739,1737,2,-3,-169,102
1,2136,1574,562,0,62,93
-1,1423,1506,-83,-8,-19,42
1,1420,1551,-131,0,16,81
1,1533,1409,124,4,42,49
-1,1596,1610,-14,3,8,78
1,1748,1728,20,0,40,47
-1,1761,2022,-261,3,31,60
1,2137,1573,564,0,-55,61
1,1720,1712,8,4,160,51
-1,1540,1732,-192,-11,-464,62
-1,2138,1820,318,-5,-136,50
1,1575,1498,77,2,19,45
-1,1158,1572,-414,-14,-374,48
1,1569,1074,495,16,382,41
1,1572,1158,414,4,1057,89
1,1412,1443,-31,-2,61,105
-1,1151,1575,-424,-2,-240,70
1,1798,1718,80,-3,493,143
0,1784,1555,229,-4,-78,44
1,1535,1731,-196,-5,-120,79
-1,1443,1435,8,0,22,48
-1,1577,1145,432,0,254,102
-1,1795,1693,102,4,206,68
1,1760,1707,53,2,167,62
1,1571,1495,76,3,295,97
-1,1621,1586,35,-3,-162,80
-1,1216,1554,-338,-6,-737,100
-1,1661,2018,-357,-5,-87,43
1,1558,1206,352,6,1507,127
1,2047,1651,396,3,339,92
-1,1552,1698,-146,-3,-113,50
-1,1197,1561,-364,-14,-443,60
-1,1682,1722,-40,1,-60,84
-1,1166,1621,-455,-11,-137,44
-1,1731,1780,-49,0,-24,136
1,2185,1758,427,2,85,49
1,2188,1767,421,0,56,75
1,1717,1870,-153,-1,17,51
1,1364,1764,-400,-1,68,77
0,1598,1608,-10,-3,-275,122
1,1732,1831,-99,10,346,57
1,1280,1500,-220,1,79,52
1,1163,1313,-150,4,455,109
-1,1469,1458,11,1,-79,106
1,1718,1561,157,2,282,79
1,1797,1746,51,2,111,65
1,1842,1615,227,2,439,89
-1,1216,1526,-310,-5,-29,44
1,1741,1604,137,1,30,47
0,1991,1911,80,4,78,59
-1,1677,1656,21,2,-13,70
1,1530,1212,318,-3,-88,66
-1,1790,1683,107,-3,-82,54
1,1610,1404,206,0,-105,130
1,1668,1665,3,0,30,59
-1,1439,1500,-61,-11,-154,70
-1,1490,1456,34,-3,-184,86
1,1637,1427,210,0,50,51
-1,1610,1859,-249,-12,-804,84
-1,1339,1596,-257,0,-51,70
-1,1287,1452,-165,-7,-690,126
1,1504,1478,26,8,558,95
-1,1646,1676,-30,1,25,52
1,1430,1557,-127,0,-43,51
1,1667,1666,1,3,282,109
1,1346,1334,12,0,24,49
1,1745,1778,-33,0,-21,53
1,1874,1605,269,2,457,99
1,1527,1536,-9,2,199,85
-1,1334,1500,-166,-5,-262,70
1,1752,1540,212,0,777,121
-1,1500,1747,-247,-4,-111,52
1,1445,1423,22,-3,-75,57
1,1422,1500,-78,4,176,61
-1,2055,1856,199,-3,2,116
1,1572,1484,88,1,-9,41
1,1738,1687,51,6,288,57
-1,1756,1633,123,0,-137,116
-1,1335,1476,-141,1,44,54
-1,1280,1500,-220,-4,-244,84
1,1830,1872,-42,-3,-68,75
1,1841,1757,84,0,79,75
-1,1456,1323,133,0,-24,64
1,1860,1842,18,5,254,59
1,1539,1415,124,14,331,49
1,1601,1887,-286,-4,13,107
1,1748,1567,181,9,101,43
-1,1431,1282,149,5,518,110
-1,1832,1870,-38,-2,-113,70
-1,1748,1849,-101,-1,-26,48
-1,1292,1538,-246,1,30,72
1,1691,1546,145,1,184,81
1,1678,1702,-24,2,51,47
-1,1717,1743,-26,1,-519,150
1,1822,1720,102,5,22,41
-1,1274,1412,-138,3,-481,92
-1,1740,1689,51,-1,-156,98
1,1830,1768,62,3,87,59
-1,1523,2015,-492,-1,-90,56
1,1965,1683,282,1,253,103
1,1669,1698,-29,1,75,67
1,1406,1414,-8,0,110,77
1,1758,1839,-81,-1,-40,67
-1,1455,1867,-412,-1,-2,40
1,1616,1398,218,5,219,76
-1,1825,1772,53,-1,-274,92
1,1472,1528,-56,0,286,87
-1,1542,1323,219,2,62,78
-1,1531,1308,223,0,197,66
-1,1265,1419,-154,-4,-237,64
-1,1418,1519,-101,-3,-581,146
-1,1679,1699,-20,-1,3,40
1,1785,1813,-28,5,69,43
1,1478,1492,-14,4,152,53
-1,1813,1785,28,1,-121,94
-1,1479,1599,-120,0,-172,76
1,1284,1635,-351,2,209,100
-1,1386,1439,-53,-7,-169,60
1,1685,1681,4,0,-24,53
1,1258,1202,56,3,178,85
1,1752,1810,-58,4,384,75
-1,1405,1488,-83,-12,-238,48
1,1609,1712,-103,2,86,61
1,1346,1636,-290,1,-2,43
1,1801,1796,5,-1,-51,91
1,1515,1484,31,-5,231,81
1,1699,1607,92,1,583,99
-1,1295,1257,38,0,-9,46
1,1870,1279,591,-2,-1,96
-1,1808,1812,-4,0,-209,120
-1,1496,1352,144,0,-37,46
-1,1598,1707,-109,0,-198,66
1,1897,2071,-174,0,178,75
1,1419,1299,120,-2,-52,55
1,2053,1917,136,0,65,83
1,1797,1822,-25,1,38,69
1,1541,1557,-16,3,564,79
-1,1256,1391,-135,-2,-62,52
1,1811,1808,3,0,-109,57
1,1621,1604,17,0,192,69
-1,1478,1123,355,-5,-307,85
-1,1798,1822,-24,2,3,50
1,1464,1500,-36,2,136,55
1,1617,1658,-41,5,1107,125
1,1832,1788,44,0,179,103
-1,1292,1426,-134,-11,-55,46
-1,1269,1802,-533,-3,-129,62
-1,1714,1908,-194,1,-4,50
-1,1778,1841,-63,1,39,108
0,1450,1676,-226,4,339,143
1,1709,1712,-3,-8,123,79
-1,1850,1769,81,0,-263,130
-1,1267,1803,-536,0,-58,76
-1,1645,1306,339,-1,-450,118
1,1915,1701,214,0,36,55
1,1554,1511,43,-3,67,60
-1,1782,1837,-55,-1,-43,92
1,1243,1398,-155,-8,-108,75
-1,1266,1804,-538,-1,-523,100
-1,1846,1773,73,-3,-157,80
-1,1904,1594,310,0,22,42
1,1786,1523,263,11,392,51
1,1698,1469,229,-1,-9,49
1,1882,1713,169,-1,-79,71
1,1786,1833,-47,1,23,47
-1,1553,1489,64,-1,-147,80
1,1498,1279,219,-3,-77,55
1,1821,1798,23,-1,-33,123
-1,1896,1707,189,0,-72,68
1,1790,1519,271,1,257,91
1,1728,1697,31,1,125,83
1,1652,1364,288,3,67,55
1,1743,1463,280,0,44,61
-1,1637,1620,17,-1,-130,84
1,1701,1396,305,0,12,43
1,1831,1663,168,1,37,59
-1,1831,1663,168,0,-281,128
1,1628,1459,169,0,-3,40
1,1670,1456,214,17,220,43
-1,1265,1459,-194,-6,-601,74
1,1706,1738,-32,0,55,121
1,1313,1346,-33,1,29,85
-1,1370,1503,-133,0,-11,62
-1,1276,1514,-238,-1,-17,52
-1,1623,2035,-412,-3,-110,66
-1,1642,1816,-174,-1,-26,76
1,1530,1492,38,4,143,67
-1,1822,1879,-57,1,-21,64
1,1718,2037,-319,1,47,47
1,1738,1519,219,1,409,125
-1,1718,1727,-9,0,8,48
-1,1258,1707,-449,-2,-182,102
-1,1585,1672,-87,-4,-223,92
-1,1511,1688,-177,0,112,178
-1,1451,1675,-224,-4,-286,74
1,1745,1595,150,1,222,103
0,1874,1782,92,-3,24,123
-1,1737,1707,30,0,11,76
1,2014,1782,232,2,10,41
-1,1720,1872,-152,-1,-19,72
-1,1773,2020,-247,0,-11,52
1,1738,1481,257,0,4,45
0,1845,1988,-143,-9,-47,165
1,1588,1752,-164,2,39,71
-1,1698,1713,-15,-1,-307,148
-1,2036,1774,262,-1,-130,60
1,2036,1803,233,-2,38,81
-1,1495,1580,-85,-1,-60,52
1,1625,1682,-57,-3,-93,49
0,1724,1687,37,1,69,117
-1,1472,2047,-575,0,-50,70
-1,1402,1661,-259,-3,-236,82
1,1477,1643,-166,-4,-116,87
-1,1472,1516,-44,0,9,46
-1,1742,1587,155,3,190,96
-1,1681,2048,-367,-3,-251,100
1,1984,1849,135,2,55,61
-1,1814,1714,100,-4,-213,64
1,1736,1500,236,14,478,63
1,1801,1723,78,0,16,63
-1,1621,1820,-199,-1,-390,136
-1,1500,1500,0,-2,-44,46
1,1337,1397,-60,7,506,75
-1,1793,1728,65,-7,-148,50
-1,1754,1795,-41,0,62,130
1,1728,1793,-65,7,167,57
-1,1342,1369,-27,-4,-375,94
1,1775,1559,216,0,5,51
1,1632,1733,-101,-3,-7,59
-1,1554,1782,-228,1,21,60
-1,1879,1842,37,1,223,82
-1,1603,1725,-122,1,69,120
1,1483,1387,96,0,23,71
1,1638,1668,-30,0,115,119
1,1760,1387,373,3,89,41
1,1817,1789,28,4,199,73
1,1645,1291,354,4,131,54
1,1256,1624,-368,2,9,97
-1,1837,1775,62,-5,-28,50
-1,1346,1423,-77,2,-384,108
-1,1500,1317,183,-1,-63,86
-1,1728,1762,-34,4,226,126
1,1812,1792,20,6,336,81
1,1607,1570,37,-1,-20,47
1,1788,2052,-264,0,333,107
1,1523,1140,383,4,641,93
-1,1809,1795,14,0,-45,132
1,1491,1493,-2,1,21,71
1,1505,1391,114,2,92,59
-1,2029,1806,223,1,43,102
-1,1689,2083,-394,-4,-176,70
1,1495,1500,-5,-2,264,111
-1,1733,1595,138,-1,-52,52
-1,1809,1790,19,4,146,52
-1,1823,2008,-185,0,-499,122
1,1809,1790,19,-1,73,111
1,1647,1605,42,3,250,95
-1,1288,1653,-365,-2,-34,44
1,1822,1772,50,-4,-150,123
1,1610,1716,-106,-1,15,55
1,2015,1573,442,2,191,87
-1,1718,1674,44,0,-782,118
-1,1482,1502,-20,-3,-95,78
-1,1833,1757,76,-12,-303,74
-1,1573,2015,-442,-3,-91,94
1,1817,1778,39,0,76,79
-1,1774,1852,-78,0,6,54
1,1778,1817,-39,0,218,83
-1,1558,1516,42,-1,-241,92
-1,1089,1713,-624,-11,-510,66
-1,1872,1706,166,0,-29,72
1,1829,1763,66,0,20,77
-1,1571,2017,-446,-2,-177,70
1,1700,1642,58,-1,17,51
1,1066,1052,14,7,723,135
1,1750,1840,-90,2,733,143
-1,1656,1847,-191,-1,-36,68
1,1513,1471,42,1,-572,89
1,1385,1706,-321,2,42,95
1,1824,1770,54,2,105,73
-1,1824,1770,54,0,-4,48
1,1710,1690,20,-3,-7,45
1,1738,1500,238,2,186,103
-1,1789,2054,-265,-3,-151,94
1,1217,1133,84,3,577,77
-1,1662,1680,-18,-5,-303,102
1,1625,1625,0,8,567,109
-1,1425,1564,-139,-6,-376,60
-1,1280,1733,-453,-7,-543,64
1,1360,1259,101,-3,389,85
1,2019,1569,450,-1,5,73
1,1529,1546,-17,0,8,91
-1,1462,1522,-60,-1,-221,100
-1,1722,1773,-51,-4,-116,60
-1,1765,1578,187,-4,-536,160
-1,1827,1942,-115,-1,-41,60
1,1651,1596,55,0,103,76
1,1499,1478,21,1,10,55
1,1782,1712,70,-2,67,49
1,1532,1452,80,0,51,77
1,1477,1741,-264,-3,-251,85
1,1703,1500,203,-4,24,65
-1,1262,1379,-117,-11,-520,73
1,1535,1541,-6,3,285,105
1,1596,1327,269,4,137,63
1,1497,1345,152,0,6,57
1,1549,1680,-131,0,-33,77
-1,1991,1955,36,0,-33,62
-1,1595,1724,-129,-8,-87,56
1,1743,1495,248,4,484,131
1,1504,1337,167,0,-72,81
1,1250,1278,-28,12,276,51
-1,1444,1540,-96,-2,-79,58
1,1843,1576,267,-1,-105,109
1,1853,1462,391,5,60,45
-1,1511,1500,11,-2,-82,100
1,1567,1731,-164,0,64,89
-1,1548,1435,113,0,-64,92
-1,1972,1755,217,0,12,98
-1,1594,1747,-153,-1,-100,94
-1,1560,1577,-17,1,-9,72
-1,1387,1254,133,-8,-141,47
-1,1389,1860,-471,-3,-153,54
1,1268,1322,-54,-9,-177,51
1,1608,1744,-136,1,82,83
-1,948,1020,-72,-4,-943,88
-1,1586,1714,-128,0,-166,90
1,1690,1691,-1,11,545,87
1,1785,1359,426,2,27,69
-1,1529,1546,-17,0,4,58
-1,1577,1722,-145,-3,-229,86
-1,1710,1527,183,2,256,82
1,1722,1577,145,0,218,125
1,1845,1610,235,-3,-120,101
-1,1747,1739,8,-1,-27,50
1,1867,1630,237,-7,-182,57
1,1321,1254,67,2,123,57
1,2064,1967,97,-10,-121,113
1,1612,1352,260,2,369,103
1,1281,1263,18,12,430,51
1,1817,1278,539,3,59,49
-1,1652,1840,-188,-1,-100,96
-1,1591,1754,-163,-1,-16,42
1,1044,935,109,22,1061,69
1,1693,1475,218,-1,-3,51
1,1872,1729,143,-1,-55,119
1,1353,1469,-116,-1,52,71
1,1894,1791,103,0,13,55
-1,1787,1679,108,-1,-49,64
-1,1466,1553,-87,1,43,56
1,1468,1776,-308,-2,52,59
-1,1346,1416,-70,-2,-54,60
1,1872,1861,11,2,57,57
1,1637,1442,195,1,79,57
1,1447,1596,-149,9,203,57
-1,1661,1683,-22,0,-78,100
1,1428,1639,-211,-1,-27,53
1,1838,1751,87,1,39,65
1,1500,1418,82,3,372,108
0,1375,1398,-23,0,-69,105
0,1773,1775,-2,-1,181,166
1,1611,1526,85,-1,51,67
-1,1686,1691,-5,1,20,66
1,1269,1723,-454,-2,-29,49
-1,1355,1581,-226,2,39,58
-1,1645,2039,-394,-7,-127,44
1,1491,1694,-203,-1,-76,67
-1,1861,1847,14,0,1,80
-1,1416,1562,-146,-1,-77,71
-1,1345,1635,-290,2,-14,94
-1,1609,1707,-98,0,7,72
0,1470,1500,-30,-1,7,57
1,1489,1459,30,11,261,55
-1,1400,2042,-642,-1,-23,48
1,1648,1348,300,-1,4,47
-1,1464,1430,34,0,13,52
1,1801,1511,290,-1,19,89
1,2043,1399,644,-1,-30,51
-1,1639,1660,-21,-1,-38,51
1,1291,1215,76,5,92,41
-1,1500,1477,23,-5,-32,40
-1,1555,1538,17,2,-74,144
1,1427,1439,-12,-2,-283,125
-1,1550,1638,-88,-2,-124,71
1,2044,1572,472,4,585,75
-1,1748,1688,60,-2,-227,124
-1,1344,1652,-308,-9,-193,54
1,1636,1227,409,-1,42,51
-1,1860,1847,13,-3,-100,74
-1,1676,1679,-3,-4,15,48
-1,1620,1380,240,2,26,50
-1,1602,1775,-173,0,-176,84
-1,1515,1407,108,-1,3,52
0,1512,1446,66,-4,-615,101
-1,1571,2046,-475,-1,-125,56
1,1540,1495,45,7,340,77
0,1715,1675,40,0,-7,127
-1,1453,1579,-126,-1,-8,84
1,2137,1789,348,0,57,65
1,1300,1218,82,5,307,84
-1,1721,1956,-235,-10,-55,44
1,1743,1671,72,-1,-3,87
0,1760,1449,311,1,120,145
-1,1861,1847,14,0,-15,100
-1,1402,1225,177,-1,-1,46
1,1545,1656,-111,5,217,105
0,1643,1507,136,-2,-267,106
-1,1668,1646,22,-8,-48,40
-1,1335,1569,-234,-3,-116,56
1,1961,1713,248,-7,-166,47
-1,1786,1781,5,-1,-103,68
1,1411,1261,150,6,476,141
-1,1398,1607,-209,-9,-137,45
-1,1465,1508,-43,-14,-276,46
1,1456,1595,-139,4,67,49
-1,1500,1592,-92,0,-37,78
1,1386,1436,-50,1,14,54
-1,1587,1446,141,0,-113,88
1,1485,1550,-65,2,238,77
0,1752,1352,400,1,437,99
-1,1701,1954,-253,0,8,92
-1,1677,1549,128,1,60,62
-1,1452,1481,-29,2,86,68
-1,1621,1551,70,-1,-96,64
0,1613,1365,248,-1,-19,89
-1,1448,1509,-61,1,115,72
-1,1385,1859,-474,3,-464,116
-1,1847,1706,141,1,49,84
-1,1595,1518,77,-8,-65,70
1,1400,1602,-202,7,-57,41
-1,1640,1560,80,0,-10,96
-1,1676,1713,-37,0,-36,108
-1,1966,1950,16,-2,-27,48
-1,1430,1706,-276,-2,-128,74
1,1453,1536,-83,0,24,57
-1,1531,1792,-261,2,31,112
1,1940,1662,278,-3,5,77
1,1571,1524,47,0,69,79
-1,1441,1591,-150,1,18,70
0,1676,1852,-176,0,29,86
1,1393,1436,-43,-2,-38,79
-1,1492,1619,-127,0,-6,66
-1,1985,2147,-162,0,-133,86
-1,1707,1986,-279,-11,-320,52
1,1814,1850,-36,-1,-13,73
0,2165,1996,169,0,-6,74
1,1430,1409,21,9,157,57
-1,1748,1953,-205,0,-61,124
1,1316,1408,-92,4,117,85
-1,1730,1830,-100,1,-49,58
1,1519,1425,94,3,381,93
-1,1500,1491,9,1,206,98
-1,1547,1485,62,-1,-180,98
-1,1084,1299,-215,-3,-370,121
1,1703,1505,198,0,113,69
1,1625,1237,388,-2,25,51
1,1751,1673,78,0,47,65
1,1341,1600,-259,0,21,109
1,1795,1619,176,-3,-127,59
-1,1838,1826,12,-2,-60,54
0,1651,1912,-261,0,-68,91
-1,1807,2155,-348,0,-9,66
-1,1341,1713,-372,-3,-91,60
1,1666,1565,101,0,64,119
1,1602,1801,-199,-1,273,139
1,1749,1752,-3,0,-32,57
1,2048,1643,405,1,10,45
1,1847,1348,499,1,262,75
1,1651,1541,110,5,18,41
-1,1399,1441,-42,-5,-370,87
-1,1474,1502,-28,4,-223,92
1,1837,1706,131,0,104,83
1,1502,1418,84,0,105,63
-1,1826,1631,195,-3,-182,64
1,1415,1527,-112,-2,-57,43
-1,1585,1418,167,-4,236,142
1,1471,1334,137,1,-10,47
1,1468,1562,-94,4,107,53
-1,1641,2050,-409,0,-132,100
1,1628,1658,-30,-5,46,101
0,1791,1997,-206,-5,-47,98
0,1821,1734,87,-1,-21,101
1,1320,1315,5,5,530,71
-1,1849,2161,-312,-1,-140,80
1,1538,1474,64,-2,62,67
1,1533,1408,125,0,84,67
1,1836,1831,5,-1,-24,41
1,1733,1722,11,3,333,90
1,1955,1696,259,1,60,65
-1,1647,1527,120,-3,-166,74
-1,1844,1959,-115,-1,-305,170
1,1409,1513,-104,0,77,105
-1,1448,1432,16,-3,-172,84
1,1577,1582,-5,-1,-6,74
1,1847,1897,-50,0,7,55
-1,1664,1761,-97,-1,-209,78
1,1613,1499,114,13,305,43
-1,1776,1810,-34,0,49,84
-1,1548,1760,-212,-9,-236,50
-1,1610,1826,-216,-5,-255,85
1,1306,1206,100,5,389,83
-1,1542,1633,-91,-6,-88,48
-1,1436,1465,-29,-3,-28,94
1,1547,1482,65,-5,6,43
-1,1601,1805,-204,0,5,56
1,1681,1729,-48,0,78,123
0,1703,1755,-52,-2,-221,131
1,1641,1473,168,0,0,61
1,1490,1537,-47,1,75,71
-1,1884,1862,22,0,5,80
-1,1711,1746,-35,0,-42,70
1,1641,1533,108,0,89,125
-1,1646,1905,-259,-1,-345,120
-1,1796,1651,145,-2,-115,75
-1,1551,1288,263,0,99,66
1,1627,1527,100,2,63,55
1,1355,1336,19,23,876,55
1,1423,1138,285,13,350,51
0,1500,1462,38,1,484,124
1,1648,1467,181,-1,28,65
-1,1331,1557,-226,-5,12,40
-1,1525,1510,15,5,116,56
-1,1787,1784,3,-7,-199,52
-1,1459,1734,-275,-3,-96,56
1,2168,1845,323,1,88,95
1,1831,1637,194,-1,48,53
0,1580,1508,72,-2,124,74
-1,1526,1649,-123,-1,-271,103
-1,1542,1909,-367,-1,-152,60
1,1541,1527,14,-2,-35,59
-1,1351,1474,-123,2,50,57
-1,1776,1735,41,-2,-42,76
1,1841,1240,601,2,90,69
1,1568,1642,-74,-2,90,55
-1,1543,1628,-85,-3,-222,76
1,1638,1796,-158,-3,-22,51
1,1654,1674,-20,1,78,91
1,2024,1872,152,0,45,112
-1,1322,1755,-433,0,-22,64
-1,1734,1690,44,-13,-578,72
-1,1750,1764,-14,-1,-105,68
-1,1743,1902,-159,-2,-113,54
0,1656,1518,138,0,-383,138
1,1513,1552,-39,3,276,91
-1,1320,1499,-179,-1,-299,66
1,1528,1513,15,3,118,53
1,1861,1757,104,1,133,79
-1,1780,1981,-201,-6,-63,98
1,1696,1595,101,3,622,107
-1,1705,1842,-137,-3,-69,60
1,1574,1540,34,-5,-91,73
1,1522,1652,-130,-3,44,79
1,1734,1474,260,0,7,55
-1,1482,1595,-113,-4,-146,46
-1,1258,1206,52,-2,-242,68
-1,1313,1765,-452,-1,-140,62
1,1869,1826,43,-3,-90,49
-1,1713,1694,19,-8,-64,42
-1,1210,1820,-610,0,-271,106
1,1837,1829,8,2,2,41
1,1491,1307,184,6,1007,133
1,1738,1584,154,1,631,139
-1,1433,1518,-85,1,-18,52
1,1637,1537,100,6,213,61
1,1476,1300,176,11,280,53
-1,1737,2052,-315,-1,-92,98
1,1415,1472,-57,2,545,167
-1,1690,1736,-46,0,-6,52
-1,1667,1968,-301,-1,-62,70
-1,1608,1565,43,1,284,94
-1,1742,1748,-6,0,1,60
1,1562,1736,-174,7,139,51
-1,1267,1529,-262,3,-489,124
-1,1300,1497,-197,-4,-186,66
0,1529,1645,-116,-1,-115,119
1,1645,1539,106,0,-53,71
-1,1636,1251,385,-2,98,92
-1,1816,1879,-63,0,1,46
-1,1740,1688,52,-3,-35,64
0,1413,1423,-10,2,143,98
1,1792,1193,599,7,87,45
1,1503,1293,210,25,326,41
1,1704,1557,147,3,185,81
-1,1330,1712,-382,-8,-554,78
1,1759,1731,28,0,-11,51
1,1691,1851,-160,-2,22,59
-1,1505,1378,127,2,64,56
1,1663,1541,122,-1,40,89
-1,1745,1676,69,0,-313,142
-1,1585,1627,-42,5,81,49
1,1693,1541,152,3,80,53
1,1262,1425,-163,6,267,69
-1,1308,1490,-182,0,25,52
1,1862,1472,390,5,188,69
-1,1807,1887,-80,-1,0,58
-1,1245,1606,-361,-12,-151,40
1,1393,1503,-110,0,-21,65
-1,1774,1609,165,0,15,44
-1,1842,1898,-56,-1,-14,50
-1,1490,1698,-208,1,-101,90
-1,1756,1770,-14,-2,-76,60
-1,1427,1457,-30,-4,-148,56
-1,1301,1497,-196,2,-943,98
-1,1397,1506,-109,0,44,70
-1,1865,1775,90,0,5,72
1,1422,1659,-237,-2,-74,51
-1,1242,1526,-284,-5,-101,47
-1,1533,1670,-137,0,-182,114
1,1413,1242,171,2,72,63
0,1737,1818,-81,0,40,114
1,1925,1718,207,0,7,55
1,1908,1831,77,3,130,61
1,1583,1694,-111,3,20,41
1,1971,1944,27,-1,1,45
-1,1663,1700,-37,-1,-30,46
1,1478,1619,-141,1,33,65
1,1930,1780,150,-2,-11,55
1,1468,1558,-90,2,156,85
1,1637,1711,-74,3,213,95
1,1420,1488,-68,-3,-35,49
-1,1428,1561,-133,0,-183,144
-1,1933,1674,259,-3,-476,112
1,1386,1514,-128,4,269,71
-1,1773,1937,-164,-1,-504,106
-1,1500,1839,-339,-3,-177,120
1,1294,1503,-209,1,16,63
1,1440,1521,-81,4,108,51
1,1515,1704,-189,-1,125,63
1,1642,1443,199,0,170,85
1,1652,1711,-59,3,95,69
1,1780,1500,280,-1,-26,99
1,1684,1234,450,-5,-28,101
1,1821,1917,-96,-1,-1,45
-1,1767,1943,-176,-3,-160,98
1,1731,1226,505,1,260,99
-1,1424,1784,-360,-1,-30,52
-1,1465,1253,212,0,103,60
1,1932,1746,186,2,-48,117
1,1692,1490,202,0,55,135
-1,1720,1773,-53,-3,-338,94
-1,1489,1598,-109,0,-501,112
1,1645,1460,185,0,56,55
-1,1468,1687,-219,5,192,78
-1,1282,1382,-100,0,1,60
-1,1575,1468,107,-1,-28,48
1,1851,1714,137,1,155,135
1,1903,1837,66,1,118,79
1,1677,1526,151,0,104,75
-1,1494,1603,-109,-1,-23,52
-1,1703,1484,219,2,-114,66
1,1533,1459,74,-1,-219,87
1,1470,1271,199,2,270,87
-1,1733,1849,-116,-3,-100,64
-1,1435,1488,-53,1,-679,106
1,1734,1832,-98,0,-3,53
1,1493,1420,73,2,34,69
1,1468,1227,241,2,81,55
-1,1437,1647,-210,0,-357,88
1,1757,1223,534,6,357,73
1,1733,1534,199,2,262,89
1,2148,1518,630,0,-62,113
1,1569,1438,131,5,456,93
1,1827,1912,-85,3,83,46
1,1565,1546,19,-3,16,75
0,1679,1574,105,-1,-697,164
0,1513,1787,-274,0,245,119
1,1685,1411,274,6,323,87
1,2296,1978,318,-2,359,117
0,1789,2031,-242,0,5,104
1,1666,1232,434,0,57,79
1,1924,1637,287,0,81,61
1,1898,1842,56,-1,151,75
-1,1439,1455,-16,3,17,52
1,1684,1371,313,4,55,51
1,1903,1775,128,4,198,64
1,1781,1566,215,0,106,75
-1,1939,1740,199,-1,-83,66
1,1759,1515,244,1,97,78
1,1566,1457,109,6,127,55
1,1327,1309,18,2,303,79
-1,1739,2133,-394,-4,-126,50
-1,1254,1400,-146,-2,-117,64
1,1657,1407,250,2,86,53
-1,1560,1268,292,-3,-348,130
-1,1913,2024,-111,-1,-99,84
-1,1707,1847,-140,-1,-20,48
-1,1751,1955,-204,-8,-88,50
0,1644,1702,-58,-3,-835,202
-1,1377,1426,-49,-3,-197,112
-1,1338,1712,-374,-6,-168,54
1,1796,1096,700,6,285,57
-1,1401,1661,-260,4,73,58
1,1832,1907,-75,0,-25,101
-1,1972,2136,-164,-2,-457,160
-1,1910,2025,-115,-1,-19,48
-1,1307,1449,-142,-9,-280,78
1,1534,1532,2,-5,-11,73
1,1960,1745,215,1,114,61
-1,1709,1500,209,-8,61,72
1,1472,1209,263,3,597,111
1,1310,1324,-14,-9,-166,47
1,1689,1407,282,4,302,99
-1,1524,1419,105,-6,-52,44
1,2072,1668,404,5,177,63
1,1486,1462,24,2,55,57
1,1739,1965,-226,5,170,45
1,1687,1768,-81,-1,188,97
1,1737,1335,402,0,67,71
-1,1757,1920,-163,-2,-122,88
-1,1665,1533,132,-6,-356,88
1,1666,1653,13,3,16,41
1,1524,1344,180,3,142,61
1,1894,1847,47,-1,343,123
-1,1559,1481,78,-2,-93,102
1,2034,2143,-109,-3,235,127
-1,1731,1786,-55,-8,-103,48
1,1820,1456,364,0,-8,45
1,2075,1564,511,7,235,55
-1,1758,1725,33,-2,-453,110
1,1239,1435,-196,0,7,49
0,1796,1722,74,-2,-562,163
1,1764,1259,505,3,118,47
1,1547,1650,-103,-1,254,135
-1,1563,2076,-513,-1,-250,90
-1,1724,1794,-70,-2,-114,68
-1,1736,1508,228,-1,-67,56
1,1506,1493,13,1,34,49
-1,1751,1940,-189,-2,-185,64
1,1803,1715,88,2,-34,87
1,2126,2049,77,1,-25,47
-1,1701,1806,-105,0,-19,58
1,1550,1495,55,0,18,71
1,1489,1391,98,1,14,41
1,1770,1863,-93,-2,-58,91
-1,1771,1593,178,-2,-90,56
1,1707,1812,-105,-4,82,103
1,1605,1817,-212,-3,-92,67
-1,1576,1439,137,1,42,70
1,1688,1632,56,-3,-46,96
-1,1756,1634,122,-6,-75,44
-1,1642,1677,-35,0,4,64
-1,1500,1569,-69,-2,-231,71
1,1823,1606,217,5,408,75
0,2040,2136,-96,0,14,109
1,1890,1850,40,5,233,67
1,1516,1325,191,0,38,49
1,2078,1833,245,0,-17,75
1,1636,1561,75,0,34,68
-1,1256,1765,-509,5,78,68
1,1236,1197,39,7,528,73
-1,1476,1500,-24,0,-87,76
1,1848,1865,-17,-1,42,79
-1,1465,1671,-206,5,637,150
-1,1383,1508,-125,1,53,66
1,1644,1604,40,7,149,50
-1,1430,1636,-206,1,72,68
0,1495,1543,-48,1,139,126
1,1840,1900,-60,0,-1,53
-1,1455,1755,-300,-4,-36,54
1,1522,1461,61,3,89,51
1,1271,1451,-180,3,-5,91
1,1344,1500,-156,-3,255,75
-1,1728,1453,275,7,125,50
1,1478,1691,-213,-1,13,50
-1,1333,1546,-213,-1,-46,78
-1,1623,1698,-75,-1,7,68
1,1559,1535,24,2,516,121
-1,1500,1422,78,-8,-461,78
0,1304,1230,74,0,-151,169
-1,1449,1701,-252,0,-52,124
1,2084,2235,-151,0,80,89
1,1767,1449,318,-4,289,105
1,1548,1674,-126,7,370,79
-1,1828,1946,-118,2,33,138
1,1531,1452,79,0,66,85
0,1854,1699,155,3,227,143
-1,1725,1577,148,0,1,58
-1,1895,1887,8,-9,-11,58
-1,1376,1524,-148,-7,-43,52
1,1829,1374,455,5,156,54
1,1134,1284,-150,18,962,81
1,1525,1482,43,3,213,53
1,1642,1425,217,1,201,153
-1,1413,1545,-132,-1,-131,80
1,1500,1424,76,0,53,69
-1,1650,1633,17,-1,-30,80
1,1707,1341,366,3,307,85
-1,1668,1938,-270,0,15,59
1,2149,1993,156,4,270,87
1,1247,1251,-4,0,-66,67
-1,1452,1737,-285,-4,-89,54
1,2104,1629,475,6,151,53
1,1434,1562,-128,1,67,61
-1,1853,1860,-7,0,-27,52
-1,1369,1394,-25,0,-16,80
-1,1705,1849,-144,-3,-1,48
-1,1265,1741,-476,-4,-179,74
-1,1759,1315,444,-7,-239,64
1,1771,1732,39,0,93,79
1,1918,1914,4,-1,36,55
-1,1721,2157,-436,-1,-40,54
1,1986,1605,381,5,148,75
-1,1771,1640,131,0,-255,108
-1,1247,1410,-163,-6,-90,48
0,1831,1541,290,1,51,96
1,1641,1322,319,5,127,47
-1,1243,1151,92,-1,-42,72
1,1563,1574,-11,-2,78,70
1,2106,1841,265,0,63,65
1,2160,1719,441,-1,-22,45
1,1410,1709,-299,-1,1,43
1,2162,1717,445,-10,-128,49
1,1710,1682,28,-4,147,111
1,1724,1500,224,4,32,49
1,1429,1545,-116,3,42,51
-1,1781,1659,122,0,-5,88
1,1627,1466,161,1,88,70
1,1856,1138,718,3,272,57
-1,1716,2164,-448,0,-3,46
1,1560,1341,219,7,337,57
-1,1645,1638,7,1,-612,102
1,1710,1494,216,0,230,101
-1,1412,1545,-133,-3,55,42
1,1768,1701,67,0,-24,41
1,2166,1714,452,0,-84,71
1,1482,1334,148,1,78,65
1,1993,1738,255,0,1,55
1,1700,1563,137,0,69,69
1,1556,1461,95,-4,484,93
1,1733,1448,285,1,124,61
1,1505,1227,278,6,207,65
1,1674,1824,-150,-3,96,70
-1,1712,2169,-457,0,-65,94
-1,1763,1387,376,0,-65,60
-1,1514,1731,-217,-8,-10,40
1,1858,1684,174,0,63,87
-1,1326,1489,-163,-15,-360,50
-1,1408,1796,-388,-6,-178,48
1,1857,2039,-182,0,7,45
1,1777,1737,40,0,75,119
1,1495,1318,177,1,23,47
-1,1601,1500,101,-5,-219,66
1,1516,1498,18,0,153,119
1,1430,1500,-70,3,72,59
1,1342,1741,-399,-2,-80,41
1,1871,1833,38,2,213,95
-1,1718,2171,-453,-3,-247,68
-1,1444,1587,-143,-1,-24,52
-1,1555,1424,131,3,71,50
1,1698,1710,-12,-3,-20,43
1,1576,1544,32,11,520,79
1,1753,1687,66,-3,100,81
-1,1407,1740,-333,0,-679,130
-1,1552,1822,-270,0,-22,60
1,2173,1710,463,4,192,73
-1,1134,1716,-582,4,13,76
0,1896,2111,-215,0,-284,125
-1,1764,1992,-228,1,45,64
1,1414,1311,103,6,158,47
-1,1634,1738,-104,0,-51,78
1,1682,1528,154,0,75,69
1,1887,1938,-51,0,16,75
-1,1436,1726,-290,-1,-60,62
-1,1703,2176,-473,0,32,84
1,1570,1482,88,1,29,67
-1,1100,1239,-139,-1,-43,58
1,1413,1884,-471,4,308,103
-1,1690,1500,190,-3,-49,52
1,1988,1873,115,0,72,93
1,1609,1359,250,1,41,47
-1,1730,1998,-268,0,32,116
-1,1616,1799,-183,-2,-21,42
-1,1556,1707,-151,0,6,68
0,1334,1405,-71,-7,-1185,120
-1,1617,1495,122,1,50,104
1,1482,1406,76,13,336,59
1,1859,1500,359,-3,21,89
1,1399,1399,0,-2,-232,87
1,1973,1865,108,0,20,63
1,1856,1859,-3,1,402,91
-1,1660,1742,-82,-3,-94,70
1,1862,1867,-5,-1,-140,85
1,1384,1500,-116,8,189,51
1,1856,1873,-17,10,199,43
1,1873,1856,17,-2,-83,67
1,1545,1473,72,1,20,47
-1,1280,1388,-108,3,-249,110
-1,1682,1759,-77,-1,-69,62
1,1845,1884,-39,-9,-128,97
-1,1334,1491,-157,-11,-199,46
-1,1394,1699,-305,-2,9,40
1,1872,1857,15,-1,-24,47
1,1779,1563,216,3,275,91
1,1857,1872,-15,0,389,143
1,1872,1857,15,1,92,75
-1,1615,1673,-58,-1,-27,50
-1,1573,1859,-286,0,-11,48
-1,1498,1290,208,0,1,84
-1,1847,1882,-35,1,4,68
1,1869,1265,604,0,8,51
-1,1262,1521,-259,-4,-673,112
1,1500,1396,104,3,151,67
1,1870,1892,-22,2,476,95
1,1507,1201,306,1,641,105
-1,1686,1767,-81,0,0,48
1,1500,1095,405,-1,-23,63
-1,1476,1752,-276,4,16,40
-1,1258,1500,-242,-16,-428,58
-1,1443,1506,-63,0,-96,116
-1,1858,1981,-123,-6,-328,84
1,1476,1500,-24,20,1486,93
1,1798,1369,429,1,159,79
1,1472,1313,159,25,427,43
1,1717,1608,109,-3,-42,49
1,1846,1456,390,8,117,45
1,1594,1198,396,11,599,67
1,1530,1478,52,-3,-2,43
1,1988,1851,137,-1,-14,45
1,1820,1460,360,0,3,113
1,1620,1504,116,-1,39,57
1,1540,1678,-138,7,130,71
-1,1118,1197,-79,0,-20,58
1,1681,1600,81,1,45,113
1,1577,1264,313,-1,-93,73
1,1510,1455,55,1,118,79
1,1265,1259,6,-1,-58,105
1,1768,1724,44,-3,-140,75
1,1842,1166,676,1,279,67
-1,1496,1558,-62,-3,-228,80
1,1713,1671,42,-4,-43,41
-1,1448,1447,1,-1,-43,46
-1,1312,1309,3,3,211,50
1,1661,1722,-61,1,120,103
1,1611,1511,100,2,321,125
0,1458,1434,24,1,-117,132
-1,1732,1706,26,-1,-60,140
1,1687,1477,210,-2,15,63
1,1837,1676,161,3,127,55
1,1607,1669,-62,3,35,47
-1,1332,1536,-204,1,103,62
1,1435,1458,-23,-2,-78,107
1,1720,1843,-123,-7,-59,88
1,1651,1667,-16,3,555,127
-1,1158,1638,-480,-6,-396,72
-1,1828,1719,109,1,-133,134
1,1735,1571,164,0,39,93
1,1744,1686,58,-1,153,163
1,1450,1183,267,6,69,43
-1,1351,1388,-37,-3,-296,74
1,1584,1857,-273,-1,161,115
1,1741,1562,179,2,94,66
-1,1606,1712,-106,0,-105,58
1,1747,1598,149,0,-7,61
1,1681,1749,-68,0,-35,87
-1,1598,1747,-149,-3,-28,50
1,1721,1599,122,0,234,105
-1,1257,1544,-287,2,102,64
1,1754,1591,163,8,58,45
1,1698,1650,48,1,5,63
1,1458,1167,291,4,82,41
0,1713,1859,-146,0,-3,45
-1,1585,1760,-175,1,-68,56
1,1707,1593,114,0,17,77
1,1836,1603,233,0,69,86
-1,1542,1694,-152,-1,-555,124
0,1160,1462,-302,0,242,118
1,1766,1579,187,2,405,79
-1,1255,1714,-459,-5,-134,50
1,1398,1341,57,-4,-80,109
-1,1775,1591,184,-4,-82,54
-1,1573,1772,-199,-5,-246,66
1,1535,1701,-166,8,214,63
-1,1603,1757,-154,-4,-163,88
1,1558,1503,55,-2,-5,63
1,1777,1568,209,2,70,99
1,1567,1295,272,-1,-10,51
1,1685,1560,125,1,153,83
1,1751,1208,543,12,774,85
0,1562,1783,-221,3,556,135
1,1252,1257,-5,2,244,73
1,1460,1259,201,-5,-79,45
-1,1669,1716,-47,2,40,50
1,1576,1566,10,-1,-18,57
1,1884,1554,330,-6,-113,61
1,1598,1784,-186,0,-13,47
1,1776,1569,207,0,6,67
1,1661,1237,424,-3,108,125
-1,1108,1207,-99,-1,-144,46
-1,1563,1782,-219,0,-82,70
-1,1265,1579,-314,-2,-211,62
1,1787,1558,229,2,339,103
-1,1726,1663,63,-2,-216,82
-1,1553,1792,-239,0,-202,94
1,1711,1844,-133,0,-37,67
1,1797,1677,120,2,22,49
-1,1261,1588,-327,-2,-308,82
1,1763,1725,38,0,-75,115
-1,1677,1797,-120,0,-18,70
1,1456,1198,258,4,545,101
-1,1647,1767,-120,-3,-341,122
1,1449,1583,-134,0,-17,57
-1,1704,1713,-9,0,65,108
-1,1726,1829,-103,-1,-345,88
1,1888,1478,410,0,15,69
1,1995,1674,321,1,289,123
1,1412,1310,102,7,134,45
-1,1724,1758,-34,0,-43,74
1,1752,1411,341,0,695,143
1,1297,1291,6,1,58,61
-1,1758,1708,50,-1,-10,40
1,1436,1279,157,4,171,59
1,1581,1492,89,0,483,123
-1,1720,1529,191,-8,-21,40
1,1837,1718,119,1,131,111
1,1495,1476,19,-3,74,105
1,1594,1401,193,3,12,41
-1,1730,1857,-127,-2,-83,50
-1,1511,1711,-200,0,-105,92
-1,1472,1522,-50,1,101,82
1,1338,1378,-40,0,50,90
-1,1589,1906,-317,0,-20,62
0,1844,1980,-136,0,143,148
1,1775,1633,142,0,43,83
-1,1382,1352,30,-3,-112,80
-1,1564,1460,104,-1,-66,90
-1,1716,1735,-19,-1,-227,134
-1,1500,1725,-225,-3,-188,84
1,1070,1468,-398,3,110,57
-1,1814,1735,79,0,43,102
1,1549,1511,38,1,23,95
1,1461,1597,-136,4,318,100
1,1736,1998,-262,-1,-6,69
1,1603,1500,103,3,72,51
0,1191,1270,-79,0,-107,122
-1,1801,1500,301,-6,-455,62
1,1626,1369,257,0,149,71
1,1609,1653,-44,-1,-5,73
-1,1364,1228,136,0,-513,108
1,1849,1413,436,4,175,65
1,1891,1796,95,-1,-102,81
-1,1457,1099,358,-9,-390,70
1,1449,1371,78,0,414,97
1,1455,1400,55,-1,49,61
1,1730,2086,-356,1,7,43
-1,1750,1789,-39,0,3,62
-1,1472,1578,-106,0,-31,76
0,1901,1786,115,-2,-242,105
1,2012,1659,353,5,37,89
-1,1818,1693,125,0,-109,160
-1,1790,1739,51,-8,-26,40
-1,1580,1677,-97,-2,-63,48
-1,1669,1348,321,-1,-415,162
-1,2066,1754,312,-3,-52,46
1,1787,1806,-19,0,112,87
-1,1693,1704,-11,-3,-109,56
1,1771,1799,-28,0,-20,65
1,1774,1742,32,2,85,67
0,1457,1401,56,-3,-189,136
-1,1794,1976,-182,0,-113,128
-1,1540,1416,124,-1,-48,54
1,1896,1829,67,-1,-14,45
1,1787,1804,-17,-2,-34,69
1,1511,1476,35,1,629,123
1,1569,1505,64,4,93,51
-1,1830,1631,199,0,-58,111
1,1622,1765,-143,-3,28,85
1,1258,1332,-74,0,-195,78
0,1774,1798,-24,-2,-298,157
1,1378,1527,-149,6,66,43
-1,1766,2140,-374,-1,696,118
1,2140,1731,409,0,22,51
1,1715,1549,166,-1,-117,121
-1,1503,1456,47,-3,-62,60
1,1464,1270,194,-1,36,63
-1,1638,1750,-112,-2,-214,127
1,1716,1452,264,9,199,49
1,1274,1433,-159,-1,9,67
1,1922,1752,170,1,148,109
-1,1473,1520,-47,0,-4,50
1,1802,1721,81,0,233,137
1,1500,1559,-59,0,35,107
-1,1692,1677,15,0,-6,54
1,1484,1591,-107,0,47,77
-1,1716,1741,-25,-3,-197,76
-1,1564,1816,-252,-9,-125,46
1,1788,1721,67,3,181,65
1,1495,1505,-10,-2,209,145
-1,1533,1657,-124,-3,98,84
1,0,1489,-1489,-1,-2,41
1,1595,1711,-116,0,29,53
-1,1307,1341,-34,-3,-647,78
-1,1681,1609,72,0,-208,96
-1,1694,1660,34,0,-100,88
-1,1744,1803,-59,0,-113,90
-1,1522,1560,-38,-8,-94,54
0,1713,1813,-100,0,142,124
0,1527,1655,-128,2,136,107
-1,1630,1707,-77,-4,-128,61
-1,1689,1822,-133,-2,-325,94
-1,1466,1809,-343,0,-41,112
-1,1211,1581,-370,-16,-119,40
-1,1622,1668,-46,0,-35,64
1,1812,1734,78,3,88,45
-1,1627,1751,-124,-3,-176,121
1,1465,1557,-92,3,152,78
-1,1725,1821,-96,-3,-175,107
1,1812,1463,349,-1,-106,95
-1,1677,1613,64,3,165,66
-1,1692,1638,54,0,-205,124
-1,1602,1733,-131,-4,-326,124
-1,1786,1600,186,0,14,62
1,1625,1664,-39,-1,64,113
-1,1467,1299,168,10,207,50
1,1681,1557,124,-1,28,69
1,1523,1478,45,1,40,49
1,1442,1217,225,3,282,103
-1,976,1208,-232,-3,-83,50
-1,1621,1898,-277,2,158,95
1,1583,1841,-258,0,2,41
1,1716,1767,-51,0,43,91
1,2055,1679,376,0,-1,43
-1,1385,1352,33,-2,-86,67
1,1585,1306,279,8,96,41
-1,1306,1244,62,-1,-671,114
-1,1503,1582,-79,-5,-259,68
-1,1689,1672,17,-1,1,40
-1,1652,1500,152,-1,-117,256
1,1497,1367,130,9,95,43
1,1910,1690,220,0,30,67
0,1716,1653,63,-1,-21,93
-1,1717,1943,-226,-3,-26,42
-1,1530,1484,46,-2,29,56
1,1763,1757,6,3,225,75
-1,1752,1729,23,1,47,112
1,1822,1692,130,0,22,65
1,1677,1525,152,-5,99,191
0,1655,1714,-59,0,-23,122
1,1768,1643,125,0,201,93
-1,1697,1455,242,0,15,57
1,1545,1455,90,2,-6,45
-1,1872,1787,85,-1,-81,98
-1,1758,1619,139,-7,-235,62
-1,1432,2187,-755,-7,-250,62
1,1495,1567,-72,1,16,91
-1,1511,1602,-91,-1,-171,92
0,1657,1712,-55,0,40,119
-1,1546,1357,189,-1,-188,74
-1,1741,1738,3,0,22,108
0,1209,1302,-93,0,-119,126
1,1659,1710,-51,-3,117,83
1,1494,1500,-6,5,194,47
1,1603,1807,-204,1,306,73
1,1526,1448,78,7,308,73
-1,1684,2187,-503,0,-7,55
0,1651,1256,395,-1,-130,94
-1,1600,1488,112,-5,60,84
-1,1432,1853,-421,-2,-164,52
1,2015,1690,325,1,40,53
1,1698,1672,26,0,138,71
1,1790,1482,308,0,11,41
-1,1747,1821,-74,2,-145,86
-1,1751,1730,21,0,-145,114
-1,1477,1798,-321,-5,-717,120
1,1549,1525,24,3,82,55
1,1513,1517,-4,3,324,93
-1,1661,1708,-47,-1,-103,72
1,1611,1126,485,1,67,57
1,1775,1697,78,0,-9,51
1,1994,2014,-20,-1,9,49
-1,1486,1417,69,2,41,62
1,1804,1473,331,0,4,41
-1,1585,1500,85,1,-210,82
-1,1514,1564,-50,-3,-567,136
1,1717,1651,66,-1,-34,79
1,1682,1429,253,-3,338,89
-1,1850,1670,180,-1,-240,92
-1,1742,1738,4,-2,-27,62
-1,1360,1379,-19,-3,-124,96
1,1475,1385,90,0,-21,57
1,1642,2127,-485,1,21,53
-1,1783,1686,97,0,-207,108
0,2006,2100,-94,-1,104,170
-1,1698,1662,36,2,79,56
0,1785,1459,326,1,-155,114
1,1685,1699,-14,-1,17,59
-1,1805,1986,-181,0,15,102
1,1419,1365,54,-1,3,49
-1,1488,1541,-53,1,43,62
-1,1750,1730,20,0,-34,84
-1,1687,1636,51,0,-96,134
1,1470,1564,-94,-1,90,57
-1,1687,1424,263,2,56,56
-1,1688,1706,-18,1,-47,74
1,1431,1255,176,9,194,47
1,1460,1365,95,-2,-38,47
-1,1448,1517,-69,-2,-304,100
1,1384,1212,172,2,292,95
-1,1917,1982,-65,0,-90,114
1,1569,1570,-1,2,128,67
-1,1484,1550,-66,-1,-23,52
-1,1535,1649,-114,3,133,96
-1,1777,2065,-288,-1,-1,46
1,1715,1484,231,0,124,79
1,1673,1248,425,0,203,133
-1,1437,1519,-82,-1,-30,60
1,1529,1635,-106,1,134,83
1,1759,1587,172,3,110,81
1,1575,1293,282,0,17,65
-1,1600,1766,-166,0,-165,120
-1,1551,1669,-118,-1,-178,96
-1,1638,1742,-104,-1,16,58
1,1595,1125,470,16,552,59
0,1830,1824,6,-2,-91,103
-1,2096,2009,87,3,68,114
1,1833,1832,1,2,256,135
-1,1541,1541,0,1,34,60
-1,1579,1278,301,0,-4,60
-1,1816,2001,-185,-5,-37,54
1,1488,1490,-2,-2,-24,61
1,1475,1500,-25,0,9,50
-1,1778,1854,-76,0,-25,58
1,1675,1445,230,-6,-353,117
-1,1649,1559,90,0,6,70
1,1373,1349,24,1,44,47
-1,1350,1576,-226,0,-58,58
-1,1809,1509,300,0,-10,44
1,2143,1750,393,1,3,65
-1,1764,1514,250,0,-987,190
-1,941,1312,-371,-4,-35,46
1,1657,1552,105,-3,17,81
1,2007,1737,270,0,30,89
-1,1529,1786,-257,0,-36,84
-1,1532,1429,103,1,-48,58
1,1561,1360,201,4,334,87
-1,1205,1391,-186,1,-159,164
-1,1580,1558,22,0,-98,108
-1,1527,1630,-103,-3,-133,90
-1,1863,1769,94,2,61,58
1,1791,1524,267,3,157,89
1,1767,1394,373,7,461,67
1,1829,1748,81,3,75,57
1,1350,1555,-205,-2,75,57
-1,1291,1581,-290,-1,-477,156
1,1624,1581,43,0,477,139
1,1617,1664,-47,-3,35,55
1,1776,1507,269,1,39,56
-1,2012,1733,279,0,-12,80
-1,1520,1796,-276,1,174,60
-1,1502,1223,279,-4,-153,60
1,1345,1544,-199,1,579,107
-1,1484,1446,38,1,15,84
1,1446,931,515,1,25,47
1,1801,1516,285,0,7,61
-1,1678,1543,135,-3,-76,65
-1,1473,1471,2,0,70,66
-1,1592,1664,-72,1,12,74
-1,1571,1635,-64,-3,-136,64
-1,1512,1805,-293,-3,-83,72
-1,1566,1753,-187,-1,-88,76
-1,1472,1744,-272,-1,-22,64
1,1809,1508,301,2,135,77
-1,1645,2079,-434,-4,-141,52
1,1673,1583,90,0,28,49
1,1591,1517,74,3,39,41
1,1492,1475,17,3,64,41
-1,1551,1679,-128,1,-5,76
-1,1531,1516,15,-1,-42,60
-1,1652,1648,4,0,-78,98
-1,1504,1814,-310,-4,-79,82
-1,1935,2081,-146,0,-19,48
-1,1503,1780,-277,0,17,84
1,1421,1395,26,6,162,57
-1,1450,1443,7,-1,-52,57
-1,1575,1681,-106,0,-85,86
-1,1458,1907,-449,-2,-89,56
1,1817,1845,-28,1,372,91
1,2022,1889,133,0,24,107
-1,1383,1531,-148,-9,-266,52
1,1770,1392,378,-2,104,97
1,1797,2074,-277,0,91,121
0,1568,1296,272,-3,25,122
1,1606,1521,85,0,81,61
-1,1849,1799,50,0,-348,190
-1,1500,1793,-293,-8,-27,40
1,1492,1603,-111,0,47,85
-1,1687,1543,144,-8,-48,46
1,1628,1373,255,0,0,69
0,1544,1465,79,-1,-39,116
-1,1883,2029,-146,0,-51,124
1,1585,1528,57,-2,92,64
1,1909,1456,453,2,96,77
1,1672,1266,406,2,282,99
1,1670,1383,287,0,23,73
1,1743,1639,104,1,85,101
1,1546,1538,8,-1,-25,47
1,1538,1377,161,2,72,45
1,1698,1500,198,0,-6,137
1,2190,1748,442,1,80,75
1,1454,1552,-98,-1,131,71
-1,1518,1484,34,2,5,54
-1,1511,1633,-122,-6,-66,54
1,1747,1337,410,1,244,61
1,1554,1487,67,-3,48,61
1,2055,1501,554,3,87,51
-1,1766,1848,-82,-4,-27,48
1,1837,2018,-181,-3,-116,81
-1,1784,1500,284,0,2,108
1,1703,1526,177,0,42,71
-1,1557,1678,-121,-8,-111,56
-1,1620,1746,-126,1,-14,84
1,1585,1500,85,3,501,135
-1,1519,1603,-84,0,96,88
-1,1706,1641,65,-2,-104,76
-1,1506,1798,-292,-16,-182,42
-1,1760,2146,-386,-4,-2,56
-1,1366,1643,-277,2,75,66
0,1709,2093,-384,0,-44,134
-1,1339,1478,-139,-2,-435,94
-1,1773,1591,182,-1,-443,162
1,1659,955,704,6,647,105
-1,1500,1477,23,0,-156,74
1,1505,1466,39,0,-3,41
-1,1815,1853,-38,1,71,72
1,1757,1501,256,0,295,85
1,1617,1630,-13,1,47,59
1,1571,1385,186,3,272,87
-1,1480,1592,-112,-3,-67,56
-1,1531,2150,-619,0,-42,54
-1,1826,2087,-261,1,-152,114
1,1552,1503,49,5,341,87
-1,1600,1751,-151,-1,-46,56
-1,1732,1535,197,1,-50,86
-1,1689,1615,74,-3,-169,92
1,1693,1797,-104,0,49,123
-1,1757,1859,-102,-3,-53,64
-1,1468,1462,6,1,117,108
1,1647,1361,286,-2,4,55
1,1718,1654,64,0,-684,131
-1,1496,1762,-266,1,27,50
-1,1397,1502,-105,2,-42,74
1,1779,1122,657,3,522,85
-1,1483,1500,-17,0,-2,52
1,1867,1698,169,4,151,62
-1,1909,1662,247,1,-143,86
-1,1365,1482,-117,-8,-152,52
1,1389,1254,135,-3,106,121
-1,1805,1863,-58,-2,-9,72
-1,1630,1676,-46,-3,-32,68
1,1764,1705,59,1,235,107
0,1766,1561,205,-8,296,136
1,1498,1242,256,4,543,117
-1,1728,2091,-363,-3,-59,52
1,1686,1468,218,0,124,153
1,1560,1489,71,4,426,89
-1,1303,1562,-259,1,22,54
1,1383,1394,-11,-3,332,99
1,2121,1645,476,0,127,119
1,1549,1538,11,0,12,45
-1,1783,1707,76,0,165,132
-1,1711,1757,-46,-1,-117,94
-1,1643,2036,-393,-3,-71,52
0,1541,1620,-79,-3,49,100
-1,1652,1599,53,-2,-197,88
1,1796,1872,-76,0,60,73
1,1500,1502,-2,5,366,79
1,1593,1205,388,0,247,73
-1,1465,1608,-143,0,-14,52
1,2038,1640,398,-1,51,79
0,1686,1619,67,0,-125,125
-1,1761,1893,-132,0,10,64
1,1472,1361,111,-2,-6,41
1,1832,1800,32,1,38,57
1,1510,1289,221,0,146,65
1,1629,1556,73,-7,335,95
-1,1587,1600,-13,1,-128,92
-1,1691,1873,-182,0,-36,79
1,1618,1107,511,5,840,105
0,1722,1911,-189,-4,-573,131
-1,1809,1859,-50,1,36,102
-1,1743,1941,-198,-6,-82,64
-1,1209,1479,-270,-13,-266,44
1,1560,1455,105,0,175,99
-1,1535,1476,59,4,93,70
-1,1638,1796,-158,-1,-465,120
1,1755,1749,6,0,47,57
0,1596,1552,44,0,89,118
1,1733,1197,536,11,314,57
-1,1463,1506,-43,-2,-337,116
1,1354,1479,-125,-7,-256,63
-1,1905,1728,177,-1,-88,92
-1,1638,1662,-24,-3,-13,42
1,1459,1460,-1,6,276,71
-1,1490,1543,-53,-4,-198,58
1,1803,1631,172,2,204,69
-1,1720,1559,161,0,-26,66
1,1800,1868,-68,0,17,47
-1,1570,1774,-204,-7,-191,92
-1,1644,1743,-99,0,-23,88
1,1812,1855,-43,1,40,57
-1,1568,1633,-65,-2,-32,48
-1,1624,1810,-186,-2,-430,84
1,1621,1715,-94,0,33,55
1,1888,1514,374,1,47,53
1,1771,1575,196,3,194,90
1,1760,1577,183,0,132,85
1,1548,1245,303,0,57,71
1,1728,1411,317,9,736,81
1,1734,1468,266,-2,-14,51
1,1824,1843,-19,0,178,143
-1,1611,1836,-225,-3,-110,70
-1,1569,1766,-197,0,-150,91
-1,1544,1397,147,-1,-104,62
1,1394,1385,9,17,193,41
-1,1849,1764,85,0,-39,152
1,1952,1578,374,-1,71,77
-1,1884,1850,34,0,-80,94
1,1611,1543,68,7,99,41
-1,1714,1707,7,0,-75,70
-1,1447,1605,-158,-5,-204,84
-1,1534,1621,-87,0,-362,76
1,1642,1669,-27,1,9,43
1,1365,1405,-40,1,157,73
-1,1719,1703,16,1,2,56
-1,1630,1928,-298,-1,56,60
1,1703,1719,-16,3,339,115
-1,1757,1883,-126,-1,-168,58
-1,1534,1615,-81,-1,-283,90
1,1932,1626,306,3,162,74
-1,1233,1298,-65,-1,-5,42
-1,1576,1459,117,1,10,48
-1,1669,1859,-190,0,-305,152
1,1956,1543,413,0,95,81
1,1591,1649,-58,2,235,79
-1,1291,1468,-177,-10,-401,70
1,1494,1653,-159,4,175,65
-1,1643,1915,-272,3,1,68
-1,1935,1622,313,6,86,78
1,1728,1599,129,0,303,107
-1,1714,1663,51,-3,5,62
-1,1437,1539,-102,-1,-380,98
1,1380,1216,164,0,81,61
1,1958,1236,722,-5,-8,51
1,1653,1475,178,1,-12,41
1,1919,1639,280,0,-16,83
-1,1452,1568,-116,-3,-557,116
1,1307,951,356,0,9,71
-1,1635,1923,-288,1,-49,78
-1,1662,1594,68,0,-234,94
-1,1427,1576,-149,-12,-411,52
1,1959,1192,767,1,50,61
1,1525,1312,213,3,103,56
1,1462,1308,154,3,82,89
1,1927,1631,296,0,15,65
-1,1702,1676,26,0,-18,74
-1,1750,1891,-141,-3,-123,60
-1,1627,1931,-304,1,200,76
1,1474,1283,191,9,309,61
-1,1510,1516,-6,-6,-265,78
1,1959,1777,182,1,14,43
-1,1307,1530,-223,-7,-205,76
1,1935,1623,312,-1,-124,61
-1,1898,1772,126,0,-106,92
-1,1513,1657,-144,-1,-202,79
1,1967,1125,842,4,158,51
-1,1619,1939,-320,0,-205,90
-1,1130,1268,-138,-2,-605,118
-1,1678,1815,-137,1,-186,62
1,1882,1865,17,0,-76,63
1,1968,1336,632,2,318,79
1,1942,1615,327,0,18,59
1,1448,1233,215,0,40,65
0,1961,1677,284,0,-17,96
1,1422,1340,82,0,-12,45
-1,1612,1946,-334,0,-55,70
-1,1304,1367,-63,3,138,42
1,1853,1893,-40,-1,-1,51
1,1387,1441,-54,8,226,41
1,1880,1867,13,-2,227,73
1,1742,1786,-44,-1,9,71
-1,1716,1669,47,0,-24,74
-1,1607,1647,-40,1,6,74
1,1949,1608,341,0,-63,83
-1,1763,1874,-111,-2,-210,104
-1,1575,1396,179,-3,-235,105
1,1605,1952,-347,0,-11,57
1,1624,1429,195,9,631,95
-1,1275,1532,-257,-1,-13,105
-1,1743,1899,-156,2,-26,66
-1,1969,1858,111,-7,55,74
1,1355,1590,-235,0,40,54
-1,1638,1794,-156,-6,-537,84
-1,1296,1598,-302,-4,-110,50
1,1426,1538,-112,-5,20,131
-1,1467,1755,-288,0,-114,80
1,1930,1949,-19,0,222,69
1,1800,1632,168,3,116,51
-1,1683,1650,33,-7,-124,66
1,1933,1571,362,-1,60,69
-1,1561,1759,-198,-9,-2,106
-1,1806,1943,-137,1,77,74
-1,1440,1499,-59,1,-38,62
1,1936,1500,436,-2,11,79
1,1402,1526,-124,1,74,67
-1,1755,1597,158,0,-83,78
1,1420,1431,-11,-3,-228,77
1,1559,1574,-15,5,555,129
1,1420,1683,-263,-1,-30,45
-1,1292,1500,-208,4,4,40
0,1824,1764,60,-4,581,150
1,1958,1940,18,-1,-26,41
1,1498,1560,-62,2,177,71
1,1537,1270,267,0,96,79
0,1404,1715,-311,-3,6,119
-1,1736,1835,-99,-2,-180,62
-1,1970,1891,79,0,-159,132
-1,1535,1287,248,0,-508,118
1,1379,1500,-121,1,140,61
-1,1705,1670,35,0,69,74
1,1444,1568,-124,3,112,43
1,1276,1240,36,3,786,123
1,1955,1925,30,0,110,71
1,1766,1818,-52,-1,253,65
-1,1396,1420,-24,0,24,54
1,1912,1966,-54,3,571,117
0,1656,1700,-44,1,42,76
-1,1782,1779,3,-1,-38,48
-1,1952,1929,23,-2,-82,56
-1,1307,1517,-210,-1,-104,84
-1,1624,1693,-69,0,-2,43
-1,1264,1481,-217,-5,-353,74
1,1790,1752,38,1,103,113
-1,1791,1809,-18,3,142,78
-1,1613,1738,-125,-4,-190,74
-1,1463,1376,87,0,-16,70
1,1683,1657,26,-4,-51,63
1,1944,1905,39,0,95,77
-1,1444,1793,-349,1,6,48
1,1689,1665,24,9,259,57
1,1254,1536,-282,2,153,57
1,1792,1799,-7,2,16,41
1,1227,1439,-212,-2,421,101
-1,1258,1504,-246,-11,-121,60
1,1804,1941,-137,2,293,95
-1,1522,1655,-133,-2,-134,64
-1,1245,1390,-145,0,-593,100
-1,1589,1773,-184,-5,-119,59
-1,1927,1818,109,0,-187,82
-1,1801,1869,-68,0,-46,72
1,1956,1793,163,-1,76,89
1,1641,1548,93,0,20,47
1,1458,1819,-361,-1,595,101
1,1788,1803,-15,-4,-15,73
1,1832,1913,-81,-3,32,55
-1,1728,1736,-8,-3,-255,98
-1,1172,1310,-138,-3,-109,54
1,1913,1832,81,-1,-10,63
-1,1786,1964,-178,0,-106,84
-1,1441,1686,-245,-1,-34,51
-1,1515,1361,154,-1,-63,82
1,1620,1532,88,8,59,42
1,1824,1921,-97,0,2,45
1,1800,1631,169,0,2,64
1,1605,1746,-141,3,383,83
-1,1282,1079,203,2,57,112
1,1252,1341,-89,3,351,120
1,1908,1837,71,-3,-221,67
-1,1579,1514,65,-1,-26,58
1,1829,1916,-87,3,100,83
1,1806,1852,-46,4,72,65
1,1317,1133,184,3,165,47
-1,1629,1500,129,10,24,40
1,1972,1372,600,1,29,45
-1,1903,1842,61,0,-17,58
-1,1627,1696,-69,0,2,44
-1,1527,1706,-179,-1,-4,56
-1,1408,1788,-380,-2,10,66
1,1973,1693,280,7,160,49
-1,1854,1891,-37,-1,-64,74
1,1488,1511,-23,-3,-60,41
1,1978,1688,290,3,35,46
-1,1818,1695,123,-5,-323,84
1,1900,1845,55,-1,46,79
-1,1474,1453,21,-7,-504,82
1,1721,1684,37,4,10,43
1,1982,1409,573,0,27,61
1,1836,1909,-73,-1,385,163
-1,1273,1564,-291,-3,-282,74
1,1730,1443,287,0,10,51
1,1405,1570,-165,3,187,83
-1,1555,1693,-138,-2,-51,46
1,1896,1848,48,-1,-112,97
1,1734,1131,603,4,367,67
1,1712,1804,-92,4,360,73
1,1499,1791,-292,1,8,55
1,1691,1436,255,2,275,105
1,1839,1905,-66,6,771,115
-1,1612,1833,-221,-2,8,82
-1,1984,1554,430,2,354,86
1,1794,1366,428,3,115,41
1,1700,1548,152,-1,27,64
-1,1673,1826,-153,1,57,44
1,1893,1852,41,-5,-176,71
1,1735,1490,245,0,124,83
-1,1456,1702,-246,-9,-154,66
-1,1621,1730,-109,-2,-17,58
-1,1868,1713,155,-2,-696,126
1,1957,1410,547,0,1,85
1,1842,1902,-60,0,473,123
-1,1451,1575,-124,6,232,58
1,1940,1788,152,2,375,67
-1,1890,1855,35,0,-273,92
-1,1408,1959,-551,-3,-37,46
-1,1268,1439,-171,-1,-104,68
-1,1490,1747,-257,-3,-343,80
1,1452,1204,248,1,72,45
1,1717,1724,-7,-3,149,131
1,1796,1400,396,0,49,63
-1,1866,1878,-12,0,149,114
-1,1385,1541,-156,-10,-411,70
-1,1266,1246,20,-2,-303,88
-1,1625,1830,-205,0,-2,57
1,1297,1428,-131,-3,-99,59
1,1525,1616,-91,3,401,125
-1,1889,1856,33,0,16,126
-1,1833,1947,-114,-2,-248,60
-1,1465,1456,9,0,-56,64
1,1960,1723,237,0,3,53
1,1868,1877,-9,4,425,83
-1,1568,1521,47,-1,-59,48
-1,1822,1733,89,-1,-3,41
1,1701,1446,255,1,-40,129
1,1730,1829,-99,1,-11,43
1,1966,1711,255,1,39,49
-1,1746,1808,-62,-2,-72,42
-1,1389,1505,-116,-1,-49,64
-1,1781,1731,50,0,-112,104
1,1414,1315,99,5,122,61
-1,1607,1563,44,1,-50,84
-1,1962,1701,261,-2,-349,114
-1,1825,1576,249,-1,-70,108
-1,1796,1745,51,-1,-262,78
-1,1128,1164,-36,2,-28,52
-1,1817,1738,79,0,8,52
1,1844,1707,137,5,119,57
1,1768,1512,256,-1,28,55
-1,1333,1342,-9,-8,-332,74
0,1772,1468,304,-3,-3,127
1,1485,1577,-92,-1,45,97
-1,1931,1854,77,0,-74,132
1,1715,1635,80,1,28,53
1,1612,1310,302,1,561,96
1,1635,1715,-80,-5,173,91
-1,1397,1798,-401,-1,-108,60
-1,1430,1648,-218,-10,-273,48
-1,1636,1851,-215,2,43,80
-1,1764,1608,156,-2,-196,94
1,1972,1723,249,1,45,59
-1,1616,1603,13,0,-13,48
-1,1260,1191,69,-21,-437,50
-1,1748,1654,94,-3,-128,82
1,1563,1500,63,2,66,57
-1,1421,1658,-237,9,244,61
1,1615,1603,12,0,7,46
1,1734,1814,-80,-2,0,59
-1,1230,1223,7,3,-7,48
-1,1977,1692,285,-1,284,78
1,1592,1353,239,1,-50,43
1,1662,1416,246,2,59,65
-1,1381,1420,-39,2,201,72
-1,1219,1629,-410,-6,-223,62
1,1954,1500,454,0,138,93
-1,1740,1943,-203,-1,-104,92
1,1490,1572,-82,1,235,83
-1,1949,1726,223,-1,-257,92
1,1593,1348,245,-5,-93,123
1,1597,1500,97,12,363,53
1,1603,1259,344,0,-6,55
1,1534,1390,144,6,440,73
1,1483,1500,-17,-7,28,48
1,1630,1632,-2,1,130,59
1,1962,1843,119,-2,-38,51
1,1620,1642,-22,0,-2,55
0,1931,1835,96,1,-477,102
-1,1500,1607,-107,1,109,72
-1,1559,1504,55,-2,16,98
1,1972,1199,773,0,-21,55
1,1838,1928,-90,11,485,59
-1,1383,1482,-99,-1,-146,68
-1,1597,1443,154,-4,-386,98
-1,1913,1853,60,0,-426,92
-1,1632,1630,2,-5,-215,72
-1,1323,1487,-164,0,27,44
-1,1128,1500,-372,-9,-170,47
-1,1198,1972,-774,-2,-32,52
0,1866,1900,-34,0,449,110
-1,1494,1316,178,1,-10,60
-1,1641,1620,21,0,-12,102
1,1973,1197,776,2,51,61
1,1613,1667,-54,-2,-3,45
-1,1334,1236,98,12,180,40
0,1502,1579,-77,-1,616,145
-1,1517,1768,-251,0,-31,58
-1,1343,1336,7,1,52,42
-1,1460,1853,-393,-6,-126,52
1,1899,1669,230,0,-168,113
1,1196,1477,-281,-7,4,49
1,1318,1352,-34,-1,-26,49
0,1664,1904,-240,-3,-777,110
1,1478,1628,-150,3,187,82
1,1458,1248,210,0,40,51
1,1546,1513,33,-3,-46,61
1,1897,1670,227,0,935,185
1,1479,1500,-21,7,14,41
-1,1344,1923,-579,1,-96,64
1,1955,1484,471,1,32,69
1,1681,1564,117,3,55,51
1,1234,1463,-229,0,-3,79
1,1924,1343,581,4,159,49
-1,1487,1602,-115,6,255,58
-1,1453,1624,-171,1,5,42
-1,1973,1908,65,0,-22,42
-1,1479,1610,-131,-1,-38,54
1,1554,1612,-58,2,74,59
-1,1342,1925,-583,0,-71,56
1,1610,1479,131,3,29,59
-1,1540,1555,-15,-1,-96,52
1,1445,1279,166,1,-32,55
-1,1957,1472,485,-3,-38,84
1,1341,1331,10,0,-1,43
1,1926,1617,309,3,27,41
1,1274,1209,65,4,295,89
1,1318,1353,-35,5,78,43
-1,1446,1706,-260,0,25,68
1,1614,1930,-316,-5,-70,43
1,1264,1452,-188,0,-47,53
-1,1222,1162,60,-25,-1569,80
1,1493,1665,-172,0,-50,85
-1,1599,1816,-217,-3,-2,48
-1,1777,1866,-89,-4,-78,46
-1,1928,1906,22,1,272,102
1,1800,1633,167,-3,-237,85
-1,1703,1500,203,0,14,56
0,1648,1509,139,-1,-385,102
-1,1395,1557,-162,-3,-186,70
-1,1627,1806,-179,0,-65,58
-1,1357,1391,-34,-2,-153,98
1,1372,1566,-194,5,94,41
1,1912,1478,434,2,41,45
-1,1644,1920,-276,-8,-627,84
1,1812,1621,191,0,54,73
1,1428,1317,111,0,15,59
1,1503,1644,-141,-1,3955,169
1,1915,1925,-10,0,202,107
1,1347,1535,-188,-5,-2,179
-1,1302,1436,-134,-1,70,68
-1,1675,1629,46,-5,-43,44
-1,1822,1863,-41,1,-293,114
1,1488,1388,100,-1,28,133
1,1750,1719,31,-1,43,69
-1,1047,1806,-759,-2,-74,61
1,1866,1930,-64,0,-43,93
1,1662,1642,20,7,199,47
1,1444,1288,156,5,66,45
-1,1483,1457,26,7,239,65
-1,1662,1642,20,0,46,82
1,1276,1450,-174,0,-2,41
1,1758,1762,-4,2,31,45
1,1669,1496,173,1,318,79
-1,1869,1926,-57,-1,-55,76
1,1434,1305,129,1,25,55
-1,1610,1790,-180,-4,-38,42
-1,1873,1812,61,1,105,54
-1,1573,1519,54,0,-32,78
1,1898,1460,438,1,27,65
1,1502,1331,171,2,48,45
1,1938,1255,683,0,61,47
1,1502,1580,-78,1,-79,49
-1,1654,1902,-248,-7,-62,48
-1,1541,1395,146,-1,-89,60
1,1528,1263,265,1,18,59
-1,1723,1700,23,1,29,52
1,1907,1649,258,-4,4,59
-1,1493,1518,-25,-2,-119,80
-1,1217,1166,51,-6,-272,74
1,1645,1911,-266,3,340,111
-1,1391,1499,-108,-4,-23,44
1,1504,1514,-10,3,618,85
1,1862,1796,66,5,149,57
-1,1239,1533,-294,-3,-183,68
1,1263,1200,63,15,386,53
1,1729,1405,324,0,-40,93
1,1939,1586,353,2,162,81
1,1440,1431,9,1,30,49
1,1664,1704,-40,2,39,93
1,1787,1662,125,-6,-157,49
-1,1511,1375,136,-7,-221,62
-1,1604,1694,-90,-3,-179,86
1,1834,1500,334,19,452,41
-1,1414,1536,-122,0,-180,78
1,1900,1825,75,5,119,47
-1,1654,1794,-140,-3,-65,76
-1,1503,1559,-56,3,6,90
-1,1306,1500,-194,-11,-500,72
-1,1712,1751,-39,-1,-434,124
-1,1219,1616,-397,-4,-673,100
-1,1400,1544,-144,-1,-74,56
-1,1801,1647,154,-4,-122,68
-1,1405,1488,-83,1,128,72
1,1595,1878,-283,3,292,83
1,1712,1702,10,2,84,63
1,1867,1748,119,4,164,73
-1,1388,1551,-163,-8,-120,56
1,1438,1292,146,-4,-140,51
-1,1446,1518,-72,0,-229,112
1,1910,1615,295,0,19,49
1,1943,1519,424,-6,178,76
-1,1835,1791,44,-2,-123,78
-1,1482,1558,-76,-9,-255,152
-1,1283,1389,-106,2,71,52
1,1892,1733,159,-4,-182,89
1,1945,1818,127,1,201,77
1,1913,1749,164,1,47,51
1,1727,1899,-172,7,801,119
-1,1650,1696,-46,-2,-12,44
0,1526,1555,-29,0,22,155
1,1882,1743,139,3,81,131
1,1690,1706,-16,-3,26,103
-1,1811,1955,-144,0,-222,118
0,1474,1302,172,-1,-55,113
-1,1736,1889,-153,-2,-76,44
1,1729,1760,-31,1,66,69
1,1889,1736,153,-8,-177,67
1,1509,1407,102,0,102,63
-1,1741,1875,-134,0,-280,114
1,1701,1804,-103,3,187,99
-1,1729,1896,-167,0,21,74
1,1964,1694,270,1,39,47
-1,1723,1902,-179,4,178,68
-1,1313,1339,-26,0,5,58
1,1909,1717,192,0,1,57
1,1469,1517,-48,2,469,117
1,1909,1717,192,-1,63,67
-1,1717,1909,-192,-1,-53,90
1,1922,1704,218,1,97,71
0,1865,1707,158,-2,-66,74
1,1302,1401,-99,-1,-520,131
-1,1482,1504,-22,1,-147,110
-1,1711,1914,-203,3,-71,134
-1,1712,1748,-36,-1,-140,66
1,1914,1711,203,-1,-277,105
1,1730,1455,275,6,53,43
1,1450,1296,154,4,67,91
1,1600,1496,104,2,133,63
-1,1778,1920,-142,-4,-46,46
1,1920,1778,142,5,318,79
-1,1243,1430,-187,0,-71,72
-1,1770,1927,-157,0,-50,66
-1,1542,1673,-131,-10,-149,46
1,1729,1406,323,4,67,47
1,1934,1624,310,6,114,47
-1,1236,1436,-200,-14,-851,70
-1,1696,1699,-3,-2,-108,62
1,1664,1715,-51,-3,-19,43
1,1335,1349,-14,-1,-80,69
-1,1500,1395,105,-1,-121,54
1,1733,1403,330,0,31,59
-1,1715,1664,51,0,107,102
-1,1230,1519,-289,-5,-181,60
-1,1677,1703,-26,-7,-239,64
-1,1713,1666,47,1,-31,48
0,1895,1937,-42,-4,-222,172
-1,1415,1410,5,-1,-100,90
-1,1458,1542,-84,1,-85,82
1,1666,1713,-47,2,-8,75
-1,1400,1736,-336,-5,-110,42
-1,1936,1897,39,0,-53,70
1,1701,1679,22,-3,13,61
1,1337,1360,-23,6,69,44
1,1646,1748,-102,0,-28,65
-1,1909,1923,-14,-3,-26,46
-1,1934,1898,36,2,50,67
1,1669,1711,-42,-1,-27,89
1,1740,1396,344,3,3,45
-1,1029,1614,-585,-8,-115,40
1,1898,1934,-36,1,98,71
-1,1922,1911,11,6,117,48
-1,1781,1726,55,-1,-6,46
0,1670,1709,-39,0,-35,105
1,1583,1556,27,-3,-223,83
-1,1413,1667,-254,-4,-214,77
1,1922,1910,12,0,513,107
-1,1708,1672,36,-9,-205,66
-1,1121,1629,-508,-2,-197,68
-1,1638,1610,28,-5,-147,50
1,1899,1933,-34,-1,83,105
1,1650,1626,24,-7,-129,73
1,1717,1659,58,-1,-13,57
1,1921,1912,9,1,16,41
1,1336,1349,-13,0,50,63
1,1464,1537,-73,-3,30,131
-1,1458,1742,-284,-3,-77,56
1,1769,1818,-49,4,31,91
1,1901,1620,281,-3,-262,73
1,1656,1696,-40,6,217,73
-1,1754,1457,297,0,72,70
-1,1616,1905,-289,-1,107,104
1,1754,1450,304,-1,17,69
1,1546,1599,-53,-1,73,95
1,1684,1669,15,0,19,87
1,1908,1611,297,1,66,85
1,1735,1441,294,4,94,41
1,1567,1481,86,0,-79,67
1,1899,1438,461,6,258,59
-1,1615,1800,-185,-8,-153,56
1,1912,1607,305,-3,-3,41
-1,2011,2215,-204,1,38,48
1,1567,1289,278,3,65,43
-1,1901,1694,207,11,433,92
-1,1337,1358,-21,-1,-126,70
1,1671,1408,263,-1,-98,121
1,1523,1477,46,6,270,73
-1,1893,2224,-331,-1,-88,96
-1,1576,1609,-33,0,-157,68
1,1711,1603,108,1,27,55
1,1638,1625,13,1,88,69
1,1901,1687,214,0,0,47
1,1607,1912,-305,0,210,65
0,2229,1889,340,0,-326,127
1,1804,1782,22,3,169,93
1,1620,1565,55,-5,131,73
1,2215,1483,732,2,22,51
-1,1718,1898,-180,-10,-132,80
-1,1766,1417,349,0,211,68
1,1468,1559,-91,0,-5,41
-1,1482,2216,-734,-1,-42,46
1,1712,1712,0,0,-37,63
1,1531,1428,103,0,-38,145
-1,1571,1619,-48,0,20,60
-1,1533,1630,-97,-8,-78,52
0,2217,1482,735,1,334,133
1,1723,1701,22,0,-51,61
-1,1432,1726,-294,-1,-79,88
1,1346,1560,-214,-1,-70,77
1,1660,1533,127,-4,-84,47
-1,1713,1707,6,-12,-282,66
-1,1942,1949,-7,0,-20,76
-1,1496,1573,-77,-1,-649,116
1,1527,1707,-180,9,672,81
1,1618,1544,74,0,-22,85
-1,1597,1893,-296,-1,-101,90
1,1924,1823,101,-1,4,47
1,1481,1358,123,4,194,69
-1,1322,1500,-178,3,143,92
1,1696,1360,336,0,92,73
1,1514,1574,-60,-1,-2,49
0,2071,2106,-35,-4,-444,147
1,1937,1798,139,0,-8,53
1,1669,1782,-113,-1,-12,67
-1,1629,1545,84,0,33,70
-1,1473,1553,-80,-10,-339,56
1,1690,1457,233,-4,28,61
0,1484,1513,-29,3,247,83
1,1932,1814,118,0,1,61
-1,1519,1677,-158,5,244,106
-1,1537,1567,-30,-5,-592,108
-1,1962,1960,2,0,297,130
1,1734,1709,25,2,88,77
-1,1736,1568,168,-6,-120,42
-1,1767,1835,-68,0,-44,70
1,1718,1702,16,0,38,45
0,1428,1542,-114,-1,-15,95
-1,1374,1523,-149,-2,-130,66
-1,1440,1606,-166,4,109,78
-1,1574,1507,67,2,-307,76
-1,1322,1342,-20,-6,-601,82
1,1849,1589,260,-1,104,101
-1,1587,1807,-220,0,-55,118
1,1307,1310,-3,5,312,93
1,1488,1438,50,9,398,67
1,1393,1520,-127,1,123,91
1,1758,1525,233,0,-33,55
-1,1778,1843,-65,0,-241,132
-1,2105,2072,33,-1,-52,66
-1,1331,1549,-218,2,102,56
-1,1530,1562,-32,2,-97,84
1,1786,1582,204,1,158,47
-1,1565,1466,99,-1,-222,114
-1,1957,1797,160,-1,-2,40
1,1797,1957,-160,0,2,41
1,1943,1957,-14,0,-92,81
-1,1674,1734,-60,2,141,150
-1,1791,1572,219,-5,-157,62
1,1763,1468,295,2,198,71
-1,1327,1500,-173,-4,-159,70
1,1389,1482,-93,6,109,45
-1,1589,1745,-156,0,-103,72
-1,1406,1732,-326,-2,-101,57
-1,1813,1865,-52,0,0,42
-1,1451,1904,-453,-1,-47,54
1,1774,1589,185,1,24,65
-1,1875,1804,71,0,-1,72
1,1671,1432,239,0,56,57
1,1579,1583,-4,1,174,79
-1,1945,1955,-10,0,94,84
1,1445,1599,-154,5,200,51
-1,1760,1783,-23,-5,-789,134
-1,1584,1780,-196,-5,-592,106
1,1887,1733,154,-2,53,43
1,1871,1807,64,3,62,49
-1,1505,1409,96,3,-156,98
1,2086,1818,268,4,135,55
1,1653,1451,202,0,92,57
1,1939,1828,111,0,48,53
1,1593,1612,-19,0,-7,45
1,1578,1519,59,-7,233,109
1,1901,1721,180,-2,-24,45
-1,1785,1880,-95,-7,-674,90
-1,1727,1894,-167,-2,-50,52
1,1453,1489,-36,1,25,42
1,1933,1744,189,0,215,103
1,1651,1759,-108,0,71,75
-1,1908,1715,193,1,40,58
1,1652,1353,299,10,230,47
-1,1558,1560,-2,-3,-61,48
1,1965,1724,241,1,18,75
1,1889,1731,158,-1,162,67
1,1508,1587,-79,0,186,87
-1,1947,1820,127,0,16,74
1,1580,1521,59,-6,-93,43
1,1476,1466,10,-10,62,89
-1,1418,1645,-227,0,-161,102
0,1346,1429,-83,1,379,121
1,1903,1719,184,-2,17,94
1,1678,1427,251,3,191,85
1,1360,1219,141,7,425,81
1,1736,1719,17,-1,-7,51
-1,1455,1487,-32,1,-109,122
1,1545,1700,-155,-3,-7,41
1,1979,2091,-112,-2,277,133
1,1326,1317,9,5,176,51
1,1658,1607,51,1,41,65
-1,1461,1547,-86,-7,-19,53
-1,1733,1837,-104,-2,-246,80
1,1822,1756,66,-1,-21,45
-1,1666,2125,-459,-2,-523,124
-1,1584,1601,-17,3,38,42
-1,1722,1811,-89,-1,-30,44
-1,1844,1725,119,0,-153,124
-1,1419,1908,-489,-7,-561,88
-1,1726,1929,-203,-5,-208,66
1,1819,1714,105,-2,297,73
1,1939,1351,588,3,166,51
1,1591,1656,-65,1,84,87
-1,1598,1503,95,-2,161,44
1,2127,1664,463,5,21,41
1,1684,1597,87,0,-8,99
-1,1706,1827,-121,2,78,50
-1,1795,1812,-17,-3,-185,62
1,1444,1367,77,1,29,95
-1,1483,1800,-317,3,208,100
-1,1350,1497,-147,-1,-833,126
1,1819,1714,105,1,39,61
1,1740,1830,-90,5,254,67
1,2148,1710,438,1,297,113
1,1856,1410,446,-12,-158,119
-1,1825,1708,117,-3,-416,110
1,1611,1573,38,-5,-127,49
-1,1349,1539,-190,-3,-42,54
0,1827,1706,121,-1,-20,207
-1,1539,1742,-203,-1,-71,59
1,1817,1754,63,1,-67,71
-1,1378,1588,-210,-9,-474,82
-1,1683,1561,122,-2,36,106
-1,1660,1683,-23,1,-555,134
1,1808,1872,-64,3,244,53
1,1451,1636,-185,3,461,127
-1,1798,1824,-26,0,5,72
1,1585,1648,-63,1,4,69
-1,1517,1584,-67,-1,123,88
1,1833,1788,45,-1,-10,41
-1,1349,1342,7,0,-159,152
1,1395,1366,29,-3,-212,87
1,1778,1843,-65,-3,172,145
-1,1593,1372,221,-3,-50,40
1,1513,1485,28,1,-17,53
1,1458,1384,74,4,390,99
1,1338,1883,-545,-2,-53,41
1,1572,1759,-187,0,23,43
1,1574,1510,64,4,118,47
-1,1710,1753,-43,6,345,94
-1,1498,1696,-198,-3,-73,46
1,1830,1791,39,-1,62,85
1,1748,1534,214,1,85,113
-1,1702,1748,-46,-6,-68,48
-1,1608,1576,32,-2,-393,220
1,1648,1763,-115,10,634,87
1,1781,1840,-59,0,-1,49
1,1309,1450,-141,3,153,82
1,1745,1575,170,-1,164,77
-1,1407,1561,-154,-1,-303,96
-1,1506,1595,-89,0,76,98
1,1784,1837,-53,0,41,123
-1,1745,1603,142,-2,-65,48
-1,1583,1700,-117,-20,-519,60
1,1589,1510,79,-2,271,71
-1,1662,1708,-46,-1,-38,52
1,1825,1748,77,4,98,51
1,1834,1821,13,5,92,43
1,1399,1101,298,-2,-47,41
-1,1568,1751,-183,1,-104,66
-1,1411,1306,105,-1,-392,88
1,1593,1508,85,0,243,107
-1,1437,1558,-121,-1,-91,54
-1,1740,1833,-93,-2,-153,102
1,1861,1361,500,2,164,67
-1,1656,1714,-58,0,12,54
1,1941,1772,169,1,17,109
-1,1288,1406,-118,-1,-36,106
1,1841,1732,109,0,28,59
-1,1527,1538,-11,0,-64,82
-1,1498,1604,-106,-1,-437,122
1,1658,1723,-65,-4,-529,131
-1,1692,1607,85,5,113,72
1,1756,1562,194,1,144,100
-1,1523,1439,84,1,11,47
0,1749,1881,-132,0,-7,97
1,1566,1430,136,1,73,61
1,1355,1331,24,-2,359,115
1,1443,1334,109,0,339,105
1,1403,1463,-60,-7,-361,87
-1,1671,1380,291,-8,-733,94
1,1507,1652,-145,-1,-5,47
0,1612,1467,145,3,790,163
1,1463,1466,-3,0,96,81
-1,1556,1548,8,-1,-76,58
1,1613,1446,167,-1,16,71
1,1601,1323,278,2,104,59
-1,1737,1855,-118,0,5,48
1,1815,1762,53,1,14,55
1,1395,1359,36,0,423,87
1,1862,1730,132,-4,-28,101
-1,1597,1663,-66,-3,-117,56
-1,1518,1655,-137,3,90,68
-1,1588,1909,-321,-1,-33,40
-1,1622,1559,63,0,-58,62
1,1636,1550,86,0,162,83
0,1606,1493,113,-4,-14,194
1,1769,1336,433,11,150,43
1,1722,1869,-147,1,45,71
-1,1404,1360,44,-2,-112,74
-1,1568,1452,116,0,35,102
1,1418,1500,-82,-8,-5,63
-1,1533,1608,-75,-3,-222,72
1,1294,1205,89,0,3,51
1,1325,1452,-127,-1,-231,123
1,1854,1738,116,0,13,49
1,1616,1523,93,5,254,61
1,1489,1319,170,-2,488,115
1,1643,1575,68,-1,-14,53
-1,1200,1644,-444,-13,-372,46
-1,1315,1366,-51,-7,-475,72
1,1572,1608,-36,-1,-143,75
1,1500,1636,-136,0,73,103
-1,1696,1782,-86,-3,-105,72
-1,1679,1735,-56,-3,-201,74
1,1753,1444,309,4,88,53
-1,1438,1646,-208,0,-141,61
-1,1295,1419,-124,-8,-88,58
-1,1541,1645,-104,-1,-105,76
-1,1626,1402,224,-2,-53,54
1,1531,1313,218,1,272,91
1,1652,1432,220,2,94,59
-1,1596,1589,7,5,-252,100
-1,1662,1566,96,-1,-200,86
1,1659,1440,219,-3,-61,43
1,1766,1477,289,1,409,77
-1,1528,1760,-232,-1,-119,68
1,1587,1595,-8,-3,-45,89
0,1295,1536,-241,-4,-4,110
1,1454,1353,101,11,393,49
1,1377,1301,76,-1,95,67
-1,1580,1648,-68,3,80,44
-1,1501,1545,-44,0,-815,132
1,1584,1487,97,2,65,49
1,1605,1537,68,8,245,48
0,1657,1571,86,-4,-258,75
1,1770,1609,161,1,288,67
-1,1329,1340,-11,-4,-158,56
1,1607,1181,426,9,168,43
1,1617,1342,275,1,373,81
-1,1668,1482,186,-3,-511,130
-1,1536,1703,-167,0,-46,86
-1,1916,1900,16,-1,118,128
1,1617,1474,143,8,252,55
-1,1574,1654,-80,0,9,80
1,1589,1829,-240,2,117,51
-1,1356,1317,39,6,330,88
1,1733,1592,141,0,56,101
1,1611,1575,36,0,217,136
1,1601,1777,-176,0,-33,61
1,1903,1912,-9,5,541,93
1,1445,1224,221,1,220,77
-1,1178,1616,-438,-5,-116,44
0,1585,1476,109,1,133,120
1,1717,1286,431,0,-12,47
-1,1652,1916,-264,-1,8,64
-1,1662,1565,97,-7,-235,50
1,1952,1338,614,-2,129,109
-1,1579,1649,-70,-2,-12,42
1,1310,1491,-181,6,621,119
-1,1740,1620,120,-3,-50,46
1,1920,1496,424,1,11,49
1,1791,1194,597,10,239,44
1,1197,1471,-274,4,258,87
-1,1760,1756,4,2,42,56
-1,1176,1528,-352,-5,-117,80
1,1577,1765,-188,1,27,47
1,1667,1607,60,-2,-41,47
-1,1493,1922,-429,-2,-218,88
-1,1555,1597,-42,-3,-249,90
1,1622,1657,-35,-2,-46,65
-1,1216,1450,-234,-4,-118,98
1,1515,1370,145,-4,-85,125
-1,1726,1635,91,-1,-101,100
1,1924,1491,433,0,-91,83
1,1273,1368,-95,-1,-107,65
1,1791,1495,296,2,180,79
1,1767,1748,19,3,62,57
1,1455,1300,155,6,242,77
-1,1466,1624,-158,-3,-294,90
1,1876,1862,14,-1,62,117
-1,1191,1279,-88,3,-203,84
1,1566,1496,70,1,388,127
-1,1480,1582,-102,-3,-142,74
1,1268,1461,-193,3,282,83
0,1712,1644,68,-6,-751,145
1,1688,1633,55,0,2,67
1,1795,1554,241,-1,63,89
-1,1137,1446,-309,-6,-169,92
-1,1635,1584,51,0,3,52
1,1531,1172,359,0,4,53
1,1553,1609,-56,0,-66,93
1,1445,1342,103,5,38,41
1,1453,1463,-10,3,185,71
-1,1953,1442,511,-8,27,60
-1,1647,1710,-63,-2,-115,64
1,1596,1622,-26,-3,-15,41
-1,1387,1500,-113,-2,-56,52
1,1642,1748,-106,0,12,91
-1,1354,1595,-241,1,3,74
-1,1363,1522,-159,-7,-216,60
1,1415,1507,-92,-1,-26,43
-1,1574,1452,122,-2,-389,106
-1,1168,1534,-366,1,83,58
1,1590,1472,118,0,409,111
-1,1719,1831,-112,-1,-161,86
1,1630,1459,171,4,144,61
-1,1462,1363,99,-2,-326,56
1,1794,1668,126,4,94,43
1,1494,1357,137,1,59,51
1,1533,1000,533,1,999,95
1,1162,1384,-222,6,353,51
1,1839,1712,127,0,23,95
1,1900,1608,292,2,35,95
1,1380,1292,88,-3,-103,59
1,1500,1661,-161,-1,10,89
1,1583,1801,-218,1,38,89
1,1772,1600,172,1,17,41
1,1413,1398,15,7,146,53
-1,1324,1413,-89,-3,-238,70
-1,1601,1907,-306,4,27,42
1,1378,1444,-66,1,397,107
1,1911,1597,314,3,923,113
-1,1597,1911,-314,0,-10,40
-1,1464,1598,-134,0,-55,86
1,1524,1551,-27,0,64,79
1,1705,1701,4,0,-1,57
-1,1914,1594,320,5,62,52
1,1914,1594,320,1,108,91
-1,1709,1856,-147,0,-96,118
1,1450,1087,363,5,243,53
1,1324,1421,-97,1,-694,121
-1,1686,1715,-29,-5,-112,54
1,1708,1926,-218,1,-14,55
1,1897,1611,286,1,69,59
-1,1107,1671,-564,-6,-113,53
-1,1703,1637,66,1,7,106
-1,1351,1605,-254,0,-2,86
-1,1607,1726,-119,0,5,66
1,1680,1458,222,1,346,129
1,1573,1733,-160,-1,-42,57
-1,1328,1307,21,-3,-107,50
1,1617,1592,25,-1,11,61
1,1734,1599,135,1,97,61
1,1389,1309,80,2,202,59
-1,1392,1560,-168,-2,-571,134
-1,1475,1552,-77,7,168,76
-1,1093,1523,-430,1,26,50
1,1540,1500,40,3,72,41
1,1592,1741,-149,1,49,69
1,1686,1512,174,15,1268,113
-1,1290,1428,-138,-10,-471,68
-1,1627,1673,-46,-1,5,48
1,1901,1608,293,2,124,43
-1,1083,1320,-237,-6,-341,64
0,1547,1685,-138,-2,1,138
-1,1609,1449,160,-2,60,48
1,1536,1495,41,0,18,135
-1,1488,1435,53,-2,-239,66
1,1816,1376,440,0,20,73
-1,1604,1905,-301,-3,-132,48
1,1797,1346,451,-1,-5,47
-1,1696,1818,-122,6,230,70
-1,1665,1381,284,-3,-92,54
1,1344,1216,128,0,-27,55
-1,1834,1730,104,-3,-533,122
-1,1917,1791,126,0,-37,54
-1,1624,1525,99,-4,-59,44
-1,1688,1600,88,-12,-386,58
-1,1352,1342,10,-3,-15,42
0,1805,1901,-96,-1,445,150
-1,1455,1427,28,-8,-185,52
1,1405,1340,65,5,57,51
-1,1551,1801,-250,1,-123,100
1,1673,1376,297,5,108,49
1,1898,1808,90,-5,693,177
-1,1805,1744,61,-4,-258,67
1,1675,1601,74,2,9,55
-1,1534,1479,55,-5,-198,68
1,1679,1929,-250,0,76,79
1,1593,1813,-220,0,0,71
-1,1500,1416,84,-3,-707,122
-1,1466,1539,-73,-1,-52,66
-1,1731,1593,138,2,69,62
1,1546,1578,-32,0,-21,61
-1,1327,1908,-581,-5,-38,42
1,1698,1428,270,1,60,65
1,1428,1454,-26,5,195,63
-1,1780,1757,23,-2,-345,111
0,1909,1702,207,-3,-12,116
1,1649,1396,253,5,99,43
-1,1492,1562,-70,-3,-124,70
-1,1328,1386,-58,1,-154,74
-1,1557,1704,-147,0,-385,122
1,1902,1708,194,2,56,67
1,1611,1520,91,-2,483,89
1,1608,1654,-46,-8,-198,59
1,1551,1483,68,-2,-144,85
1,1448,1475,-27,-2,141,61
1,1523,1615,-92,4,118,65
1,1621,1773,-152,6,328,67
1,1389,1092,297,6,332,81
-1,1437,1549,-112,1,-39,80
1,1702,1974,-272,1,-51,139
-1,1457,1571,-114,3,218,104
1,1633,1608,25,1,2,61
1,1796,1809,-13,4,25,47
-1,998,1460,-462,-2,-213,68
-1,1395,1492,-97,-7,-427,72
-1,1719,1768,-49,4,83,44
1,1560,1399,161,0,134,141
-1,1915,1909,6,-8,-357,63
1,1941,1702,239,-1,45,113
1,1635,1794,-159,0,-36,99
1,1922,1903,19,3,489,105
1,1449,1326,123,-1,-41,61
-1,1509,1756,-247,-1,-185,95
-1,1893,1934,-41,-2,-117,64
-1,1619,1500,119,-8,-372,78
-1,1945,1883,62,2,112,78
1,1557,1427,130,0,-349,107
1,1462,1460,2,0,158,71
-1,1475,1383,92,1,118,82
-1,1610,1502,108,-5,-28,44
-1,1808,1890,-82,-2,-111,62
-1,1449,1546,-97,1,8,62
1,1500,1651,-151,-1,-38,69
-1,1724,1882,-158,-1,-439,182
1,1359,1299,60,11,467,60
1,1882,1724,158,1,246,107
1,1641,1802,-161,4,69,53
-1,1481,1665,-184,-2,-83,82
-1,1709,1574,135,1,-241,122
1,1718,1888,-170,3,26,43
1,1595,1441,154,1,311,119
-1,1661,1654,7,2,25,74
1,1872,1733,139,-4,2,55
-1,1697,1945,-248,0,159,152
0,1548,1665,-117,-1,189,80
1,1500,1504,-4,-4,-429,91
-1,1727,1879,-152,0,294,94
-1,1382,1812,-430,0,61,94
1,1902,1799,103,7,119,43
-1,1593,1693,-100,-1,-35,68
-1,1496,1677,-181,0,220,88
-1,1672,1812,-140,-3,-49,48
-1,1485,1640,-155,-1,-101,70
1,1886,1720,166,0,-3,49
-1,1312,1559,-247,-3,-429,116
-1,1418,1564,-146,-4,-210,58
0,1449,1474,-25,-5,-317,154
-1,1291,1270,21,-7,-21,44
-1,1378,1649,-271,-3,-89,62
1,1714,1892,-178,-3,56,71
1,1702,1583,119,1,100,69
-1,1744,1491,253,-4,-47,48
1,1706,1261,445,6,89,45
1,1876,1730,146,-7,-819,117
1,1671,1577,94,-5,-276,101
1,1661,1552,109,-3,1005,145
-1,1574,1709,-135,-6,-204,62
-1,1723,1882,-159,2,-7,78
-1,1516,1679,-163,-3,-43,42
1,1516,1679,-163,1,2,59
1,1653,1373,280,3,210,57
-1,1889,1717,172,0,-285,84
1,1685,1615,70,13,157,47
-1,1717,1888,-171,-1,-115,90
-1,1568,1694,-126,-6,-274,72
-1,1246,1712,-466,-2,-347,68
-1,1733,1873,-140,-1,-271,122
1,1701,1534,167,11,119,49
1,1817,1680,137,0,392,95
1,1602,1678,-76,1,43,49
-1,1508,1707,-199,1,24,104
0,1206,1258,-52,-3,-12,80
-1,1880,1726,154,0,-212,76
1,1474,1500,-26,8,340,71
1,1566,1500,66,6,64,41
-1,1670,1838,-168,-2,-28,44
-1,1391,1554,-163,-3,-66,92
-1,1710,1646,64,-1,-28,48
1,1470,1717,-247,3,-2,64
-1,1674,1907,-233,-1,-41,54
-1,1461,1579,-118,-6,-122,56
-1,1369,1563,-194,-1,-87,60
1,1512,1433,79,0,60,54
1,1697,1819,-122,0,107,56
1,1766,1814,-48,2,511,179
1,1669,1648,21,-1,50,65
1,1650,1665,-15,1,95,99
1,1614,1425,189,3,36,41
1,1500,1461,39,3,177,78
-1,1602,1657,-55,-1,-109,94
1,2037,1888,149,1,222,111
-1,1356,1319,37,-2,-366,84
-1,1741,1615,126,0,-53,88
-1,1586,1923,-337,-3,-299,86
-1,1309,1639,-330,-9,-3,86
-1,1698,1617,81,-1,1,74
1,1542,1499,43,-4,-99,51
1,1447,1340,107,4,139,51
-1,1948,1821,127,0,-107,142
-1,1775,1936,-161,0,15,54
1,1670,1339,331,0,0,47
1,1619,1655,-36,0,136,85
1,1642,1306,336,15,714,69
1,1548,1771,-223,0,13,59
-1,1630,1570,60,-1,-31,49
-1,1285,1797,-512,-2,-39,52
1,1980,1986,-6,1,35,51
-1,1120,1359,-239,-6,-258,70
1,1593,1230,363,3,102,41
1,1631,1684,-53,11,274,77
1,1930,1795,135,2,165,98
0,1712,1764,-52,0,-407,155
1,1801,1626,175,1,439,120
-1,1499,1418,81,-1,-1087,142
1,1385,1133,252,0,242,87
-1,1303,1645,-342,-3,-52,46
-1,1436,1382,54,-5,-534,89
1,1845,1721,124,3,49,47
-1,1498,1617,-119,-5,-94,60
1,1416,1280,136,8,593,83
1,1975,1991,-16,1,45,61
1,1648,1299,349,0,-9,95
-1,1631,1726,-95,2,116,87
-1,1671,1643,28,-3,-244,106
-1,1596,2179,-583,0,-114,72
1,1677,1332,345,0,2,59
-1,1360,1163,197,-5,-91,50
1,1857,1355,502,4,86,51
1,1726,1597,129,0,28,57
-1,1441,1639,-198,-1,-21,64
-1,1579,1742,-163,0,-82,84
1,1296,1651,-355,5,721,113
-1,1555,1542,13,1,-46,67
1,1458,1134,324,6,913,101
-1,1434,1523,-89,-8,-184,64
-1,1490,1624,-134,-1,6,88
1,1419,1284,135,-1,61,57
1,1840,1986,-146,-3,231,141
-1,1531,1713,-182,4,90,62
-1,1353,1858,-505,0,-2,60
1,1451,1526,-75,6,423,95
1,1630,1319,311,1,120,67
-1,1702,1724,-22,0,-32,70
-1,1423,1413,10,-4,-740,106
1,1640,1215,425,10,126,41
1,1785,1756,29,-2,17,123
1,1719,1525,194,-3,-150,71
-1,1329,1681,-352,-9,-95,84
-1,1344,1326,18,-1,-10,62
-1,1128,1389,-261,-3,-469,108
-1,1454,1410,44,1,24,50
-1,1521,2118,-597,0,-1,64
-1,1634,1753,-119,0,-47,108
-1,1364,1442,-78,-1,-245,126
-1,1523,1495,28,-5,-110,56
1,1854,1891,-37,2,156,90
-1,1622,1827,-205,-3,-165,60
1,1563,1520,43,-7,-33,51
1,1936,2108,-172,-1,-6,87
-1,1963,2119,-156,0,42,90
-1,1724,1836,-112,1,-52,76
1,1838,1840,-2,0,-10,65
-1,1631,1789,-158,-6,-342,68
1,1798,1570,228,2,147,109
0,2128,1956,172,0,-184,86
1,1510,1573,-63,12,413,53
-1,1419,1573,-154,-1,-6,48
-1,1788,1937,-149,-3,-212,98
-1,1270,1652,-382,1,-25,60
1,1702,1763,-61,3,8,41
-1,1625,1708,-83,0,-46,60
1,1560,1523,37,0,-15,51
1,1115,1165,-50,3,576,82
-1,1734,1500,234,0,-202,148
-1,1513,1570,-57,6,74,78
-1,1810,1577,233,-3,-52,40
-1,1616,1717,-101,-3,-92,60
1,1424,1565,-141,7,1124,93
1,1470,1356,114,2,329,79
-1,1465,1659,-194,0,-619,142
1,1792,1598,194,1,529,99
-1,1507,1511,-4,-2,-142,58
-1,1961,2121,-160,0,-74,90
1,1579,1504,75,3,845,127
1,1750,1715,35,2,5,43
1,1746,1796,-50,-1,-3,41
-1,1798,1591,207,0,111,58
-1,1617,1734,-117,-3,-27,48
1,1608,1501,107,3,341,87
1,1294,1343,-49,-2,-58,47
-1,1379,1465,-86,-3,-98,70
-1,1413,1393,20,0,80,106
0,1847,1714,133,-4,-195,97
1,2144,2122,22,-1,93,87
1,2046,1611,435,-3,23,66
-1,1814,1980,-166,-12,-104,52
1,1971,1844,127,1,37,53
-1,1609,2048,-439,0,-50,67
1,1587,1461,126,8,244,53
1,1796,1852,-56,2,125,69
1,1705,1760,-55,2,81,59
-1,1781,1761,20,-1,-65,84
1,2110,2156,-46,6,224,73
-1,2050,1607,443,0,19,68
-1,1392,1586,-194,1,-33,48
-1,1588,1927,-339,-1,-79,56
-1,1554,1594,-40,-6,-93,40
-1,1572,1900,-328,-2,-27,42
1,1576,1603,-27,2,148,85
-1,1452,1595,-143,-1,77,118
-1,1986,2089,-103,-2,179,88
-1,2024,2141,-117,-3,-48,54
1,1769,1645,124,7,768,101
1,1658,1577,81,5,147,53
1,1635,1413,222,1,283,67
-1,1837,1978,-141,-2,-41,60
1,1439,1560,-121,4,4,41
1,2150,2014,136,0,15,83
1,1777,1637,140,5,531,81
-1,1494,1456,38,0,10,46
-1,1620,1665,-45,0,-365,106
1,1648,1530,118,-1,-51,77
-1,2005,2159,-154,-4,-259,68
-1,1469,1629,-160,0,14,58
1,1601,1444,157,-5,-174,53
-1,1784,1697,87,-9,-213,52
1,1324,1170,154,-2,69,91
1,1944,1782,162,0,-11,53
1,2059,2098,-39,-1,-26,77
1,1641,1498,143,-3,94,79
1,2166,1997,169,-5,-41,73
-1,1730,1542,188,3,327,84
0,1867,1616,251,2,49,69
1,1713,1636,77,1,239,115
-1,1500,1643,-143,0,-78,100
1,1437,1608,-171,6,460,89
1,1985,1830,155,0,-2,73
-1,1347,1462,-115,-1,-46,68
1,1989,2174,-185,-5,-4,63
1,1545,1522,23,0,139,145
-1,1459,1434,25,-3,-367,100
-1,1684,1758,-74,0,7,130
-1,1659,1747,-88,3,-27,114
-1,1815,1622,193,1,48,66
0,1609,1511,98,0,-158,130
1,1405,1124,281,1,53,51
1,1517,1573,-56,9,956,97
1,1731,2009,-278,0,-28,57
1,1810,1596,214,0,173,63
1,1592,1455,137,-8,-114,57
1,1921,2124,-203,2,36,85
1,1461,1377,84,4,157,75
1,1893,1769,124,-2,40,79
1,1751,1618,133,0,-51,59
1,1543,1580,-37,-1,176,65
-1,1775,1951,-176,-1,-35,54
1,1987,1531,456,2,7,41
1,1355,1299,56,4,250,87
-1,1823,1991,-168,0,-8,74
-1,2105,1989,116,-1,-124,72
1,1837,1930,-93,-2,65,109
-1,1643,1718,-75,2,200,150
-1,1759,1939,-180,8,101,48
-1,1330,1394,-64,-9,-161,51
1,1447,1599,-152,3,304,69
1,1511,1361,150,1,484,103
-1,1120,1409,-289,-6,-156,52
1,1606,1465,141,5,714,103
1,2007,2089,-82,1,82,55
-1,1925,1945,-20,-3,-35,42
-1,1523,1656,-133,-4,-481,134
-1,1483,1461,22,-10,-210,50
-1,1956,1910,46,-9,-757,122
1,2074,1761,313,0,-21,79
1,1462,1276,186,2,11,41
-1,1639,1799,-160,-6,-153,58
-1,1657,1382,275,-1,-18,98
-1,1643,1764,-121,-5,19,120
-1,1717,1783,-66,-2,-109,96
-1,1321,1462,-141,-3,-409,108
1,1997,1817,180,1,44,63
1,1762,1487,275,0,65,63
-1,1153,1174,-21,-2,-813,146
-1,1721,1819,-98,-1,-25,54
1,1928,1943,-15,4,154,71
1,1338,1445,-107,0,17,81
1,1779,1514,265,0,114,73
1,1544,1412,132,0,139,91
-1,1623,1859,-236,-3,-79,70
1,2081,1754,327,0,-72,95
-1,1569,1565,4,-2,-97,84
0,1673,1651,22,0,21,101
-1,1053,1252,-199,-1,21,108
1,1931,1944,-13,-1,30,47
1,1404,1514,-110,-6,-11,55
-1,1444,1606,-162,-8,-172,44
-1,1750,2085,-335,0,-122,86
-1,1471,1553,-82,0,-105,80
1,1567,1444,123,1,121,75
1,1928,1943,-15,-2,522,103
-1,1642,1520,122,0,-45,76
-1,1270,1116,154,-11,-205,78
1,1933,1792,141,1,20,53
-1,2012,2082,-70,-4,-707,100
-1,1510,1712,-202,1,3,52
-1,1324,1547,-223,-5,-443,72
1,1783,1592,191,0,10,69
1,2088,1747,341,0,-16,53
1,1674,1701,-27,0,-5,61
1,1815,1736,79,-4,-61,105
-1,1931,1943,-12,-4,-357,88
-1,1633,1957,-324,-4,-15,54
-1,1648,1497,151,2,101,83
-1,1744,2091,-347,0,-143,72
-1,1957,1920,37,-3,-29,50
-1,1480,1723,-243,-3,-24,60
0,1785,1940,-155,0,-115,116
1,1519,1613,-94,1,-5,41
1,1319,1469,-150,-1,-73,71
1,1585,1538,47,0,-71,97
1,2094,1741,353,0,49,59
-1,1382,1595,-213,-10,-57,42
1,1672,1722,-50,1,220,85
1,1955,1922,33,-2,-26,49
1,1689,1753,-64,-1,-15,45
-1,1738,2097,-359,-2,-100,62
1,1960,1630,330,1,31,51
-1,1686,1624,62,-3,-29,64
-1,1647,1574,73,-1,-378,100
-1,1418,1425,-7,0,2,72
1,1911,1967,-56,-2,34,141
1,1516,1364,152,5,234,77
1,1532,1481,51,6,652,93
1,1353,1517,-164,5,58,41
1,1455,1430,25,-1,-4,53
1,1735,2101,-366,0,-45,115
-1,1785,1827,-42,-2,-83,70
-1,1952,1924,28,0,-64,76
-1,1673,1739,-66,-1,2,78
1,1864,1618,246,-4,-83,43
1,1601,1609,-8,-3,93,131
-1,1618,1599,19,-1,-5,45
1,1679,1642,37,0,26,55
-1,1528,1485,43,-4,66,70
-1,1936,1938,-2,0,-36,80
-1,1955,2077,-122,1,29,44
-1,1935,1790,145,-1,-41,66
1,1412,1330,82,4,157,49
1,1624,1529,95,-2,-84,71
-1,1789,1632,157,-1,-2,48
1,2086,1947,139,2,25,43
-1,1497,1514,-17,-4,-530,80
-1,1620,1616,4,-5,-92,113
1,1951,1925,26,0,-89,79
1,1978,1665,313,0,-4,55
1,1692,1638,54,0,62,67
-1,1890,1963,-73,-1,6,66
1,1728,1471,257,-4,-23,97
-1,1447,1537,-90,-1,-240,102
1,1734,1594,140,1,150,75
-1,1631,1708,-77,0,-13,44
1,1353,1316,37,1,185,61
1,1708,1659,49,0,-7,49
1,1526,1487,39,3,416,75
-1,1837,1900,-63,0,-19,48
-1,1699,1561,138,0,26,44
-1,1774,1534,240,0,-5,54
1,1915,1681,234,-2,-166,83
-1,1805,1919,-114,-3,-551,124
-1,1297,1596,-299,-5,-158,53
-1,1477,1536,-59,-7,-296,68
1,1576,1682,-106,0,195,187
-1,1477,1348,129,-9,-280,66
-1,1369,1413,-44,-9,-697,126
-1,1614,1870,-256,1,-130,80
1,1569,1513,56,7,72,71
1,1727,1717,10,-2,0,79
1,1552,1754,-202,1,97,52
-1,2094,1941,153,-1,-151,110
-1,1799,1988,-189,0,-102,72
1,1589,1420,169,2,55,49
-1,1640,1541,99,1,-126,92
-1,1408,1442,-34,1,1,44
-1,1710,1909,-199,0,-85,63
-1,1409,1617,-208,-9,-82,48
1,1914,1746,168,1,10,75
-1,1572,1601,-29,-7,-14,44
-1,1736,1569,167,0,-11,60
-1,1500,1430,70,-3,-116,58
-1,1812,1912,-100,0,-63,156
-1,1914,1705,209,-3,-269,72
1,1792,1993,-201,0,9,117
1,1828,1631,197,-5,120,103
-1,1421,1813,-392,-3,-50,66
1,1684,1191,493,8,267,59
1,1667,1590,77,-2,331,131
-1,1663,1632,31,-6,-214,46
1,1546,1732,-186,0,179,109
-1,1742,2054,-312,0,-14,114
1,1622,1404,218,0,-70,87
-1,1701,1631,70,1,-9,56
-1,1351,1297,54,0,17,40
1,1685,1254,431,4,190,61
-1,1227,1583,-356,0,-226,82
-1,1968,1717,251,0,-183,70
1,1130,1133,-3,10,898,107
-1,1477,1254,223,0,-52,92
1,1623,1189,434,-3,-72,75
0,1972,2076,-104,0,-12,100
1,1525,1587,-62,0,284,101
1,1983,1897,86,0,2,73
-1,1253,1471,-218,0,26,56
1,1866,1628,238,-3,14,79
-1,1613,1555,58,-4,-328,84
1,1739,1973,-234,-1,27,69
-1,1420,1503,-83,1,39,52
-1,1732,1735,-3,-1,-54,80
-1,1437,1687,-250,0,-50,130
-1,1803,2012,-209,-2,-17,43
1,1920,1804,116,1,29,53
-1,1948,1804,144,1,-25,136
1,1445,1517,-72,-4,64,67
0,1895,1976,-81,1,403,142
1,1693,1512,181,2,151,63
1,1626,1594,32,-1,433,131
0,1956,2001,-45,0,7,79
1,1473,1461,12,0,114,75
1,1658,1474,184,10,476,63
-1,1224,1586,-362,0,-68,76
-1,2000,1957,43,1,-246,70
-1,1722,1980,-258,-2,-82,87
-1,1468,1664,-196,-7,-230,56
1,1718,1578,140,8,140,63
0,1746,1824,-78,-1,-321,133
1,1609,1806,-197,0,-83,85
-1,2011,1970,41,0,-412,106
0,1401,1522,-121,-1,12,127
-1,1931,2085,-154,-1,-194,74
1,1680,1617,63,1,31,51
-1,1499,1622,-123,-3,-53,62
1,2050,2072,-22,4,206,67
-1,1699,1351,348,1,19,54
-1,1178,0,1178,-8,-375,70
1,1534,1725,-191,0,169,79
1,1888,1760,128,-5,-23,53
1,1982,1997,-15,0,10,131
1,1522,1676,-154,2,80,111
0,2059,2062,-3,0,-61,112
-1,1503,1624,-121,1,28,58
1,1670,1462,208,-1,108,79
-1,1571,1726,-155,0,-79,60
-1,1399,1857,-458,-4,-89,44
0,1765,1467,298,3,176,142
1,1500,1532,-32,-9,-25,73
-1,1692,1505,187,0,-5,80
1,1984,1993,-9,0,8,45
1,2062,2059,3,3,140,67
1,1993,1984,9,-1,109,101
-1,1797,1867,-70,0,-2,44
1,1937,1991,-54,0,0,103
-1,2047,2073,-26,0,-16,84
1,1769,1954,-185,0,18,45
-1,1469,1665,-196,-3,37,88
-1,1972,1982,-10,-2,-225,76
1,1583,1357,226,-5,-140,53
1,1985,1953,32,0,6,99
1,1228,1237,-9,13,904,77
1,1606,1720,-114,2,44,53
-1,2083,2036,47,0,10,64
-1,1992,1960,32,-2,-357,124
1,1702,1651,51,-1,135,65
1,1496,1224,272,0,88,133
1,1221,1418,-197,-4,-71,87
0,1603,1628,-25,-2,-563,116
1,1453,1813,-360,-1,8,49
-1,2049,2071,-22,0,-28,98
1,1551,1721,-170,-2,59,87
1,1363,1520,-157,-1,44,55
1,1499,1585,-86,4,273,71
-1,1673,1463,210,-2,-78,66
1,1610,1878,-268,-3,301,121
1,1587,1574,13,0,48,55
-1,1979,2042,-63,-1,-85,72
1,1759,1627,132,0,78,57
-1,1836,1786,50,0,-274,112
1,1973,1588,385,7,461,65
1,1736,1669,67,-1,-45,79
1,1583,1307,276,2,134,59
-1,1955,1895,60,-1,-18,54
-1,1765,2038,-273,-3,19,48
1,2042,1761,281,5,181,57
1,1923,1592,331,-1,219,93
-1,1284,1327,-43,-12,-296,169
-1,1761,1647,114,2,66,76
-1,1657,1596,61,1,16,50
1,1978,1584,394,10,238,55
-1,1678,1523,155,0,-105,74
-1,1722,1529,193,-2,-46,42
1,1477,1722,-245,0,-23,87
-1,1757,2047,-290,-2,-11,66
1,1448,1563,-115,0,-2,43
1,2180,2081,99,0,44,76
-1,1460,1688,-228,-3,-396,78
-1,1581,1981,-400,-1,-311,74
-1,1586,1606,-20,2,59,88
-1,1710,2050,-340,-14,-244,62
1,1318,1360,-42,0,-3,47
1,1660,1671,-11,-1,382,141
-1,1641,1711,-70,4,32,114
1,1688,1623,65,-5,39,45
1,1747,1664,83,1,16,85
1,1542,1714,-172,0,25,71
1,2073,2192,-119,0,9,79
-1,1396,1476,-80,-2,33,92
-1,1500,1963,-463,2,52,58
-1,1579,1670,-91,-1,-453,148
-1,1240,1653,-413,-4,-205,70
-1,1707,1983,-276,2,-111,70
-1,1582,1609,-27,-1,-153,78
-1,1867,1996,-129,0,-41,74
1,1697,1613,84,0,-35,117
1,2171,2088,83,-1,-44,79
-1,1397,1812,-415,-5,-497,93
-1,1649,1627,22,-1,-22,56
1,1937,1696,241,1,203,117
1,1927,1644,283,0,-63,135
1,1652,1664,-12,2,289,143
1,1987,1702,285,3,165,85
1,1678,1570,108,-7,-33,119
-1,1698,1649,49,0,-10,62
1,1755,2183,-428,-4,-51,97
1,1965,2079,-114,-4,-62,57
-1,1447,1647,-200,-3,-202,58
-1,1463,1626,-163,-2,-114,68
-1,1698,1992,-294,0,-609,116
1,1973,1604,369,0,202,117
-1,1258,1803,-545,-1,-319,76
-1,1662,1771,-109,-6,-409,78
-1,1406,1500,-94,0,-60,64
-1,2065,1982,83,-3,149,70
-1,1276,1247,29,3,163,69
1,1638,1499,139,4,155,61
1,1693,1454,239,10,299,67
1,1996,1693,303,2,92,45
-1,1775,2154,-379,-8,-395,70
-1,1540,1618,-78,-2,-210,90
1,1753,1611,142,1,240,79
1,1640,1473,167,3,86,53
-1,1220,1703,-483,4,87,70
-1,0,1178,-1178,-3,-280,62
-1,1998,2051,-53,0,-93,66
-1,2000,1689,311,1,-46,120
1,1821,1860,-39,0,8,69
-1,1745,1821,-76,0,-427,106
-1,1604,1760,-156,-3,-449,90
1,1656,1651,5,0,206,95
-1,1937,2004,-67,-1,-73,76
1,1589,1657,-68,1,306,115
-1,1650,1576,74,-3,-76,70
-1,1486,1386,100,-2,-420,148
1,1767,1597,170,4,260,65
1,1931,1564,367,1,160,69
-1,1640,1721,-81,0,-573,228
-1,1438,1779,-341,-9,-196,54
-1,1591,1774,-183,4,-146,84
1,1721,1632,89,-6,-74,47
-1,1897,2157,-260,0,17,122
-1,1467,1646,-179,-3,-63,52
1,1716,1773,-57,0,-2,57
-1,1475,1645,-170,-1,-544,104
1,2069,2054,15,-2,-75,67
-1,1450,1697,-247,-17,-672,60
1,1561,1934,-373,0,124,119
-1,1474,1431,43,0,-7,50
-1,1847,1811,36,-1,-5,44
1,1456,1447,9,-6,9,51
1,1643,1604,39,-1,221,77
-1,1865,2080,-215,-1,-55,50
1,1606,1634,-28,4,322,81
1,1706,1893,-187,-3,104,113
1,2105,1898,207,0,167,75
0,1479,1663,-184,0,-59,123
-1,1562,1816,-254,0,-189,118
1,1613,1635,-22,0,-17,63
1,1668,1094,574,0,191,96
1,1696,1626,70,0,-21,53
1,1651,1468,183,9,229,49
-1,1970,1908,62,0,12,56
1,1593,1654,-61,1,152,107
-1,2085,1860,225,0,88,116
1,1634,1651,-17,3,361,99
0,1782,1435,347,0,8,143
0,1619,1574,45,-2,137,137
-1,1500,1824,-324,-10,-265,156
1,1631,1524,107,2,61,43
-1,1823,1835,-12,-1,-45,94
1,1704,1530,174,1,32,45
-1,1436,1462,-26,0,-34,68
-1,1957,1925,32,-3,-263,90
-1,1443,1332,111,-3,-122,58
-1,1860,1802,58,1,8,42
1,1976,1722,254,2,74,73
1,1467,1824,-357,0,15,49
-1,1878,2068,-190,-3,-95,54
-1,1470,1639,-169,0,-76,64
1,1639,1556,83,-3,219,87
-1,1729,1804,-75,-10,-505,76
1,2073,1872,201,1,97,81
1,1512,1483,29,-1,-28,69
-1,1780,1982,-202,-6,-55,50
-1,1598,1576,22,-1,-77,58
-1,1600,1586,14,3,11,46
1,1989,1774,215,1,206,159
-1,1416,1301,115,0,-79,114
-1,1773,2042,-269,0,-1,54
-1,1635,1407,228,0,-277,92
-1,1866,2079,-213,-6,-120,72
-1,1718,1617,101,0,3,58
-1,1463,1512,-49,0,0,64
1,1579,1309,270,-2,949,141
-1,1657,1607,50,0,57,108
1,2046,1769,277,0,25,47
1,1767,1711,56,0,61,117
0,1429,1347,82,0,555,153
1,1587,1256,331,0,386,95
-1,1347,1619,-272,-6,-66,48
1,1790,1846,-56,-1,71,96
1,1813,1418,395,-4,-104,56
-1,1380,1564,-184,0,-61,51
1,1322,1671,-349,0,33,72
-1,1741,1484,257,0,-23,44
1,1474,1459,15,0,191,81
-1,1564,1620,-56,-1,-35,55
1,2110,1840,270,1,134,67
1,1570,1824,-254,-4,285,123
-1,1851,1790,61,-8,-176,48
1,1885,1578,307,-1,9,63
1,1935,1887,48,0,84,113
1,1634,1584,50,-1,79,69
-1,1529,1475,54,5,44,46
1,1373,1260,113,1,457,133
1,1822,1595,227,4,182,61
-1,1654,1688,-34,0,-79,154
-1,1523,1457,66,-1,-111,66
1,1949,1898,51,-1,468,132
1,1768,1842,-74,3,142,55
-1,1714,1494,220,0,4,70
-1,1775,1874,-99,-1,-89,130
-1,1588,1973,-385,-1,-10,44
0,1611,1627,-16,2,93,95
1,1699,1563,136,-2,315,109
-1,2114,1797,317,-1,-161,76
1,1792,1784,8,0,-17,61
-1,1500,1438,62,-1,54,56
1,1747,1806,-59,0,4,45
-1,1968,1975,-7,1,11,108
1,1265,1405,-140,-3,88,77
-1,1749,1629,120,1,-695,218
1,2093,1826,267,0,30,79
1,1945,1613,332,-2,88,79
1,1833,1829,4,0,83,59
1,1570,1374,196,-1,68,53
-1,1986,1956,30,-9,-151,126
-1,1586,1730,-144,-4,-119,57
-1,1230,1434,-204,0,37,86
1,2098,1819,279,1,114,59
1,1907,1805,102,0,11,64
1,1666,1405,261,9,217,51
-1,1844,1794,50,0,10,54
1,1520,1475,45,1,47,53
0,1969,1974,-5,1,158,138
-1,1644,1613,31,-8,-620,84
1,1722,1381,341,1,232,129
1,1677,1684,-7,0,-37,59
-1,1831,1814,17,-8,-249,68
1,1534,1725,-191,0,15,49
-1,1622,1831,-209,-2,-97,64
0,1583,1487,96,0,-71,139
1,1974,1969,5,0,-67,41
1,1708,1552,156,1,277,99
-1,1506,1329,177,-2,24,82
-1,1519,1574,-55,0,-511,144
1,1830,1800,30,-1,14,47
-1,1575,1689,-114,-3,-97,74
-1,1589,1985,-396,-2,-86,60
1,1664,1422,242,0,100,82
1,1501,1553,-52,-1,-55,59
1,1610,1778,-168,4,53,45
1,1545,1714,-169,-1,1,47
-1,1878,1889,-11,-1,-79,79
1,1463,1310,153,1,219,74
-1,1774,1801,-27,0,-93,103
-1,1775,1844,-69,0,-119,82
-1,1747,1554,193,-1,-36,60
1,1987,2102,-115,-1,-40,61
1,1682,1577,105,-1,-2,61
-1,1392,1439,-47,-2,-73,86
-1,1758,1881,-123,0,-99,78
-1,2085,2002,83,1,-142,112
1,1510,1686,-176,2,-9,43
-1,1698,1626,72,1,28,146
1,1899,1867,32,-3,19,67
1,1713,1627,86,0,9,53
-1,1655,1586,69,0,33,72
-1,1490,1550,-60,-1,-274,98
-1,1339,1400,-61,-3,-313,76
1,2016,1754,262,1,52,55
1,1517,1772,-255,3,70,53
-1,2070,2173,-103,0,-123,58
1,2018,1587,431,-2,53,51
-1,1745,2020,-275,-1,-142,126
-1,2182,2061,121,0,-15,58
-1,1553,1433,120,2,64,46
1,1909,2086,-177,0,4,77
1,2077,2165,-88,0,18,57
-1,1767,1736,31,-4,-878,118
1,2021,1900,121,2,-40,40
1,2024,1280,744,5,391,79
-1,1566,1697,-131,-10,-130,100
-1,1760,1956,-196,2,-175,78
1,2150,2093,57,-2,257,77
1,1690,1585,105,0,45,55
1,1889,1750,139,3,155,81
1,1617,1575,42,-2,-59,79
1,1763,1644,119,0,25,87
-1,1729,1822,-93,0,-96,78
1,1500,1611,-111,0,0,67
-1,1700,1767,-67,1,-113,94
-1,1890,1889,1,-2,-45,52
-1,1661,1539,122,-1,-34,46
-1,1206,1500,-294,1,-145,78
1,1698,2024,-326,1,104,77
1,1655,1500,155,2,78,61
-1,1937,1727,210,-1,-22,48
-1,2082,2160,-78,0,119,102
-1,1521,1384,137,0,-88,104
1,2008,1714,294,-2,256,101
-1,2170,2073,97,0,13,48
0,1448,1478,-30,-2,12,56
-1,1802,1922,-120,-4,-64,90
-1,1823,1934,-111,0,-13,104
-1,1878,1720,158,-2,-41,42
1,1591,1593,-2,1,-23,57
1,1224,1482,-258,-3,-61,53
-1,2154,2088,66,-5,14,60
-1,1737,2047,-310,0,-5,58
1,1953,1924,29,-1,74,121
-1,1481,1626,-145,-2,-170,74
1,1861,1711,150,0,56,73
-1,1509,1589,-80,-4,-54,47
-1,1726,1803,-77,-4,-234,82
1,1530,1776,-246,-1,189,65
1,2102,2140,-38,0,5,77
-1,1615,1524,91,-2,-41,70
0,1704,1868,-164,-2,135,116
-1,1413,1341,72,-2,-70,82
1,2127,2115,12,0,-6,77
1,1725,1600,125,0,113,107
0,1863,1709,154,0,46,165
1,1642,1566,76,4,69,43
1,2030,2012,18,-1,-109,73
-1,1201,1771,-570,-1,-129,92
1,2104,2138,-34,-3,131,115
-1,1584,1572,12,-3,-57,66
1,1636,1748,-112,2,179,104
-1,1557,1565,-8,2,-55,80
1,1915,1950,-35,0,129,85
-1,1713,1858,-145,0,-1,69
1,1811,1745,66,4,76,51
-1,1733,2001,-268,1,-1,52
-1,1474,1461,13,1,-13,60
-1,2125,2116,9,0,-26,60
-1,1782,1510,272,-1,-22,44
1,1914,1753,161,1,465,171
1,1727,1762,-35,2,171,93
1,1552,1537,15,-2,-89,57
-1,1478,1546,-68,-1,-152,118
1,2005,2042,-37,0,23,73
1,1285,1195,90,1,342,87
1,1929,2119,-190,4,207,81
1,1609,1200,409,0,223,119
1,1939,1926,13,0,58,67
-1,1507,1598,-91,0,-267,120
1,1859,1758,101,3,126,61
1,1772,1462,310,2,3,50
0,1634,1726,-92,0,239,143
1,2030,2014,16,1,50,63
1,1734,1233,501,-5,161,69
1,1348,1252,96,8,276,59
1,2002,2041,-39,-3,-38,45
0,1614,1667,-53,0,19,90
1,1715,1750,-35,-2,-24,63
1,1463,1467,-4,0,-23,53
1,1530,1500,30,-1,-55,55
-1,1820,1867,-47,0,-44,78
1,2100,1945,155,-1,9,50
-1,1337,1247,90,-6,-201,51
1,1650,1500,150,12,116,41
-1,1916,1949,-33,0,-41,56
1,2016,2053,-37,0,131,201
-1,1768,1826,-58,-7,-10,42
-1,1298,1410,-112,-6,-150,52
1,1537,1561,-24,-4,-162,88
1,1679,1569,110,1,46,53
1,1474,1554,-80,0,-29,61
-1,1350,1315,35,1,111,86
1,1686,1561,125,6,360,77
1,1722,1636,86,-3,455,143
1,1706,1417,289,3,32,47
-1,1716,1716,0,-2,-64,66
1,1500,1461,39,0,38,75
1,1418,1322,96,-3,203,65
1,2030,2040,-10,0,52,125
-1,1441,1590,-149,-2,-133,64
1,1856,2028,-172,0,3,49
-1,1327,1308,19,-3,-82,60
-1,1533,1382,151,0,-165,104
1,1473,1296,177,-4,-3,45
-1,1706,2067,-361,0,-73,84
1,2028,2042,-14,2,52,51
-1,1620,1701,-81,-2,-65,52
-1,1473,1749,-276,-1,-24,48
1,1661,1197,464,4,79,51
-1,1872,2206,-334,-1,25,92
1,2040,2030,10,-1,64,141
-1,1665,1656,9,-2,-121,51
-1,1339,1389,-50,-8,-383,92
-1,1764,1500,264,-3,-6,48
-1,1356,1356,0,-2,-100,79
-1,1725,1452,273,-1,-84,112
-1,1426,1365,61,0,-15,40
1,1541,1528,13,-3,27,43
1,1786,1370,416,4,288,59
-1,2042,2028,14,0,-33,104
1,1461,1652,-191,-1,14,53
-1,1704,1723,-19,-1,-135,72
1,1538,1322,216,0,127,51
-1,1540,1433,107,-4,-380,74
-1,1416,1736,-320,-7,-12,54
1,1478,1548,-70,3,90,54
1,2077,1939,138,1,-27,113
1,1662,1195,467,0,-142,71
1,2040,2030,10,-1,55,61
1,1176,1201,-25,1,217,93
1,1531,1552,-21,0,4,55
-1,1437,1477,-40,-2,-74,48
-1,2018,2051,-33,0,-242,96
1,1305,1562,-257,-1,23,63
1,1522,1378,144,2,71,61
1,1831,1776,55,0,212,96
1,1356,1500,-144,6,282,55
-1,1731,1753,-22,-1,-17,48
0,1517,1735,-218,0,-48,173
1,1693,2070,-377,3,344,103
1,2062,2008,54,0,7,61
1,1752,1714,38,-5,109,67
-1,1493,1523,-30,-3,-209,78
-1,1518,1365,153,-16,-223,48
-1,1998,2071,-73,0,-98,108
1,1804,1591,213,-5,8,45
1,1477,1570,-93,4,203,57
1,1696,1500,196,-1,-9,49
-1,2080,1989,91,0,-2,42
-1,1477,1512,-35,0,-39,112
-1,1586,1814,-228,0,-114,74
1,2042,1713,329,1,216,139
0,1346,1247,99,0,1,72
-1,1452,1528,-76,-3,-102,60
1,1490,1401,89,6,599,107
-1,1577,1701,-124,-1,-10,50
-1,1544,1730,-186,-2,6,44
0,1377,1487,-110,-2,109,112
-1,1382,1502,-120,0,-546,88
1,1453,1354,99,9,183,41
1,2011,1895,116,-1,-2,45
1,1708,1569,139,-1,47,51
1,1304,1397,-93,1,79,83
1,1765,1840,-75,0,76,113
1,1727,1556,171,0,331,153
1,2053,1729,324,1,26,49
1,1345,1452,-107,5,470,107
-1,1710,2046,-336,-1,-177,70
1,2108,1963,145,-2,120,77
-1,1586,2056,-470,1,-300,98
-1,1761,1754,7,0,-163,126
1,1703,1714,-11,0,-21,41
-1,1412,1506,-94,1,-16,56
-1,1715,1502,213,-2,122,116
-1,1845,1764,81,6,120,86
1,1544,1344,200,6,251,57
1,1541,1442,99,3,88,59
-1,1560,1817,-257,-1,2,42
-1,1584,1562,22,0,107,100
1,1789,2017,-228,0,44,79
1,1518,1467,51,0,-53,53
1,1544,1686,-142,-1,-8,57
0,1509,1128,381,2,-50,94
1,1556,1469,87,0,70,75
1,2115,1877,238,-1,102,71
1,1284,1191,93,0,-74,67
1,1526,1572,-46,-3,40,89
1,1525,1465,60,-1,39,69
1,1707,1544,163,2,161,97
1,1737,1567,170,6,445,127
-1,1714,2050,-336,-5,-46,54
-1,1726,1670,56,0,-46,108
-1,1306,1459,-153,-5,-160,65
1,1831,1739,92,-2,16,59
-1,1500,2019,-519,-6,-47,44
-1,1560,1822,-262,-1,-39,70
1,1276,1451,-175,-8,-36,47
1,1644,1448,196,-1,-5,51
1,2021,1470,551,-1,-31,59
-1,1733,1750,-17,0,3,58
-1,1675,2058,-383,-1,-40,76
-1,1500,1562,-62,0,-91,62
0,1506,1599,-93,1,6,79
-1,1448,2022,-574,-2,-97,70
-1,1711,1880,-169,0,-31,104
1,2060,1673,387,-1,-32,53
1,1539,1200,339,4,240,69
-1,1560,1728,-168,-1,-132,56
-1,1650,1671,-21,0,-14,52
1,1722,1746,-24,2,83,131
1,2024,1430,594,-4,-29,111
1,1356,1698,-342,-1,20,127
0,1271,1501,-230,0,485,109
1,2100,1891,209,0,12,83
-1,1404,1489,-85,-1,-48,46
1,1668,1458,210,3,140,58
-1,1434,1474,-40,0,179,82
-1,1416,2025,-609,-4,-49,50
-1,1233,1379,-146,-2,-74,70
1,1886,1704,182,3,100,51
1,1788,1569,219,0,-99,81
1,1553,1430,123,10,236,59
1,2027,1999,28,-3,-17,173
-1,1518,1580,-62,-3,-218,76
0,1698,1893,-195,0,-346,168
1,1576,1413,163,-2,-17,43
-1,1988,2038,-50,-4,-17,42
-1,1712,2210,-498,-3,-28,50
-1,2049,1979,70,-2,-83,50
1,1421,1375,46,-1,506,89
1,1328,1277,51,-2,-6,69
-1,1418,1353,65,3,106,44
-1,1542,1359,183,0,-212,72
-1,1992,2034,-42,-1,-31,62
1,1836,1516,320,1,18,71
-1,1309,1507,-198,-10,-567,82
1,1516,1293,223,2,163,137
-1,1700,1745,-45,-1,-98,70
1,1523,1593,-70,1,129,109
-1,1711,1582,129,0,-71,137
-1,2045,1982,63,-1,-13,40
1,2112,1854,258,0,62,59
1,1424,1383,41,-5,3,67
1,1590,1555,35,1,4,103
-1,1995,2031,-36,-3,-43,46
1,1766,1459,307,1,56,77
1,1495,1279,216,5,355,85
-1,1855,2041,-186,-1,-41,60
1,1232,1685,-453,0,141,87
1,1723,1612,111,-1,-36,41
1,1704,1731,-27,1,85,101
1,1345,1387,-42,1,54,51
1,1445,1400,45,-3,8,47
0,1561,1467,94,1,175,120
1,2047,1849,198,0,-27,111
1,1465,1592,-127,-1,200,111
1,1508,1403,105,-1,-16,59
1,1844,2053,-209,1,52,67
1,1732,1798,-66,-1,3,69
0,1719,1716,3,0,12,159
-1,1849,2116,-267,-2,-140,94
-1,1424,1465,-41,0,-311,144
1,1484,1584,-100,6,248,67
1,1690,1401,289,3,116,51
1,2034,1861,173,1,184,99
-1,1778,1896,-118,-4,-160,64
-1,1502,1577,-75,0,-34,54
1,1502,1500,2,1,80,53
1,1763,1728,35,1,-4,81
1,1559,1409,150,1,15,41
1,1359,1392,-33,-5,188,79
1,1854,2041,-187,0,294,97
-1,1686,1586,100,1,19,56
-1,1611,1887,-276,-5,-58,70
1,1555,1453,102,1,102,109
-1,1273,1616,-343,-1,43,46
1,1398,1303,95,9,254,53
-1,1525,1664,-139,0,-80,90
1,1535,1537,-2,-4,12,53
-1,1456,1769,-313,0,-8,46
-1,1529,1646,-117,1,-115,72
-1,1558,1570,-12,-9,-111,54
-1,1716,1719,-3,0,-31,66
1,2023,1871,152,2,74,57
-1,1507,1512,-5,-3,-176,116
-1,1729,1495,234,0,17,92
1,1299,1522,-223,1,16,43
1,2121,1845,276,-4,144,69
-1,1864,2030,-166,0,21,88
-1,1436,1679,-243,0,11,50
1,1516,1373,143,-5,-24,135
1,1794,1564,230,1,89,99
-1,1601,1684,-83,-1,-63,51
-1,1705,1676,29,-1,-87,68
1,1694,1608,86,0,-74,71
1,2037,1858,179,0,-15,99
1,1547,1494,53,-1,2,81
1,1949,1729,220,1,34,57
-1,1294,1406,-112,0,60,96
0,1670,1750,-80,-3,-219,220
1,1368,1385,-17,0,14,49
-1,1497,1558,-61,3,65,98
1,1573,1416,157,1,208,62
-1,1852,2043,-191,-2,-239,70
1,1659,1741,-82,0,-147,99
-1,1763,1676,87,-3,-211,82
1,1692,1639,53,-1,-31,65
-1,1500,1448,52,-2,-183,66
-1,1377,1380,-3,0,-112,98
-1,1395,1596,-201,-3,-116,60
1,1904,1770,134,1,13,154
1,1304,1288,16,1,506,143
-1,1402,1428,-26,-8,-122,51
1,1725,1581,144,3,186,85
1,1954,1717,237,0,6,89
-1,1800,1683,117,1,64,54
-1,2049,1846,203,-1,-257,98
-1,1316,1434,-118,-3,-136,68
1,1511,1500,11,-6,-128,55
1,1576,1600,-24,3,422,89
-1,1701,1783,-82,0,-77,98
-1,1456,1344,112,-2,-143,94
1,1652,1560,92,2,48,53
-1,1863,2031,-168,-1,-75,58
1,1392,1232,160,5,152,85
1,1475,1414,61,-6,-9,151
-1,1841,2037,-196,-1,-53,72
-1,1701,1700,1,0,-185,120
1,1777,1501,276,5,134,51
1,1574,1731,-157,1,50,55
-1,1519,2090,-571,0,-69,64
-1,2038,1857,181,0,-88,68
1,1402,1690,-288,2,40,49
1,1557,1596,-39,1,-94,89
1,1523,1372,151,1,113,59
1,1702,1408,294,3,342,82
-1,1171,1445,-274,0,7,70
1,1537,1671,-134,-1,-8,41
1,1363,1269,94,0,13,65
1,1716,1589,127,0,7,57
1,1712,1655,57,1,694,115
-1,1661,1600,61,-1,-47,56
-1,1320,1371,-51,2,-61,97
1,1445,1449,-4,-1,-8,63
-1,1739,2020,-281,1,29,86
1,1644,1722,-78,0,194,73
-1,1582,1723,-141,-1,-66,66
1,2025,1735,290,1,59,58
-1,1722,1644,78,-9,-621,128
1,1793,1443,350,0,30,57
1,1438,1477,-39,0,-8,49
1,1732,2028,-296,14,410,57
-1,1314,1382,-68,2,-55,93
1,1689,1729,-40,0,93,123
-1,1717,1684,33,-1,-61,48
1,1781,1496,285,0,73,111
-1,1751,1835,-84,-2,-34,44
-1,1534,1595,-61,4,189,64
1,2008,1751,257,-1,-19,91
-1,1365,1529,-164,2,75,62
-1,1304,1566,-262,-1,-129,92
-1,1733,1997,-264,0,-50,70
-1,1449,1548,-99,-2,-106,50
-1,1836,1959,-123,-1,-16,40
-1,1203,1174,29,-10,-1167,116
-1,1743,1911,-168,0,-46,120
1,1730,1691,39,-3,-63,55
1,1582,1659,-77,4,79,44
1,1588,1588,0,-3,-5,73
1,1413,1737,-324,0,-7,95
-1,1629,2013,-384,-7,-73,70
1,1794,1575,219,0,88,129
-1,1289,1547,-258,0,-12,60
1,1594,1446,148,3,367,84
1,1702,2068,-366,-2,-74,133
1,2015,1615,400,0,19,51
1,1596,1646,-50,0,36,63
0,1843,1742,101,1,352,141
1,1496,1498,-2,-2,205,96
-1,1739,1670,69,0,-156,78
-1,1531,1538,-7,-1,-43,78
-1,1967,1828,139,-2,-47,136
1,1785,1199,586,0,-169,101
1,1536,1359,177,2,23,47
1,1408,1305,103,1,128,65
1,1594,1362,232,7,122,47
1,2018,1869,149,-1,-43,109
1,1713,1434,279,-1,58,57
-1,931,1348,-417,4,-650,116
1,1774,1500,274,0,16,55
-1,1325,1500,-175,-1,-23,50
1,1827,1748,79,-12,57,117
1,1263,1311,-48,1,396,111
-1,1862,2025,-163,-8,-115,42
-1,1421,1634,-213,-3,-93,56
-1,1438,1601,-163,0,-13,48
1,1684,1599,85,4,31,41
1,1663,1584,79,-1,-3,61
1,1299,1201,98,3,591,81
-1,1682,1725,-43,-1,-11,44
-1,1608,1300,308,-3,-134,60
1,1608,1429,179,0,80,61
-1,1379,1404,-25,1,-601,148
-1,1489,1371,118,-3,-187,73
1,2032,1856,176,6,47,41
1,1548,1520,28,-4,-250,93
-1,1429,1718,-289,1,-98,96
-1,1604,1639,-35,-1,-165,108
-1,1731,1923,-192,-4,-362,138
-1,1616,1591,25,-2,-71,62
0,1380,1409,-29,3,193,80
0,1579,1372,207,0,163,103
1,1844,1951,-107,0,12,81
1,2039,1752,287,1,9,47
1,1724,1443,281,2,34,53
-1,1574,1962,-388,-3,-49,67
1,1542,1557,-15,1,309,91
-1,1685,1830,-145,-2,-111,90
-1,1571,1422,149,-3,-35,44
-1,1747,2043,-296,-1,-34,58
-1,1542,1500,42,-3,13,48
-1,1183,1550,-367,-6,-47,44
1,1500,1424,76,-3,-57,95
-1,1604,1738,-134,0,-42,96
1,1584,1234,350,3,241,81
-1,1540,1592,-52,-2,-197,108
-1,1245,1743,-498,-2,-37,50
-1,1916,1900,16,0,-210,132
1,1454,1157,297,5,334,71
-1,1532,1698,-166,-2,-143,98
-1,1709,1631,78,-6,-106,55
1,1488,1457,31,7,488,77
-1,1540,1360,180,1,21,50
1,1460,1501,-41,-1,83,87
1,1174,1505,-331,-9,-812,93
1,1693,1549,144,5,129,55
1,1789,1203,586,9,343,61
-1,1700,1542,158,-3,-60,42
-1,1568,1754,-186,-1,-109,76
1,1992,1510,482,11,213,43
-1,1665,1684,-19,1,37,62
1,1695,1644,51,4,141,54
-1,1547,1715,-168,-10,-133,51
-1,1597,1745,-148,0,-23,86
1,1328,1500,-172,7,162,49
-1,1834,1972,-138,-2,-67,62
1,1523,1448,75,0,79,98
1,2094,1722,372,0,91,65
1,1790,1202,588,1,111,61
1,1253,1612,-359,4,621,111
-1,1880,1994,-114,-4,-76,54
-1,1500,1527,-27,-2,-60,48
1,1446,1513,-67,4,97,53
-1,1705,1635,70,2,163,70
-1,1472,1719,-247,0,-34,106
-1,1277,1561,-284,1,-4,60
-1,1429,1353,76,-1,-46,60
-1,1542,1439,103,-1,-18,48
1,1791,1541,250,0,417,153
-1,1459,1489,-30,-4,-17,42
-1,1347,1277,70,1,14,48
1,1360,1358,2,2,292,87
1,1745,1421,324,7,635,111
-1,1581,1417,164,3,12,40
1,1800,1599,201,-8,89,97
1,1631,1632,-1,2,88,83
-1,1704,1526,178,0,-29,42
1,1500,1822,-322,1,202,137
-1,1418,1398,20,3,-379,86
1,1324,1467,-143,-5,55,115
1,2217,1724,493,1,22,71
1,1485,1042,443,-4,1,67
1,1582,1420,162,17,383,49
1,1534,1537,-3,-1,-1,49
1,1852,1277,575,6,508,81
1,1700,1447,253,0,7,47
-1,1643,1691,-48,0,-7,62
1,1752,1413,339,0,14,67
-1,1499,1407,92,0,12,66
-1,1694,1460,234,2,-72,76
1,1552,1230,322,2,-13,43
-1,1520,1647,-127,-1,-18,56
1,1457,1210,247,11,797,59
-1,1241,1332,-91,-6,-550,82
1,1351,1215,136,0,-5,47
-1,1563,1723,-160,-2,3,82
1,1528,1459,69,2,267,75
1,1798,1904,-106,0,19,51
1,1419,1500,-81,-7,-67,45
-1,1197,1303,-106,-6,-118,47
1,1630,1413,217,-3,58,61
1,1360,1423,-63,0,184,111
1,1701,1633,68,-7,-155,63
1,1648,1550,98,-1,235,87
1,1755,1751,4,-1,16,53
1,1730,1556,174,1,58,81
1,1681,1200,481,-4,-282,127
0,1905,1669,236,0,-33,116
-1,1035,1589,-554,-2,-193,76
-1,1363,1499,-136,6,-239,176
-1,1481,1417,64,-10,-48,42
1,1646,1853,-207,-1,-14,61
-1,1235,1144,91,3,-261,110
1,1863,1805,58,0,96,75
1,1431,1371,60,0,1573,151
1,1796,1216,580,1,66,57
1,1766,1827,-61,0,181,93
1,1835,1197,638,2,338,73
1,1660,1654,6,0,218,77
1,1276,1340,-64,-2,-8,41
-1,1704,1451,253,-5,-138,60
-1,1834,1663,171,0,-3,62
0,1779,1910,-131,-5,90,109
0,1962,1387,575,0,-34,97
1,1812,1736,76,5,133,47
1,1371,1737,-366,4,274,71
1,1635,1501,134,-1,25,59
-1,1254,1440,-186,-2,-39,60
-1,1684,1550,134,4,80,52
1,1791,1710,81,0,61,55
1,1812,1683,129,-3,331,119
1,1187,1482,-295,-15,-417,51
1,1682,1899,-217,0,-53,153
-1,1727,1822,-95,0,301,100
1,1669,1565,104,-1,67,93
-1,1032,1407,-375,4,7,110
-1,1478,1677,-199,1,-88,112
-1,1701,1872,-171,1,77,64
-1,1372,1360,12,-3,123,100
-1,1732,1616,116,-3,-80,54
1,1537,1213,324,2,583,101
-1,1280,1428,-148,-1,-70,52
-1,1667,1843,-176,1,25,42
-1,1130,1460,-330,-3,-121,54
-1,1459,1581,-122,-2,-54,68
1,1557,1677,-120,10,910,95
1,1816,1574,242,-1,77,63
-1,1718,1831,-113,0,-38,60
-1,1642,1599,43,0,-11,90
-1,1724,1615,109,2,-367,180
-1,1662,1572,90,2,-665,90
-1,1402,1710,-308,-5,49,72
1,1562,1302,260,6,365,81
-1,1679,1657,22,-10,-412,120
1,1840,1614,226,0,18,51
-1,1340,1433,-93,2,-73,106
1,1493,1548,-55,-1,-16,51
1,1751,1630,121,-1,-53,55
1,1403,1373,30,-1,207,117
1,1586,1649,-63,-8,-232,47
1,1541,1445,96,-2,24,43
1,1853,1850,3,0,76,75
-1,1419,1609,-190,-6,-116,52
1,2007,1845,162,0,-17,115
1,1891,1789,102,0,47,125
1,1636,1600,36,0,166,101
1,1394,1269,125,19,2383,161
1,1713,1874,-161,-2,-18,79
0,1570,1821,-251,-2,-155,109
-1,1820,1675,145,0,-10,54
1,1878,1702,176,0,-13,59
1,1858,1730,128,-1,-18,65
-1,1838,2014,-176,-3,-40,72
1,1646,1590,56,7,644,99
1,1240,1220,20,7,519,77
-1,1152,1613,-461,10,156,48
-1,1806,1677,129,-4,-48,40
0,1837,1670,167,0,50,124
1,1476,1410,66,-5,-117,69
-1,1836,1196,640,1,31,54
1,2020,1831,189,1,93,103
1,1437,1550,-113,0,218,87
-1,1500,1723,-223,6,266,92
1,1371,1391,-20,0,5,45
1,1277,1383,-106,-2,-110,61
1,1655,1615,40,1,-19,59
-1,1717,1775,-58,2,-205,116
1,1630,1023,607,3,406,90
1,1877,2099,-222,0,23,81
1,1664,1605,59,0,-155,65
-1,1506,1779,-273,0,-28,54
1,1825,1096,729,10,1021,85
-1,1370,1534,-164,-2,-63,62
1,1674,1595,79,-1,47,69
-1,1763,1661,102,0,-247,128
1,1804,1691,113,2,-77,99
1,2077,1894,183,-3,70,64
-1,1500,1813,-313,-6,-174,66
1,1561,1594,-33,-4,-107,47
1,1651,1549,102,-2,50,67
-1,1682,1586,96,0,-156,74
-1,1979,1941,38,0,-2,70
-1,1826,1728,98,3,26,96
1,1574,1260,314,1,158,83
1,1577,1456,121,1,27,45
-1,1888,2084,-196,-1,-24,60
-1,1645,1667,-22,-4,-244,74
-1,1668,1600,68,1,27,60
-1,1838,1865,-27,-5,-203,61
1,1920,1817,103,3,220,97
1,1655,1614,41,2,42,49
1,1269,1334,-65,9,322,57
-1,1400,1479,-79,0,-19,50
1,1630,1500,130,-1,1,95
1,1457,1107,350,3,196,63
-1,1238,1427,-189,-15,-569,56
1,1665,1604,61,3,65,41
-1,1392,1807,-415,-6,-122,42
-1,1573,1796,-223,2,107,68
1,1820,1223,597,-1,586,111
1,2096,1759,337,1,41,71
-1,1810,1743,67,-2,-521,124
-1,1708,1695,13,-2,-287,118
-1,1674,1595,79,0,-84,122
-1,1582,1706,-124,-4,-63,40
1,1812,1623,189,0,-64,97
-1,1662,1209,453,-2,-424,84
1,1018,1630,-612,-1,50,53
0,1801,1568,233,-3,-554,89
-1,1584,1635,-51,0,-146,128
1,1661,1608,53,-1,-97,139
1,1797,1361,436,5,268,59
-1,1980,1683,297,0,10,92
-1,1441,1406,35,2,57,58
1,1583,1503,80,-8,21,71
-1,1492,1623,-131,-1,-10,44
-1,1954,1890,64,-3,-195,80
-1,1606,1669,-63,-2,-199,96
0,1500,1687,-187,-5,-79,127
0,1894,1671,223,-4,-6,100
-1,1502,1810,-308,-3,-126,72
1,1575,1794,-219,2,247,85
-1,1363,1427,-64,0,46,82
1,1450,1215,235,13,662,71
1,1465,1498,-33,3,707,135
-1,1696,1929,-233,0,2,64
1,1620,1268,352,-1,10,49
1,1588,1529,59,1,182,135
1,1714,1575,139,-1,-27,53
1,1610,1757,-147,0,50,55
1,1670,1599,71,0,221,65
1,1675,1540,135,-9,9,85
-1,1674,1844,-170,-3,-121,64
-1,1430,1327,103,4,83,76
1,1679,1590,89,-10,-96,45
1,1740,1626,114,-2,-89,91
1,1695,1495,200,-3,4,51
-1,1094,1799,-705,-8,-214,60
1,2001,1786,215,0,0,47
1,1618,1749,-131,8,155,47
1,1687,1588,99,11,289,43
-1,2099,1941,158,0,-14,62
1,1733,1634,99,-1,94,65
1,1694,1593,101,3,939,99
1,1412,1453,-41,6,209,59
-1,1678,1644,34,0,40,82
1,1464,1489,-25,0,19,73
1,1626,1741,-115,4,322,77
-1,1701,1731,-30,0,-105,98
1,1930,1596,334,4,470,103
1,1702,1638,64,1,432,81
1,1451,1584,-133,1,64,55
1,1822,1354,468,5,135,53
1,1726,1641,85,-4,-208,65
1,1198,1469,-271,-13,-358,43
1,1691,1702,-11,0,29,101
1,1935,1800,135,0,2,43
1,1814,1515,299,0,74,129
1,1540,1451,89,3,220,89
1,1443,1592,-149,3,243,69
-1,1265,1623,-358,-1,-48,46
1,1576,1627,-51,1,81,59
-1,1500,1499,1,0,110,84
1,1632,1735,-103,5,923,111
1,1636,1413,223,4,251,121
-1,1586,1477,109,-1,38,70
-1,1304,1593,-289,-16,-385,48
1,1956,2083,-127,0,33,69
-1,1667,1410,257,-12,-286,44
1,1838,1788,50,-2,8,43
-1,1568,1721,-153,-1,6,55
1,1520,1593,-73,0,-26,123
-1,1727,1482,245,0,-7,64
-1,1824,1791,33,0,2,58
1,1532,1460,72,2,174,65
0,1888,1377,511,-3,-237,86
-1,1353,1437,-84,-3,-288,78
1,1720,1646,74,0,13,63
-1,1270,1379,-109,0,-62,76
-1,1637,1729,-92,3,250,90
1,1478,1589,-111,0,42,55
1,1405,1258,147,15,429,53
-1,1890,1995,-105,0,-4,72
1,1542,1451,91,0,-10,75
-1,1282,1345,-63,2,-6,40
1,1324,1391,-67,-1,-46,71
1,1703,1593,110,0,-31,81
1,1620,1497,123,1,56,73
-1,1552,1574,-22,-2,-56,42
1,1538,1225,313,9,111,43
-1,1390,1503,-113,-1,-64,66
1,1737,1629,108,-2,-367,109
-1,1549,1494,55,0,-7,52
-1,1966,1703,263,-1,-11,44
1,1666,1656,10,-1,120,109
-1,2067,1971,96,0,35,86
-1,1510,1424,86,-8,-170,44
-1,1541,1442,99,-3,-150,84
1,1299,1088,211,-5,-143,111
-1,1487,1629,-142,4,111,52
-1,1202,1597,-395,-1,-167,86
-1,1672,1492,180,0,-59,84
-1,1621,1746,-125,-1,-198,92
1,1670,1638,32,0,-3,60
1,1493,1428,65,5,584,119
1,1351,1197,154,10,200,51
1,1542,1344,198,0,57,66
1,1662,1407,255,-3,591,109
-1,1482,1614,-132,-1,-33,48
-1,1262,1711,-449,-5,-49,56
1,1881,2004,-123,-2,-120,73
1,1646,1676,-30,-3,-33,42
1,1463,1356,107,2,109,81
-1,1391,1472,-81,-1,-89,112
-1,1527,1886,-359,0,0,40
-1,1205,1460,-255,-13,-994,78
-1,1452,1402,50,-3,-200,58
1,1438,1579,-141,-1,-5,41
1,1223,1364,-141,1,-4,59
1,1628,1585,43,0,-274,93
-1,1822,1494,328,-10,-207,146
1,1320,1465,-145,-3,-47,53
-1,1621,1657,-36,-7,-131,40
1,1372,1382,-10,0,-36,69
1,1508,1655,-147,-1,275,91
1,1819,1561,258,-2,-28,71
1,1467,1263,204,-7,83,131
1,1396,1611,-215,-6,221,83
1,1889,1494,395,-4,-62,41
-1,1369,1399,-30,0,-723,104
1,1568,1475,93,-1,-7,49
1,1484,1667,-183,-1,-127,79
1,1857,1734,123,0,-16,53
-1,1533,1511,22,-1,-58,58
1,1457,1402,55,-5,-58,73
-1,1517,1823,-306,-5,-175,66
1,1443,1542,-99,-7,-145,63
1,1644,1585,59,14,356,53
-1,1818,1512,306,0,-287,134
-1,1682,1742,-60,-5,-474,126
1,1820,1379,441,3,81,83
0,1649,1489,160,-2,-137,103
1,1595,1382,213,0,-7,49
-1,1548,1339,209,-1,-485,114
1,1827,1739,88,0,0,47
0,1439,1506,-67,-4,172,154
1,1335,1440,-105,3,431,145
1,1711,1576,135,4,81,57
-1,1558,1569,-11,1,-27,56
-1,1453,1670,-217,-6,-475,72
0,1376,1651,-275,7,704,95
1,1523,1711,-188,-1,-76,93
-1,1451,1404,47,4,-69,122
-1,1881,1989,-108,-3,-122,68
-1,1183,1483,-300,-30,-480,40
1,1350,1243,107,3,382,101
1,1514,1090,424,5,153,45
-1,1415,1439,-24,-6,-82,70
1,1537,1589,-52,1,15,45
1,1639,1430,209,5,311,69
-1,1892,2081,-189,-4,-58,62
1,1781,1563,218,3,66,69
1,1591,1538,53,3,125,65
-1,1718,1637,81,2,-47,80
0,1550,1577,-27,1,359,77
0,1793,1535,258,-1,-20,93
1,1799,1566,233,0,-12,63
-1,1513,1721,-208,-3,-317,94
1,1551,1576,-25,-1,-42,49
-1,1557,1476,81,3,26,46
1,1908,1638,270,1,38,52
-1,1384,1444,-60,4,-14,74
-1,1786,1865,-79,-8,-204,80
-1,1587,1406,181,-13,-215,42
1,1493,1174,319,8,877,133
1,1991,1960,31,0,12,65
1,1644,1558,86,1,156,75
1,1598,1520,78,8,409,65
-1,1836,1734,102,1,-26,54
1,1705,1578,127,-2,105,83
-1,1508,1821,-313,-1,-171,104
-1,1356,1658,-302,-9,-308,68
1,1712,1571,141,-8,-69,45
1,1554,1464,90,-2,49,93
1,1530,1485,45,4,113,45
-1,1822,1742,80,1,19,62
1,1845,1625,220,0,7,44
1,1942,1475,467,4,215,65
0,1540,1561,-21,-2,-757,120
-1,1828,1998,-170,-1,-98,63
1,1718,1564,154,-1,3,47
1,1712,1829,-117,0,0,75
-1,1804,1728,76,0,20,82
-1,1526,1563,-37,-1,-42,90
1,1543,1565,-22,0,-14,45
1,1875,1777,98,3,52,49
1,1463,1374,89,13,185,49
-1,1824,1668,156,0,35,72
-1,1435,1583,-148,-6,-167,56
1,1646,1495,151,1,507,111
-1,1530,1473,57,-2,-57,54
-1,1662,1352,310,2,80,56
1,1359,1078,281,-3,-113,119
-1,1603,1528,75,-4,-70,107
1,1549,1653,-104,0,37,69
1,1874,1955,-81,-3,-22,89
1,1462,1673,-211,-1,-60,79
1,1580,1555,25,2,80,61
1,1504,1593,-89,-3,-73,61
-1,1363,1426,-63,-5,-367,86
-1,1303,1643,-340,-4,-405,74
-1,1768,1884,-116,-1,-108,96
1,1955,1785,170,-1,-49,57
-1,1872,2005,-133,-3,-78,56
-1,1500,1722,-222,-4,-90,50
-1,1606,1572,34,2,-137,128
-1,1536,1474,62,-1,-65,80
-1,911,2134,-1223,2,87,69
1,1519,1783,-264,4,341,125
-1,1524,1365,159,2,-56,92
1,1503,1726,-223,3,305,91
1,1328,1235,93,0,329,145
1,1541,1372,169,3,436,135
1,1638,1564,74,1,114,61
1,1646,1408,238,5,73,41
1,1808,1517,291,2,76,51
1,1653,1435,218,2,707,95
-1,1756,1807,-51,-2,-235,76
1,2089,1472,617,-2,249,99
1,1526,1300,226,0,-2,41
1,1996,1903,93,-4,65,111
1,1358,1251,107,2,156,77
0,1708,1651,57,0,58,106
-1,1066,1812,-746,-4,-187,62
-1,1538,1614,-76,-4,-134,76
1,1893,1760,133,8,200,65
1,1489,1778,-289,0,-76,99
1,1790,1443,347,-2,-43,57
-1,1729,1543,186,-4,-108,98
1,1492,1419,73,8,105,41
1,1533,1346,187,5,139,61
-1,1886,2119,-233,-4,-91,66
1,1847,1557,290,0,31,65
1,1647,1641,6,0,85,85
1,2002,1635,367,0,30,89
1,1968,1552,416,1,136,65
-1,1898,1229,669,4,-187,110
-1,1833,1757,76,1,42,98
-1,1500,1500,0,-10,-567,96
-1,1523,1492,31,0,34,82
-1,1552,1818,-266,0,-30,56
-1,1793,1789,4,0,384,144
1,1293,1406,-113,1,4,101
1,1653,1287,366,15,158,41
1,1517,1706,-189,0,119,93
0,2043,1895,148,1,-44,90
1,1547,1471,76,-4,-153,89
-1,1753,1676,77,0,22,54
-1,1500,1453,47,2,-79,74
1,1813,1065,748,2,174,65
-1,1546,1550,-4,1,-104,64
-1,1365,1500,-135,-3,-172,62
-1,1823,1971,-148,-3,-7,110
1,1547,1535,12,-10,-93,79
-1,1562,1500,62,0,-8,72
1,1795,1639,156,-1,-14,47
1,1563,1422,141,5,150,44
1,1881,1819,62,-3,-21,53
1,1753,1901,-148,0,159,177
-1,1472,1397,75,-2,-42,44
-1,1418,1556,-138,0,286,124
-1,1758,1584,174,0,-10,52
1,1553,1578,-25,5,314,79
1,1980,1816,164,0,62,61
-1,1524,1500,24,-4,-244,74
1,1308,1635,-327,1,319,133
1,1906,1516,390,6,334,56
1,1350,1673,-323,0,191,127
-1,1652,1899,-247,-2,-102,66
-1,1471,1630,-159,0,-426,152
1,1813,1734,79,1,68,99
-1,1810,1891,-81,-2,-36,52
1,1988,1764,224,0,11,77
1,1458,1448,10,1,118,59
-1,2134,911,1223,-1,-22,60
1,1704,1809,-105,-1,11,67
-1,1514,1561,-47,-4,-127,48
1,1739,1588,151,-4,23,91
1,1360,1716,-356,-1,-22,49
-1,1360,1522,-162,-4,-268,74
-1,1488,2021,-533,-4,-145,78
-1,1529,1851,-322,3,-9,92
-1,1619,1457,162,0,-69,126
-1,1554,1575,-21,4,106,56
-1,1556,1701,-145,0,9,46
1,1797,1860,-63,0,6,73
-1,1694,1801,-107,0,-122,94
1,1594,1654,-60,0,-4,73
1,1696,1903,-207,3,604,113
1,1801,1598,203,-2,0,47
1,1511,1380,131,-5,-142,49
-1,1666,1899,-233,-3,-93,56
-1,1800,1710,90,-2,-33,49
-1,1729,1694,35,-3,-31,102
1,1848,1811,37,-1,7,53
-1,1549,1447,102,-3,-428,124
1,1413,1479,-66,-6,-107,45
1,1435,1469,-34,0,288,133
-1,1725,1823,-98,1,431,128
0,1325,1353,-28,-1,-277,135
-1,1487,1382,105,-3,-185,108
-1,1782,1861,-79,0,-186,86
-1,1773,1708,65,-1,22,60
-1,1589,1612,-23,-1,-86,68
0,1408,1456,-48,9,457,74
-1,1582,1570,12,-2,-4,47
1,1504,1409,95,1,64,53
1,1800,1857,-57,2,20,49
-1,1368,1500,-132,-2,-40,42
-1,1807,1593,214,-5,-193,58
1,1769,1746,23,0,68,89
-1,1634,1886,-252,0,15,78
1,2154,1759,395,0,-72,117
1,1721,1524,197,0,46,107
-1,1773,1585,188,0,-321,94
-1,1594,1556,38,2,51,62
-1,1959,2072,-113,-1,-105,70
1,1501,1393,108,2,57,51
-1,1404,1588,-184,1,7,48
0,1500,1245,255,-1,-148,136
1,1761,1181,580,11,575,67
1,1748,1251,497,-5,94,105
1,1518,1470,48,-2,-180,85
1,1623,1417,206,0,-8,53
1,2021,1988,33,0,5,77
1,923,1065,-142,3,233,71
1,2080,1952,128,1,168,71
-1,2017,1805,212,1,-192,138
1,1618,1627,-9,0,50,95
-1,1862,1902,-40,-2,-77,50
1,1855,1761,94,0,33,59
0,1368,1249,119,-12,-771,78
1,1508,1327,181,3,171,71
1,1945,2087,-142,0,-48,101
-1,1426,1638,-212,-4,-511,106
-1,1450,1594,-144,0,0,46
-1,1560,1606,-46,0,85,100
1,1757,1370,387,1,63,73
-1,1858,2033,-175,-3,-112,64
-1,1528,1749,-221,-4,-112,94
-1,1791,1977,-186,1,71,64
-1,1534,1486,48,-11,-741,114
1,1572,1551,21,-1,32,67
1,1027,945,82,-2,47,53
1,1959,1911,48,0,7,47
-1,1915,2041,-126,-1,-380,86
1,1253,1365,-112,3,128,53
1,1675,1701,-26,0,-147,79
-1,1629,1445,184,-6,-206,56
-1,1636,1698,-62,-2,-294,68
-1,1403,1460,-57,0,14,70
1,1753,1864,-111,-1,-75,65
1,1766,1304,462,0,45,64
1,2050,1907,143,2,447,107
-1,1470,1514,-44,-2,-218,90
-1,1760,1852,-92,0,-366,122
-1,1776,1528,248,0,-59,68
1,1772,1667,105,-1,-20,55
-1,1627,1997,-370,0,-42,66
1,1971,1953,18,-1,208,105
1,1902,1969,-67,0,157,69
-1,1629,1602,27,0,-2,52
1,1405,1249,156,-1,111,121
0,2058,1900,158,-11,-687,110
1,1521,1365,156,0,123,75
1,1689,1688,1,-3,356,107
1,1364,1268,96,0,113,73
1,1505,1723,-218,-1,-50,115
-1,1514,1558,-44,-13,-190,40
-1,1905,2053,-148,-1,-60,84
-1,1417,1380,37,-6,-250,72
-1,2053,1905,148,1,137,70
-1,1500,1448,52,-14,-399,54
1,1848,1767,81,1,15,45
-1,1921,2034,-113,-3,-87,72
1,1528,1355,173,0,-46,77
-1,1700,1956,-256,2,35,42
-1,1589,1582,7,-6,-123,54
1,1442,1406,36,2,86,67
-1,1913,2043,-130,0,-45,68
1,1804,1472,332,3,419,123
-1,1658,1296,362,-1,-12,54
-1,1260,1614,-354,-9,-737,94
0,1969,1738,231,-1,-61,129
1,1730,1565,165,11,463,65
0,1960,1696,264,2,206,108
1,1566,1651,-85,-1,-69,83
1,2052,1906,146,0,92,131
1,1320,1534,-214,-1,-3,103
1,1484,1367,117,13,904,73
-1,1769,1565,204,-2,-62,49
1,1452,1440,12,2,120,61
-1,1696,1697,-1,-1,-40,80
1,1898,2059,-161,-4,-110,79
1,1351,1527,-176,0,24,43
-1,1701,1979,-278,-1,-188,78
-1,1660,1513,147,-2,-45,54
1,1434,1435,-1,-3,152,120
1,1364,1551,-187,0,110,71
1,2041,1915,126,2,411,111
-1,1821,1915,-94,0,-453,124
1,1582,1732,-150,-1,-24,45
1,1962,1688,274,3,44,89
1,1355,1360,-5,9,264,61
-1,1907,2050,-143,0,-122,112
-1,1703,1860,-157,-1,-83,78
1,1444,1338,106,9,170,59
1,1526,1512,14,-3,-73,57
-1,1645,1565,80,-6,-128,47
1,1857,1646,211,1,45,59
1,1623,1705,-82,-9,-32,52
1,1611,1587,24,0,127,65
1,1983,1698,285,0,25,69
-1,1747,1828,-81,0,-26,96
-1,1611,1950,-339,0,7,66
-1,1348,1579,-231,-5,-173,66
-1,1584,1461,123,-1,-107,48
-1,1761,1502,259,0,12,74
1,1967,1867,100,1,65,73
-1,1607,1697,-90,0,-152,106
1,1697,1592,105,-3,43,57
1,1463,1213,250,2,81,55
1,1387,1206,181,-1,192,62
-1,1316,1535,-219,-6,-157,54
-1,1622,1591,31,-6,-133,70
-1,1634,1863,-229,-3,-28,44
-1,1257,1349,-92,0,29,42
1,1678,1536,142,4,221,69
1,1584,1338,246,-5,-145,45
-1,1240,1450,-210,0,-5,54
1,1578,1683,-105,0,33,57
1,1900,1852,48,1,85,75
1,1349,1272,77,25,517,41
1,1705,1519,186,-3,16,77
-1,1633,1909,-276,-2,-25,51
1,1617,1399,218,17,550,59
1,1807,1653,154,6,245,67
-1,1910,1427,483,0,8,42
0,1376,1461,-85,-1,-63,144
-1,1885,1986,-101,-1,-55,74
-1,1475,1623,-148,-3,-18,60
1,1625,1627,-2,-1,79,97
-1,1516,1250,266,-7,-212,58
-1,1451,1888,-437,-4,-100,40
1,1421,1248,173,-4,-23,123
-1,1501,1537,-36,1,28,70
-1,1689,1667,22,0,-260,94
-1,1489,1890,-401,-2,-134,78
-1,1450,1510,-60,-7,-491,98
1,1636,1691,-55,1,-8,47
1,1486,1411,75,-3,96,117
1,1923,1868,55,3,109,67
1,1892,1715,177,0,631,125
1,1672,1853,-181,0,-117,165
1,1711,1541,170,-3,-42,115
1,1874,1714,160,0,201,145
1,1468,1618,-150,9,292,63
-1,1768,2061,-293,-1,-42,72
-1,1646,1815,-169,-2,-280,104
-1,1452,1616,-164,-2,-143,98
1,1899,1678,221,0,5,89
1,1954,1608,346,0,3,45
1,1393,1407,-14,-1,-40,117
-1,1459,1691,-232,3,64,121
0,1078,0,1078,0,-127,90
-1,1673,1904,-231,-1,-95,104
1,1480,1541,-61,2,616,139
1,1694,1792,-98,2,232,93
0,1404,1500,-96,-1,-152,90
1,1396,1519,-123,-1,1,53
1,2065,1764,301,-1,-4,69
-1,1510,1647,-137,-8,-45,42
-1,1438,1476,-38,5,92,44
1,1699,1208,491,0,26,51
-1,2136,1932,204,-1,-54,106
-1,1697,1622,75,0,-94,96
1,1520,1429,91,5,216,65
1,1717,1680,37,0,60,77
-1,1759,1454,305,0,-597,82
1,1717,1636,81,-1,71,81
-1,1405,1249,156,0,1,46
1,1704,1500,204,1,20,49
1,1263,1300,-37,-2,-192,109
-1,1602,1484,118,-1,-45,70
-1,1329,1554,-225,2,32,54
-1,1632,1842,-210,-2,-546,122
1,1356,1404,-48,1,96,57
-1,1603,1688,-85,2,50,78
1,1728,1513,215,2,126,71
-1,1649,1678,-29,0,-79,96
1,1500,1259,241,0,95,59
-1,1292,1497,-205,0,-13,46
-1,1426,1492,-66,0,-229,100
-1,1629,1958,-329,-3,-100,65
1,1532,1339,193,2,130,69
0,1654,1411,243,6,115,47
1,1949,2116,-167,1,1,51
1,1911,1447,464,8,129,49
-1,1508,1733,-225,-5,-107,114
0,1628,1425,203,-2,-75,220
-1,1392,1405,-13,0,-130,104
1,1822,1639,183,1,501,105
-1,1641,1877,-236,-5,-14,54
1,1688,1939,-251,0,325,219
-1,1342,1241,101,1,-117,116
1,1851,1627,224,4,429,111
1,2097,1964,133,0,7,58
-1,1500,1535,-35,-2,-298,60
0,1445,1500,-55,5,133,128
1,1443,1381,62,-2,171,117
-1,1351,1623,-272,0,-65,68
-1,1323,1548,-225,-4,-159,114
-1,1628,1798,-170,0,-28,108
-1,1676,1863,-187,-3,-376,110
1,1603,1417,186,10,691,87
-1,1503,1474,29,1,-177,112
1,1513,1280,233,1,262,119
1,1756,1575,181,3,118,51
1,1738,1738,0,0,34,69
1,1957,2106,-149,1,50,59
-1,1621,1859,-238,0,33,68
-1,1267,1474,-207,2,68,62
-1,1521,1575,-54,-3,-48,54
-1,1421,1629,-208,3,96,126
0,1388,1763,-375,0,-25,84
-1,1699,1583,116,-6,-56,44
0,1278,1372,-94,-2,343,119
1,2057,1500,557,-1,-35,65
1,2069,1817,252,0,409,111
-1,1256,1328,-72,-5,-528,80
-1,1456,1500,-44,2,32,60
1,2088,1972,116,0,-10,57
-1,1449,1654,-205,-4,-198,62
-1,1633,1829,-196,0,-49,106
1,1859,1708,151,3,47,51
-1,1726,1749,-23,-3,39,70
-1,1446,1537,-91,0,20,72
1,1416,1717,-301,-1,19,55
1,1880,1883,-3,0,-59,73
1,1412,1543,-131,-1,-1,41
-1,1372,1472,-100,1,19,156
-1,1475,2059,-584,0,-21,62
-1,1813,2074,-261,-3,-75,50
1,1866,1616,250,1,189,101
-1,1434,1670,-236,-6,-167,56
-1,1444,1614,-170,1,8,44
1,1844,1892,-48,0,262,95
1,1716,1318,398,-2,-24,43
-1,1515,1633,-118,-3,-12,42
1,1542,1463,79,0,645,163
1,1500,1614,-114,1,60,51
-1,1953,2071,-118,0,9,92
-1,1620,1438,182,0,-4,42
-1,1479,1261,218,-5,-36,46
1,1878,1884,-6,0,-51,83
1,1738,1810,-72,-3,-13,41
-1,1501,1486,15,1,-34,76
-1,1965,2096,-131,-4,-77,52
-1,1845,1622,223,0,-34,50
-1,1689,1639,50,-2,-14,40
1,2061,1851,210,-1,505,125
-1,1587,1470,117,-2,-212,82
-1,1726,1715,11,0,-34,62
-1,1611,1760,-149,-1,-294,132
1,2079,1946,133,0,32,59
1,1590,1514,76,-2,-103,61
-1,1416,1443,-27,-3,-279,82
0,2067,1844,223,0,225,124
-1,1434,1836,-402,-6,-189,62
1,1522,1350,172,-5,-98,57
1,1363,1485,-122,1,-7,63
1,1842,1432,410,5,359,93
1,2104,1958,146,0,-1,49
1,1708,1720,-12,4,67,51
-1,1798,1747,51,-1,-123,146
-1,1344,1374,-30,1,123,80
1,1727,1712,15,0,31,67
-1,1626,1605,21,-1,-19,40
1,1699,1886,-187,0,178,61
-1,1429,1369,60,-7,-203,70
-1,1695,1619,76,-1,-40,68
1,1882,1685,197,0,-13,60
1,1438,1318,120,3,99,59
1,1649,1514,135,2,12,49
-1,1551,1454,97,-10,-243,130
1,1604,1873,-269,-3,-51,57
1,1471,1638,-167,0,52,77
1,1845,1786,59,2,-2,57
1,1530,1457,73,4,1243,113
1,1767,1738,29,7,88,45
1,1962,1928,34,3,39,49
1,1518,1520,-2,-8,67,63
1,1777,1916,-139,-1,-16,47
1,1698,1453,245,0,-11,64
-1,1638,1703,-65,-2,-460,102
1,1640,1214,426,1,446,139
1,1727,1777,-50,0,72,103
-1,1930,1500,430,-1,-104,84
-1,1262,1644,-382,-5,-815,124
-1,1626,1733,-107,-2,-108,72
-1,1586,1539,47,-2,-241,102
1,1791,1819,-28,-4,134,59
1,1836,1627,209,1,110,61
-1,1703,1712,-9,0,-38,62
-1,1652,1383,269,-7,-144,68
-1,1602,1424,178,3,85,50
1,1919,1972,-53,1,44,131
1,1806,1326,480,0,1,77
1,1754,2061,-307,0,-18,67
1,1870,1697,173,-2,-34,51
0,1635,1383,252,0,1,86
-1,1765,1740,25,-2,-67,58
1,1802,2181,-379,1,278,73
-1,1448,1435,13,-8,-163,42
1,1715,1250,465,11,270,42
1,1822,1476,346,7,199,61
1,1719,1619,100,0,191,133
-1,1493,1601,-108,-3,-10,46
1,1752,1753,-1,1,194,107
-1,1354,1375,-21,2,-645,112
-1,1500,1270,230,-19,-272,48
-1,1644,1677,-33,0,-78,86
-1,1546,1590,-44,-3,-62,58
1,1636,1448,188,-8,273,117
-1,1825,2151,-326,-5,-160,56
1,1508,1179,329,-6,-203,83
0,1615,1633,-18,-1,218,103
1,2156,1822,334,1,44,77
1,1679,1524,155,-3,-65,49
-1,1476,1842,-366,-1,2,66
0,1645,1609,36,-2,185,230
1,1469,1445,24,0,-67,105
-1,1597,1782,-185,-6,-213,55
-1,1627,1751,-124,-1,-58,44
-1,1819,2160,-341,0,21,66
1,1845,1931,-86,-1,-103,69
-1,1613,1797,-184,-1,-115,150
1,1472,1720,-248,-3,42,107
1,1448,1437,11,7,160,49
-1,1845,1891,-46,-1,-136,74
1,1536,1397,139,0,205,63
1,1390,1627,-237,1,25,89
1,1397,1451,-54,13,723,69
-1,1722,1709,13,-5,-264,58
0,1422,1406,16,2,158,79
1,1918,1865,53,0,316,127
-1,1682,1501,181,-10,-67,62
-1,1517,1692,-175,-3,-179,72
-1,1497,1587,-90,1,-48,65
1,1724,1644,80,0,49,75
-1,1646,1259,387,4,174,60
-1,1442,1534,-92,-1,7,52
1,1607,1558,49,3,117,61
1,1304,1297,7,1,80,63
0,1632,1481,151,1,98,156
-1,1559,1609,-50,1,-149,74
1,1845,1467,378,1,615,117
1,1515,1543,-28,3,111,67
1,1852,1927,-75,-1,-48,93
1,1548,1617,-69,2,10,45
-1,1602,1732,-130,0,-29,86
-1,1889,1403,486,0,-270,84
1,1604,1590,14,-1,219,77
-1,1665,1632,33,0,-1,62
1,1865,2078,-213,0,-14,65
-1,1363,1293,70,-8,-287,74
-1,1535,1525,10,0,-193,134
1,1635,1324,311,1,63,77
-1,1744,1588,156,0,-16,56
1,1579,1614,-35,-2,-116,75
1,1610,1538,72,3,63,47
-1,1770,2165,-395,0,-155,112
1,1857,1923,-66,0,-14,53
1,2059,1882,177,-2,-68,99
-1,1574,1630,-56,-5,-168,78
1,1491,1438,53,-3,-179,90
1,1602,1592,10,1,252,117
1,1531,1498,33,-9,221,115
1,2168,1767,401,1,290,91
1,1644,1684,-40,3,132,75
1,1621,1700,-79,0,-5,55
1,1081,0,1081,22,753,59
1,1911,1875,36,2,81,51
1,1869,1618,251,0,76,57
-1,1764,1443,321,0,18,136
1,1904,1661,243,-5,-287,89
1,1948,1643,305,-5,-4,71
-1,1581,1613,-32,-3,-685,132
1,1642,1208,434,1,246,89
1,1844,1666,178,1,325,63
1,1114,1282,-168,0,292,95
1,1349,1295,54,3,205,71
-1,1848,1511,337,0,-54,56
1,1618,1500,118,7,175,43
1,1636,1618,18,0,214,117
-1,1813,1873,-60,0,10,52
-1,1571,1623,-52,-1,-44,74
-1,1572,1557,15,1,-71,82
-1,1285,1316,-31,-7,-189,56
0,1615,1733,-118,0,-189,136
-1,1862,1783,79,0,-420,110
1,1662,1496,166,3,-9,79
-1,1485,1432,53,-12,-350,44
1,1541,1670,-129,2,107,57
1,1632,1561,71,0,198,135
1,1686,1653,33,2,254,99
-1,1818,1850,-32,-1,-106,96
1,1869,1660,209,1,23,55
1,1610,1657,-47,-1,-58,81
-1,1553,1641,-88,-1,8,50
1,1644,1603,41,0,-4,43
1,1420,1281,139,6,390,89
-1,1721,1761,-40,-3,-307,172
1,1688,1502,186,1,245,107
-1,1624,1704,-80,0,-10,60
-1,1531,1825,-294,0,-104,58
-1,1672,1882,-210,0,16,70
1,1511,1540,-29,-4,-70,69
-1,1433,1724,-291,-2,-107,68
-1,1655,1874,-219,-2,-118,100
0,1594,1654,-60,5,36,59
-1,1496,1694,-198,-1,-104,102
-1,1483,1745,-262,0,8,48
-1,1335,1382,-47,6,163,44
1,1619,1648,-29,5,505,123
1,1403,1390,13,1,45,81
0,1328,1745,-417,2,229,118
1,1296,1299,-3,6,225,55
1,1807,1868,-61,-7,-225,63
-1,1650,1888,-238,1,15,40
-1,1556,1596,-40,4,-51,76
-1,1729,1640,89,-4,-221,86
-1,1540,1644,-104,-5,-298,58
-1,1692,1837,-145,-1,-127,114
-1,1203,1305,-102,-12,-239,48
1,1602,1765,-163,-1,88,87
-1,1639,1482,157,-6,-277,58
-1,1472,1583,-111,1,-389,118
-1,1677,1690,-13,0,-362,124
1,1398,1267,131,2,701,113
-1,1834,1649,185,0,-136,58
-1,1860,2086,-226,0,13,110
1,1490,1421,69,-5,-226,93
-1,1665,1815,-150,-5,48,76
1,1631,1227,404,9,201,47
1,1748,1621,127,0,5,83
1,1527,1546,-19,3,510,115
1,2007,1798,209,0,45,73
-1,1274,1427,-153,-14,-256,66
1,1704,1258,446,1,144,63
1,1524,1499,25,0,23,76
1,1830,1652,178,0,5,107
-1,1416,1485,-69,2,36,54
1,1784,2012,-228,4,102,57
-1,1636,1714,-78,1,-45,76
1,1247,1084,163,4,189,43
1,1612,1756,-144,0,-24,61
1,1668,1702,-34,0,5,93
1,1994,1829,165,2,55,89
1,1646,1836,-190,-4,24,85
1,1532,1476,56,2,201,83
1,1721,1605,116,0,12,79
1,1814,2001,-187,8,194,49
1,1498,1523,-25,3,300,87
1,1285,1322,-37,-7,-66,71
1,2091,1856,235,0,-19,67
1,1740,1630,110,0,-15,75
-1,1914,1511,403,-3,-230,130
1,1557,1524,33,6,86,49
1,1818,1663,155,-2,42,67
-1,1984,1852,132,-3,-107,50
0,1365,1516,-151,1,45,80
-1,1535,1683,-148,-5,8,110
1,1968,1502,466,12,331,45
1,1500,1554,-54,-3,2,41
-1,1301,1608,-307,0,-27,58
-1,1598,1730,-132,-2,-218,82
1,1656,1825,-169,0,31,81
-1,1724,1995,-271,0,-74,86
-1,1626,1569,57,0,-21,90
-1,1501,1970,-469,-1,-231,74
-1,1683,1844,-161,2,1,98
1,1621,1748,-127,1,19,69
1,1711,1595,116,-5,38,111
-1,1775,1797,-22,0,17,64
-1,1680,1881,-201,-1,-37,72
-1,1190,1749,-559,-2,-261,108
1,1464,1535,-71,4,29,93
1,1808,1672,136,0,16,50
-1,1631,1669,-38,-2,-73,78
-1,1500,1720,-220,1,29,62
1,1972,1493,479,5,572,89
-1,1337,1560,-223,0,-13,111
-1,1625,1458,167,0,-16,58
1,1584,1593,-9,3,169,55
1,1665,1815,-150,0,2,81
-1,1816,1886,-70,-1,-57,78
-1,1190,1468,-278,-10,-556,76
1,1654,1718,-64,0,-51,69
-1,1966,2096,-130,0,-50,100
1,1876,1814,62,-1,60,77
-1,1500,1485,15,-4,-42,42
-1,1703,1528,175,3,21,42
-1,1851,1999,-148,0,-14,56
0,1618,1498,120,-1,-138,62
-1,1551,1548,3,-3,-160,64
-1,1798,1681,117,0,-66,84
1,1885,1621,264,0,20,61
-1,1238,1395,-157,-4,-53,46
-1,1239,1500,-261,-11,-457,68
-1,1676,1644,32,2,-90,78
-1,1615,1500,115,0,-136,81
1,1228,1402,-174,9,330,55
1,1578,1739,-161,2,28,45
-1,1076,1371,-295,-6,-189,56
-1,1542,1565,-23,0,-130,100
1,1704,1669,35,-3,-1,87
1,1695,1783,-88,0,-1,57
1,1720,1320,400,0,58,73
1,1690,1528,162,-7,69,61
-1,1378,1511,-133,2,-435,105
-1,1584,1535,49,1,-35,88
1,1258,1323,-65,9,312,53
1,1782,1630,152,1,76,67
1,1745,1755,-10,1,23,59
1,1542,1495,47,-3,-316,91
1,1750,1188,562,0,301,73
-1,1863,1958,-95,2,8,58
-1,1475,1610,-135,-3,-147,70
1,2066,1984,82,0,-2,47
1,1658,1714,-56,-1,-5,43
-1,1405,1433,-28,-1,-21,60
1,1558,1440,118,2,85,69
1,2193,1656,537,0,17,51
-1,1174,1509,-335,0,-161,86
1,1860,1788,72,4,151,65
-1,1543,1368,175,3,98,40
-1,1362,1597,-235,-1,-63,72
0,1477,1417,60,0,-343,126
-1,1297,1510,-213,-4,-19,41
1,1554,1600,-46,4,146,69
1,1812,1645,167,-2,-50,83
-1,1780,1871,-91,-7,-95,52
1,1680,1837,-157,-3,115,77
1,1270,1385,-115,2,43,43
-1,1881,1772,109,2,65,70
1,1636,1674,-38,1,41,59
-1,1746,1847,-101,0,-197,102
0,1513,1467,46,-1,-57,88
1,1855,1738,117,2,53,55
-1,1785,1864,-79,1,7,58
-1,1588,1582,6,1,22,48
1,1627,1869,-242,6,26,41
1,1821,1718,103,0,81,77
1,1696,1872,-176,0,122,133
-1,1433,1488,-55,-3,-264,73
-1,1596,1398,198,-2,-398,114
0,1651,1818,-167,-2,135,127
-1,1462,1435,27,0,-328,112
-1,1874,1777,97,-10,-33,92
-1,1502,1774,-272,-9,-639,82
1,1511,1469,42,4,327,97
-1,1638,1672,-34,-2,29,58
1,1502,1508,-6,-3,-63,51
1,1813,1656,157,4,98,45
1,1450,1415,35,2,84,53
1,1793,1498,295,5,1060,123
1,1858,1580,278,5,58,47
1,1682,1628,54,2,39,46
-1,1448,1769,-321,-2,-77,50
-1,1577,1862,-285,-1,-223,74
1,2195,1706,489,3,103,59
1,1597,1377,220,0,111,69
-1,1618,1692,-74,-5,-26,54
1,1583,1675,-92,12,787,73
1,1713,1601,112,3,36,43
1,1900,1404,496,0,28,57
-1,1418,1539,-121,-6,-337,74
1,1447,1418,29,0,-3,51
1,1867,1573,294,0,71,55
-1,1521,1459,62,-5,-367,94
-1,1546,1558,-12,-6,-87,48
-1,1357,1667,-310,0,21,60
1,1598,1659,-61,2,72,45
-1,1721,1593,128,-2,-75,104
1,1785,1716,69,-1,66,67
-1,1601,1708,-107,0,49,54
0,1778,1724,54,-1,-25,75
-1,1691,1636,55,-4,-38,50
1,1407,1459,-52,-2,-25,45
-1,1612,1596,16,-9,-120,40
-1,1508,1547,-39,0,-743,144
-1,1314,1863,-549,-3,-387,94
-1,1437,1912,-475,-2,-31,50
1,1677,1783,-106,-10,-85,63
1,1562,1409,153,0,70,61
1,1630,1678,-48,-2,-241,81
-1,1585,1723,-138,-1,-5,52
1,1768,1691,77,2,-7,47
1,1864,1313,551,0,-10,49
1,1600,1680,-80,5,31,41
-1,1682,1777,-95,-3,-53,54
-1,1469,1809,-340,-6,-592,90
-1,1786,1674,112,0,-22,44
-1,1706,1760,-54,-12,-270,51
1,1730,1578,152,1,15,45
-1,1854,1642,212,0,-52,56
-1,1568,1498,70,1,70,96
1,1689,1771,-82,-3,-130,63
-1,1731,1793,-62,-12,-610,78
1,1771,1689,82,14,212,45
-1,1614,1675,-61,-4,-59,62
-1,1722,1802,-80,1,-66,76
-1,1680,1780,-100,-1,-60,70
1,1466,1563,-97,2,103,59
-1,1360,1520,-160,-7,37,74
-1,1696,1676,20,-5,-196,70
-1,1714,1614,100,-3,-1153,134
-1,1667,1614,53,0,-52,104
1,1788,1672,116,12,348,57
-1,1350,1665,-315,5,200,66
1,1709,1620,89,0,228,97
-1,1665,1796,-131,-6,-167,50
1,1692,1701,-9,7,477,77
1,1810,1782,28,1,190,79
-1,1480,1541,-61,-1,-176,94
-1,1803,1658,145,0,12,50
1,1480,1418,62,7,660,89
1,1611,1717,-106,4,195,119
-1,1673,1787,-114,-1,-7,52
1,1704,1626,78,4,60,49
1,1770,1359,411,1,21,59
1,1511,1045,466,-3,-82,55
-1,1826,1704,122,-1,-20,110
-1,1357,1773,-416,1,234,70
-1,1617,1712,-95,1,5,40
-1,1795,1665,130,2,139,62
1,1712,1617,95,-3,109,67
1,1408,1489,-81,6,250,73
1,1689,1397,292,-1,-19,41
-1,1486,1559,-73,2,-3,61
-1,1784,1884,-100,-4,-214,84
-1,1775,2101,-326,-1,-75,78
1,1754,1554,200,0,13,60
1,1349,1501,-152,5,712,133
1,2101,1775,326,5,115,45
-1,1771,2105,-334,-4,-392,78
-1,1475,1423,52,0,64,62
1,1654,1548,106,-3,-63,41
-1,1545,1811,-266,0,-8,40
-1,1605,1608,-3,2,14,78
-1,1768,2109,-341,0,-71,68
1,2113,1765,348,1,23,49
-1,1662,1598,64,0,11,44
1,2116,1780,336,-2,-117,71
0,1734,1777,-43,0,927,248
-1,1465,1451,14,-2,-122,64
-1,1593,1397,196,2,44,60
-1,1444,1450,-6,1,-45,76
1,1383,1393,-10,5,10,51
-1,1511,1533,-22,0,67,60
-1,1777,2120,-343,-9,-31,56
-1,1421,1723,-302,-8,-5,54
1,1448,1640,-192,-1,-11,59
-1,1537,1819,-282,0,17,82
1,1684,1619,65,-1,-31,117
1,2124,1774,350,-6,-110,75
1,1726,1418,308,0,-8,40
-1,1771,2127,-356,0,1,56
1,1313,1517,-204,-3,-161,61
-1,1461,1533,-72,4,76,66
1,1918,1650,268,7,245,63
1,1823,1533,290,-3,-125,75
1,1510,1414,96,0,121,53
1,1808,1500,308,3,196,72
-1,1327,1503,-176,-5,-352,76
-1,1379,1396,-17,-9,-488,84
-1,1581,1611,-30,0,45,58
1,1473,1211,262,-8,-196,119
-1,1649,1730,-81,9,320,66
-1,1471,1526,-55,6,-268,108
0,1549,1452,97,-1,-380,90
-1,1359,1043,316,-2,-39,54
-1,1529,1827,-298,-2,-18,46
1,1853,1562,291,4,440,99
1,1685,1649,36,0,1,53
1,1516,1501,15,2,75,49
1,1402,1295,107,6,95,47
-1,1479,1610,-131,-1,4,66
1,1830,1526,304,1,18,47
1,1527,1490,37,-2,-3,81
1,1873,1640,233,0,-9,47
1,1769,1691,78,9,635,79
1,1857,2015,-158,1,120,79
-1,1464,1483,-19,1,-91,64
-1,1520,1469,51,-5,-383,100
1,1541,1462,79,8,324,63
-1,1522,1834,-312,-1,-8,40
-1,1321,1441,-120,-8,-362,74
-1,1879,1801,78,-3,-174,68
-1,1366,1589,-223,0,-85,60
1,1838,1518,320,1,26,51
1,1600,1635,-35,-3,-7,93
0,1340,1476,-136,-4,181,108
-1,1453,1530,-77,-1,-29,50
1,1448,1514,-66,-2,-54,55
-1,1481,1499,-18,0,1,66
-1,1515,1841,-326,0,-5,42
1,1501,1461,40,-2,32,51
1,1623,1623,0,3,309,63
1,1617,1651,-34,-1,-23,49
1,1461,1501,-40,3,107,57
-1,1516,1471,45,-2,-149,74
-1,1471,1621,-150,-1,-220,97
1,1929,1844,85,0,-3,118
-1,1932,1864,68,-3,-16,78
1,1511,1451,60,3,61,55
-1,1445,1346,99,0,-141,80
-1,1220,1360,-140,8,156,128
-1,1671,1522,149,0,-348,88
1,1483,1497,-14,8,402,79
-1,1900,1520,380,-20,-527,46
-1,1842,1862,-20,-10,-147,52
-1,1768,1830,-62,-1,-11,56
-1,1773,1650,123,-14,-665,60
-1,1565,1719,-154,2,58,62
1,1875,1759,116,-5,-175,71
1,1480,1495,-15,5,331,83
-1,1664,1840,-176,0,-113,78
1,1576,1500,76,-3,-32,53
1,1998,1879,119,0,77,97
-1,1826,1945,-119,0,29,110
-1,1483,1658,-175,-2,-28,78
0,1431,1603,-172,-5,-878,119
-1,1501,1628,-127,-2,-392,98
-1,1079,1500,-421,-7,-93,44
-1,1573,1297,276,-5,-351,88
1,1667,1681,-14,2,14,41
-1,1410,1629,-219,-3,-89,60
-1,1603,1847,-244,-5,-131,50
-1,1689,1657,32,-4,-155,50
-1,1444,1491,-47,1,67,100
1,1812,1368,444,7,267,57
1,1582,1487,95,-1,273,87
1,1677,1670,7,-1,-6,75
-1,1878,1719,159,2,-25,54
0,1760,1846,-86,-8,31,145
1,1871,1725,146,0,10,41
1,1458,1472,-14,2,387,99
1,1627,1500,127,-1,80,81
-1,1658,1688,-30,-1,-148,84
1,1228,1447,-219,0,5,59
-1,1861,1434,427,-5,-117,50
1,1726,1370,356,4,139,55
1,1805,1953,-148,1,-30,69
-1,1450,1507,-57,-5,-130,58
1,1940,2006,-66,-1,-40,99
1,1726,1730,-4,2,84,65
-1,1572,1974,-402,-2,-141,58
1,1820,1937,-117,1,8,45
1,1814,1625,189,0,132,69
1,1756,1650,106,2,165,119
-1,1340,1411,-71,4,-161,88
1,1289,1258,31,1,72,69
-1,1593,1545,48,2,23,52
-1,1479,1479,0,-2,-15,58
1,1500,1619,-119,1,142,85
1,1930,1698,232,-1,-50,45
1,1605,1401,204,-2,123,51
0,1642,1688,-46,0,57,209
-1,1628,1810,-182,-3,-324,106
1,1491,1518,-27,3,74,59
-1,1433,1567,-134,0,1,44
-1,1640,1566,74,-1,-9,94
1,1288,1301,-13,2,98,63
1,1433,1500,-67,3,139,67
-1,1907,2102,-195,1,-27,62
-1,1288,1318,-30,-7,-359,70
1,1816,1622,194,1,114,75
1,1366,1482,-116,0,-45,75
-1,1584,1430,154,-5,-104,44
-1,1463,1550,-87,-3,-90,64
-1,2019,2112,-93,-2,-28,56
1,1595,1446,149,2,111,55
1,1687,1644,43,8,555,99
1,2127,2010,117,0,4,47
1,2003,1751,252,0,52,99
1,1573,1641,-68,4,173,58
1,2010,2127,-117,0,455,155
-1,1784,1607,177,1,21,50
1,1475,1334,141,0,627,239
-1,1776,1708,68,-4,-345,82
-1,1278,1344,-66,-11,-141,46
-1,1693,1871,-178,0,0,40
1,1974,1876,98,-1,-16,47
-1,1817,1747,70,0,-120,78
1,2102,2003,99,-1,116,65
1,1589,1263,326,-4,-225,87
1,1633,1607,26,3,119,47
-1,1583,1615,-32,1,-147,108
-1,1518,1517,1,-3,-522,118
-1,1868,2001,-133,0,-88,98
1,1490,1579,-89,9,228,52
-1,1452,1588,-136,-3,-99,61
-1,1525,1737,-212,-3,-236,80
-1,1877,1703,174,0,70,78
-1,1511,1611,-100,-4,-57,52
-1,1953,1994,-41,0,-347,146
1,1715,1648,67,0,20,83
-1,1861,1804,57,0,23,52
-1,1482,1617,-135,-1,-142,68
1,1633,1592,41,0,134,143
1,1595,1442,153,0,152,113
-1,1259,1634,-375,-2,-60,60
1,1786,1546,240,0,-138,87
-1,1857,1864,-7,-1,-393,106
1,1817,1849,-32,0,35,63
-1,1943,2004,-61,0,-38,76
1,1833,1745,88,0,329,71
-1,1528,1507,21,-3,-715,112
1,1616,1527,89,-1,-7,43
-1,1835,1799,36,0,44,76
1,1705,1460,245,13,319,51
1,1417,1509,-92,-8,-194,135
1,1429,1327,102,0,102,107
-1,1344,1925,-581,-13,-353,42
-1,1837,1828,9,0,-85,128
-1,2127,1723,404,-3,-98,106
-1,1762,1634,128,2,-263,141
1,1664,1256,408,-4,-191,129
1,1707,1610,97,-8,35,43
1,1812,1823,-11,0,168,101
-1,1874,1853,21,0,15,58
1,1627,1542,85,0,9,97
1,1701,1616,85,-1,32,59
1,1732,1672,60,-2,193,115
1,1697,1765,-68,-1,-7,51
-1,1482,1570,-88,-3,-102,52
1,1668,1291,377,3,301,79
-1,1228,1158,70,-5,-148,68
-1,1239,1314,-75,-9,-255,70
1,1713,1698,15,0,26,50
-1,1482,1458,24,2,64,64
-1,1250,1564,-314,0,-12,52
-1,1446,1446,0,-3,-116,90
-1,1753,1715,38,-2,-62,64
1,1289,1670,-381,5,88,51
-1,1530,1553,-23,1,12,44
1,1545,1704,-159,-1,-19,67
0,1471,1470,1,0,-19,61
-1,1730,1741,-11,0,12,52
1,1598,1488,110,0,25,49
1,1175,1181,-6,0,4,75
1,1470,1471,-1,1,607,87
-1,1180,1311,-131,-24,-652,48
-1,1176,1204,-28,-3,-423,90
1,1630,1751,-121,-4,83,59
-1,1366,1515,-149,7,182,72
-1,1317,1983,-666,-4,-121,54
-1,1481,1606,-125,-1,-138,64
0,1504,1565,-61,-4,-539,78
-1,1481,1516,-35,-1,-31,108
1,1167,1254,-87,-2,80,65
1,1623,1736,-113,1,11,43
-1,1613,1802,-189,-1,-10,58
-1,1622,1649,-27,-3,-123,60
1,1790,1358,432,7,202,53
-1,1717,1864,-147,-2,-65,48
-1,1636,1666,-30,1,62,66
-1,1455,1759,-304,0,27,56
1,1676,1563,113,0,92,95
1,1762,1423,339,-1,48,55
1,2191,1417,774,0,19,57
1,1699,1647,52,2,162,65
1,1423,1762,-339,-2,-53,71
1,1355,1356,-1,1,224,69
1,1792,1607,185,1,134,127
1,1827,1760,67,0,-7,69
1,2192,1748,444,2,128,73
1,1807,1665,142,-4,8,59
-1,1342,1370,-28,-2,-57,48
-1,1684,1554,130,-1,-68,80
-1,1577,1474,103,4,33,46
1,1641,1643,-2,0,-30,55
1,1377,1271,106,-4,-84,67
1,1555,1508,47,-3,6,53
1,1826,1751,75,-1,-71,87
1,1659,1572,87,2,75,63
-1,1384,1330,54,7,146,74
1,1149,1353,-204,0,90,49
-1,1606,1626,-20,-3,-464,114
-1,1602,1799,-197,0,-263,154
-1,1715,1632,83,0,1,52
1,1818,1331,487,7,190,67
-1,1637,1632,5,-2,54,92
1,1657,1722,-65,0,-33,89
1,1260,1329,-69,6,59,40
0,1669,1675,-6,0,4,113
1,1400,1464,-64,5,107,53
-1,1341,1395,-54,1,-23,46
0,2159,1497,662,2,334,150
1,1500,1453,47,-1,-39,57
-1,1741,1756,-15,0,74,116
1,1308,1175,133,1,77,61
1,1331,1270,61,5,333,71
-1,1318,1896,-578,-3,-100,58
-1,1668,1562,106,-1,-496,88
1,1607,1359,248,-2,-14,43
1,1732,1663,69,0,-136,75
-1,1445,1737,-292,0,4,62
-1,1776,1723,53,0,18,64
0,1766,1730,36,-3,-35,115
-1,1661,1859,-198,-13,-402,52
-1,1508,1673,-165,2,335,108
-1,1677,1953,-276,-2,-40,50
1,1805,1596,209,3,47,55
-1,1438,1744,-306,-1,-117,56
1,1386,1360,26,-1,20,77
1,1675,1597,78,-2,71,59
-1,1359,1345,14,-4,-384,74
-1,1653,1579,74,1,-44,51
1,1622,1672,-50,3,119,57
0,1732,1765,-33,0,90,160
1,1471,1656,-185,0,-1,57
1,1433,1247,186,0,-7,53
-1,1431,1750,-319,0,72,100
1,1584,1319,265,-3,124,79
-1,1818,1871,-53,0,-28,68
-1,1837,1673,164,-1,19,64
1,1664,1818,-154,0,-1,49
-1,1586,1502,84,0,-56,60
1,1600,1645,-45,0,355,145
1,1823,1932,-109,3,86,51
1,1754,1428,326,1,261,103
1,1764,1733,31,0,11,61
-1,1803,1679,124,-6,-119,52
1,1918,1837,81,-2,-243,111
-1,1424,1757,-333,0,-30,80
1,1593,1510,83,0,27,45
1,1694,1789,-95,1,104,60
1,1723,1563,160,0,63,87
1,1397,1500,-103,4,268,83
-1,1504,1489,15,3,138,70
1,2107,1659,448,1,64,57
-1,1479,1603,-124,-4,-160,102
-1,1946,1786,160,-4,-93,48
-1,2141,1719,422,1,-43,108
-1,1612,1686,-74,-2,-178,100
-1,1356,1662,-306,-11,-437,52
1,1618,1740,-122,-1,-10,71
1,1369,1405,-36,-5,-152,53
1,1631,1612,19,-2,-245,107
1,1775,1814,-39,1,131,53
1,1811,1702,109,0,5,69
1,1655,1657,-2,0,118,69
1,1662,1299,363,6,299,71
1,2109,1937,172,3,98,55
1,1729,1798,-69,1,279,78
-1,1692,1669,23,-5,-327,88
1,1708,1423,285,0,25,56
-1,1625,1734,-109,0,-23,102
1,1540,1393,147,1,54,87
-1,1382,1369,13,-5,-111,52
-1,1574,2119,-545,-1,-30,50
-1,1533,1645,-112,-4,-254,80
-1,1667,1703,-36,0,-31,62
-1,1612,1455,157,0,2,42
-1,1617,1742,-125,0,-71,64
-1,1602,1727,-125,0,58,74
-1,1834,1664,170,-1,-78,76
1,1667,1352,315,12,334,49
-1,1481,1643,-162,-9,-149,48
-1,1407,1645,-238,-4,-53,62
1,1555,1421,134,-2,-52,71
1,1630,1619,11,-3,-61,61
-1,1690,1573,117,0,-5,56
-1,1525,1687,-162,0,-126,80
1,1749,1609,140,-2,-32,65
1,1386,1550,-164,3,80,65
1,2123,1669,454,9,114,41
1,1708,1500,208,15,691,61
-1,1931,1811,120,-4,-54,44
-1,1815,1483,332,-9,-19,62
-1,1694,1820,-126,2,154,82
-1,1919,1695,224,0,-103,84
-1,1602,1756,-154,-2,-6,40
1,1519,1416,103,0,10,51
-1,1175,1387,-212,-2,-71,64
-1,1827,1927,-100,0,42,79
1,1589,1674,-85,-2,89,71
-1,1603,1694,-91,1,179,116
-1,1348,1306,42,-3,-18,40
-1,1595,1732,-137,-1,-14,67
1,2126,1728,398,-2,42,51
1,1702,1596,106,0,-8,67
1,1526,1381,145,5,390,77
-1,1440,1500,-60,-2,-107,58
1,1527,1381,146,1,-74,61
-1,1559,1831,-272,-7,-535,100
1,1608,1486,122,3,28,43
1,1503,1392,111,11,212,51
-1,1494,1641,-147,-2,-25,52
-1,1374,1534,-160,-1,-6,74
1,1413,1910,-497,0,47,77
1,1828,1739,89,3,839,223
-1,1209,1328,-119,-16,-254,48
1,1724,1471,253,2,139,73
1,1835,1552,283,2,146,81
1,1574,1510,64,-1,-25,53
-1,1913,2133,-220,-1,-104,76
0,1760,1885,-125,-3,-153,119
-1,1557,1588,-31,-1,-110,79
-1,1437,1718,-281,-6,-128,52
1,1583,1650,-67,-1,30,53
1,1541,1453,88,2,159,77
1,1437,1166,271,5,107,53
1,1816,1764,52,1,143,117
1,1729,1467,262,3,74,61
1,1722,1432,290,0,77,83
1,2141,1501,640,2,60,75
1,1740,1647,93,2,117,63
-1,1597,1468,129,-3,-19,76
-1,1444,1549,-105,4,131,64
1,1349,1335,14,-6,-41,41
0,1825,1754,71,-11,-390,105
1,2142,1807,335,1,92,69
0,1347,1310,37,-1,614,149
-1,1583,1522,61,-3,73,94
1,1828,1733,95,-4,-103,71
-1,1462,1501,-39,0,-100,50
-1,1500,1428,72,-2,-131,72
0,1793,1908,-115,0,-3,148
1,1823,1756,67,2,31,55
1,1756,1823,-67,1,71,47
1,1636,1596,40,3,57,62
1,1659,1489,170,-6,-56,48
1,2147,2125,22,-1,31,59
1,1832,1747,85,-3,-23,67
1,1988,1836,152,2,29,57
1,1536,1480,56,3,55,89
-1,1321,1546,-225,-1,-2,40
1,1840,1738,102,1,199,109
-1,1830,2163,-333,-4,-173,66
-1,1272,1444,-172,1,77,48
1,1466,1367,99,1,76,59
-1,1315,1554,-239,2,28,42
1,1827,1905,-78,0,21,63
-1,1598,1537,61,0,-19,68
-1,1393,1211,182,-4,-90,58
-1,1339,1662,-323,0,-55,44
-1,1563,1474,89,-1,-75,110
-1,1840,1892,-52,0,-38,66
1,1665,1639,26,1,30,63
1,2168,1946,222,1,77,81
1,1551,1585,-34,-3,-174,87
1,1404,1650,-246,1,32,61
1,1313,1345,-32,2,17,49
-1,1735,1500,235,-3,-138,58
1,1901,1831,70,0,0,49
-1,1336,1551,-215,-12,-42,40
-1,1359,1475,-116,-9,-270,62
-1,1822,1910,-88,-1,-35,50
1,1942,1865,77,-1,-15,67
-1,1573,1563,10,-1,-142,86
-1,1837,1500,337,-5,-16,42
-1,1918,1814,104,1,8,90
1,1671,1542,129,0,297,117
1,1488,1549,-61,0,65,75
1,1706,1476,230,1,59,65
-1,1331,1411,-80,-1,-330,130
1,1575,1561,14,4,-22,73
1,1778,1856,-78,2,153,115
1,1950,1904,46,0,114,103
1,1675,1628,47,-5,57,161
-1,2113,1684,429,-2,-35,50
1,1511,1351,160,-7,425,103
1,1332,1228,104,3,165,43
-1,1915,2084,-169,-4,-117,102
1,1824,1408,416,6,261,62
-1,1708,1661,47,-2,1,48
1,1402,1438,-36,3,210,95
1,1536,1501,35,-1,741,127
-1,1909,2093,-184,-1,-134,84
1,1542,1484,58,-1,-26,48
1,1810,1687,123,3,71,47
-1,1678,1616,62,2,-29,100
1,2101,1919,182,2,55,43
1,1919,2101,-182,-1,-40,63
-1,1647,1903,-256,-1,-15,54
1,2079,1934,145,0,13,61
1,1326,1555,-229,6,174,55
1,1640,1907,-267,5,517,113
-1,1928,2088,-160,0,-74,104
-1,1332,1406,-74,-2,3,84
-1,1742,2178,-436,0,-37,86
1,1826,1577,249,4,138,59
1,1889,1667,222,0,109,71
-1,1551,1586,-35,-2,-106,76
1,2096,1922,174,3,107,49
-1,1916,2104,-188,0,-33,88
1,1792,1895,-103,2,117,55
1,1344,1496,-152,4,118,53
1,1673,1533,140,-5,-95,135
-1,1347,1533,-186,-5,-217,54
-1,1574,1577,-3,-2,-391,150
1,1894,1911,-17,-2,-88,87
1,1665,1942,-277,0,89,91
1,1491,1546,-55,-2,377,147
1,1670,1250,420,2,120,69
1,1806,1881,-75,1,317,117
-1,1583,1641,-58,-4,-116,58
-1,1695,1680,15,-8,-158,62
-1,1900,1906,-6,-4,-34,54
-1,1733,1820,-87,2,24,54
-1,1910,1917,-7,-3,-105,94
1,1740,1843,-103,0,19,89
1,1823,1387,436,8,260,57
-1,1482,1928,-446,-3,14,78
1,1683,1692,-9,5,83,51
-1,1415,1322,93,-3,-53,53
-1,1431,1667,-236,-2,-266,103
-1,1868,1819,49,-2,-161,86
-1,1434,1360,74,1,-48,54
1,2118,1895,223,1,131,67
-1,1587,1540,47,1,201,82
1,1694,1492,202,2,27,57
1,1684,1685,-1,-2,27,81
-1,1890,2124,-234,0,-30,74
1,1424,1501,-77,7,184,47
1,1874,1735,139,1,95,77
1,2047,1930,117,-2,-43,53
-1,1676,1650,26,0,-30,48
-1,1681,1725,-44,-8,-234,42
1,1672,1426,246,0,368,81
0,1831,1856,-25,2,69,208
-1,1374,1408,-34,-10,-306,56
1,2056,1922,134,0,343,71
-1,1699,1828,-129,-2,1,40
1,1338,1401,-63,2,-10,53
1,1864,1625,239,1,187,105
1,1709,1414,295,0,36,53
1,1976,1994,-18,0,150,95
-1,1823,1815,8,0,-83,142
1,1519,1516,3,-2,-55,64
-1,1091,1318,-227,-8,-311,60
-1,1410,1713,-303,-4,-31,45
1,1911,1933,-22,0,-212,111
1,1811,1823,-12,-2,-151,93
1,1717,1406,311,-1,10,53
1,1765,1571,194,0,189,77
-1,1839,1826,13,-3,-60,58
1,1922,1924,-2,0,5,49
1,1268,1397,-129,3,147,59
1,1324,1059,265,10,429,61
1,1748,2102,-354,0,9,69
1,1912,1933,-21,0,569,151
-1,1569,1575,-6,-7,-236,66
-1,1403,1565,-162,3,59,82
1,1837,1828,9,0,-7,61
-1,1925,1922,3,-4,-39,78
1,1692,1642,50,3,504,85
0,1441,1433,8,3,302,174
1,1720,1571,149,1,870,131
1,1888,1395,493,10,568,75
1,1932,1913,19,0,63,47
-1,1913,1932,-19,1,43,72
1,1935,1820,115,2,12,43
-1,1394,1890,-496,0,41,56
-1,1530,1443,87,-4,-273,92
-1,1202,1710,-508,-3,-8,52
1,1942,1902,40,6,227,77
1,1620,1431,189,3,519,91
-1,1552,2134,-582,-4,-67,50
-1,1818,1847,-29,0,-56,68
0,1935,2083,-148,0,-127,129
1,1365,1392,-27,2,58,47
1,1891,1951,-60,-5,-304,79
-1,1036,1240,-204,-18,-701,60
1,1758,1312,446,0,2,49
-1,1679,1558,121,0,19,70
1,1633,1701,-68,0,-33,111
-1,1381,1551,-170,-4,-43,42
-1,1939,1905,34,0,-64,112
1,1920,1989,-69,-1,-85,123
-1,1284,1581,-297,4,31,110
1,1943,1790,153,-1,52,91
1,1557,1374,183,-1,53,49
-1,1857,1808,49,3,42,52
1,1928,1918,10,0,13,51
-1,1699,1760,-61,4,28,46
1,1367,1563,-196,0,-7,73
1,1633,1581,52,0,160,65
1,1844,1833,11,-3,-95,74
0,1906,1938,-32,3,157,118
-1,1939,2077,-138,-6,-190,72
-1,1619,1516,103,1,-375,112
1,1610,1518,92,-4,-21,93
1,1546,1386,160,0,52,61
1,1820,1845,-25,0,32,63
-1,1937,1907,30,-4,-74,46
-1,1594,1532,62,3,6,54
-1,1379,1553,-174,-2,115,62
0,1653,1533,120,0,-9,124
-1,1381,1500,-119,1,-118,70
1,1920,1926,-6,-2,-156,77
1,1559,1372,187,4,207,55
-1,1651,1869,-218,7,337,94
-1,1649,2096,-447,-2,-77,60
-1,1915,1931,-16,0,43,58
1,1310,1458,-148,4,145,53
-1,1573,1558,15,0,-30,74
-1,1530,1605,-75,-2,-2,62
1,1366,1565,-199,3,136,51
-1,1942,1905,37,2,-122,94
1,1834,1831,3,-2,61,69
-1,1823,1855,-32,2,34,49
1,1548,1385,163,6,238,69
1,1573,1664,-91,3,254,75
1,1994,1663,331,4,98,59
-1,1917,1929,-12,1,-7,106
-1,1378,1554,-176,1,15,66
1,1442,1434,8,0,226,135
1,1613,1521,92,0,16,87
-1,1940,1907,33,0,-21,68
-1,1510,1619,-109,2,20,74
1,1560,1371,189,-1,71,71
-1,1572,2054,-482,1,-53,84
1,1328,1480,-152,-1,545,157
-1,1918,1928,-10,0,-233,134
0,1645,1625,20,0,101,115
1,1537,1679,-142,0,-30,87
-1,1365,1566,-201,-2,-19,60
1,1821,1844,-23,0,-22,75
-1,1222,1252,-30,0,-62,156
-1,1531,1660,-129,0,59,52
-1,1443,1566,-123,4,2,66
-1,1561,1450,111,-1,-20,50
-1,1939,1908,31,0,39,64
1,1572,1359,213,2,45,45
-1,1929,1973,-44,-1,-112,84
1,1513,1622,-109,-1,-103,101
1,1312,1478,-166,-10,-347,55
-1,1341,1478,-137,0,-65,110
1,2056,1783,273,3,505,99
1,1502,1627,-125,-2,105,115
1,1686,1480,206,1,-1,41
-1,1927,1664,263,3,25,46
1,1375,1402,-27,16,849,67
-1,1778,2060,-282,-4,-140,66
-1,1464,1586,-122,-6,-206,76
-1,1691,1909,-218,2,53,48
1,1642,1853,-211,1,269,103
1,1712,1475,237,0,84,67
-1,1681,1659,22,-5,-492,88
1,1914,1684,230,-1,-102,73
1,2064,1774,290,0,203,97
-1,1833,1832,1,-2,136,128
1,1607,1528,79,1,108,99
-1,1933,1667,266,-2,-238,82
-1,1769,2068,-299,-5,-69,68
-1,1655,2000,-345,0,-69,152
-1,1490,1464,26,0,-27,70
1,1612,1517,95,3,66,53
1,1521,1435,86,0,-24,139
-1,1377,1387,-10,-4,-702,123
1,2072,1765,307,0,-7,45
-1,1451,1439,12,0,-5,50
1,1519,1616,-97,1,39,95
1,2075,1761,314,-2,61,75
1,1735,1742,-7,2,104,71
-1,1252,1336,-84,1,42,64
-1,1342,1596,-254,-1,-149,142
-1,1757,2079,-322,0,215,88
-1,1331,1404,-73,-5,-90,46
1,1456,1691,-235,0,-22,67
1,1673,1470,203,2,182,77
0,1672,1669,3,-8,146,152
1,1748,1214,534,5,461,97
1,1365,1509,-144,-2,-136,62
-1,1885,1984,-99,0,22,88
-1,1646,1675,-29,-1,-99,71
-1,1467,1450,17,4,62,82
-1,1822,2023,-201,-5,-32,68
1,2082,1753,329,0,-1,59
-1,1602,1533,69,0,296,88
-1,1975,1818,157,-5,-200,64
1,1790,1750,40,0,-12,57
1,1679,1464,215,1,126,79
-1,1437,1622,-185,0,-57,112
1,1861,1717,144,0,31,63
1,1677,1403,274,1,105,121
0,1738,1812,-74,0,260,112
1,1370,1641,-271,1,0,41
-1,1372,1474,-102,-1,-57,68
-1,1667,1508,159,-5,-35,50
1,1623,1400,223,-1,447,115
1,1911,1635,276,1,143,87
1,1807,1741,66,-8,-100,67
-1,1546,1589,-43,-2,-196,88
1,1411,1271,140,-5,376,101
1,1660,1685,-25,0,16,63
1,1760,1817,-57,-1,79,73
-1,1602,1462,140,-11,-38,44
-1,1714,1684,30,0,-80,68
-1,1730,1826,-96,0,39,92
-1,1399,1832,-433,0,22,86
-1,1722,1787,-65,-6,-90,54
1,1545,1645,-100,1,27,71
1,1407,1384,23,1,185,77
1,1594,1398,196,5,108,43
-1,1306,1334,-28,-6,-139,56
1,1636,1449,187,1,402,101
1,1500,1453,47,-2,106,69
-1,1710,1555,155,0,-76,78
0,1960,1931,29,2,66,187
-1,1723,1123,600,0,105,68
1,1586,1418,168,2,110,59
-1,1384,1292,92,2,-62,114
-1,1393,1694,-301,-1,-241,110
1,1702,1696,6,4,185,71
-1,1408,1453,-45,-5,-111,52
-1,1484,1478,6,-1,-45,58
-1,1919,2086,-167,-2,-117,62
-1,1631,1916,-285,-4,-158,94
-1,1673,1671,2,-1,-723,140
0,1491,1507,-16,-2,-81,118
-1,1723,1913,-190,1,188,82
1,1500,1593,-93,-2,-34,59
0,1504,1585,-81,0,18,96
-1,1446,1653,-207,-2,-336,104
0,1409,1467,-58,-4,-150,104
1,1426,1528,-102,5,232,69
1,1597,1495,102,3,139,64
1,1918,1716,202,-5,-130,55
1,1805,1659,146,-2,493,137
1,1500,1524,-24,0,-12,65
-1,1940,1993,-53,0,-138,96
1,1750,1363,387,3,248,95
1,1692,1492,200,1,41,63
-1,1936,1959,-23,-1,-122,126
-1,1710,1924,-214,0,74,80
1,1245,1344,-99,-4,-117,47
-1,1391,1619,-228,-2,-240,94
1,1390,1458,-68,-2,-24,66
-1,1332,1704,-372,-5,-31,52
1,1514,1772,-258,1,59,57
1,1582,1507,75,-1,15,131
0,1920,1627,293,0,-326,152
-1,1440,1490,-50,-1,-70,66
-1,1652,1811,-159,0,54,102
-1,1464,1606,-142,-2,-255,140
1,1929,1820,109,0,-11,61
-1,1443,1642,-199,-10,-776,86
-1,1441,1467,-26,-1,56,136
0,1507,1558,-51,2,323,203
-1,1571,2093,-522,-9,-396,60
1,1698,1500,198,4,42,41
1,1970,1884,86,-5,-83,73
1,1713,1248,465,1,25,47
1,1507,1491,16,-2,113,65
1,1500,1570,-70,-1,223,103
1,1812,1937,-125,0,264,121
1,1430,1500,-70,2,25,45
-1,1694,1687,7,0,-9,66
-1,1922,1827,95,-9,-713,78
-1,1245,1715,-470,-13,-180,44
1,1650,1508,142,3,52,42
-1,1591,1703,-112,0,-45,72
1,1818,1646,172,2,120,70
1,1717,1242,475,0,4,51
-1,1682,1662,20,-3,-172,74
1,1842,1908,-66,-3,-77,49
-1,1423,1602,-179,-11,-226,44
1,1592,1226,366,3,169,67
1,1486,1443,43,-2,12,95
1,1895,1855,40,2,17,45
-1,1462,1620,-158,-3,-62,58
1,1713,1688,25,0,20,53
0,1122,1329,-207,0,-64,81
-1,1679,1824,-145,-1,24,46
-1,1905,1845,60,2,0,62
-1,1858,1914,-56,-4,19,62
1,1881,1672,209,-2,-68,71
1,1431,1416,15,7,188,45
0,1645,1763,-118,0,0,134
1,1823,1628,195,0,2,71
1,1923,1848,75,0,-22,67
-1,987,1440,-453,-10,-853,82
-1,1667,1918,-251,1,24,58
-1,1404,1496,-92,-12,-331,53
-1,1635,1865,-230,0,-89,64
-1,1539,1718,-179,-3,-12,44
-1,1840,1932,-92,-7,-36,40
-1,1945,1662,283,-2,-172,56
-1,1327,1392,-65,-2,-38,56
1,1796,1685,111,0,16,69
-1,1932,1840,92,-3,-254,84
1,1627,1273,354,7,79,51
1,1712,1498,214,3,96,56
1,1529,1589,-60,8,235,53
1,1441,1254,187,-5,-232,61
1,1656,1674,-18,0,549,109
-1,1337,1395,-58,-5,-391,74
1,1726,1940,-214,0,41,61
-1,1807,1674,133,0,-219,150
-1,1317,1841,-524,-10,-813,90
1,1793,1640,153,1,105,139
1,1607,1629,-22,3,78,55
-1,1677,1804,-127,-1,-14,46
-1,1718,1843,-125,0,-31,72
0,1844,1923,-79,1,459,133
0,1870,1630,240,-1,89,162
-1,1612,1980,-368,-3,-49,52
-1,1308,1352,-44,-3,-477,92
1,1565,1541,24,3,164,65
-1,1921,1848,73,-6,-304,84
1,1345,1811,-466,-2,100,67
0,1560,1500,60,0,-171,153
1,1967,1767,200,0,180,93
-1,1602,1753,-151,0,-17,84
1,1460,1379,81,-1,-24,101
-1,1270,1399,-129,-2,-46,50
-1,1308,1488,-180,0,-14,86
-1,1447,1404,43,-4,-695,116
1,1634,1908,-274,-3,4,65
-1,1469,1410,59,-2,-402,88
1,1850,1710,140,0,13,55
1,1298,1312,-14,3,155,61
1,1890,1653,237,1,-2,51
0,1618,1632,-14,-1,-104,116
-1,1984,1785,199,0,4,84
-1,1649,1894,-245,2,5,74
-1,1385,1574,-189,-3,-112,67
1,1395,1093,302,2,799,113
1,1657,1670,-13,-1,-54,63
-1,1307,1468,-161,-11,-248,78
1,1588,1759,-171,9,384,65
-1,1702,1856,-154,0,-17,64
1,1899,1644,255,0,279,89
-1,1510,1686,-176,0,-559,168
1,1502,1406,96,2,25,67
-1,1453,1674,-221,-1,-21,48
1,1790,1633,157,0,4,55
1,1182,1369,-187,5,815,175
-1,1417,1435,-18,0,-17,78
1,1841,1500,341,-2,33,81
-1,1439,1616,-177,4,81,64
-1,1639,1903,-264,0,-681,116
1,1629,1364,265,-2,574,141
-1,1602,1649,-47,0,13,40
1,1662,1668,-6,-1,119,79
-1,1531,1583,-52,5,232,74
-1,1649,1874,-225,0,-42,80
1,1907,1635,272,-1,-81,63
1,1534,1731,-197,0,72,55
1,1973,1750,223,-3,-70,111
1,1749,1347,402,2,86,59
-1,1631,1911,-280,1,-44,68
1,1742,1605,137,-1,10,71
1,1805,1685,120,0,-10,97
1,1299,1406,-107,2,119,54
-1,1897,1802,95,1,62,78
1,1631,1618,13,0,-6,55
-1,1445,1578,-133,-4,-220,78
-1,1797,1713,84,-2,218,114
-1,1647,1726,-79,-9,-221,67
-1,1644,1888,-244,-1,-44,70
1,1425,1229,196,6,1213,111
-1,1778,2138,-360,0,-75,60
1,1580,1376,204,0,156,61
-1,1359,1717,-358,0,-7,42
-1,1761,1469,292,-2,-19,52
-1,1739,1627,112,-7,-223,58
1,1262,1306,-44,-6,221,161
0,1545,1642,-97,0,-290,149
-1,1599,1522,77,-2,-381,138
1,1735,1869,-134,1,34,47
-1,1089,1402,-313,-6,-71,78
1,1695,1575,120,0,-3,111
1,2128,1721,407,0,142,87
-1,1328,1500,-172,-3,-25,44
1,2142,1776,366,1,123,111
1,1598,1749,-151,0,260,73
1,1893,1639,254,5,116,93
-1,1816,1883,-67,1,-4,88
-1,1647,1359,288,-9,-462,62
1,1479,1610,-131,-2,-91,85
1,1700,1504,196,0,282,165
1,1621,1747,-126,-1,3,53
1,1639,1548,91,0,68,95
0,1651,1631,20,-1,-52,168
-1,1718,2130,-412,-1,-25,50
1,1729,1637,92,0,-2,45
1,1572,1663,-91,-1,-20,85
1,1752,1595,157,4,128,65
-1,1398,1573,-175,0,-28,84
1,1735,1638,97,0,-9,63
-1,1515,1367,148,0,2,56
-1,1345,1301,44,2,14,70
1,1585,1500,85,-6,-185,97
0,1862,1853,9,1,35,107
1,1738,1716,22,0,-29,53
-1,1572,1685,-113,-3,-207,93
1,1892,1807,85,0,90,59
1,1704,1751,-47,4,118,59
1,1736,1718,18,-2,24,67
-1,2150,1897,253,0,25,82
1,1798,1900,-102,0,46,91
-1,1434,1488,-54,-1,-126,60
1,1754,1812,-58,2,68,83
1,1706,1748,-42,2,89,69
1,1771,1962,-191,-4,-78,55
-1,1458,1486,-28,2,-63,78
1,1392,1445,-53,-2,42,65
-1,1755,1829,-74,0,-8,64
1,1734,1720,14,7,-18,47
1,1494,1548,-54,1,14,48
0,1761,1536,225,-10,-84,134
-1,1743,1915,-172,0,-8,70
-1,1371,1431,-60,-4,-260,92
-1,1617,1712,-95,-2,-153,76
1,1423,1664,-241,-1,-14,50
1,1886,1812,74,0,10,45
1,1854,1746,108,9,206,57
1,1637,1651,-14,0,2,46
-1,1737,1861,-124,-1,-129,72
1,1760,1417,343,4,89,43
1,2044,1468,576,4,116,59
-1,1557,1547,10,1,-118,126
1,1721,1350,371,0,75,145
-1,1362,1637,-275,-15,-192,44
1,1595,1712,-117,1,174,115
1,1869,1729,140,-1,259,109
-1,1769,1862,-93,0,58,72
1,1588,1320,268,0,-5,53
-1,1329,1499,-170,-4,-85,52
-1,1338,1500,-162,-7,-297,62
-1,1804,1895,-91,0,-151,94
-1,1431,1306,125,-5,-35,44
-1,1490,1722,-232,-2,-615,92
1,1496,1440,56,-1,98,107
1,1586,1568,18,0,48,97
-1,1778,1798,-20,1,-27,70
1,1591,1529,62,2,45,41
-1,1385,1812,-427,-1,-57,50
1,1613,1727,-114,3,312,81
1,1599,1497,102,2,16,49
-1,1485,1648,-163,3,88,72
0,1475,1048,427,-3,-24,103
1,1759,1870,-111,1,13,55
1,1332,1500,-168,5,327,55
-1,1746,1837,-91,0,-18,62
-1,1711,1628,83,1,28,62
-1,1498,1543,-45,0,-204,126
1,1477,1223,254,14,351,45
-1,1590,1505,85,-3,-50,86
1,1744,1560,184,1,-4,41
0,1641,1696,-55,-1,-258,139
1,1500,1613,-113,1,37,49
1,1740,1462,278,-1,-6,55
1,1490,1646,-156,6,138,51
0,1647,1507,140,3,157,94
1,1776,1856,-80,0,13,47
1,1694,1643,51,-1,463,125
-1,1601,1761,-160,-2,-91,102
-1,1788,1783,5,-3,-337,86
-1,1628,1729,-101,-4,-31,40
-1,1692,1814,-122,0,-138,94
1,1724,1456,268,1,68,59
-1,1634,1704,-70,0,-227,84
1,1596,1409,187,3,69,51
-1,1492,1620,-128,-4,-227,70
1,1713,1777,-64,6,244,49
-1,1500,1182,318,0,-110,68
-1,1287,1316,-29,-5,-16,53
1,1659,1845,-186,0,-40,121
-1,1566,1504,62,3,122,72
-1,1791,1843,-52,0,-6,82
1,1467,1634,-167,4,113,45
1,1486,1213,273,4,114,53
-1,1272,1451,-179,-1,0,94
1,1620,1552,68,3,87,49
-1,1500,1714,-214,-1,-72,68
-1,1693,1691,2,0,-504,126
1,1602,1402,200,-1,-7,69
-1,1448,1728,-280,-10,-81,40
-1,1405,1719,-314,-4,-151,98
1,1828,1821,7,2,40,49
1,1618,1483,135,-1,7,47
-1,1423,1380,43,-7,-122,46
1,1592,1510,82,4,192,53
-1,1490,1489,1,0,-18,54
-1,1470,1534,-64,0,-37,60
1,1543,1629,-86,-4,11,59
1,1633,1310,323,-3,-34,75
1,1516,1508,8,-4,-33,41
-1,1829,1675,154,1,19,58
-1,1597,1527,70,-1,58,75
-1,1811,1902,-91,-2,-94,114
-1,1476,1625,-149,-2,-27,46
-1,1595,1662,-67,-3,-246,86
1,1500,1038,462,1,225,55
1,1780,1852,-72,0,277,127
-1,1371,1528,-157,0,14,56
-1,1723,2045,-322,0,-17,100
1,1430,1330,100,0,1,49
-1,1460,1637,-177,-3,-28,40
1,1566,1319,247,5,862,103
1,2178,1697,481,8,44,44
-1,1708,1833,-125,-1,55,64
-1,1370,1266,104,1,9,44
-1,1691,2180,-489,-6,-197,55
-1,1346,1555,-209,0,13,64
1,1997,1758,239,0,0,87
-1,1496,1608,-112,0,-600,110
-1,1298,1674,-376,-2,-64,52
1,2002,1725,277,2,180,89
-1,1587,1553,34,-3,-13,74
1,2182,1685,497,11,380,61
1,1379,1223,156,4,761,197
-1,1674,1900,-226,1,17,50
1,1634,1327,307,9,1037,107
1,1253,1640,-387,8,263,49
-1,1502,1435,67,-3,-149,80
-1,1680,2184,-504,-6,-508,70
-1,1743,1688,55,2,27,56
1,1626,1594,32,-1,29,79
1,2006,1876,130,0,38,71
-1,1578,1453,125,-3,-126,54
0,1694,1709,-15,-3,-89,106
1,1440,1585,-145,0,12,47
-1,2186,1675,511,6,861,88
-1,1678,1764,-86,-3,-109,55
-1,1869,2014,-145,-6,-426,94
1,1865,1860,5,5,477,119
1,1864,1882,-18,0,-41,67
1,1568,1486,82,1,246,155
-1,1758,2157,-399,-2,-19,44
1,1565,1575,-10,0,13,63
1,1510,1084,426,21,1312,79
1,1714,1550,164,1,83,81
-1,1539,1520,19,9,75,40
1,2022,1862,160,0,1311,143
-1,2160,1750,410,0,20,60
0,1677,1517,160,0,-61,121
1,1692,1893,-201,6,191,59
1,1563,1570,-7,0,62,67
1,1728,1391,337,1,55,71
-1,1820,1618,202,-2,-293,74
-1,1585,1636,-51,0,16,59
1,1456,1364,92,0,8,43
1,1967,1902,65,-3,-20,107
1,1733,1592,141,1,17,47
-1,1489,1619,-130,-1,-81,66
1,2175,1926,249,0,16,55
1,2132,1824,308,3,12,43
1,1554,1403,151,-3,-114,63
-1,2010,1937,73,-1,-76,82
-1,1709,1670,39,-1,-95,78
-1,1500,1601,-101,-6,-580,84
-1,1241,1402,-161,-2,-325,66
1,1512,1373,139,-8,-184,51
1,1773,1670,103,7,414,65
-1,1705,1515,190,0,-44,82
1,1271,1312,-41,11,160,47
1,1352,1298,54,0,5,55
-1,2137,1721,416,0,-102,116
-1,1848,1877,-29,0,-12,80
1,1645,1493,152,0,20,67
-1,1284,1355,-71,-11,-318,60
1,1876,1860,16,-1,21,61
1,1480,1592,-112,1,129,87
0,1449,1489,-40,0,39,183
-1,1528,1465,63,0,28,74
-1,1081,1092,-11,-11,-292,50
-1,1753,2184,-431,-1,-160,90
1,1373,1356,17,-4,-260,83
-1,1802,2109,-307,-1,-337,96
-1,1486,1474,12,-9,-120,40
1,1814,1875,-61,0,-19,69
-1,1882,1839,43,0,-1,58
1,1340,1209,131,7,256,83
1,1250,1172,78,13,690,67
-1,1669,1816,-147,0,-283,136
1,1597,1543,54,0,320,117
1,1521,1543,-22,-3,13,63
1,1626,1449,177,-1,70,77
1,1731,1126,605,2,657,97
1,2114,1789,325,0,233,103
1,1717,1668,49,0,276,137
-1,1893,2103,-210,0,-90,96
-1,1880,1708,172,-1,-20,56
1,1417,1410,7,-6,248,83
1,1622,1287,335,-1,-3,57
-1,1778,2119,-341,1,83,84
-1,1975,1839,136,4,111,74
-1,1696,2029,-333,-5,-437,118
-1,1203,1431,-228,-20,-368,40
1,1531,1453,78,0,3,63
1,1753,1444,309,2,403,69
-1,1486,1474,12,-6,-641,112
1,1652,1485,167,1,184,125
-1,1665,1645,20,2,35,42
0,1888,1837,51,-1,3,150
-1,1515,1479,36,-2,86,54
1,1586,1464,122,-3,-30,57
1,2123,1692,431,2,192,77
1,1493,1638,-145,-1,84,45
-1,1944,1824,120,-3,-23,45
-1,1489,1436,53,-7,-667,122
-1,1768,1757,11,-3,-78,56
-1,1297,1874,-577,0,-12,80
1,1432,1498,-66,-1,-43,53
-1,1690,2126,-436,-2,-30,42
-1,1768,1732,36,-4,-158,126
-1,1717,1506,211,0,21,52
1,1494,1577,-83,0,18,49
1,2110,1888,222,0,37,79
-1,1420,1633,-213,-1,-62,58
-1,1762,1534,228,0,-118,106
1,1706,1549,157,3,408,121
-1,1384,1118,266,-4,-548,98
0,1855,1863,-8,-2,-38,137
1,1369,1455,-86,3,431,71
-1,1479,1640,-161,-3,-158,55
-1,1663,1724,-61,0,143,118
-1,1396,1561,-165,10,426,66
-1,1442,1429,13,-5,-207,52
0,1509,1733,-224,1,-37,127
-1,1230,1285,-55,1,201,90
-1,1500,1476,24,-2,-681,104
-1,1686,1767,-81,0,-149,110
1,1474,1430,44,8,647,101
-1,1870,1920,-50,0,-41,74
1,1622,1453,169,1,530,195
1,1658,1557,101,0,82,97
-1,1364,1647,-283,-2,-22,50
1,1800,1923,-123,0,26,149
-1,1700,1698,2,0,1,52
1,1782,1490,292,0,-27,61
-1,1677,1791,-114,0,-350,118
0,1265,1162,103,-4,-987,188
-1,1875,1883,-8,-1,-8,57
1,1869,1880,-11,0,-6,43
-1,1499,1483,16,-4,-147,86
1,1602,1797,-195,-1,4,51
1,1862,1855,7,1,335,159
1,1707,1397,310,0,-46,121
-1,2032,1668,364,-6,-63,60
1,1780,1620,160,1,10,83
0,1894,1863,31,0,-3,117
1,1503,1543,-40,-1,-40,63
-1,1482,1486,-4,4,122,62
-1,1691,2010,-319,-1,-202,86
-1,1569,1717,-148,-2,-94,54
1,1484,1699,-215,3,421,147
-1,1613,1786,-173,-1,-22,52
-1,1500,1445,55,-3,-213,142
-1,1560,1571,-11,-1,-62,82
0,1346,1345,1,0,-345,142
1,1556,1146,410,2,267,85
-1,1687,1733,-46,-1,-166,80
1,1843,1874,-31,2,104,101
-1,1327,1559,-232,-1,-333,106
1,1793,1607,186,0,-78,65
1,1666,1547,119,0,77,109
0,1300,1271,29,3,471,132
1,1487,1451,36,-8,-31,133
1,1322,1085,237,0,67,105
1,1881,1846,35,0,38,59
-1,1543,1562,-19,-3,-236,134
1,1725,1696,29,2,368,109
-1,1601,1798,-197,-1,3,44
1,1445,1584,-139,5,93,47
-1,1676,2131,-455,0,-266,102
1,1516,1370,146,-1,-94,73
1,1500,1360,140,5,101,43
1,1368,1471,-103,3,375,137
1,1515,1531,-16,-3,-4,77
1,1372,1390,-18,-2,-40,45
-1,1192,1472,-280,-3,221,118
1,1769,1864,-95,0,-18,43
-1,1471,1709,-238,-4,-103,54
1,1743,1804,-61,-1,-88,83
1,1861,1856,5,4,137,57
-1,1365,1441,-76,2,-353,98
1,1713,1404,309,3,791,147
-1,1383,1711,-328,-5,-33,60
-1,1500,1628,-128,0,-48,80
-1,1498,1645,-147,-2,-108,56
-1,1476,1563,-87,-2,-125,64
1,1845,1873,-28,-1,-78,63
1,1950,1821,129,-7,-39,55
-1,1849,1785,64,-2,-103,106
1,1786,1608,178,0,11,85
1,1768,1829,-61,0,42,85
1,1829,1710,119,0,-124,63
-1,1466,1737,-271,0,-157,113
1,1762,1531,231,0,271,71
1,1578,1470,108,-10,-38,55
1,1629,1714,-85,0,-7,41
-1,1631,1592,39,-1,-69,62
-1,1593,1503,90,3,110,56
1,1717,1164,553,0,0,55
1,1387,1460,-73,0,234,71
-1,1526,1538,-12,-2,-35,44
-1,1995,1891,104,0,79,83
1,1860,1857,3,1,130,71
-1,1756,1500,256,1,41,44
-1,1524,1439,85,2,118,60
-1,1788,1641,147,0,-122,94
-1,1523,1715,-192,0,-112,110
1,1070,1063,7,2,-41,43
-1,1526,1838,-312,-3,-103,98
1,1572,1468,104,2,146,99
-1,1356,1636,-280,-1,-426,98
-1,1779,1755,24,-2,-204,96
-1,1700,1643,57,0,-12,72
-1,1718,1807,-89,0,-42,72
-1,1799,1835,-36,0,-60,82
1,1849,1745,104,1,39,57
1,1587,1327,260,4,29,41
-1,1462,1742,-280,-2,-408,120
-1,1046,1103,-57,-17,-553,52
-1,1313,1534,-221,-4,-96,58
1,1837,1791,46,-3,62,63
-1,1957,1904,53,-2,-72,50
-1,1427,1423,4,1,-547,124
0,1373,1158,215,-2,224,137
1,1587,1514,73,0,9,71
-1,1586,1452,134,0,0,133
-1,1781,1846,-65,-3,70,150
-1,1948,1739,209,-1,-151,66
0,1352,1365,-13,1,-179,153
1,1780,1636,144,0,83,69
1,1667,1640,27,-1,-44,55
-1,1692,1702,-10,-1,-68,74
0,1565,1500,65,1,85,121
1,1694,1674,20,-3,-82,75
1,1846,1788,58,3,188,75
-1,1300,1462,-162,-1,-77,146
1,1823,1709,114,0,63,59
1,1817,1209,608,1,112,57
1,1689,1538,151,-3,-45,49
-1,1288,1449,-161,0,-481,110
-1,1905,1659,246,-3,-84,50
-1,1273,1471,-198,-2,-155,66
1,1524,1633,-109,-5,-208,107
1,1651,1573,78,0,4,83
1,1793,1469,324,2,756,117
-1,1349,1699,-350,0,-28,54
1,1812,1768,44,1,226,95
-1,1388,1537,-149,-1,1,46
-1,1577,1453,124,-2,-81,70
1,1630,1787,-157,2,84,63
-1,1289,1597,-308,-7,-471,68
1,1702,1346,356,2,40,63
1,1434,1414,20,6,373,63
1,1628,1460,168,-1,128,59
-1,1539,1825,-286,-4,-88,48
1,1531,1709,-178,-1,41,85
1,1682,1674,8,-3,246,131
1,1842,1629,213,3,312,105
-1,1733,1677,56,-1,-89,70
-1,1343,1704,-361,-4,-317,64
1,1564,1665,-101,0,376,117
-1,1579,1506,73,-8,-198,62
1,1584,1335,249,20,1008,61
1,1704,1477,227,1,33,92
-1,1453,1458,-5,-5,-67,54
1,1829,1461,368,3,18,75
1,1480,1432,48,4,129,51
-1,1267,1726,-459,-1,-11,72
1,1693,1315,378,6,210,57
-1,1411,1855,-444,-8,-105,50
-1,1337,1710,-373,-10,-225,48
-1,1705,1662,43,0,-11,52
1,1354,1547,-193,2,53,57
1,1672,1668,4,0,24,49
1,1353,1471,-118,-3,226,97
1,1516,1408,108,14,140,41
1,1453,1589,-136,-5,-31,47
-1,1759,1853,-94,-4,-152,54
-1,1689,1721,-32,-16,-220,48
-1,1449,1517,-68,-3,-109,66
-1,1471,1571,-100,0,-35,64
1,1712,1335,377,-2,-39,55
-1,1581,1589,-8,-5,-170,74
0,1484,1578,-94,-2,-233,134
-1,1680,1689,-9,1,-382,82
1,1523,1394,129,2,243,73
-1,1457,1831,-374,-6,-231,72
-1,1332,1715,-383,-6,-94,50
1,1337,1156,181,13,542,61
1,1883,1624,259,-1,-19,49
-1,1547,1752,-205,-2,-324,94
0,1670,1701,-31,1,458,93
1,1595,1280,315,2,203,69
1,1862,2116,-254,0,3,77
1,1696,914,782,-2,233,79
1,1571,1468,103,-1,-7,61
1,1717,1329,388,3,77,45
-1,1527,1423,104,-1,-16,46
1,1265,1310,-45,3,195,71
1,1190,1367,-177,8,284,49
0,1716,1685,31,0,-45,146
-1,1827,1779,48,0,110,134
1,1575,1487,88,0,703,157
1,1541,1455,86,2,305,53
-1,1772,1815,-43,0,-219,112
-1,1731,1889,-158,0,-46,56
1,1526,1285,241,2,611,99
1,1690,1733,-43,-1,489,143
1,1226,1204,22,17,525,61
-1,1403,1675,-272,-4,-86,100
1,1741,1710,31,3,112,43
1,1826,1762,64,0,-5,43
-1,1135,1192,-57,-4,-105,42
1,1806,1823,-17,1,249,77
1,1721,1684,37,-6,-400,105
-1,1238,1503,-265,-11,-397,64
0,1614,1700,-86,0,96,56
-1,1545,1481,64,1,-124,82
-1,1823,1806,17,0,-168,82
1,1552,1490,62,0,-6,65
-1,1578,1681,-103,1,-35,58
1,1812,1818,-6,-1,-50,61
-1,1500,1651,-151,-3,-144,88
-1,1674,1731,-57,1,-311,98
-1,1753,1835,-82,0,-101,62
1,1647,1550,97,3,57,41
1,1426,1595,-169,-1,-88,93
1,1739,1665,74,1,184,83
-1,1474,1520,-46,0,114,88
-1,1806,1822,-16,0,-123,92
1,1202,1120,82,12,284,51
-1,1656,1748,-92,-1,-157,80
-1,1531,1779,-248,-2,-39,56
1,1475,1583,-108,5,127,55
-1,1233,1365,-132,3,107,54
1,1756,1648,108,0,45,57
-1,1301,1465,-164,-3,-123,56
-1,1563,1632,-69,-1,-2,43
-1,1896,1725,171,0,-59,78
-1,1697,1617,80,-2,-136,106
1,1749,1655,94,2,18,53
-1,1398,1686,-288,-1,-33,49
-1,1568,1774,-206,-6,-83,48
-1,1642,1906,-264,-5,-74,52
1,1702,1578,124,2,48,53
-1,1647,1757,-110,1,-32,98
-1,1481,1578,-97,-2,-122,58
-1,1212,1375,-163,-2,-241,80
-1,1641,1780,-139,-3,-51,57
1,1764,1639,125,0,37,53
-1,1493,1579,-86,-1,-38,70
1,1225,1372,-147,3,637,81
-1,1443,1554,-111,-3,-90,56
-1,1632,1771,-139,-2,295,114
-1,1401,1472,-71,5,181,98
-1,1559,1634,-75,-1,-389,94
1,1778,1625,153,0,-6,69
-1,1554,1809,-255,0,22,44
1,1983,1911,72,0,27,53
1,1394,1693,-299,1,3,68
1,1421,1312,109,-8,-314,73
1,1738,1496,242,2,114,61
-1,1618,1784,-166,0,-130,102
1,1611,1484,127,-3,-370,119
-1,1796,1747,49,1,133,86
1,1791,1612,179,3,182,71
-1,1748,1820,-72,0,4,58
1,1539,1642,-103,1,12,43
-1,1242,1734,-492,-1,-86,62
1,1527,1568,-41,0,29,61
-1,1606,1796,-190,0,-31,97
-1,1428,1634,-206,0,6,46
1,1644,1628,16,0,160,115
-1,1874,1901,-27,-2,-57,64
-1,1761,1783,-22,0,-14,52
1,1802,1601,201,0,13,57
1,1553,1430,123,0,71,119
1,1476,1494,-18,0,84,87
1,1793,1749,44,-3,-49,87
1,1595,1807,-212,0,4,41
0,1906,1766,140,0,-22,140
1,1423,1414,9,1,390,93
1,1790,1612,178,1,39,53
1,1453,1457,-4,-2,-18,48
-1,1241,1735,-494,-3,-268,64
-1,1665,1416,249,-4,-121,122
1,1550,1544,6,-1,266,85
-1,1594,1984,-390,-3,-122,70
1,1802,1601,201,2,97,69
-1,1912,1971,-59,1,52,66
1,1738,1803,-65,2,224,77
1,1595,1807,-212,0,-143,85
1,1986,1591,395,-1,-28,77
1,1790,1506,284,0,10,61
1,1790,1613,177,4,331,100
-1,1588,1988,-400,0,-178,122
-1,1239,1652,-413,-7,-197,54
-1,1526,1744,-218,-1,-332,128
1,1607,1796,-189,1,707,135
-1,1472,1586,-114,-2,-559,86
1,1794,1494,300,3,118,67
-1,1534,1542,-8,1,34,68
1,1686,1844,-158,0,1,51
-1,1414,1722,-308,0,-118,78
-1,1779,1623,156,0,15,60
1,1753,1655,98,0,-8,67
-1,1631,1901,-270,-2,-49,134
1,1523,1690,-167,-2,-111,75
1,1764,1639,125,0,16,59
1,1554,1360,194,1,62,73
-1,1797,1902,-105,-1,-201,112
-1,1413,1736,-323,-8,-167,48
1,1617,1484,133,0,37,129
0,1880,1990,-110,-1,67,108
-1,1632,1771,-139,2,-332,80
-1,1702,1828,-126,-2,-23,42
1,1778,1625,153,0,142,73
1,1743,1407,336,3,199,67
-1,1152,1615,-463,-1,-33,70
-1,1987,1651,336,-1,-149,82
0,1910,1789,121,1,372,130
-1,1237,1725,-488,0,-645,108
1,1598,1428,170,11,186,41
1,1480,1866,-386,3,133,51
1,1647,1762,-115,0,232,129
1,1953,1709,244,4,131,52
1,1539,1253,286,7,266,51
1,1521,1267,254,6,177,51
1,1666,1718,-52,0,9,59
-1,1436,1627,-191,-1,-99,80
-1,1793,1906,-113,-2,-111,65
1,1958,1835,123,2,130,173
0,1443,1359,84,-2,-121,104
1,1630,1554,76,2,161,73
1,1958,1914,44,0,132,135
1,1695,1792,-97,2,153,67
-1,1639,1546,93,1,-146,87
-1,1547,1622,-75,-2,-128,70
1,1143,1441,-298,-4,-71,79
-1,1571,1500,71,0,-344,98
-1,1746,1661,85,0,-277,180
-1,1981,1903,78,0,-13,54
-1,1627,1553,74,-2,-259,114
1,1553,1273,280,6,481,61
-1,1593,1712,-119,-2,-49,62
1,1700,1762,-62,0,11,61
-1,1439,1629,-190,3,689,124
0,1613,1487,126,1,-34,95
1,1971,1904,67,0,92,95
-1,1634,1902,-268,0,8,166
1,1797,1587,210,-4,27,41
-1,1895,1980,-85,-4,-130,58
1,1980,1895,85,0,9,57
-1,1582,1844,-262,-3,-129,62
1,1709,1686,23,-2,-13,59
-1,1886,1989,-103,-7,-245,56
1,1998,1878,120,8,417,66
1,1713,1802,-89,-1,172,143
-1,1305,1196,109,-14,-337,90
-1,2005,1870,135,2,-601,192
1,1436,1550,-114,3,214,79
-1,1863,1990,-127,0,-6,46
1,1990,1863,127,4,128,55
-1,1855,1997,-142,-3,-65,54
-1,1635,1705,-70,-4,-418,76
1,1787,1731,56,0,22,57
1,1997,1855,142,0,273,103
1,1423,1464,-41,1,55,65
1,1744,1575,169,-1,90,55
1,1946,1844,102,0,20,61
-1,1536,1630,-94,0,-66,52
-1,1726,1972,-246,0,3,40
1,1233,1203,30,11,524,69
1,1528,1574,-46,-3,37,51
1,1750,1644,106,-3,-39,45
-1,1638,1669,-31,0,-267,110
-1,1471,1662,-191,-1,-113,56
-1,1633,1323,310,-4,-362,94
-1,1398,1481,-83,-5,-333,73
1,1530,1451,79,-7,-78,63
-1,1613,1906,-293,0,5,64
1,1431,1545,-114,2,150,75
1,1729,1875,-146,0,48,61
-1,1758,1627,131,0,76,78
1,1977,1678,299,1,115,97
1,1433,1490,-57,2,61,65
1,1505,1969,-464,-2,-4,89
-1,1527,1780,-253,-1,-28,70
1,1442,1539,-97,5,781,123
1,1958,1735,223,0,228,134
-1,1403,1465,-62,-9,-773,80
-1,1569,1653,-84,-1,-16,44
1,1578,1429,149,-2,79,57
1,2084,1916,168,0,29,67
-1,1376,1484,-108,-3,-154,76
-1,1677,1567,110,-9,-128,50
1,1638,1679,-41,-3,-7,41
1,1785,1522,263,0,-72,83
1,1475,1394,81,5,477,75
-1,1464,1341,123,-2,-47,70
-1,1608,1744,-136,-1,-139,102
1,1510,1377,133,5,450,85
-1,1675,1634,41,0,-160,76
0,1357,1449,-92,1,139,143
1,1446,1235,211,-1,97,79
1,1574,1666,-92,-2,550,133
-1,1518,1789,-271,5,170,86
1,1457,1370,87,3,434,93
1,1751,1600,151,-4,73,93
-1,1509,1522,-13,-7,-391,96
-1,1322,1596,-274,7,312,58
1,1541,1667,-126,-7,-84,41
1,1258,1193,65,4,160,75
1,1969,1631,338,3,237,103
1,1669,1474,195,1,44,57
-1,1318,1733,-415,-1,-8,52
1,1526,1663,-137,5,123,91
-1,1294,1552,-258,0,-58,66
1,1910,1980,-70,3,65,49
1,1735,1517,218,0,-9,47
-1,1585,1588,-3,0,-199,99
-1,1770,1966,-196,0,-10,50
-1,1374,1614,-240,-7,45,56
1,1408,1386,22,-3,2,87
1,1473,1522,-49,-3,-80,49
1,1499,1229,270,6,397,71
-1,1441,1587,-146,2,28,72
0,1491,1456,35,1,-25,58
-1,1468,1684,-216,0,-49,70
-1,1892,2201,-309,-4,-125,62
1,1923,1966,-43,-1,-8,65
1,1447,1435,12,-1,-14,53
-1,1887,1417,470,-1,-133,66
-1,1417,1887,-470,-9,-671,86
1,1503,1457,46,5,158,65
1,1660,1639,21,2,65,65
1,1622,1198,424,15,298,49
1,1889,1444,445,6,799,105
1,1520,1594,-74,0,-10,63
1,1747,2211,-464,0,-15,77
-1,1465,1697,-232,0,17,42
1,1742,1414,328,10,274,57
-1,1762,1501,261,-14,-199,44
1,1454,1459,-5,6,100,43
-1,1460,1291,169,1,-38,78
-1,1606,1627,-21,-1,-15,45
1,1288,1444,-156,-1,-330,91
-1,1139,1426,-287,-9,-527,70
1,1581,1534,47,1,94,53
-1,1637,1595,42,-1,-298,82
1,1625,1182,443,-4,-45,51
0,1973,1757,216,-1,-120,136
-1,1608,1644,-36,-5,8,40
-1,1710,2061,-351,0,-6,88
-1,1519,1626,-107,0,-110,72
1,1435,1416,19,-8,-63,127
-1,1430,1564,-134,-1,32,54
1,1490,1466,24,1,146,97
1,1936,1670,266,0,2,61
1,1300,1423,-123,2,78,97
-1,1356,1360,-4,-5,-71,40
1,2064,1821,243,0,83,127
1,1601,1054,547,8,592,77
-1,1654,1598,56,0,-30,50
-1,1599,1654,-55,0,-193,106
1,1634,1511,123,-1,60,91
-1,1208,1538,-330,-5,9,42
1,1372,1345,27,-1,16,103
1,1862,1810,52,0,105,53
-1,1817,2069,-252,-4,-104,114
1,1524,1590,-66,0,107,59
-1,1429,1304,125,3,265,74
-1,1432,1538,-106,2,18,76
1,1608,1625,-17,5,432,87
-1,1455,1289,166,-6,-425,126
-1,1640,1611,29,-1,-21,53
1,1455,1500,-45,2,100,54
1,1620,1570,50,-2,-2,40
1,1812,2074,-262,-2,7,81
-1,1495,1387,108,0,-15,56
-1,1763,1465,298,0,-71,132
-1,1492,1349,143,0,-210,96
1,1727,1134,593,7,190,47
1,1289,1463,-174,0,95,75
1,1488,1468,20,0,223,102
-1,1800,1302,498,2,106,66
1,1577,1538,39,-1,91,69
-1,1424,1467,-43,2,130,78
1,1668,1430,238,1,66,63
-1,1629,1736,-107,-1,-124,132
1,1627,1662,-35,-4,137,87
-1,1504,1470,34,7,226,52
1,1598,1541,57,1,-22,99
-1,1364,1151,213,2,-91,58
1,1821,1886,-65,1,120,87
-1,1457,1498,-41,0,-18,150
1,1532,1552,-20,0,-131,77
-1,1795,1636,159,-1,-37,54
-1,1629,1628,1,0,-9,70
-1,1662,1490,172,-2,-114,67
-1,1328,1777,-449,-4,-167,76
-1,1527,1587,-60,0,-811,130
1,1503,1477,26,7,535,123
-1,1584,1470,114,-1,32,50
1,1414,1403,11,5,226,105
1,1466,1513,-47,1,26,49
1,1873,1471,402,2,55,49
-1,1612,2040,-428,0,6,74
1,1666,1500,166,1,283,109
-1,1052,1775,-723,-4,-300,86
-1,1594,1554,40,0,-33,84
-1,1636,1718,-82,1,30,58
1,2042,1610,432,0,110,81
-1,1773,1562,211,0,69,48
1,1467,1436,31,8,129,43
1,1199,1121,78,3,508,65
0,1761,1415,346,2,134,53
-1,1619,1475,144,-11,-328,58
1,1632,1816,-184,-2,-3,55
1,1469,1893,-424,0,33,63
1,1745,1434,311,0,78,83
0,1835,1832,3,0,-32,125
1,1503,1663,-160,3,120,71
1,2000,2044,-44,-3,387,109
-1,1442,1484,-42,-1,-5,108
1,1716,1487,229,0,21,53
-1,1795,2195,-400,2,131,100
1,1627,1465,162,1,-76,53
1,2031,2013,18,0,202,111
1,1679,1392,287,0,29,51
1,1578,1468,110,-1,170,82
1,1749,1784,-35,0,52,83
1,1570,1502,68,0,633,115
-1,1523,1640,-117,-1,-441,114
-1,1862,1832,30,-1,-84,68
-1,1482,1683,-201,-1,-41,62
1,1500,1551,-51,0,88,199
-1,1500,1685,-185,-7,-462,70
0,2002,2042,-40,0,-25,139
-1,1425,1396,29,0,65,73
1,1772,1762,10,0,88,99
-1,1639,1546,93,-9,-185,43
-1,1482,1751,-269,-2,-60,48
1,1808,1605,203,-1,196,85
-1,1835,1720,115,0,-55,96
1,1509,1577,-68,-1,-1,63
-1,1459,1634,-175,-1,-683,146
0,1518,1430,88,-3,91,124
0,1653,1694,-41,1,135,96
-1,1608,1584,24,-4,-51,66
0,1588,1624,-36,0,43,121
1,1528,1388,140,4,105,71
1,1505,1460,45,3,407,107
1,1743,1442,301,-1,381,107
1,1750,1979,-229,-6,-203,119
1,1678,1782,-104,-1,52,87
1,1599,1594,5,0,275,77
1,1317,1390,-73,8,150,47
1,1577,1415,162,-2,168,97
-1,1426,1625,-199,-8,-105,44
-1,1582,1613,-31,-11,-46,43
1,1488,1575,-87,4,591,123
-1,1613,1582,31,-1,-78,72
1,1748,1740,8,0,13,53
1,1777,1454,323,0,7,43
1,2000,1697,303,0,131,95
1,1603,1529,74,-5,-110,83
-1,1301,1431,-130,-4,-384,100
1,1842,1780,62,-2,-315,159
-1,1631,1991,-360,-1,-34,62
1,1596,1598,-2,0,3,69
-1,1692,1962,-270,-2,-161,80
1,1447,1646,-199,0,-32,47
0,1584,1608,-24,0,335,75
1,1477,1500,-23,-1,7,53
1,1561,1726,-165,-1,-38,59
-1,1491,1516,-25,-1,-115,96
-1,1438,1527,-89,0,73,74
1,1607,1585,22,1,-36,95
1,1590,1222,368,16,425,45
1,1576,1675,-99,3,211,89
1,1845,1711,134,3,93,55
1,1628,1464,164,0,107,67
-1,1702,1431,271,0,-19,102
1,1704,1267,437,12,343,59
-1,1521,1500,21,0,-62,72
1,2004,1852,152,0,26,57
-1,1729,1902,-173,-1,-7,48
1,1685,1472,213,0,165,65
-1,1845,2011,-166,-2,-92,70
1,1705,1464,241,-1,14,55
-1,1489,1457,32,0,7,68
1,1593,1472,121,-3,-57,55
-1,1478,1448,30,-6,0,40
0,1992,1770,222,-3,-22,94
-1,1574,1710,-136,1,-13,70
1,1500,1260,240,2,22,47
1,1535,1429,106,5,220,67
1,1814,1599,215,0,2,40
-1,2018,1839,179,0,-86,120
-1,1767,1491,276,-7,-151,48
0,1478,1529,-51,0,-105,119
1,1818,1768,50,-2,-64,59
-1,1701,1508,193,0,126,92
0,1603,1560,43,-1,-316,169
-1,1459,1567,-108,-4,-402,96
-1,1317,1717,-400,-8,-111,72
1,1876,1760,116,0,3,69
1,1559,1389,170,-1,-39,73
1,1491,1500,-9,-3,-104,73
1,1829,1549,280,0,71,73
-1,1551,1674,-123,-2,-106,74
1,1879,1837,42,-1,-104,81
-1,1251,1187,64,-4,-67,52
-1,1637,1683,-46,0,9,52
-1,1390,1460,-70,-8,-43,52
-1,1624,1668,-44,-1,-225,92
1,2096,1874,222,2,169,83
-1,1420,1542,-122,0,-46,46
1,1883,1834,49,0,1031,151
-1,1719,1752,-33,0,-107,88
-1,1575,1450,125,1,-65,66
1,1553,1266,287,1,1023,149
-1,1059,1390,-331,-4,-119,46
0,1822,1892,-70,-3,-283,113
1,1562,1560,2,-3,-201,75
1,1820,1702,118,0,216,122
1,1661,1612,49,2,23,45
-1,1560,1560,0,5,364,82
1,1856,1709,147,3,77,41
1,1584,1291,293,1,323,91
-1,1261,1557,-296,-5,-517,82
0,1405,1556,-151,-1,-127,174
-1,1746,1702,44,3,56,42
-1,1586,1620,-34,-13,-353,52
1,1521,1500,21,2,106,63
-1,1350,1666,-316,0,27,58
1,1770,1852,-82,-2,-45,71
1,1479,1376,103,3,302,89
1,2151,1472,679,0,73,79
-1,1602,1671,-69,-2,-229,82
1,1715,1733,-18,0,65,83
-1,1724,1433,291,-6,-170,88
0,1744,1469,275,0,27,139
1,1408,1307,101,-1,379,131
-1,1548,1571,-23,2,45,76
-1,1252,1564,-312,-23,-601,50
0,2198,1721,477,-4,103,102
1,1549,1544,5,-1,496,121
-1,1320,1217,103,0,83,56
1,2004,1754,250,0,109,115
-1,1090,1247,-157,0,23,40
1,1239,1164,75,-4,-54,71
1,1705,1692,13,-2,249,145
1,1538,1582,-44,1,22,95
1,1418,1379,39,-4,-122,59
-1,1687,1782,-95,-2,-124,86
1,1680,1594,86,2,133,59
1,1306,1554,-248,0,329,71
-1,1297,1262,35,4,-205,69
0,1614,1518,96,2,51,193
1,1536,1352,184,-2,32,77
-1,1569,1551,18,-11,-587,108
1,1543,1560,-17,0,320,125
1,1685,1704,-19,0,-22,49
1,1958,1731,227,4,78,45
1,1480,1193,287,9,177,55
-1,1670,1500,170,0,-18,72
1,1317,954,363,2,124,59
1,1338,1542,-204,-3,146,71
-1,1500,1614,-114,-1,-3,76
-1,1552,1409,143,-8,-452,78
-1,1272,1547,-275,-2,-507,116
-1,1567,1256,311,0,-388,126
1,1785,1455,330,4,233,76
1,1718,1726,-8,0,-19,63
-1,1136,1669,-533,-3,-239,74
1,1563,1529,34,4,286,73
-1,1220,1282,-62,18,378,50
-1,1406,1766,-360,0,18,56
1,1726,1545,181,1,675,121
1,1500,1472,28,1,-288,79
-1,1424,1560,-136,0,-25,52
-1,1660,2050,-390,-3,-80,50
-1,1477,1631,-154,-1,-95,62
1,1842,1431,411,5,164,57
1,1484,1539,-55,0,199,73
1,1705,1625,80,-2,-53,75
-1,1715,2074,-359,0,2,46
1,1539,1732,-193,1,-93,95
-1,1429,1696,-267,-1,-110,60
-1,1449,1788,-339,0,-83,84
1,1320,1495,-175,11,910,97
-1,1990,1729,261,0,-23,56
1,1780,1658,122,0,1,133
1,1654,1502,152,0,171,75
-1,1700,2185,-485,-1,-46,68
1,1314,1180,134,1,46,69
1,1472,1685,-213,0,119,65
1,1273,1320,-47,-3,122,129
1,1757,1559,198,3,71,57
-1,1620,1200,420,-1,-246,96
1,1263,1365,-102,2,5,45
-1,1756,1572,184,2,12,86
-1,1426,1537,-111,-2,-150,98
-1,1510,1414,96,-2,10,50
1,1669,1698,-29,0,76,77
-1,1552,1864,-312,-5,-71,48
-1,1470,1533,-63,0,91,72
-1,1735,1165,570,-1,-41,78
-1,1589,1735,-146,-6,-314,62
-1,1680,1785,-105,-1,-14,52
-1,949,1496,-547,-4,-403,74
1,1637,1712,-75,-1,-57,67
1,1792,1745,47,1,478,161
1,1421,1241,180,-1,66,70
1,1744,1582,162,1,89,65
1,1369,1428,-59,-3,-22,43
-1,1496,1430,66,-4,-102,58
-1,1553,1678,-125,1,2,62
1,1342,1472,-130,-1,27,53
-1,1763,1746,17,0,-323,134
0,1242,1131,111,0,276,87
1,2165,1686,479,0,14,79
1,1575,1751,-176,-2,-48,73
-1,1488,1415,73,0,-84,64
-1,1287,1465,-178,-6,-257,72
1,1719,1868,-149,0,-76,69
1,2012,1931,81,0,5,63
1,1828,1500,328,2,203,66
1,1350,1498,-148,1,30,57
1,1732,1592,140,2,249,85
1,1545,1418,127,0,114,91
-1,1948,2001,-53,0,-55,58
1,1497,1240,257,-5,141,55
-1,1549,1747,-198,-5,-241,66
-1,1750,1500,250,0,-112,84
1,1585,1740,-155,0,327,127
-1,1461,1529,-68,-5,-79,46
0,1916,2021,-105,-9,-168,67
1,1825,1793,32,-6,-286,65
1,2105,1947,158,0,127,101
1,1611,1621,-10,5,569,99
-1,1485,1445,40,-5,-96,56
0,1667,1493,174,5,114,178
-1,1549,1573,-24,1,-115,84
1,1699,1650,49,5,666,117
1,1650,1641,9,0,10,45
-1,1783,1836,-53,-1,-13,74
1,1283,1278,5,3,897,89
1,1489,1543,-54,3,589,87
-1,2018,1922,96,0,-63,106
-1,1307,1287,20,5,212,81
1,1738,1753,-15,1,30,85
-1,1734,1778,-44,0,50,138
-1,1608,1745,-137,-12,-393,120
-1,1834,1916,-82,-1,-30,110
1,1554,1226,328,0,129,69
-1,1941,2113,-172,-4,-228,90
1,1235,1427,-192,-7,-145,69
0,1546,1616,-70,6,113,41
1,1847,1773,74,1,56,75
-1,1539,1585,-46,-1,-151,88
1,1715,1630,85,1,43,101
1,1280,1429,-149,1,48,51
1,1655,1264,391,3,278,77
-1,1410,1552,-142,0,-66,64
-1,1341,1542,-201,-5,-424,88
1,1451,1844,-393,-5,-37,55
-1,1751,1563,188,0,-480,164
-1,1298,1400,-102,-10,-284,60
1,1557,1509,48,4,9,43
1,1628,1423,205,-5,663,137
-1,1548,1542,6,0,-4,48
-1,1521,1765,-244,-11,-272,54
-1,1537,1475,62,-3,-58,42
-1,1913,1741,172,1,53,93
1,1473,1513,-40,-2,301,97
-1,1529,2120,-591,-1,-335,122
0,1495,1362,133,2,277,81
-1,1383,1583,-200,-15,-485,56
1,1837,1769,68,0,161,65
-1,1421,1516,-95,-4,-70,46
-1,1581,1733,-152,-3,-484,114
1,1479,1420,59,0,107,63
1,1944,2003,-59,-1,-16,59
-1,1723,1675,48,5,345,160
-1,1550,1445,105,-1,-20,40
-1,1760,1846,-86,-6,-37,42
-1,1529,1553,-24,-1,-109,90
1,1740,1573,167,1,313,87
-1,1187,1370,-183,-2,-425,136
-1,1535,1459,76,0,-42,70
-1,1800,1761,39,0,19,88
1,1477,1090,387,7,284,59
1,1757,1897,-140,0,289,135
-1,1433,1473,-40,-2,-47,94
-1,1543,1500,43,-1,100,90
-1,1567,1747,-180,-2,-273,138
1,1832,1493,339,0,45,47
1,1528,1576,-48,5,341,65
1,1410,1395,15,5,85,57
-1,1489,1523,-34,-13,-175,42
1,1590,1109,481,9,283,52
-1,1485,1650,-165,0,-29,52
1,1548,1335,213,2,77,71
-1,1589,1599,-10,0,-126,78
1,1412,1486,-74,2,25,61
1,1771,1627,144,0,4,55
1,2065,1915,150,-4,44,67
-1,1533,1503,30,0,-25,126
1,1720,1845,-125,-1,-18,45
1,1725,1619,106,4,261,64
-1,1872,1734,138,0,-77,140
-1,1420,1677,-257,-6,-245,74
-1,1427,1364,63,0,-5,60
-1,1728,1882,-154,-2,-100,64
1,1277,1367,-90,7,110,53
-1,1526,1609,-83,3,191,66
1,1748,1683,65,0,132,81
-1,1439,1194,245,1,55,52
1,1828,1352,476,-1,-180,45
1,1735,1802,-67,0,3,59
1,1662,1521,141,0,-1,57
-1,1565,1682,-117,-1,-283,88
1,1596,1680,-84,-10,-178,47
1,1886,1901,-15,-1,240,89
1,1611,1733,-122,-1,339,95
1,1617,1614,3,3,163,70
-1,1385,1825,-440,-5,-458,104
1,1629,1354,275,3,304,86
-1,1513,1669,-156,0,-45,72
-1,1451,1705,-254,-3,-75,58
-1,1610,1721,-111,-1,-55,148
1,2130,1890,240,3,183,65
1,1666,1610,56,-1,198,91
-1,1676,1505,171,0,20,68
1,1555,1299,256,6,482,79
1,1695,1500,195,13,288,47
1,1515,1604,-89,-2,11,61
0,1431,1656,-225,-1,-17,110
1,1466,1350,116,1,-9,51
1,1700,1400,300,12,286,51
-1,1560,1557,3,-1,-388,106
-1,1600,1675,-75,-2,-138,64
-1,1660,1640,20,0,-2,54
1,1767,1229,538,1,74,57
1,1897,1885,12,-2,205,95
1,1718,1625,93,2,665,101
1,1788,1352,436,9,243,51
-1,1874,1907,-33,1,214,100
-1,1684,1591,93,1,15,60
1,1423,1406,17,0,116,91
1,1855,1832,23,-1,1010,138
-1,1908,2073,-165,-1,-131,110
1,1628,1572,56,2,69,53
0,2135,1864,271,2,358,96
-1,1552,1619,-67,-2,-114,74
-1,1756,1500,256,-2,-133,148
-1,1725,1967,-242,-4,-108,54
-1,1712,1889,-177,1,75,94
-1,1657,1749,-92,2,202,100
0,1546,1451,95,2,213,155
-1,1342,1347,-5,-1,-117,92
-1,1174,1313,-139,-4,-43,48
-1,1990,1959,31,3,-28,94
-1,1606,1670,-64,-4,-157,56
1,1962,1602,360,2,-21,49
1,1830,1680,150,1,120,75
-1,1631,1396,235,-6,-61,50
1,1551,1345,206,3,49,51
1,1868,1748,120,0,20,53
-1,1679,1596,83,5,253,76
-1,1971,1977,-6,-1,-203,72
-1,1494,1387,107,-6,-1127,120
1,1927,1854,73,0,-38,93
-1,1557,1600,-43,-4,-103,62
-1,1700,1902,-202,-1,-42,54
-1,1393,1434,-41,-5,-527,100
-1,1320,1500,-180,1,45,50
1,1673,1837,-164,0,123,91
-1,1604,1315,289,0,-6,44
0,1704,1749,-45,0,23,81
-1,1876,1931,-55,0,-37,76
-1,1845,1917,-72,0,-329,116
1,1715,1770,-55,-1,-47,69
-1,1628,1628,0,5,60,48
-1,1595,1538,57,0,-20,52
-1,1500,1642,-142,-1,-43,76
-1,1561,1538,23,-5,-86,70
1,1543,1184,359,-6,258,111
1,1925,1836,89,0,32,49
1,1551,1583,-32,0,227,129
1,1817,1416,401,0,-3,77
-1,1215,1611,-396,-9,-291,68
-1,1828,1933,-105,-2,-68,68
1,1746,1684,62,2,242,85
-1,1867,1924,-57,-1,-386,106
-1,1462,1330,132,3,36,58
-1,1595,1550,45,1,11,42
1,1608,1288,320,0,165,71
1,1216,1246,-30,3,243,73
-1,1543,1620,-77,0,-29,74
-1,1705,1741,-36,0,-16,56
1,1747,1545,202,0,28,129
-1,1679,1660,19,0,-102,100
-1,1936,1858,78,0,-29,74
-1,1933,2038,-105,-1,-105,64
1,1886,1817,69,0,2,59
1,1656,1649,7,0,111,73
-1,1619,1718,-99,-1,-279,138
-1,1573,1941,-368,-4,-46,48
-1,1806,1402,404,-3,-170,76
1,1923,1943,-20,-1,2,57
1,1234,1230,4,-5,-66,47
-1,1752,1871,-119,0,-22,164
1,1500,1513,-13,0,-8,57
1,1559,1496,63,5,417,97
-1,1448,1534,-86,3,64,46
1,1700,1364,336,0,518,97
1,1934,1931,3,0,-3,87
-1,1710,1709,1,0,-12,94
-1,1748,1674,74,-3,-41,58
-1,1794,1691,103,-1,-42,68
-1,1571,1539,32,2,20,82
1,1437,1159,278,-1,98,75
-1,1578,1626,-48,-1,-332,140
1,1726,1635,91,1,105,110
-1,1695,1751,-56,2,25,50
1,1878,1925,-47,-1,-120,79
1,1423,1110,313,2,751,89
1,1730,1687,43,3,493,117
1,1667,1611,56,-2,28,69
1,1945,1921,24,-3,95,87
1,1749,1462,287,1,287,77
-1,1459,1373,86,0,-5,74
-1,1667,1750,-83,-3,-141,64
1,1675,1546,129,5,299,71
-1,1414,1553,-139,-3,-136,72
-1,1703,1812,-109,-3,-54,70
1,1634,1710,-76,-1,10,91
1,1608,1678,-70,3,13,43
-1,1748,1856,-108,-2,-334,94
-1,1435,1599,-164,-2,92,80
-1,1921,1880,41,0,-14,110
-1,1699,1921,-222,0,-157,130
-1,1308,1479,-171,-22,-663,54
1,1561,1407,154,0,28,91
1,1325,1286,39,-5,-346,83
1,1429,1601,-172,-3,0,49
1,1536,1446,90,5,50,43
1,1634,1497,137,0,41,81
1,1506,1558,-52,6,210,45
0,1779,1564,215,-1,-22,146
1,1591,1669,-78,9,430,67
1,1913,1909,4,0,0,63
1,1756,1760,-4,-1,-6,65
-1,1752,1633,119,-1,-365,114
1,1708,1349,359,0,5,51
-1,1948,1871,77,0,-53,72
1,1632,1448,184,-1,50,111
1,1500,1585,-85,3,310,95
1,1885,1935,-50,3,147,61
-1,1486,1550,-64,0,-23,64
-1,1565,1472,93,-10,-256,48
1,1738,1731,7,0,-37,117
-1,1923,1898,25,1,-47,66
-1,1898,1924,-26,-3,-202,84
-1,1711,1820,-109,0,7,78
-1,1485,1325,160,-1,-33,50
-1,1910,1912,-2,2,99,72
-1,1648,1704,-56,-3,-139,82
1,1628,1558,70,-4,14,109
1,1543,1230,313,3,299,125
1,1814,1692,122,5,140,61
1,1922,1899,23,-3,-89,41
-1,1461,1336,125,-4,-184,56
1,1888,1932,-44,2,50,67
1,1810,1879,-69,-1,-26,101
1,1500,1442,58,-1,-69,65
1,1934,1888,46,2,25,45
0,1377,1470,-93,0,162,190
-1,1720,1836,-116,0,18,76
-1,1584,1625,-41,1,-122,128
-1,1741,1892,-151,2,204,136
1,1920,2068,-148,-2,-175,87
-1,1879,1943,-64,0,-137,80
-1,1685,1825,-140,0,-56,62
-1,1627,1515,112,-8,-364,129
1,1560,1690,-130,-7,-344,73
-1,1486,1319,167,-3,-13,41
1,1586,1420,166,3,69,45
1,2050,1935,115,0,247,71
-1,1335,1457,-122,-2,-232,76
1,1500,1610,-110,4,272,77
-1,1282,1454,-172,-2,-80,96
1,1863,1830,33,3,45,51
-1,1931,1660,271,-1,3,96
1,1613,1352,261,3,507,141
-1,2000,1870,130,1,-7,58
-1,1749,1768,-19,-2,-64,62
1,1614,1547,67,-1,-47,65
-1,1749,1770,-21,-1,-8,66
-1,1485,1540,-55,-3,-382,104
-1,1507,1648,-141,-1,11,52
-1,1738,1735,3,0,-51,84
1,1664,1692,-28,5,150,79
-1,1581,1390,191,2,20,48
1,1816,1875,-59,1,57,83
-1,1703,1901,-198,-2,-161,98
1,1503,1384,119,1,336,103
-1,1436,1574,-138,1,-6,58
-1,1569,1772,-203,-4,-150,58
-1,1471,1345,126,0,2,66
-1,1884,2130,-246,-1,-134,124
1,1637,1836,-199,2,151,117
1,1680,1677,3,-1,27,65
1,1460,1275,185,-2,133,71
1,1727,1623,104,0,111,79
1,1500,1173,327,7,111,43
1,1906,1928,-22,0,-1,65
-1,1269,1466,-197,-4,-519,116
1,1768,1544,224,0,273,111
1,1687,1655,32,-4,-273,57
-1,1733,1534,199,1,-118,82
-1,1444,1585,-141,-3,-143,68
-1,1758,1529,229,-3,-467,170
-1,1236,1230,6,-9,-806,116
1,1612,1899,-287,3,10,41
1,1350,1259,91,-12,159,117
1,1968,1960,8,-3,-170,79
-1,1638,1895,-257,-3,-153,66
1,1860,1834,26,0,37,65
1,1735,1396,339,-2,35,47
1,1704,1546,158,0,47,61
1,1897,2110,-213,1,53,71
-1,1554,1716,-162,9,115,46
-1,1706,1569,137,-1,37,86
1,1608,1880,-272,3,66,57
0,1787,1926,-139,0,78,121
1,1882,1475,407,2,325,97
1,1747,1738,9,1,30,49
1,1738,1669,69,1,88,69
-1,1539,1773,-234,-2,-135,88
-1,1408,1421,-13,0,14,57
1,1713,1604,109,0,-77,111
-1,1949,1978,-29,0,-10,64
1,1835,1922,-87,0,4,45
-1,1544,1533,11,0,18,44
1,2086,1914,172,-5,71,85
1,1437,1477,-40,9,174,52
-1,1615,1431,184,0,71,72
1,1747,1718,29,1,58,61
1,1676,1587,89,6,75,45
1,1850,1909,-59,-1,263,145
1,1584,1365,219,0,142,121
1,1774,1620,154,-2,-32,59
0,1691,1546,145,-4,-260,155
1,1617,1297,320,1,67,54
-1,1606,1740,-134,-5,-105,54
1,1653,1511,142,-5,-251,71
1,1939,1988,-49,0,13,59
-1,1723,1779,-56,0,-127,77
-1,1470,1577,-107,0,14,41
0,1917,1896,21,-2,-475,135
1,1552,1541,11,0,-17,125
-1,1351,1357,-6,0,-44,64
1,1723,1614,109,0,107,65
1,1757,1705,52,1,20,47
-1,1363,1301,62,-6,-815,124
0,1952,1865,87,-2,53,64
1,1684,1591,93,1,22,49
-1,1897,1916,-19,2,19,56
1,1747,1586,161,1,127,78
1,1908,2095,-187,1,74,105
1,1885,1473,412,2,160,78
1,1710,1580,130,3,64,51
1,1926,1887,39,2,471,85
-1,1174,1465,-291,1,-33,68
1,1620,1277,343,9,170,49
1,1787,1836,-49,0,48,113
-1,1605,1733,-128,-5,-150,64
1,1233,1360,-127,6,276,65
1,1877,1935,-58,0,-15,57
0,1781,1628,153,0,-33,133
1,1717,1558,159,0,6,45
-1,1191,1418,-227,-1,-106,78
-1,1923,1890,33,-2,-82,84
-1,1812,1713,99,-1,-251,81
1,1780,1500,280,-1,199,101
1,1579,1563,16,-1,213,127
1,1634,1500,134,1,39,65
-1,1901,1912,-11,0,-74,90
-1,1560,1550,10,-3,-183,122
1,1789,1713,76,4,26,47
1,1446,1327,119,3,100,55
-1,1724,2080,-356,-3,-59,122
-1,1251,1358,-107,-7,-157,50
-1,1728,1903,-175,2,98,86
-1,1527,1837,-310,-2,-339,112
-1,1492,1615,-123,0,-187,92
1,1922,1891,31,-1,-50,89
-1,1887,1778,109,-4,-78,80
1,1368,1504,-136,5,196,53
-1,1449,1500,-51,-6,-177,72
1,1589,1410,179,-5,42,75
1,1799,1742,57,0,-15,73
1,1530,1563,-33,5,459,89
-1,1918,2081,-163,-1,31,89
1,1698,1634,64,0,-59,77
-1,1709,1930,-221,0,-110,128
1,1500,1274,226,1,388,119
0,1721,1714,7,0,-12,92
1,1840,1524,316,2,251,133
-1,1881,1598,283,-1,15,70
-1,1537,1786,-249,0,-32,74
1,1351,1352,-1,4,382,77
1,1500,1517,-17,-1,95,112
1,1928,1797,131,0,36,89
-1,1714,1721,-7,-2,-57,92
-1,1619,1863,-244,-1,-176,80
-1,1236,1239,-3,-5,-38,40
1,1714,1639,75,0,36,81
1,1456,1425,31,-5,-19,41
-1,1651,1442,209,-4,-253,94
-1,1810,1596,214,4,27,72
-1,1847,1750,97,-1,-595,132
-1,1312,1328,-16,-13,-342,48
-1,1224,1250,-26,1,15,50
1,1561,1529,32,1,134,111
-1,1762,1692,70,-2,-329,100
-1,1609,1872,-263,-8,-42,40
-1,1500,1642,-142,-9,-48,40
-1,1731,1808,-77,-3,-66,98
1,1701,1591,110,1,-102,95
-1,1876,1605,271,-3,-59,52
-1,1621,1793,-172,1,29,76
-1,1551,1542,9,-2,-156,106
-1,1687,1622,65,0,-4,52
-1,1485,1603,-118,0,-6,60
-1,1765,1834,-69,-3,2,66
-1,1625,1858,-233,-2,-84,60
-1,1704,1596,108,-3,-174,104
-1,1213,1261,-48,4,86,56
-1,1500,1758,-258,-3,-74,58
-1,1927,2068,-141,-1,-57,54
1,1799,1867,-68,1,22,104
1,1863,1620,243,-3,35,53
1,1636,1631,5,7,505,91
1,1495,1635,-140,2,121,67
1,1850,1696,154,4,105,57
-1,1615,1867,-252,1,138,74
-1,1191,1356,-165,-2,-171,56
-1,1799,1612,187,0,-40,68
1,1615,1598,17,0,4,93
1,1705,1749,-44,1,45,102
1,1202,1271,-69,12,267,47
-1,1343,1421,-78,-2,-142,78
-1,1827,1794,33,-1,-140,87
1,1641,1489,152,1,84,67
1,1872,1610,262,-1,209,95
-1,1720,1952,-232,0,-103,82
-1,1823,2077,-254,2,83,62
-1,1754,1500,254,0,-675,178
-1,1477,1320,157,-1,15,60
1,1783,1789,-6,0,56,97
-1,1511,1876,-365,-1,29,54
1,1533,1257,276,8,747,93
-1,1455,1570,-115,0,100,68
-1,1816,1814,2,-8,-101,52
-1,1843,1663,180,0,-10,60
1,1532,1500,32,-7,-56,49
-1,1302,1319,-17,-1,-8,92
-1,1553,1540,13,0,-305,150
-1,1936,1590,346,-2,-110,64
1,1574,1921,-347,1,198,123
0,1631,1490,141,2,113,110
-1,1690,1595,95,3,7,77
1,1625,1693,-68,13,479,63
-1,1807,1888,-81,0,-609,120
1,1776,1794,-18,-1,91,77
-1,1216,1493,-277,-2,-23,58
1,1956,1714,242,-1,102,91
0,1736,1717,19,0,-19,107
-1,1648,1725,-77,-7,-257,90
1,1443,1647,-204,-4,8,47
1,1386,1489,-103,1,193,99
1,1618,1520,98,-1,-1,47
1,2083,1807,276,-2,-5,65
1,1610,1443,167,0,10,49
1,1798,1711,87,3,189,71
-1,1680,1638,42,-3,-91,44
-1,1783,1789,-6,-1,-180,82
0,1813,1854,-41,1,203,169
1,1413,1541,-128,-1,64,71
1,1667,1650,17,3,69,65
-1,1501,1627,-126,-1,-105,70
1,1678,1507,171,-5,-114,49
-1,1806,1702,104,-1,-57,58
1,1183,1289,-106,6,211,77
-1,1208,1500,-292,0,-33,68
1,1347,1268,79,-1,84,105
-1,1413,1430,-17,-3,-67,44
1,1420,1437,-17,0,206,75
1,1587,1475,112,1,40,53
-1,1801,1772,29,0,-51,110
1,1896,1803,93,0,247,109
-1,1616,1676,-60,-1,-124,88
0,1639,1314,325,-1,-45,140
-1,1815,1878,-63,-3,-85,62
-1,1717,2088,-371,1,53,88
0,1668,1640,28,1,131,153
-1,1500,1362,138,0,9,76
-1,1447,1425,22,-1,-176,86
-1,1845,1500,345,-2,-174,84
1,1594,1635,-41,0,35,81
-1,1640,1683,-43,-2,-113,64
0,1461,1537,-76,-3,27,104
-1,1794,1905,-111,-2,-53,60
-1,1435,1685,-250,-3,-86,44
-1,1733,1639,94,-1,-260,114
-1,1335,1458,-123,-4,-70,48
-1,1204,1573,-369,-3,-146,60
1,1843,1755,88,0,6,55
-1,1573,2020,-447,-4,-177,70
-1,1490,1607,-117,0,16,78
-1,1754,1914,-160,0,-15,102
-1,1677,1631,46,-5,-550,98
1,1551,1542,9,0,-24,55
1,1784,1788,-4,3,327,109
1,1429,1332,97,9,513,93
1,1776,1503,273,0,175,91
-1,1665,1643,22,2,28,52
-1,1468,1431,37,-1,5,40
-1,1852,1680,172,-1,-88,58
1,1470,1401,69,0,114,82
1,1483,1631,-148,2,370,102
1,1740,1578,162,0,203,85
-1,1653,1654,-1,-2,-360,92
1,1758,1630,128,4,59,69
1,2091,1703,388,0,16,49
1,1631,1652,-21,2,7,49
1,1795,1758,37,0,14,91
1,2235,1835,400,0,120,103
1,1915,1612,303,1,-3,75
1,1913,1665,248,-5,-184,83
-1,1701,2093,-392,0,-5,50
1,1463,1534,-71,8,232,61
-1,1257,1355,-98,-5,-233,82
-1,1194,1509,-315,-5,17,58
0,1618,1606,12,0,-29,90
1,1739,1493,246,-1,-135,67
-1,1622,1703,-81,0,-136,102
1,1532,1562,-30,10,353,67
-1,1661,1917,-256,0,-34,80
1,1892,1715,177,2,240,84
-1,1597,1682,-85,0,-30,122
-1,1444,1456,-12,-2,-72,64
1,2096,1698,398,0,59,93
1,1749,1805,-56,1,549,115
1,1993,1654,339,1,24,45
-1,1494,1780,-286,0,-76,114
1,1403,1500,-97,8,238,55
1,1921,1656,265,1,86,83
1,2027,1543,484,3,128,62
-1,1972,1694,278,4,170,86
-1,1391,1483,-92,-1,-93,58
1,1624,1576,48,0,477,179
-1,1527,1342,185,1,-61,70
-1,1373,1595,-222,-10,-530,112
1,1437,1452,-15,0,243,141
1,1652,1926,-274,0,1,107
1,2058,1651,407,6,168,48
1,1649,1500,149,7,585,105
-1,1696,2099,-403,0,-1,66
1,1538,1500,38,3,104,43
1,1949,1642,307,1,99,97
1,1630,1170,460,4,568,103
-1,1550,1543,7,0,-128,66
-1,1292,1381,-89,-7,-35,44
1,1777,1651,126,0,25,75
-1,1460,1357,103,-1,36,62
0,1792,1634,158,0,308,138
-1,1185,1371,-186,-2,-73,48
-1,1414,2032,-618,-3,-169,52
1,1606,1660,-54,-2,-9,45
1,1606,1618,-12,2,253,91
1,1822,1436,386,0,-55,105
-1,1667,1705,-38,1,14,82
1,1785,1485,300,-8,55,67
1,1500,1487,13,-1,-10,47
1,1953,1888,65,1,83,87
-1,1524,1377,147,2,-12,58
1,1729,1587,142,0,11,83
-1,2101,1716,385,-5,-102,58
-1,1521,1413,108,0,-10,70
-1,1879,1965,-86,-1,-62,58
1,1477,1639,-162,0,0,41
-1,1426,1635,-209,-3,3,76
1,1639,1644,-5,-1,329,139
-1,1787,1761,26,0,-137,80
-1,1173,1339,-166,0,-48,48
-1,1526,1436,90,-2,-39,50
1,1870,1554,316,-1,7,57
-1,1194,1373,-179,-4,-536,77
1,2077,1975,102,3,102,63
-1,1874,1741,133,3,20,106
1,1468,1750,-282,-1,-2,61
-1,1271,1309,-38,0,-27,86
1,1772,1776,-4,2,73,61
1,1493,1433,60,-6,-17,77
1,1715,1656,59,4,90,51
-1,1689,1637,52,-2,-133,78
1,1597,1161,436,-4,367,135
1,1530,1519,11,1,-57,117
-1,1436,1388,48,-2,-208,58
-1,1703,1804,-101,1,129,56
1,1500,1894,-394,0,38,65
1,1473,1450,23,1,168,77
-1,1500,1384,116,11,272,56
1,1573,1500,73,5,502,139
1,1562,1509,53,-4,-246,91
1,1882,1965,-83,-3,5,57
1,1482,1289,193,-1,-114,87
-1,1526,1523,3,-1,-158,92
1,1678,1569,109,-2,-167,123
-1,1423,1522,-99,-1,-146,74
1,1589,1500,89,-8,-648,123
-1,1712,1661,51,2,-9,50
-1,1665,1779,-114,0,3,74
1,1410,1507,-97,0,9,57
-1,1492,1553,-61,3,195,78
-1,1394,1496,-102,-4,-152,54
-1,1880,1676,204,0,-25,74
-1,1580,1531,49,-10,-653,128
1,1575,1700,-125,-4,-273,69
1,1413,1438,-25,-1,30,57
1,1685,1610,75,-4,194,101
-1,1158,1607,-449,-2,-401,111
1,1544,1411,133,0,42,77
1,2014,1695,319,1,48,61
-1,1590,1694,-104,-2,-198,68
-1,1500,1589,-89,-3,-25,40
-1,1386,1426,-40,1,20,46
-1,1691,2023,-332,-1,-102,60
-1,1705,1509,196,2,38,46
1,1709,1559,150,-7,-268,83
1,1552,1456,96,2,205,69
1,2038,1685,353,-3,-27,49
1,1657,1637,20,0,42,67
-1,1547,1716,-169,3,-175,134
0,1723,1535,188,-5,-458,104
-1,1161,1375,-214,-9,-20,40
1,1586,1536,50,1,263,133
-1,1560,1500,60,2,78,52
-1,1567,1436,131,2,-156,106
1,1277,1493,-216,1,61,118
-1,1440,1483,-43,-9,-213,56
0,1812,2052,-240,-1,-51,84
1,1707,1551,156,2,-49,79
-1,1381,1147,234,-5,-177,58
-1,1273,1487,-214,-2,-11,60
-1,1424,1504,-80,-4,-738,104
-1,1687,1864,-177,2,34,46
-1,1545,1781,-236,0,-125,102
0,1425,1616,-191,6,219,56
1,1195,1485,-290,-3,-47,59
1,1597,1634,-37,3,64,87
-1,1471,1552,-81,-2,-174,76
-1,1680,1947,-267,0,17,60
-1,1502,1421,81,-3,-92,51
1,1363,1193,170,-3,-67,55
1,1823,1540,283,0,-177,77
1,1277,1301,-24,-6,-204,55
-1,1416,1821,-405,-10,-253,56
-1,1290,1375,-85,11,226,52
-1,1672,1545,127,0,18,58
1,1560,1513,47,1,303,163
-1,1178,1369,-191,4,161,56
-1,1571,1723,-152,1,-131,82
1,1536,1824,-288,3,84,61
-1,1622,1734,-112,-2,-429,116
-1,1842,1954,-112,-3,-70,54
0,1729,1560,169,-2,-325,94
-1,1434,1489,-55,-7,-213,68
1,1675,1589,86,2,203,64
-1,1568,1724,-156,2,-189,98
-1,1068,1452,-384,-3,-149,112
1,1714,1668,46,1,-1,41
-1,1962,1835,127,0,-22,50
1,1556,1503,53,0,23,45
-1,1375,1164,211,-6,-128,94
1,1954,1894,60,0,101,77
1,1548,1500,48,7,1051,101
-1,1259,1307,-48,-11,-422,78
-1,1427,1281,146,-7,-352,62
1,1490,1563,-73,5,362,63
1,1494,1566,-72,0,97,95
1,1492,1367,125,5,226,63
1,1298,1410,-112,4,728,69
-1,1543,1504,39,-14,-186,48
-1,1886,2026,-140,-1,-55,98
-1,1652,1946,-294,0,-209,90
1,1517,1525,-8,-3,-3,59
-1,1855,1725,130,-4,-55,44
-1,1394,1315,79,-10,-174,52
-1,1596,1618,-22,-11,-196,62
-1,1552,1507,45,1,-6,74
1,1950,1648,302,0,84,57
1,1330,1380,-50,-4,-147,77
1,1737,1517,220,-3,-61,53
1,1742,1615,127,-2,-40,41
1,1579,1409,170,4,219,137
-1,1848,1954,-106,0,-27,68
1,1203,1357,-154,9,288,61
1,1690,1553,137,0,775,129
-1,1520,1539,-19,-4,-42,68
1,1725,1571,154,0,500,77
1,1703,1810,-107,3,36,57
1,1498,1425,73,6,146,49
1,1571,1725,-154,6,118,49
-1,1787,1953,-166,0,-16,116
1,1538,1705,-167,-1,-13,45
-1,1709,1592,117,-5,-533,94
1,1777,1355,422,-1,29,61
-1,1359,1500,-141,-7,-130,46
-1,1962,1962,0,-11,-256,42
-1,1317,1235,82,-5,195,90
-1,1610,1694,-84,-8,-526,76
-1,1550,1500,50,3,51,78
1,1341,1237,104,-2,-36,51
1,1703,1600,103,6,106,41
1,2036,1550,486,0,-26,57
1,1671,1548,123,0,-33,63
-1,1617,1711,-94,-13,-560,78
1,1711,1617,94,1,371,123
-1,1840,1863,-23,0,9,108
-1,1500,1540,-40,-5,-54,44
1,1540,1679,-139,0,18,65
-1,1607,1719,-112,-1,-447,74
-1,1541,1039,502,-1,-30,48
-1,1873,1830,43,-2,-33,44
-1,1727,1598,129,0,-7,44
1,1500,1556,-56,8,156,50
-1,1572,1353,219,-4,-15,62
-1,1556,1500,56,2,6,40
-1,1842,1861,-19,1,-139,72
1,1705,1547,158,1,227,71
0,1407,1616,-209,-1,165,102
-1,1521,1251,270,-2,-90,60
-1,1334,1294,40,-6,-86,58
1,1820,1695,125,-3,-39,49
1,1663,1609,54,8,512,83
1,1871,1832,39,-3,6,43
1,1399,1267,132,2,220,93
-1,1586,1346,240,1,-333,112
-1,1491,1430,61,-8,-134,40
-1,1598,1541,57,0,-175,90
1,1822,1881,-59,0,110,79
-1,1673,1487,186,-1,-127,60
1,1479,1185,294,3,98,49
1,1960,1701,259,0,53,63
-1,1688,1829,-141,0,1,56
1,1609,1532,77,-1,116,88
1,1544,1595,-51,-5,-218,47
1,1544,1595,-51,4,332,159
1,1657,1603,54,0,12,57
-1,1327,1482,-155,0,32,74
1,1593,1862,-269,-3,-123,55
-1,1667,1548,119,-1,-221,90
1,1580,1557,23,-2,-15,49
-1,1446,1738,-292,1,-32,46
-1,1592,1546,46,-2,-578,132
-1,1104,1405,-301,-4,-168,62
-1,1652,1778,-126,-4,-35,50
-1,1749,1868,-119,0,-8,74
1,1560,1603,-43,0,-21,45
1,1880,1432,448,0,11,53
-1,1572,1589,-17,2,19,44
1,1645,1841,-196,-2,-82,61
-1,1517,1504,13,-4,-118,50
0,1793,1657,136,-2,-829,152
0,1601,1584,17,6,225,129
1,1208,1251,-43,4,205,57
-1,1585,1600,-15,-2,-54,56
-1,1612,1780,-168,-5,-50,42
1,1650,1733,-83,1,94,89
1,1339,1341,-2,-6,-244,67
-1,1611,1574,37,2,145,52
-1,1973,1875,98,0,-18,54
-1,1574,1611,-37,-3,-32,42
1,1622,1564,58,4,165,57
-1,1489,1430,59,0,-105,88
1,1409,1424,-15,0,-3,49
-1,1632,1555,77,-13,-506,56
0,1660,1566,94,-3,102,100
-1,1542,1895,-353,-3,-30,68
-1,1721,1773,-52,-9,13,52
-1,1555,1632,-77,-3,-52,52
-1,1568,1641,-73,0,-35,94
-1,1225,1228,-3,-5,-337,96
1,1569,1657,-88,1,157,89
1,1650,1559,91,0,37,59
1,1659,1573,86,6,981,149
-1,1959,1889,70,0,8,47
-1,1712,1645,67,-1,-2,46
-1,1643,1823,-180,0,5,50
-1,1500,1587,-87,3,290,104
-1,1658,1699,-41,-1,-223,110
-1,1369,1421,-52,-6,-54,42
1,1902,1606,296,1,234,103
1,1709,1648,61,-2,47,53
-1,1639,1718,-79,2,3,46
-1,1637,2061,-424,1,-23,64
1,1718,1639,79,9,153,41
0,1661,1786,-125,6,1417,211
-1,1954,1883,71,-1,-44,62
0,1630,1727,-97,0,21,105
-1,1315,1834,-519,-8,-181,56
-1,1724,1633,91,-1,-54,52
-1,2063,1829,234,3,88,90
1,1500,1424,76,0,-35,73
-1,1647,1710,-63,-2,-279,78
1,1419,1313,106,-2,188,91
1,1500,1452,48,3,225,57
1,1710,1647,63,9,379,61
1,1824,1286,538,5,122,43
1,1942,1950,-8,6,4,40
1,2043,1593,450,0,197,97
-1,1638,1719,-81,-6,-235,50
1,1642,1416,226,1,-55,89
-1,1737,1245,492,-4,-56,52
1,1727,1629,98,0,143,123
-1,1620,1592,28,-13,-529,54
1,1500,1427,73,0,34,57
1,1365,1284,81,-1,-32,55
1,1485,1445,40,-1,35,59
1,1602,1500,102,1,193,69
-1,1642,1500,142,-4,-434,76
1,1613,1604,9,0,80,77
-1,1649,1305,344,-2,-178,72
0,1466,1516,-50,0,-146,130
1,1602,1616,-14,11,778,77
-1,1604,1614,-10,9,192,70
1,1825,1408,417,0,7,43
1,1418,1268,150,-2,-119,53
-1,1593,1624,-31,-3,-150,90
1,1905,1756,149,0,11,47
-1,1624,1593,31,-2,-38,62
1,1731,1403,328,-2,-54,59
-1,1314,1347,-33,-1,4,50
-1,1750,1912,-162,-3,-228,118
-1,1634,1605,29,1,-46,96
-1,1256,1427,-171,-1,34,82
-1,1318,1463,-145,-3,-158,78
1,2045,1595,450,0,-9,63
1,1899,1182,717,2,95,59
1,1434,1245,189,-4,-231,77
1,1918,1743,175,-10,8,65
1,1644,1593,51,0,0,61
1,1555,1374,181,-1,-1,57
-1,1593,1644,-51,-1,-24,50
-1,1500,2046,-546,-1,-4,114
1,1653,1584,69,0,0,56
1,1181,1900,-719,4,220,77
-1,1584,1653,-69,2,59,66
-1,1236,1441,-205,0,391,104
-1,1738,1924,-186,-1,-43,50
1,1662,1575,87,5,191,65
0,1575,1662,-87,-9,-571,133
-1,1709,1610,99,0,1,88
0,1525,1667,-142,0,33,67
1,1652,1277,375,3,122,50
-1,1930,1932,-2,-2,-36,110
1,1670,1577,93,6,90,41
-1,1702,1778,-76,-6,-36,40
-1,1678,1569,109,-2,43,102
-1,1952,1854,98,-3,-42,69
-1,1583,1664,-81,1,-6,42
1,1664,1583,81,-2,61,57
-1,1663,1529,134,0,-156,94
1,1583,1664,-81,-1,169,69
-1,1302,1277,25,-6,-42,64
-1,1605,1526,79,0,-209,110
1,1428,1304,124,8,297,53
1,2039,1597,442,0,36,51
-1,1827,1939,-112,0,-217,94
-1,1729,1657,72,-2,34,40
1,1786,1639,147,7,248,63
1,2024,1920,104,-1,52,65
1,2043,1595,448,6,212,65
1,1947,1819,128,4,160,65
1,1593,1651,-58,0,22,71
1,1639,1607,32,-2,414,99
1,2077,1913,164,0,50,79
1,1632,1558,74,-6,6,43
-1,1702,1683,19,-1,-65,69
1,1596,1648,-52,-5,-63,47
-1,1648,1596,52,0,18,56
1,2047,1202,845,4,70,49
1,1961,1805,156,0,6,61
1,1609,1636,-27,-2,242,81
1,1549,1641,-92,2,21,47
1,1436,1374,62,5,426,83
-1,1500,1546,-46,-3,-253,72
-1,1907,2113,-206,0,-59,92
1,1625,1621,4,2,98,59
-1,1434,1368,66,2,170,94
-1,1610,1635,-25,0,20,44
1,1906,1967,-61,0,20,41
-1,1635,1610,25,0,13,42
1,1638,1486,152,1,150,71
-1,1622,1624,-2,-9,-350,72
1,1325,1453,-128,-2,-162,111
1,1611,1634,-23,0,-22,83
1,2140,1902,238,-6,-61,75
1,1765,1654,111,8,194,41
1,1703,1648,55,0,68,96
1,1646,1653,-7,0,19,65
1,1363,1373,-10,0,6,63
1,1500,1397,103,-1,-23,79
-1,1397,1589,-192,-1,-3,46
-1,1562,1408,154,0,-201,78
-1,1941,2014,-73,0,5,48
1,2076,2060,16,1,120,73
1,1425,1343,82,-3,-171,91
1,1819,1845,-26,0,50,71
1,1563,1670,-107,0,169,119
-1,1631,1581,50,-4,9,40
1,1873,1601,272,6,89,47
-1,1417,1538,-121,2,-11,49
1,1805,1833,-28,0,-20,65
-1,1622,1644,-22,1,-124,82
-1,1547,1870,-323,-4,-86,40
1,1532,1524,8,0,-4,43
-1,1623,1490,133,0,-52,58
-1,1448,1696,-248,0,-285,116
-1,1597,1741,-144,0,16,68
1,1519,1569,-50,-1,-154,91
-1,1825,1592,233,-1,-8,72
1,1945,1713,232,2,252,91
1,1891,1632,259,-1,-24,53
1,1594,1638,-44,0,-25,110
-1,1493,1422,71,3,104,76
1,1828,1416,412,2,133,107
-1,1658,1642,16,0,-74,92
1,1758,1708,50,0,6,45
-1,1930,1893,37,-9,-6,178
1,1905,1624,281,3,131,47
-1,1789,1747,42,-12,-102,48
-1,1704,1615,89,0,20,66
1,1594,1391,203,1,39,75
1,1769,1589,180,1,73,59
-1,1533,1917,-384,-1,-246,100
1,2050,2087,-37,0,27,59
-1,1443,1575,-132,4,246,84
-1,1777,1583,194,2,121,86
1,1500,1473,27,-3,-72,109
-1,1619,1625,-6,0,-59,52
-1,2074,2062,12,-6,-185,54
1,1373,1357,16,5,81,43
1,1788,1749,39,-1,36,65
1,1596,1529,67,4,65,43
-1,1620,1909,-289,-2,-224,66
1,1489,1434,55,2,313,83
-1,2073,2062,11,0,32,66
-1,1484,1588,-104,-3,-57,74
1,1954,1834,120,3,260,90
-1,1636,1696,-60,-3,-128,84
1,1583,1435,148,8,648,79
1,2074,2062,12,-6,-181,79
-1,1616,1765,-149,1,-51,86
-1,1332,1588,-256,-1,-160,76
-1,1760,1702,58,1,204,124
1,1402,1425,-23,4,64,45
1,1631,1625,6,0,22,51
-1,1452,1443,9,1,40,104
0,1359,1305,54,-13,-581,92
-1,1462,1355,107,0,195,94
0,1817,1482,335,1,-23,100
-1,1472,1575,-103,-9,-335,58
1,1432,1516,-84,8,15,41
1,1275,1576,-301,-1,55,93
1,1831,1696,135,0,-80,61
1,1206,1304,-98,-2,32,41
1,1931,1824,107,0,52,59
-1,1715,1747,-32,-1,-84,84
1,1597,1627,-30,-7,-105,50
-1,1839,2007,-168,0,-6,54
-1,1465,1370,95,0,-4,62
-1,1550,1350,200,1,-38,64
-1,1816,2151,-335,-1,-68,84
-1,1822,1606,216,-4,-1,42
-1,1498,1276,222,1,15,50
1,1512,1616,-104,1,276,89
1,1961,2024,-63,0,17,47
-1,2052,2163,-111,1,99,86
1,1594,1516,78,-1,-72,61
-1,1419,1632,-213,-1,-364,86
-1,1424,1413,11,-5,-241,89
-1,1445,1538,-93,-5,-351,110
1,1501,1632,-131,0,60,53
1,1615,1551,64,2,198,75
-1,1586,1648,-62,-2,-48,48
-1,1571,1609,-38,0,-8,62
1,1247,1404,-157,4,63,49
1,1444,1315,129,1,18,41
1,1451,1435,16,0,62,78
-1,1716,1812,-96,1,17,70
1,1510,1499,11,-9,19,76
1,1756,1601,155,1,95,83
1,1609,1607,2,5,305,79
-1,1522,1656,-134,-4,-205,76
1,1605,1598,7,2,109,87
1,1572,1453,119,-1,-18,65
-1,1451,1451,0,2,94,84
-1,1105,1247,-142,-9,-194,52
-1,1557,1700,-143,-1,-33,70
1,1905,1935,-30,-2,100,73
-1,1805,1686,119,0,-22,46
-1,2013,1833,180,-1,-253,160
-1,1481,1861,-380,-2,-71,46
-1,1490,1807,-317,-7,-267,72
-1,1503,1604,-101,-1,20,76
1,1334,1207,127,1,-174,85
1,1741,1581,160,5,157,55
1,1686,1545,141,1,355,125
1,1871,1594,277,0,-12,83
1,1455,1437,18,-1,-4,45
1,1550,1707,-157,0,-42,87
-1,1464,1601,-137,-3,-250,116
-1,1728,1771,-43,-1,-145,88
1,1758,1821,-63,0,66,95
1,1875,1752,123,-3,-6,49
-1,1816,1939,-123,0,-312,114
1,1707,1923,-216,0,-79,103
1,1590,1778,-188,0,10,63
-1,1745,1883,-138,0,15,54
-1,1418,1515,-97,0,-269,112
-1,1271,1821,-550,-11,-171,44
1,1643,1355,288,2,59,47
1,1690,1212,478,1,56,47
1,1754,1607,147,5,171,69
1,1432,1539,-107,0,10,87
-1,1559,1440,119,-5,-126,110
1,1811,1596,215,-2,-76,73
-1,1748,1704,44,1,-215,98
1,1476,1309,167,2,116,87
0,1518,1663,-145,0,-4,122
1,1822,1269,553,0,35,65
1,1500,1582,-82,-7,104,65
-1,1301,1763,-462,-3,-88,58
1,1475,1632,-157,4,237,95
-1,1747,1668,79,-1,-122,98
1,1596,1590,6,1,84,71
-1,1373,1424,-51,0,49,78
1,1264,1436,-172,-4,68,67
-1,1513,1600,-87,0,14,56
1,1639,1587,52,0,-7,67
-1,1703,1701,2,-4,-54,46
-1,1707,1735,-28,-1,-47,62
-1,1573,1720,-147,-1,-161,106
-1,1267,1823,-556,-1,-136,68
1,1516,1429,87,0,53,71
1,1807,1771,36,5,154,49
-1,1487,1547,-60,-1,-208,86
1,1502,1609,-107,0,262,77
-1,1805,2000,-195,0,-78,140
1,1769,1905,-136,0,25,69
1,1523,1410,113,1,147,65
-1,1753,2174,-421,10,414,110
-1,1520,1594,-74,-1,-74,56
1,1608,1692,-84,-1,7,75
1,1693,1499,194,4,151,61
0,1716,1735,-19,0,-1,119
1,1427,1439,-12,-5,-13,44
1,1825,1264,561,2,344,71
-1,1510,1603,-93,-9,-499,70
1,1456,1325,131,2,152,101
0,1761,1817,-56,0,-8,101
-1,1561,1840,-279,0,5,80
-1,1706,1776,-70,0,-12,54
1,1691,1634,57,-1,96,133
1,1751,1687,64,2,86,55
-1,1687,1617,70,-1,-122,96
-1,1420,1525,-105,-1,-61,60
1,1781,1718,63,1,73,107
-1,1367,1585,-218,0,-231,88
1,1472,1270,202,2,57,71
1,1890,1803,87,3,19,51
-1,1263,1826,-563,-8,-487,62
-1,1612,1760,-148,0,129,88
1,1947,1809,138,4,262,123
-1,1501,1461,40,-3,-133,62
1,1654,1538,116,-1,-14,45
-1,1402,1359,43,-3,-199,86
-1,1771,1631,140,-4,-243,92
-1,1735,1717,18,-1,7,56
1,1870,1712,158,-1,-19,65
-1,1785,1696,89,0,-32,66
1,1420,1370,50,-4,171,67
1,1259,1828,-569,-5,-87,91
-1,1576,1556,20,0,10,48
-1,1543,1612,-69,0,-8,58
-1,1478,1839,-361,-14,-482,50
1,1461,1438,23,-2,16,57
1,2157,1742,415,-1,-50,59
-1,1317,1464,-147,0,-38,56
1,1728,1723,5,1,76,62
-1,1711,1771,-60,1,39,98
1,1763,1634,129,-1,-71,71
-1,1701,1622,79,0,-2,86
-1,1669,1376,293,-1,-46,50
-1,1348,1455,-107,0,-370,80
1,1386,1531,-145,1,205,109
1,1670,1662,8,0,42,101
0,1591,1425,166,2,183,114
1,1414,1434,-20,1,66,69
1,1648,1475,173,2,95,83
-1,1489,1630,-141,0,-53,66
1,2092,1737,355,0,84,113
1,1477,1799,-322,5,279,57
-1,1712,1739,-27,-1,-25,90
1,1591,1469,122,1,4,115
-1,1767,1757,10,-4,-83,50
1,1842,1614,228,-1,253,96
1,1624,1534,90,0,319,134
1,1522,1505,17,2,52,57
-1,1534,1593,-59,-1,-153,132
1,1581,1145,436,9,739,69
1,1698,1636,62,2,232,111
-1,1521,1463,58,-4,-213,72
1,1295,1207,88,3,277,77
1,1491,1471,20,-4,-3,57
-1,1769,1755,14,-2,-110,52
-1,1112,1200,-88,-3,-296,76
1,2035,1816,219,0,61,109
0,2065,1841,224,-1,-75,118
1,1803,1964,-161,-1,-9,49
1,1913,1590,323,0,83,59
1,1476,1508,-32,5,346,71
1,1457,1402,55,-1,-68,65
1,1757,1627,130,0,15,61
-1,1749,1702,47,0,22,94
1,1587,1708,-121,3,105,61
-1,1495,1488,7,-8,-416,76
-1,1767,1763,4,-3,-430,82
-1,1682,1542,140,1,-50,80
1,1469,1399,70,7,532,59
-1,1428,1655,-227,-1,-4,41
-1,1587,1932,-345,0,5,60
1,1413,1535,-122,-1,-24,83
-1,1673,1595,78,1,-385,108
-1,1465,1453,12,-12,-114,40
-1,1779,1756,23,0,-21,60
-1,1518,1778,-260,-4,-503,94
-1,1656,1610,46,0,-4,48
-1,1764,2176,-412,0,36,68
1,1739,1708,31,3,129,79
-1,1579,1753,-174,-3,-466,108
1,1525,1487,38,6,233,73
1,1616,1578,38,-1,118,61
1,1767,1763,4,2,58,73
1,1822,1701,121,1,80,73
-1,1730,1849,-119,0,-113,94
-1,1490,1301,189,-8,-41,40
1,1497,1455,42,1,95,75
1,1947,1584,363,0,63,73
-1,1253,1391,-138,-3,-321,117
-1,1777,1790,-13,0,-20,78
1,1762,1573,189,0,59,49
1,1651,1707,-56,-1,-48,69
1,1482,1389,93,-1,-17,41
1,1819,1644,175,0,100,73
-1,1768,1778,-10,-6,-138,48
1,1466,1454,12,8,169,47
1,1340,1477,-137,-6,-258,47
-1,1693,1627,66,-1,34,170
0,1439,1617,-178,-1,86,117
-1,1620,1434,186,0,-283,156
-1,1558,1665,-107,-1,-57,78
-1,1581,1960,-379,0,-135,80
-1,1535,1378,157,-8,-346,134
-1,1687,1789,-102,-1,-34,56
-1,1694,1830,-136,1,54,80
1,1616,1574,42,0,18,127
-1,1646,1847,-201,0,-112,88
-1,1600,1544,56,-1,-204,86
-1,1859,1808,51,0,-14,64
-1,1544,1564,-20,-6,-161,64
-1,1757,1788,-31,-1,-45,42
1,1594,1692,-98,-3,-255,83
1,1848,1443,405,-3,-6,47
-1,1748,1445,303,-5,-198,68
1,1759,1573,186,-2,-12,53
1,1784,1748,36,1,241,143
1,1470,1498,-28,5,184,61
1,1507,1478,29,0,8,53
1,1769,1798,-29,-1,-21,51
1,1857,1722,135,0,20,67
1,1463,1330,133,-6,-128,49
-1,1747,1707,40,-2,-118,86
-1,1226,1478,-252,0,-30,69
1,1448,1257,191,-1,76,67
-1,1678,1577,101,-2,-127,58
1,1918,1786,132,-1,355,85
1,1623,1443,180,0,11,41
0,1852,1641,211,0,-62,105
-1,1782,1795,-13,2,31,44
1,1974,1826,148,-3,5,73
1,1674,1266,408,3,186,67
1,1719,1734,-15,1,142,87
-1,1926,1779,147,-9,-137,40
1,1608,1972,-364,0,-88,113
-1,1562,1565,-3,0,-275,120
-1,1818,1977,-159,-1,-558,140
-1,1567,1838,-271,0,-117,74
1,1519,1417,102,-1,215,81
0,1438,1525,-87,0,183,122
0,1699,1910,-211,-1,-9,115
1,1646,1444,202,0,6,55
1,1550,1533,17,0,-17,49
-1,1718,1973,-255,-4,-120,62
1,1908,1509,399,1,417,117
-1,1551,1825,-274,-2,-58,44
1,2026,1598,428,2,143,59
1,1469,1372,97,2,42,119
-1,1891,2096,-205,-1,-1,68
1,1618,1480,138,1,124,57
1,1518,1200,318,-3,-75,49
1,1476,1434,42,-3,-77,63
-1,1440,1542,-102,-2,-140,106
-1,1525,1814,-289,-1,-149,74
1,1453,1629,-176,0,1,50
-1,1750,1833,-83,0,-7,66
-1,1919,1750,169,-2,-171,82
-1,1845,2161,-316,-1,-183,114
1,1696,1528,168,9,139,47
1,1726,1786,-60,-8,10,50
1,1354,1156,198,1,7,43
-1,1593,1809,-216,0,-311,120
-1,1388,1337,51,0,58,64
0,1883,2172,-289,0,-81,107
1,1795,1570,225,6,156,49
-1,1808,1780,28,2,198,118
1,1362,1366,-4,-2,96,85
1,1727,1595,132,0,8,51
-1,1398,1703,-305,0,-50,84
-1,1419,1629,-210,-4,-542,102
-1,1818,1586,232,0,80,84
-1,1500,1426,74,-7,-114,48
-1,1767,1900,-133,-6,-122,120
1,2049,1732,317,0,3,79
1,1842,1701,141,4,186,77
1,1899,1774,125,0,110,95
1,1521,1622,-101,0,5,99
1,1843,1740,103,0,10,79
1,1766,1569,197,-1,58,99
1,1472,1188,284,-3,-60,57
1,1489,1418,71,5,158,61
1,1734,1647,87,2,10,55
1,1521,1421,100,-1,-82,77
-1,1749,1563,186,0,-58,110
1,1692,1799,-107,-1,-86,59
-1,1400,1464,-64,-1,-3,40
1,1509,1544,-35,6,73,41
1,1415,1410,5,6,965,107
1,1522,1394,128,0,173,83
-1,1839,1900,-61,-2,-272,88
1,1908,1760,148,-1,160,81
-1,1707,1814,-107,0,-110,88
1,1349,1489,-140,0,37,61
1,1326,1174,152,1,254,115
-1,1555,1613,-58,-1,0,92
-1,1830,1970,-140,0,43,60
1,1784,1710,74,3,573,123
1,1909,1808,101,-4,-5,49
1,1401,1576,-175,0,122,81
1,1558,1778,-220,-3,-107,69
-1,1516,1588,-72,2,136,90
-1,1389,1522,-133,-2,-113,58
-1,1355,1374,-19,-1,-45,120
-1,1752,1916,-164,-2,-49,54
1,1977,1824,153,-3,-6,63
-1,1573,1620,-47,7,-211,112
-1,1799,1917,-118,-1,89,74
1,1329,1333,-4,6,52,77
1,1638,1742,-104,0,64,57
1,1731,1561,170,3,143,69
1,2062,1852,210,-3,22,77
1,1728,1529,199,0,1,57
0,1772,1563,209,2,484,217
-1,1500,1568,-68,-2,-2,54
1,1395,1635,-240,1,205,107
-1,1493,1514,-21,-10,-609,110
1,1793,1699,94,0,143,85
1,1817,1983,-166,-2,-95,77
1,1536,1297,239,9,43,41
-1,1792,1782,10,4,107,76
-1,1698,1822,-124,-5,-511,122
1,1955,1632,323,2,235,105
1,1924,1746,178,2,45,41
-1,1298,1315,-17,-8,-151,42
-1,1349,1563,-214,0,-571,126
-1,1619,1720,-101,-1,-440,190
-1,1560,1561,-1,-3,-216,78
1,1967,1833,134,2,122,55
1,1545,1552,-7,-8,8,225
1,1543,1494,49,0,43,131
1,1541,1653,-112,-2,-111,61
-1,1386,1529,-143,-1,-264,130
0,1689,1802,-113,-3,-537,164
-1,1477,1572,-95,-6,-196,80
1,1464,1571,-107,-1,-20,63
-1,1739,1930,-191,-3,-215,90
-1,1826,1974,-148,-5,-149,100
1,1588,1632,-44,-5,184,101
1,1564,1558,6,1,567,139
1,1333,1500,-167,2,-76,77
-1,1846,2082,-236,0,89,120
1,1500,1714,-214,0,151,83
1,1466,1389,77,0,28,51
1,1396,1400,-4,2,4,41
-1,1510,1754,-244,-3,-23,50
-1,1523,1734,-211,0,130,140
1,1564,1577,-13,1,210,77
-1,1798,1694,104,0,-51,66
1,1937,1733,204,0,108,77
-1,1829,1689,140,1,192,122
-1,2019,1850,169,0,-32,84
-1,1476,1434,42,0,-416,112
-1,1813,1987,-174,0,-64,98
1,1627,1548,79,-1,7,107
1,1561,1760,-199,-1,-20,47
-1,1617,1900,-283,-2,-269,104
1,1738,1237,501,2,218,67
1,1727,1554,173,1,129,69
-1,1505,1759,-254,0,-16,46
1,1530,1411,119,1,73,69
1,1710,1783,-73,0,-43,109
-1,1385,1345,40,-2,-63,64
1,1728,1611,117,7,372,83
-1,1669,1539,130,-11,-250,58
-1,1807,1993,-186,0,-52,92
1,1555,1563,-8,0,41,65
-1,1638,1781,-143,0,114,80
-1,1547,1830,-283,0,4,54
1,1604,1554,50,16,468,47
-1,1870,1907,-37,0,-8,46
1,1578,1562,16,0,96,59
-1,1500,1457,43,-2,-212,62
1,1999,1802,197,0,38,71
-1,1448,1719,-271,-3,-180,80
0,1529,1510,19,0,-140,98
1,1669,1536,133,1,2,45
1,1770,1726,44,-3,759,151
1,1320,1340,-20,-7,-415,75
-1,1426,1442,-16,3,27,40
-1,1529,1356,173,0,-61,58
1,1734,1548,186,0,24,67
-1,1064,1343,-279,-2,214,118
-1,1379,1582,-203,-1,-17,48
1,1692,1739,-47,-6,157,86
1,1692,1529,163,-11,-416,83
1,1486,1400,86,-1,-18,55
1,2098,1917,181,0,-85,69
1,1796,1727,69,1,-76,113
1,1608,1502,106,6,492,89
-1,1429,1403,26,2,127,98
1,1739,1840,-101,1,76,62
1,1411,1569,-158,-2,305,97
-1,1631,1451,180,-2,61,84
-1,1483,1470,13,-3,-31,50
1,1711,1522,189,-21,-774,71
1,1703,1788,-85,-2,211,87
-1,1360,1377,-17,-4,-355,86
1,1292,1676,-384,-3,-39,53
1,1641,1285,356,2,333,71
1,1482,1470,12,-9,-309,49
0,1727,1517,210,8,647,93
-1,1561,1418,143,0,-126,108
-1,1566,1500,66,-3,26,50
-1,1496,1378,118,0,101,76
-1,1733,1904,-171,0,8,70
1,1718,1805,-87,3,468,109
-1,1587,1373,214,2,44,50
1,1591,1780,-189,0,-103,115
-1,1538,1493,45,0,30,68
1,1655,1895,-240,0,54,71
0,1545,1507,38,-8,-79,44
0,1422,1405,17,3,498,104
-1,1588,1824,-236,-2,-393,170
-1,1754,1689,65,1,2,54
1,1361,1457,-96,0,68,77
-1,1725,1778,-53,2,24,48
1,1467,1551,-84,0,447,115
-1,1347,1053,294,2,33,68
-1,1479,1506,-27,0,-95,70
1,1791,1732,59,3,1,47
1,1763,1607,156,2,140,65
1,1588,1568,20,0,8,49
-1,1637,1987,-350,-1,-201,79
1,2117,1885,232,0,83,75
-1,1346,1494,-148,0,17,48
-1,1441,1756,-315,-10,-103,50
-1,1444,1381,63,0,-167,114
1,1723,1801,-78,0,25,59
-1,1399,1746,-347,-2,-85,42
1,1409,1498,-89,-2,-137,109
-1,1601,1769,-168,0,-190,92
-1,1740,1794,-54,-1,3,48
-1,1787,1737,50,-2,-31,46
-1,1269,1717,-448,-1,-89,82
1,1411,1432,-21,3,79,57
-1,1437,1366,71,-7,-190,54
-1,1481,1620,-139,1,-429,112
-1,1421,1536,-115,-2,-163,76
-1,1562,1727,-165,-3,-167,74
-1,1714,1686,28,-3,-35,40
1,1546,1835,-289,-1,-29,51
-1,1433,1375,58,3,91,70
1,1774,1569,205,5,103,47
0,1648,1579,69,2,295,122
1,1507,1522,-15,2,99,43
1,1776,1594,182,0,16,103
1,1835,1880,-45,0,16,79
1,1384,1217,167,-2,-75,46
1,1630,1714,-84,-3,4,51
1,2219,1750,469,2,54,47
0,1663,1500,163,-3,-269,149
-1,1392,1752,-360,-15,-699,67
-1,1500,1752,-252,-6,-261,64
1,1731,1647,84,1,248,115
1,1544,1627,-83,-3,-47,43
-1,1563,1779,-216,-1,-15,100
-1,1501,1684,-183,0,-5,42
-1,1425,1500,-75,-1,-140,74
-1,1748,2221,-473,-1,-29,62
-1,1474,1698,-224,-1,-213,70
-1,1527,1698,-171,1,-69,72
1,1506,1701,-195,1,66,76
1,1588,1782,-194,-1,87,93
-1,1543,1810,-267,3,-235,148
1,1613,1484,129,7,685,105
-1,1404,1560,-156,-2,-91,46
1,2223,1747,476,1,11,47
1,1556,1385,171,4,70,48
1,1868,1849,19,-1,-162,125
1,1482,1424,58,-2,73,81
-1,1473,1486,-13,-15,-469,56
-1,1765,1605,160,4,191,108
-1,1350,1654,-304,-2,-15,42
0,1396,1538,-142,-1,-32,53
0,1768,1686,82,0,-19,70
-1,1500,1581,-81,-3,-6,56
1,1707,1210,497,1,86,53
-1,1603,1739,-136,0,1,74
-1,1677,1634,43,0,-61,74
-1,1733,1641,92,1,-114,104
-1,1708,1500,208,2,-16,48
-1,1784,1723,61,0,-195,106
1,1719,1267,452,0,17,95
1,1414,1558,-144,2,133,59
1,1391,1874,-483,-2,-42,49
1,1622,1355,267,1,540,93
-1,1345,1426,-81,-6,-195,56
1,1500,1341,159,-2,-193,71
1,1414,1493,-79,-2,257,153
1,1580,1412,168,5,250,59
-1,1394,1473,-79,1,18,46
1,1478,1374,104,3,414,93
1,1621,1748,-127,-1,-29,67
-1,1602,1588,14,0,-58,90
-1,1682,1843,-161,-1,-142,72
-1,1644,2006,-362,-8,-617,74
-1,1434,1500,-66,-3,-501,105
-1,1768,2002,-234,0,-22,90
0,1533,1760,-227,0,-8,112
-1,1525,1550,-25,0,-329,128
1,2132,1637,495,2,42,45
-1,1400,1690,-290,-4,-216,76
1,1946,1569,377,0,64,93
1,1418,1437,-19,-1,76,59
-1,1590,1850,-260,-5,-129,61
-1,1527,1500,27,-2,-491,106
-1,1562,1497,65,-4,-28,40
1,1733,1636,97,-1,-65,95
-1,1462,1346,116,-4,-145,60
-1,1837,1878,-41,1,7,61
1,1482,1661,-179,3,178,65
1,1500,1268,232,2,62,49
1,1704,1701,3,0,43,79
-1,1245,1538,-293,0,-364,88
1,1405,1309,96,-1,-10,55
1,1536,1544,-8,0,-48,47
-1,1510,1397,113,3,542,88
1,1500,1634,-134,0,23,58
-1,1500,1658,-158,-10,-53,40
-1,1760,2103,-343,-2,-146,68
-1,1475,1545,-70,-4,-280,88
-1,1675,1447,228,1,-156,68
-1,1560,1741,-181,-1,-10,72
0,1690,1848,-158,3,136,76
-1,1850,1646,204,1,159,94
1,1628,1741,-113,1,25,103
-1,1706,2013,-307,-2,-143,62
-1,1548,1510,38,1,-74,176
1,1408,1429,-21,-2,25,53
-1,1332,1709,-377,-6,-81,66
0,1611,1589,22,5,195,97
-1,1292,1500,-208,1,20,46
-1,1517,1771,-254,-8,-37,86
1,1689,1623,66,-3,-50,57
1,1726,1643,83,2,20,53
1,2107,1757,350,-2,18,71
-1,1264,1721,-457,-1,-52,78
-1,1567,1949,-382,0,-202,94
1,1478,1428,50,1,84,67
-1,1427,1388,39,1,32,58
-1,1555,1599,-44,2,9,58
1,1731,1599,132,0,425,145
-1,1281,1319,-38,-9,-434,68
1,1741,1397,344,3,87,59
1,2047,1736,311,4,203,65
1,1690,1500,190,7,455,77
1,1697,1534,163,2,82,81
1,1806,1511,295,2,531,133
-1,1734,2035,-301,-3,-106,76
1,1603,1858,-255,-2,64,107
1,1722,1219,503,0,37,87
-1,1729,2051,-322,9,374,84
-1,1211,1233,-22,-25,-448,40
0,1368,1583,-215,0,56,166
-1,1477,1343,134,5,262,62
1,1707,1686,21,0,29,43
-1,1561,1665,-104,-2,-41,40
1,1573,1673,-100,0,232,89
-1,1500,1200,300,15,373,42
-1,1376,1802,-426,1,24,54
1,2054,1723,331,1,104,63
-1,1185,1308,-123,0,-15,49
-1,1717,2058,-341,1,62,80
1,1115,1214,-99,8,565,81
1,1417,1569,-152,2,92,69
-1,1556,1728,-172,0,-47,72
-1,1532,1553,-21,-3,-304,78
-1,1619,1288,331,-4,-220,71
-1,1360,1591,-231,3,201,86
-1,1448,1409,39,-11,-319,78
-1,1395,1717,-322,-5,-911,130
1,1929,1726,203,1,225,89
1,1561,1591,-30,-4,-68,61
1,1824,1649,175,0,121,61
-1,1179,1632,-453,-4,-103,46
1,1510,1414,96,10,124,45
0,1745,1654,91,-2,-226,124
1,1824,1686,138,0,-242,93
1,1598,1302,296,0,519,87
-1,1598,1672,-74,-5,-216,72
1,1430,1295,135,0,-18,41
-1,1734,1887,-153,-3,-82,61
-1,1619,1668,-49,2,57,86
1,1592,1270,322,3,732,97
-1,1673,1831,-158,0,-10,66
1,1689,1681,8,2,-144,99
1,1652,1744,-92,0,-14,55
-1,1578,1375,203,2,101,66
-1,1681,1589,92,5,257,60
1,1575,1552,23,0,56,59
-1,1266,1403,-137,-1,-299,98
-1,1176,1112,64,2,-295,102
-1,1549,1591,-42,-2,26,96
1,1523,1285,238,4,219,67
1,1374,1633,-259,-2,-72,71
1,1229,1350,-121,2,-17,47
-1,1662,1700,-38,-6,-962,128
-1,1441,1409,32,-6,-112,47
1,1488,1199,289,1,34,59
1,1727,1374,353,-5,-6,47
1,1488,1213,275,1,110,81
-1,1541,1573,-32,1,44,52
1,1895,1727,168,-1,57,53
1,1838,1661,177,-2,-41,83
1,1381,1311,70,0,31,73
1,1707,1460,247,-3,-74,102
1,1795,1858,-63,0,21,49
-1,1478,1641,-163,-5,-203,56
0,1682,1756,-74,0,-316,148
1,1723,1630,93,0,88,83
1,1596,1539,57,3,42,45
-1,1643,1831,-188,0,-70,76
-1,1341,1194,147,2,47,58
-1,1700,1936,-236,0,-4,60
1,1442,1416,26,5,135,50
-1,1811,1685,126,4,106,106
1,1521,1592,-71,-3,-174,81
-1,1492,1572,-80,-1,-359,92
-1,1467,1470,-3,-8,-96,54
-1,1421,1429,-8,-7,-167,56
-1,1711,2053,-342,-2,-77,54
-1,1602,1539,63,-8,-154,86
-1,1500,1604,-104,-7,21,54
-1,1754,1684,70,-3,-43,66
-1,1625,1689,-64,-1,-134,66
1,1832,1717,115,5,217,61
1,1215,1324,-109,2,72,61
-1,1657,1721,-64,-1,-101,82
-1,1712,1730,-18,0,-49,72
1,1731,1628,103,-1,8,73
1,1485,1210,275,3,828,101
1,1716,1491,225,2,48,45
1,1675,1616,59,0,13,57
-1,1224,1562,-338,1,37,58
1,2060,1801,259,0,9,87
-1,1220,1811,-591,-6,-273,76
0,1742,1935,-193,-1,39,104
1,1579,1534,45,-2,4,47
-1,1579,1812,-233,-1,-29,60
-1,1360,1684,-324,-2,-127,74
1,1741,1219,522,5,237,65
-1,1671,1620,51,-6,-112,56
-1,1571,1536,35,-1,101,98
1,1880,1760,120,0,-4,51
1,1468,1391,77,-5,-10,45
1,1658,1633,25,0,945,137
0,1482,1455,27,-3,-656,201
1,1565,1208,357,-2,-205,117
1,1606,1739,-133,0,-87,61
-1,1485,1610,-125,0,-23,110
1,2091,1650,441,-2,-89,77
1,1845,1845,0,0,79,95
-1,1801,1766,35,5,144,79
1,1548,1435,113,0,169,81
-1,1619,1825,-206,-3,-314,60
-1,1439,1410,29,1,-39,56
-1,1195,1568,-373,2,-47,72
-1,1702,1874,-172,0,22,96
1,1687,1605,82,9,1076,113
-1,1393,1507,-114,0,13,52
0,1592,1797,-205,0,-70,118
-1,1739,1888,-149,0,5,50
-1,1708,1730,-22,1,-20,74
-1,1123,1287,-164,-3,-78,50
-1,1592,1538,54,6,255,102
1,1724,1779,-55,0,4,49
-1,1563,1585,-22,-3,3,40
1,1696,1596,100,1,719,131
-1,1527,1688,-161,-3,-60,86
1,1725,1526,199,0,6,55
-1,1613,1499,114,-2,-63,64
1,1792,1645,147,-1,-67,115
-1,1571,1183,388,0,-14,54
1,1787,1754,33,-5,-8,93
1,1721,1707,14,2,68,65
1,1454,1530,-76,0,24,71
-1,1748,1730,18,-2,-158,66
-1,1379,1490,-111,-5,-211,74
1,1624,1733,-109,1,761,117
-1,1276,1551,-275,0,105,80
-1,1670,1618,52,0,-1096,202
-1,1579,2109,-530,-2,-545,128
1,1788,1728,60,0,1,47
1,1581,1475,106,10,808,95
1,1552,1478,74,1,52,62
-1,1574,1730,-156,0,29,58
1,1487,1355,132,-4,-143,61
1,1548,1558,-10,3,80,65
-1,1278,1659,-381,-3,-239,62
-1,1812,1912,-100,1,4,109
1,1998,1748,250,0,21,45
-1,1556,1259,297,-10,-339,70
1,1599,1608,-9,5,252,53
1,1727,1669,58,-1,-12,101
-1,1880,1895,-15,-1,-310,108
1,1719,1639,80,0,-23,89
1,1274,1289,-15,3,479,141
-1,1758,1660,98,3,55,56
-1,1500,1364,136,0,-661,112
-1,1798,1628,170,0,-277,110
1,1856,1753,103,-2,-9,137
0,1545,1559,-14,-2,23,117
1,1500,1442,58,4,433,71
1,1606,1217,389,13,491,57
1,1072,1384,-312,0,75,64
1,1842,1569,273,4,42,43
-1,1704,1667,37,-6,-124,50
-1,1898,2100,-202,0,-35,62
-1,1610,1799,-189,0,-105,64
-1,1275,1662,-387,-5,-332,66
1,1596,1472,124,10,380,69
1,2112,1578,534,2,513,97
1,1740,1258,482,-2,215,97
1,1788,1804,-16,0,23,77
-1,1922,2002,-80,-2,30,80
-1,1692,1680,12,0,5,52
1,1167,1375,-208,1,18,64
1,1577,1597,-20,0,74,123
-1,1640,1668,-28,-9,-81,146
-1,1425,1435,-10,-7,55,42
-1,1695,1560,135,-4,-20,44
-1,1601,1522,79,1,16,50
1,1693,1740,-47,-1,-8,65
1,1492,1335,157,0,2,65
-1,1698,1813,-115,-1,-73,74
-1,1428,1501,-73,0,3,76
1,1730,1712,18,-5,-53,119
1,1487,1614,-127,3,354,111
-1,1107,1218,-111,-24,-435,44
1,1684,1325,359,1,34,73
-1,1906,2127,-221,0,-20,48
1,1743,1446,297,3,49,49
1,1311,1499,-188,-9,140,103
0,1783,1870,-87,0,-166,138
-1,1510,1604,-94,4,65,82
-1,1727,1633,94,2,14,42
1,1805,1604,201,4,90,41
0,1577,1630,-53,1,-1,125
1,1385,1665,-280,0,123,93
-1,1254,1346,-92,5,198,68
-1,1496,1356,140,-4,-89,92
1,1706,1509,197,0,-5,45
1,1741,1592,149,0,172,79
0,1687,1490,197,0,48,147
-1,1482,1367,115,0,-65,86
1,1834,2125,-291,0,111,69
-1,1652,1616,36,1,-10,70
1,1647,1735,-88,5,466,103
1,1216,1364,-148,5,117,57
-1,1589,1771,-182,0,-41,114
1,1780,1513,267,1,-21,43
-1,1745,1965,-220,0,3,52
-1,1599,1812,-213,-1,-72,74
0,1533,1480,53,2,348,93
1,1446,1481,-35,4,28,43
1,1279,988,291,20,471,43
-1,1690,1822,-132,-1,-495,122
-1,1906,2133,-227,1,8,50
1,1688,1490,198,3,-12,41
1,1413,1467,-54,-1,-3,49
1,1728,1706,22,3,42,49
1,1901,1864,37,-1,-35,45
1,1613,1606,7,0,4,41
-1,963,1340,-377,-7,-244,68
-1,1568,1500,68,-3,-303,110
1,1693,1474,219,6,204,63
1,1515,1621,-106,-1,-66,93
1,1401,1506,-105,1,46,65
-1,1454,1450,4,0,-10,94
1,1244,1375,-131,1,112,55
-1,1586,1750,-164,-2,-162,72
1,1558,1546,12,-1,547,129
1,1698,1461,237,0,126,61
1,1345,1293,52,0,87,65
1,1579,1629,-50,2,114,75
1,1703,1449,254,0,63,59
1,1790,1443,347,0,31,53
-1,1586,1624,-38,3,244,88
-1,1537,1521,16,-4,-664,108
-1,1740,1784,-44,-2,-54,106
-1,1920,1845,75,-1,-73,78
-1,949,1359,-410,-4,-294,92
-1,1786,1743,43,-2,-203,84
-1,1411,1647,-236,-4,-141,54
1,1480,1443,37,-1,-24,61
-1,1747,1561,186,1,47,58
-1,2138,1902,236,0,-7,66
0,1729,2057,-328,0,-54,96
-1,1696,1738,-42,-7,-246,68
1,2104,1853,251,0,36,121
1,1334,1226,108,9,626,89
1,1818,1970,-152,-2,289,125
1,1683,1691,-8,-4,-8,55
-1,1671,1712,-41,-4,-11,44
-1,1408,1458,-50,0,-96,92
1,2128,2107,21,0,51,97
1,1815,1673,142,2,45,47
-1,1661,1754,-93,1,62,58
-1,1516,1628,-112,0,11,82
1,1417,1589,-172,0,140,71
1,1758,1579,179,1,175,119
1,1722,1608,114,-2,74,59
1,1679,1607,72,2,90,62
1,1735,1372,363,2,379,86
1,1773,1758,15,-3,89,103
-1,1576,1927,-351,0,-294,74
-1,1431,1646,-215,-3,-652,96
1,1766,1652,114,-5,-46,93
-1,1472,1624,-152,0,-21,76
-1,1600,1730,-130,0,40,88
-1,1773,1635,138,-3,-169,96
-1,1636,1508,128,-4,-741,128
-1,1321,1687,-366,-2,-238,68
-1,1497,1653,-156,-8,-342,64
-1,1450,1504,-54,1,-152,90
-1,1193,1645,-452,-4,-136,58
-1,1589,1544,45,-4,-187,66
-1,1747,1686,61,-2,-51,64
1,1571,1607,-36,1,391,175
0,1535,1569,-34,-2,-77,112
1,1745,1907,-162,-1,-38,68
1,1793,1652,141,0,-35,41
1,1784,1533,251,0,-153,79
1,1954,1858,96,0,44,93
1,1675,1286,389,0,16,53
-1,1521,1348,173,0,-19,66
1,1758,1874,-116,-1,-16,71
-1,1526,1440,86,-6,-637,90
1,1558,1527,31,0,156,82
-1,1646,1639,7,-1,-30,64
1,1524,1621,-97,1,120,61
1,1516,1724,-208,-4,-70,131
1,1711,1630,81,-3,23,126
-1,1423,1514,-91,-3,-617,98
1,1600,1588,12,0,-55,147
1,1481,1516,-35,3,117,43
1,1741,1388,353,2,157,49
-1,1695,1854,-159,-4,22,58
-1,1573,1765,-192,1,47,92
-1,1770,2139,-369,-1,-35,50
1,1455,1496,-41,3,112,53
-1,1125,1587,-462,-13,-337,48
1,1651,1495,156,2,82,107
1,1678,1555,123,0,244,115
-1,1583,1537,46,-2,-89,52
1,1788,1848,-60,0,-29,71
1,1470,1469,1,-6,-304,71
-1,1511,1540,-29,-1,-20,42
1,2006,1844,162,-1,-59,69
-1,1518,1953,-435,-1,-146,62
-1,1514,1579,-65,0,-25,68
1,1974,2075,-101,-3,96,139
1,1616,1613,3,17,320,43
-1,1508,1500,8,1,67,78
-1,1444,1500,-56,0,34,52
-1,1967,1892,75,1,36,58
-1,1316,1723,-407,-3,-217,94
-1,1750,1728,22,-5,-344,96
-1,1711,1913,-202,0,-82,78
1,1313,1320,-7,0,-39,51
1,1615,1582,33,4,47,45
1,2060,1990,70,-2,4,43
-1,1270,1250,20,-12,-261,44
1,1847,1869,-22,-5,14,81
1,1560,1540,20,-3,431,165
1,1543,1649,-106,-2,-43,45
0,1546,1587,-41,0,334,154
1,1980,2070,-90,0,90,79
1,1595,1445,150,4,539,115
1,1605,1742,-137,0,24,57
1,1451,1221,230,2,71,51
-1,1472,1582,-110,0,110,108
1,1436,1436,0,-2,-19,111
-1,1665,1756,-91,-1,-82,68
-1,1670,1671,-1,1,28,66
-1,1333,1379,-46,0,-151,64
-1,1973,1848,125,-3,-317,68
1,1452,1635,-183,0,19,76
1,1617,1551,66,4,387,77
1,1446,1572,-126,0,-9,61
-1,1804,1906,-102,0,-25,54
-1,1885,1957,-72,-7,-271,92
-1,1848,2055,-207,0,1,52
1,1480,1512,-32,8,595,89
1,1651,1871,-220,0,22,93
1,1443,1402,41,-1,-21,43
1,1967,1864,103,0,106,91
-1,1521,1743,-222,0,-1,42
1,1511,1325,186,4,243,75
1,1914,1796,118,0,19,47
1,1715,1918,-203,-1,-196,133
-1,1617,1808,-191,0,-27,70
-1,1499,1987,-488,-8,-220,56
-1,1419,1389,30,3,30,49
-1,1572,1644,-72,0,-35,70
1,1580,1500,80,9,473,66
1,1771,1617,154,1,51,61
-1,1209,1395,-186,0,-106,86
-1,2167,2060,107,0,-153,113
1,1983,1831,152,0,-8,49
-1,1558,1541,17,-3,-157,66
-1,1659,1744,-85,-2,29,84
-1,1513,1500,13,-8,-115,40
0,1585,1908,-323,-2,-157,112
1,1622,1313,309,3,609,153
1,1627,1403,224,7,201,57
-1,1513,1467,46,2,-44,96
1,1990,1990,0,1,71,141
1,1529,1387,142,4,54,59
1,1696,1622,74,1,50,61
-1,1469,1616,-147,-6,-296,70
1,1545,1512,33,-4,-69,75
1,1544,1329,215,0,6,45
-1,1806,2076,-270,-1,-130,82
-1,1748,1726,22,-1,-155,94
-1,1664,1668,-4,0,-397,156
-1,1281,1537,-256,-23,-514,48
1,1500,1553,-53,1,4,53
1,1853,1838,15,0,-32,61
-1,1978,2002,-24,0,-131,94
1,1593,1889,-296,-1,75,67
1,1422,1602,-180,-2,135,125
-1,1605,1579,26,-1,-19,44
1,2080,1802,278,1,242,119
1,1795,1838,-43,2,2,121
1,1501,1408,93,2,49,41
1,2014,1967,47,0,380,93
-1,1778,1782,-4,0,-2,44
1,1551,1557,-6,-3,-240,73
1,1500,1601,-101,5,212,59
-1,1310,1513,-203,7,67,72
1,1957,2025,-68,0,-10,73
1,1630,1844,-214,-1,11,41
1,1594,1500,94,0,143,63
-1,1546,1705,-159,-4,-275,67
1,1550,1611,-61,0,375,157
1,2010,1971,39,2,194,91
-1,1626,1823,-197,-7,-81,45
1,1602,1798,-196,0,52,67
1,1311,1360,-49,-1,217,65
1,1516,1241,275,7,392,77
1,1305,1213,92,4,82,44
1,1651,1681,-30,1,29,41
1,1806,1753,53,1,119,77
1,1679,1652,27,0,107,111
-1,1654,1497,157,-2,-95,110
1,1961,2021,-60,0,-4,45
1,1290,1613,-323,0,145,75
1,1827,1866,-39,1,37,45
-1,1601,1553,48,-4,-39,44
-1,1519,1666,-147,-4,-376,106
1,1487,1363,124,4,230,64
1,2007,1974,33,0,79,81
0,1364,1478,-114,0,188,164
-1,1466,1780,-314,5,142,72
1,1964,2018,-54,-1,-111,123
1,1705,1725,-20,0,28,65
-1,1399,1486,-87,0,-179,96
1,1499,1494,5,-4,-26,58
1,1314,1284,30,0,-6,49
-1,1826,1693,133,3,54,79
-1,1587,1474,113,-3,-505,120
-1,1598,1606,-8,-6,-35,40
-1,1488,1481,7,-3,-351,114
1,1563,1652,-89,-7,68,65
-1,1459,1787,-328,1,-87,58
1,1535,1611,-76,2,221,81
-1,2004,1977,27,0,-213,92
-1,1839,2000,-161,-1,-192,110
-1,1709,1827,-118,-3,-58,64
1,1520,1439,81,0,276,87
-1,1621,1828,-207,0,2,50
1,1631,1667,-36,-2,-119,73
1,1790,1456,334,3,166,59
1,1726,1456,270,0,136,105
1,1989,1991,-2,1,136,109
1,1631,1495,136,2,250,109
-1,1510,1617,-107,-5,-70,52
1,1980,2000,-20,1,34,59
1,1505,1532,-27,-1,103,71
0,1562,1546,16,-1,-520,104
-1,1603,1795,-192,-4,-233,80
1,1576,1701,-125,5,237,79
1,1401,1274,127,-1,14,57
-1,1680,1600,80,-5,-83,54
-1,1988,1992,-4,0,-247,140
-1,1440,1679,-239,0,-250,98
-1,1712,1714,-2,-8,-85,68
1,1734,1612,122,-5,132,95
1,1655,1644,11,-1,-10,81
1,1502,1512,-10,-2,117,119
1,1605,1331,274,0,61,85
1,2084,1995,89,0,0,63
1,1967,2014,-47,0,201,89
1,1665,2007,-342,1,133,91
-1,1613,1808,-195,-1,-17,42
1,1632,1549,83,0,15,53
0,2001,1980,21,1,33,67
1,1986,1453,533,-3,-17,73
1,1334,1272,62,0,148,61
1,1780,1874,-94,0,-28,71
1,1461,1305,156,3,129,73
-1,1474,1368,106,-1,-210,67
-1,1980,2000,-20,-7,-32,44
-1,2019,1827,192,-2,-57,64
-1,1513,1872,-359,2,-132,108
1,1599,1482,117,0,15,44
1,2011,1970,41,0,67,69
-1,1446,1623,-177,-1,-51,54
1,1408,1266,142,-2,22,59
-1,1751,1708,43,-5,-57,47
-1,1357,1266,91,1,73,60
-1,1649,1500,149,-3,-61,62
1,1786,1624,162,0,29,65
1,1987,1452,535,-2,29,51
-1,1638,1698,-60,-3,-158,60
1,1507,1315,192,0,47,77
1,1719,1741,-22,0,159,129
1,1720,1687,33,1,-67,71
-1,1468,1504,-36,-8,-97,42
-1,1505,1988,-483,-2,-445,96
1,1985,1751,234,3,189,73
-1,1606,1615,-9,0,17,50
0,1705,1608,97,0,-113,149
-1,1682,1845,-163,-3,-86,56
-1,1500,1654,-154,-1,-51,58
1,1506,1591,-85,0,-16,57
1,1990,1502,488,-9,100,87
-1,1427,1355,72,5,114,57
1,1504,1577,-73,7,107,43
-1,1546,1568,-22,3,110,69
1,1539,1429,110,5,261,43
-1,1499,1991,-492,0,18,78
1,1605,1573,32,3,296,79
-1,1677,1971,-294,-4,-281,66
1,1610,1707,-97,1,169,133
1,1353,1327,26,0,30,54
-1,1993,1743,250,1,118,74
1,1521,1537,-16,3,242,73
-1,1851,2103,-252,-1,-72,64
1,1920,2001,-81,-2,-27,67
-1,1641,1748,-107,0,-50,70
-1,1421,1547,-126,-2,-15,54
1,1492,1627,-135,-3,82,81
1,1610,1573,37,0,53,87
-1,1308,1598,-290,3,14,44
-1,1755,1729,26,2,73,126
1,1673,1874,-201,-2,5,159
-1,1975,1935,40,0,20,62
-1,1397,1771,-374,1,19,40
-1,1791,1856,-65,0,-97,76
1,1567,1402,165,3,194,60
1,1729,1731,-2,2,116,105
-1,1520,1578,-58,0,-183,120
0,1829,1885,-56,-1,-21,171
-1,1500,1513,-13,-1,-87,96
1,1511,1488,23,-4,-145,79
-1,1437,1414,23,0,-10,62
-1,1394,1574,-180,-3,-132,86
1,2107,1846,261,0,-4,41
1,1505,1536,-31,-1,12,43
1,1601,1304,297,0,154,59
-1,1727,1756,-29,0,98,122
1,1478,1372,106,-1,-1,47
0,1797,1500,297,0,-23,116
-1,1630,1477,153,-1,-109,108
-1,1591,1581,10,0,-64,104
1,1606,1653,-47,0,204,107
-1,1933,1947,-14,-2,121,126
1,1708,1701,7,7,62,41
1,1618,1371,247,5,158,57
1,1818,1686,132,4,262,79
1,2116,1844,272,0,100,69
1,1856,1521,335,-3,27,69
1,1512,1521,-9,8,404,59
-1,1743,1790,-47,-2,-93,68
1,1666,1329,337,2,50,67
-1,1671,1719,-48,-2,-22,46
1,1322,1022,300,-2,377,77
-1,1317,1625,-308,-3,-18,60
1,1321,1428,-107,3,186,107
-1,1468,1695,-227,-10,-319,64
1,1593,1524,69,1,22,49
1,1610,1349,261,6,828,115
1,1588,1511,77,1,69,45
-1,1559,1306,253,-11,-424,60
-1,1723,1740,-17,0,-40,74
1,1507,1463,44,9,580,81
-1,1424,1910,-486,-9,-6,118
1,1834,1624,210,0,-16,65
1,1737,1652,85,1,9,51
-1,1473,1378,95,-3,-63,50
-1,1716,1679,37,-3,-7,92
1,1740,1751,-11,0,-114,149
-1,1840,2120,-280,-5,-35,46
1,1795,1485,310,5,100,57
1,1654,1623,31,0,40,53
0,1583,1546,37,0,-264,139
-1,1643,1746,-103,2,-43,60
-1,1523,1662,-139,-2,-545,148
1,1342,1295,47,0,-34,116
-1,1712,2171,-459,0,16,58
-1,1957,1962,-5,0,-182,108
1,1932,1807,125,4,169,66
-1,1607,1615,-8,-3,-735,152
-1,1754,1635,119,-9,-189,66
1,1453,1302,151,5,861,105
1,2173,1784,389,-3,3,53
-1,1502,1466,36,2,-136,91
-1,1288,1482,-194,-3,-384,92
-1,1650,1739,-89,0,-40,48
-1,1711,1975,-264,0,-30,98
1,1923,1836,87,1,587,111
-1,1747,1642,105,3,129,56
-1,1795,1826,-31,0,-3,48
-1,1786,1612,174,-5,-82,54
-1,1315,1533,-218,-1,-27,58
1,1656,1733,-77,1,25,71
0,1707,1980,-273,0,-33,118
1,1327,1406,-79,-5,-201,49
1,1658,1842,-184,1,13,73
1,1640,1539,101,-2,486,77
-1,1335,1010,325,1,-471,102
1,1704,1569,135,-1,-122,71
-1,1624,1527,97,0,24,42
-1,1301,1258,43,-8,-235,62
1,2021,1720,301,1,139,83
1,1826,1931,-105,-5,-401,87
-1,1641,1670,-29,-2,-234,90
1,1669,1741,-72,0,141,105
1,1459,1465,-6,0,32,49
-1,1717,2024,-307,-5,-767,124
-1,1714,1751,-37,-3,30,104
-1,1640,1627,13,-2,-79,110
1,1575,1500,75,3,140,65
-1,1569,1537,32,0,-27,72
1,1540,1798,-258,2,61,45
-1,1573,1794,-221,-1,-97,84
1,2028,1713,315,6,107,45
-1,1665,1621,44,4,191,68
1,1500,1764,-264,-6,-19,97
1,1459,1415,44,3,213,101
-1,1710,2031,-321,-7,-446,104
1,1499,1461,38,5,310,79
-1,1541,1414,127,0,5,46
-1,1375,1615,-240,0,6,44
-1,1918,1947,-29,0,-363,140
1,1651,1634,17,3,50,41
1,2034,1707,327,12,1095,99
1,1770,1521,249,-2,11,55
1,1728,1213,515,-2,6,65
0,1650,1974,-324,-1,-20,110
-1,1574,1323,251,-10,-256,56
1,1525,1508,17,-10,-100,109
1,1835,1695,140,0,132,61
1,1493,1569,-76,0,-38,98
1,1501,1480,21,1,316,99
-1,1436,2061,-625,-1,-491,96
1,1470,1301,169,9,305,51
-1,1669,1553,116,-7,-30,40
1,1650,1640,10,-2,-18,53
1,1479,1500,-21,1,14,53
-1,1500,1683,-183,-1,-36,72
1,1779,1326,453,-3,85,53
1,1456,1558,-102,7,288,59
1,2062,1435,627,-2,-37,47
1,1592,1708,-116,-1,3,53
1,2066,1940,126,3,116,51
-1,1324,1781,-457,-4,-72,46
1,1469,1511,-42,3,57,43
1,1524,1519,5,4,142,61
-1,1545,1543,2,0,-105,94
-1,1527,1831,-304,-2,-138,66
-1,2176,1771,405,-3,-51,48
0,1606,1745,-139,-10,-86,121
-1,1500,1594,-94,1,73,84
1,1684,1646,38,1,39,57
1,1476,1434,42,2,64,67
1,1511,1317,194,5,167,45
1,1499,1482,17,5,520,157
1,1648,1657,-9,0,1,79
1,1487,1557,-70,0,33,65
-1,2142,2063,79,-10,-405,68
1,1783,1322,461,8,317,69
-1,2016,1949,67,-5,75,120
1,1641,1622,19,0,29,79
1,1523,1501,22,6,113,43
1,1332,1319,13,1,401,99
1,1795,2120,-325,0,-28,61
-1,1377,1580,-203,-1,-37,51
1,1843,1487,356,-4,46,67
1,1490,1534,-44,0,29,107
-1,1479,1468,11,1,-80,66
1,1644,1632,12,0,101,95
1,1962,1658,304,2,15,41
-1,1962,2003,-41,0,-35,122
0,1416,1780,-364,2,61,79
-1,1580,1509,71,-1,-545,154
1,2090,2080,10,2,82,65
1,1255,1223,32,-1,-66,73
1,1543,1503,40,6,544,107
-1,1639,1580,59,0,126,102
-1,2066,2106,-40,0,-161,82
0,1694,1542,152,-1,-99,114
1,1465,1531,-66,1,138,75
-1,1741,1953,-212,-1,-26,76
1,1512,1476,36,-6,-2,89
1,1607,1565,42,0,3,42
1,1534,1737,-203,1,41,95
1,1521,1423,98,0,-12,87
1,2013,1953,60,0,41,71
1,1493,1557,-64,6,543,81
0,1617,1659,-42,0,-374,213
0,2054,2121,-67,0,91,120
-1,1308,1342,-34,-12,-406,56
-1,1655,1967,-312,0,9,96
-1,1814,1982,-168,-5,-60,52
1,1846,1565,281,1,147,65
1,1488,1378,110,17,326,41
-1,1617,1661,-44,-13,-258,65
-1,1539,1506,33,-3,-289,82
1,1561,1500,61,7,173,49
1,1529,1509,20,-5,-6,81
1,1531,1466,65,0,210,101
1,2057,1578,479,1,89,85
1,1469,1807,-338,-1,-34,48
-1,1623,1500,123,1,-20,52
1,1737,1808,-71,0,66,45
1,1538,1597,-59,2,188,75
1,1486,1169,317,5,587,103
1,1691,1628,63,1,99,95
-1,1794,1750,44,-4,-168,76
1,1347,1358,-11,2,86,53
-1,1925,2100,-175,0,-32,76
1,1500,1133,367,0,-20,47
1,1546,1835,-289,-1,-175,87
-1,1563,1755,-192,-2,11,62
-1,1250,1585,-335,-2,-68,58
1,1764,1425,339,5,68,49
-1,1606,1317,289,0,71,84
-1,1786,1490,296,-4,-48,46
1,1613,1533,80,-5,-16,69
-1,1607,1724,-117,-1,-154,136
-1,1512,1642,-130,-2,-418,84
1,1500,1708,-208,-3,-10,49
1,1525,1376,149,-2,-31,71
1,1574,1204,370,0,19,41
-1,1594,1671,-77,-1,-26,76
1,1512,1477,35,3,75,43
1,1565,1792,-227,2,-3,79
-1,1275,1419,-144,-7,-455,69
-1,1540,1546,-6,1,-345,118
-1,1616,1539,77,-3,-80,66
-1,1576,1481,95,-1,33,56
0,1302,1552,-250,-4,300,123
1,1812,1671,141,2,79,53
-1,1532,1439,93,-5,-107,56
-1,1522,1638,-116,1,18,92
-1,1127,1556,-429,1,68,110
-1,1487,1718,-231,-7,-72,48
1,2106,1967,139,0,27,59
1,2058,2053,5,0,22,67
-1,1293,1315,-22,0,-262,106
-1,2106,2061,45,-1,-49,54
-1,1511,1519,-8,1,69,48
1,1658,1554,104,-5,-208,80
1,1440,1447,-7,0,67,75
1,1430,1166,264,-10,501,149
1,1422,1770,-348,0,-128,79
1,1730,1804,-74,4,132,55
-1,1735,1688,47,0,-22,118
1,1682,1465,217,-3,-61,75
-1,1337,1586,-249,0,-260,72
1,1679,1584,95,-3,-170,73
1,2072,1974,98,1,258,107
-1,1960,2114,-154,-1,-302,138
-1,1586,2022,-436,0,22,52
1,1352,1401,-49,-1,-7,51
-1,1552,1199,353,0,-70,84
-1,1483,1743,-260,0,-19,102
1,1509,1645,-136,0,18,57
1,1515,1366,149,0,-1,55
1,1643,1607,36,-2,37,60
1,1869,1965,-96,3,94,61
1,2024,1584,440,0,-7,59
1,1558,1700,-142,1,4,43
-1,1950,1885,65,1,122,86
-1,1582,2026,-444,-3,-82,56
-1,1507,1521,-14,-5,-5,50
1,1540,1502,38,1,231,95
1,1628,1653,-25,2,71,61
1,1819,1600,219,2,156,95
-1,1911,1871,40,-8,25,58
1,1708,1674,34,-1,46,81
1,1500,1228,272,2,74,45
-1,1393,1612,-219,0,-429,142
0,1340,1281,59,0,-100,138
0,1687,1664,23,-2,-15,160
1,1883,1897,-14,3,77,55
-1,1578,2030,-452,-1,-44,66
1,1575,1642,-67,1,31,57
0,2082,1613,469,0,712,144
1,1651,1478,173,0,68,91
1,1885,1894,-9,0,12,51
1,1530,1608,-78,2,257,69
1,1578,1432,146,-11,-216,87
1,1591,1333,258,2,588,101
1,1640,1619,21,-3,12,57
1,1883,1897,-14,0,-61,83
-1,2070,2175,-105,-8,13,40
1,1478,1571,-93,3,128,63
-1,1623,1523,100,-7,-71,46
1,1885,1894,-9,-1,-63,99
1,1502,1562,-60,0,1,117
0,1500,1483,17,-1,-14,89
1,1925,1932,-7,1,35,73
1,1798,1638,160,1,446,101
1,1594,1543,51,-3,115,89
1,1562,1551,11,-7,3,53
-1,1441,1871,-430,-2,-105,65
-1,1743,2060,-317,-3,-671,122
-1,1752,1386,366,-1,-22,48
-1,1521,1546,-25,-3,-29,74
1,1492,1550,-58,0,8,59
1,1587,1132,455,8,494,71
-1,1609,1908,-299,-6,-331,76
-1,1051,1184,-133,-14,-324,42
1,2064,1736,328,9,312,57
-1,1736,2064,-328,-1,-30,44
1,1700,1619,81,0,26,65
1,1912,1605,307,5,163,57
1,1573,1528,45,-3,-73,55
1,1534,1604,-70,0,60,67
1,2068,1729,339,2,91,71
1,1613,1559,54,0,154,151
0,1785,1813,-28,1,16,81
-1,1576,1764,-188,-3,-30,47
1,1778,1534,244,-1,-236,121
-1,1910,1858,52,0,12,54
-1,1602,1915,-313,1,-65,71
1,1587,1282,305,4,-68,79
1,1661,1804,-143,3,91,59
-1,1500,1500,0,-4,-93,50
-1,1732,1694,38,-5,-36,50
-1,1667,1269,398,10,837,114
1,1541,1377,164,-1,-9,65
-1,1606,1513,93,-2,-90,58
1,1919,1598,321,2,61,45
-1,1653,1631,22,1,-5,80
-1,1303,1531,-228,-1,-46,64
1,1595,1922,-327,0,-6,75
-1,1537,1582,-45,0,-18,62
-1,2022,2094,-72,-6,-93,78
-1,1570,1762,-192,0,107,70
-1,1901,1615,286,4,101,68
1,2093,1904,189,0,32,55
1,1708,1478,230,-2,32,57
1,1715,1310,405,0,65,47
-1,1452,1393,59,-11,-414,70
-1,1412,1550,-138,1,-603,112
1,1560,1686,-126,0,51,55
-1,1718,1847,-129,-1,-166,116
-1,1566,1573,-7,-1,-116,58
-1,1567,2071,-504,-3,-74,62
-1,1485,1824,-339,0,-3,56
1,1590,1357,233,3,78,69
-1,2013,1926,87,-4,-234,84
-1,1892,1712,180,0,-3,58
1,1718,1324,394,-6,-27,59
-1,1556,1703,-147,-2,-134,104
-1,2103,2099,4,1,91,68
1,1676,1617,59,2,58,61
1,1682,1583,99,4,144,49
-1,1486,1867,-381,-2,237,87
1,1472,1688,-216,2,36,49
0,1641,1789,-148,1,-11,102
1,1872,1896,-24,-4,-66,57
-1,1729,1815,-86,0,15,100
1,1522,1257,265,2,70,67
-1,1355,1460,-105,-5,-255,74
-1,1559,2073,-514,-1,-88,66
1,1873,1439,434,5,126,43
1,1870,1697,173,2,33,55
1,2000,1953,47,1,22,58
-1,1260,1391,-131,0,-110,64
0,1483,1557,-74,-2,-583,148
1,1669,1494,175,1,560,103
1,2075,1672,403,9,184,45
-1,1406,1528,-122,1,67,56
-1,1855,1708,147,-4,5,74
1,1593,1617,-24,0,39,67
-1,1685,1933,-248,0,-408,110
1,1617,1575,42,1,86,75
1,1529,1769,-240,2,547,125
1,1720,1666,54,0,179,139
-1,1283,1387,-104,1,-92,98
-1,1530,1783,-253,0,-247,116
-1,2009,1943,66,0,-65,76
1,1724,1832,-108,-6,96,57
-1,1395,1672,-277,-8,-273,54
1,1492,1500,-8,-2,-53,57
-1,1091,1717,-626,-8,-138,48
1,1614,1605,9,0,5,71
1,1812,1636,176,0,405,85
-1,2103,2099,4,-1,-46,92
1,1827,1482,345,3,60,49
1,1557,1405,152,3,119,63
-1,1549,1745,-196,-3,-172,66
1,1883,1885,-2,1,20,57
-1,1437,1875,-438,-1,-63,92
-1,1629,1820,-191,-1,-66,94
1,2077,1730,347,-1,-29,43
1,1601,1608,-7,0,-6,73
1,1500,1614,-114,-1,0,75
1,1426,1562,-136,2,86,59
0,1751,1543,208,1,727,93
1,1997,1935,62,2,109,91
-1,1534,1718,-184,1,54,72
1,1923,1727,196,6,137,48
1,1264,1318,-54,2,49,51
1,1828,1623,205,2,397,131
-1,1496,1371,125,-4,-350,74
1,1556,1398,158,6,395,117
1,1708,1675,33,-2,55,103
-1,1666,1555,111,0,-295,122
1,1703,1664,39,2,83,123
-1,1721,1929,-208,-1,-128,90
0,1590,1484,106,-3,-99,88
1,1680,1696,-16,3,216,75
1,1937,1832,105,1,-2,41
-1,1617,1835,-218,1,-296,116
1,1785,1624,161,4,201,61
1,1745,1655,90,3,163,57
-1,1364,1389,-25,-3,-164,70
1,1692,1535,157,-3,-13,47
-1,2005,1927,78,0,-114,130
1,1564,1520,44,1,33,57
1,2081,1824,257,-3,263,115
1,2110,2092,18,0,76,91
-1,1842,1612,230,0,-347,150
0,1618,1792,-174,-7,437,153
1,1141,1139,2,3,397,101
1,1565,1628,-63,-3,69,91
-1,1595,1671,-76,0,-170,74
-1,1665,1719,-54,0,19,60
-1,1611,1481,130,1,-118,74
1,1747,1518,229,4,99,43
-1,1631,1819,-188,-1,-360,100
1,1786,1584,202,2,52,57
-1,1744,1575,169,0,-463,136
-1,1684,1992,-308,-1,-164,74
1,1748,1278,470,2,434,101
1,1728,1656,72,0,46,62
-1,1737,1921,-184,0,-58,72
0,1486,1551,-65,12,234,49
1,1787,1525,262,0,-11,55
1,1723,1585,138,6,94,43
-1,1895,1873,22,0,33,62
1,1575,1716,-141,1,20,55
-1,1513,1831,-318,0,-75,100
1,1440,1683,-243,2,36,45
-1,1500,2086,-586,-1,76,80
1,1787,1625,162,3,153,55
0,1578,1792,-214,0,11,103
-1,1134,1530,-396,-14,-633,68
-1,1165,1600,-435,-16,-380,42
0,1304,1375,-71,3,329,91
1,1522,1365,157,7,145,69
-1,1698,1666,32,6,167,142
1,1647,1737,-90,0,-2,57
-1,1992,1939,53,-1,-33,54
0,1586,1618,-32,-2,-71,87
1,1881,2088,-207,0,-72,87
1,1753,1291,462,4,96,47
0,1899,2067,-168,0,-175,76
-1,1681,1945,-264,0,33,104
-1,1500,1905,-405,0,-53,98
1,1392,1591,-199,1,62,75
-1,1785,1584,201,0,-62,80
1,1481,1261,220,7,380,73
-1,1651,1565,86,1,27,47
1,1693,1530,163,2,60,41
1,1592,1508,84,0,121,79
1,1908,2004,-96,0,86,73
1,1750,1689,61,0,-85,81
1,1886,1883,3,-3,1,47
1,1424,1349,75,-2,36,85
1,1992,1650,342,1,114,69
1,1578,1486,92,0,-7,57
1,1949,1661,288,-1,156,115
-1,1762,1770,-8,0,-10,102
-1,1840,1940,-100,1,-56,68
1,1990,1923,67,0,59,81
-1,1373,1424,-51,-10,-697,130
-1,1792,1955,-163,-1,-80,126
-1,1602,1766,-164,0,-76,96
-1,1641,1601,40,1,72,80
0,1913,1999,-86,-3,-50,66
-1,1526,1556,-30,1,2,44
-1,1364,1605,-241,0,-385,114
-1,1786,1731,55,-2,-1623,132
0,1657,1953,-296,0,257,156
-1,1409,1387,22,-2,-130,60
1,1948,1832,116,1,130,73
-1,1996,1916,80,-1,-62,82
1,1756,1377,379,1,265,75
-1,1602,1638,-36,5,45,53
0,1743,1792,-49,-1,-220,167
1,1523,1792,-269,11,115,45
1,1931,1983,-52,-1,6,95
1,1681,1566,115,-4,-80,71
1,1385,1500,-115,8,168,43
-1,1624,1687,-63,-3,-53,49
1,1595,1614,-19,4,112,67
-1,1522,1825,-303,-1,-73,62
1,1944,1970,-26,-1,-25,83
1,1945,1665,280,5,138,67
-1,1629,1871,-242,-3,-213,80
1,1613,1528,85,-2,-72,73
-1,1957,1958,-1,-1,-74,60
1,1400,1397,3,-1,29,61
1,1500,1131,369,11,857,83
-1,1661,1949,-288,-1,-130,99
1,1969,1945,24,0,-35,91
1,1610,1359,251,0,-29,67
1,1688,1537,151,6,163,49
-1,1422,1434,-12,2,-32,138
-1,1519,1753,-234,-1,-62,70
1,1648,1625,23,2,91,69
-1,1574,1716,-142,-9,-224,53
1,1935,1979,-44,5,456,81
-1,1595,1840,-245,-2,-140,109
-1,1586,1548,38,-6,-206,64
1,1602,1551,51,3,28,41
-1,1819,1812,7,0,-75,78
1,1577,1411,166,-3,-87,51
1,1967,1947,20,-4,-71,79
-1,1578,1622,-44,-2,-81,56
1,1937,1977,-40,1,-13,97
1,1823,1807,16,1,17,47
1,1965,1949,16,0,-4,48
-1,1514,1762,-248,1,-9,70
1,1939,1975,-36,-3,93,59
-1,1530,1695,-165,-2,-102,54
-1,1963,1951,12,0,-130,72
1,1834,1679,155,3,187,77
-1,1612,1608,4,-4,-11,60
1,1738,1495,243,15,268,51
1,1424,1547,-123,0,331,151
1,1706,1764,-58,0,13,45
-1,1568,1631,-63,0,-2,48
1,1963,1952,11,0,541,123
-1,1421,1600,-179,-3,-88,46
-1,0,1244,-1244,-5,-1025,104
-1,1334,1187,147,-4,-11,40
-1,1691,1885,-194,-1,-119,76
-1,1354,1238,116,0,53,64
-1,1614,1658,-44,-10,-501,80
-1,1709,1550,159,0,-63,68
1,1896,1666,230,-3,224,115
1,1257,1399,-142,3,-308,86
-1,1952,1956,-4,2,157,102
1,1503,1395,108,6,190,58
0,1942,1973,-31,-6,-81,98
-1,1773,1655,118,-8,-152,46
1,1643,1548,95,8,270,51
1,1770,1385,385,10,148,41
-1,1692,1568,124,1,-1,44
1,1271,1398,-127,2,12,41
1,1701,1524,177,-8,-181,55
1,1481,1500,-19,10,194,43
1,1500,1605,-105,1,236,97
1,1972,1943,29,-2,335,119
-1,1724,1744,-20,0,-56,76
1,1658,1608,50,-2,310,94
-1,1677,1585,92,6,151,70
-1,1662,1828,-166,-2,-232,104
1,1558,1640,-82,0,-8,69
1,1595,1255,340,0,48,57
-1,1606,1953,-347,-3,-515,142
-1,1590,1876,-286,0,-78,98
-1,1473,1442,31,-20,-289,50
1,1933,1982,-49,1,141,67
1,1469,1650,-181,0,217,67
-1,1669,1756,-87,2,-32,74
-1,1489,1514,-25,1,-45,74
-1,1970,1945,25,1,-10,46
-1,1811,1716,95,1,-2,64
1,1820,1691,129,1,58,59
1,2004,1952,52,0,-14,55
1,1728,1465,263,4,145,51
1,1367,1387,-20,1,140,73
-1,1956,1958,-2,0,-11,60
-1,1500,1800,-300,-17,-647,64
1,1969,1946,23,-2,-100,117
-1,1383,1288,95,-1,-30,52
-1,1203,1658,-455,-3,2,52
-1,1203,1259,-56,-11,-299,52
-1,1744,1735,9,-5,-106,64
-1,1766,1661,105,-4,-136,56
-1,1798,1763,35,0,-627,130
1,1636,1597,39,0,53,69
1,1956,1603,353,-1,238,93
1,1448,1377,71,6,478,93
-1,1663,1655,8,0,-46,63
1,1518,1501,17,12,427,49
-1,1627,1596,31,0,539,156
0,1941,2014,-73,0,-26,115
1,1202,1232,-30,1,53,61
1,1453,1732,-279,2,232,95
-1,1244,1682,-438,-13,-125,44
-1,1598,1604,-6,0,-9,50
1,1454,1483,-29,6,359,59
1,1686,1619,67,0,79,73
1,1748,1317,431,3,117,61
-1,1936,1819,117,0,-171,68
-1,1587,1500,87,0,-49,80
1,1490,1529,-39,-2,106,71
1,1880,1727,153,-1,-36,57
1,1383,1275,108,-1,-44,53
1,1579,1479,100,-3,-43,61
1,1667,1706,-39,-2,-6,85
0,2184,1829,355,-5,-33,87
-1,1964,2086,-122,-2,-86,74
1,1616,1586,30,1,60,67
-1,1194,1591,-397,-4,398,124
1,1364,1373,-9,17,325,47
1,1671,1568,103,12,155,41
-1,1516,1503,13,-4,-197,64
0,1303,1369,-66,2,-36,107
0,1769,1928,-159,-4,-47,134
-1,1837,2174,-337,0,-89,104
1,1703,1602,101,-2,-118,93
1,1596,1646,-50,-1,35,77
-1,1348,1376,-28,-3,-87,58
-1,2032,1922,110,0,0,68
1,1576,1248,328,4,487,109
0,1751,1776,-25,3,174,101
-1,1361,1375,-14,4,-133,130
1,1500,1686,-186,1,32,65
-1,1322,1269,53,-6,-103,42
1,1461,1472,-11,2,341,113
1,1826,1580,246,-5,-15,43
-1,1244,1580,-336,0,-46,64
1,1546,1310,236,5,240,61
-1,1472,1527,-55,7,231,56
-1,1572,1579,-7,-1,-195,78
-1,1565,1606,-41,-1,-669,126
-1,1466,1603,-137,0,14,43
1,1946,1920,26,0,-28,89
-1,1572,1580,-8,0,-36,54
1,1515,1504,11,-7,-190,63
1,1580,1572,8,4,607,77
-1,1891,1942,-51,0,-65,132
1,1598,1478,120,0,27,69
1,1473,1426,47,5,168,61
1,1835,1743,92,1,32,47
-1,1500,1662,-162,-4,-266,66
-1,1725,1711,14,1,-40,82
-1,1491,1559,-68,-2,-29,46
0,1449,1449,0,0,-317,138
-1,1480,1647,-167,0,-242,100
-1,1241,1482,-241,-13,-195,42
-1,1753,1773,-20,0,-81,112
-1,1273,1754,-481,-2,-119,72
1,1777,1270,507,0,49,77
-1,1464,1487,-23,-14,-103,44
1,1614,1216,398,1,839,113
1,1555,1470,85,2,32,43
-1,1479,1682,-203,-4,-66,43
-1,1475,1497,-22,3,-63,76
1,1298,1261,37,-6,-256,71
1,1787,1609,178,0,10,47
-1,1474,1287,187,-5,-158,62
0,1732,1794,-62,0,-285,146
0,1280,1370,-90,-1,-149,120
1,1787,1455,332,5,552,83
1,1507,1464,43,0,165,93
1,1506,1534,-28,0,70,67
1,1714,1882,-168,0,-54,113
1,1722,1708,14,-11,-52,47
1,1733,1616,117,-1,-34,81
1,1462,1563,-101,1,153,51
1,1570,1520,50,-1,-6,43
-1,1668,1831,-163,-1,-36,58
-1,1454,1517,-63,0,-114,88
-1,1108,1697,-589,-3,-188,78
-1,1926,1823,103,-2,-20,90
1,1435,1415,20,1,66,53
-1,1464,1321,143,-5,-74,42
1,1261,1118,143,11,332,59
-1,1526,1445,81,0,-252,96
1,1948,1848,100,0,-10,99
1,1592,1567,25,4,219,73
-1,1305,1481,-176,1,-33,51
-1,1300,1844,-544,0,-394,112
1,1271,1405,-134,0,3,47
1,1585,1517,68,2,141,111
-1,1371,1421,-50,3,170,64
-1,1734,1792,-58,-3,-929,156
-1,1459,1577,-118,3,102,60
-1,1474,1539,-65,-3,-272,96
-1,1459,1513,-54,5,263,74
-1,1502,1544,-42,-3,-377,106
-1,1740,2009,-269,-1,44,90
1,1610,1466,144,-1,101,73
-1,1522,1450,72,-9,-292,64
1,1802,1724,78,3,184,65
1,1463,1509,-46,0,20,67
-1,1487,1107,380,-12,-347,56
1,1851,1662,189,0,64,45
-1,1481,1698,-217,-2,-98,56
1,1729,1774,-45,0,-53,81
-1,1354,1298,56,1,-110,74
-1,1397,1690,-293,-9,-343,64
1,1840,1956,-116,2,207,147
1,1497,1475,22,-13,-412,61
-1,1715,1810,-95,1,-2,73
-1,1312,1642,-330,-9,-359,60
-1,1452,1549,-97,1,56,94
1,1663,1694,-31,-2,-10,40
1,1465,1507,-42,-3,-56,63
-1,1622,1580,42,-2,-221,138
0,1346,1491,-145,3,703,137
1,1857,1615,242,0,88,79
1,1539,1621,-82,4,69,59
-1,1362,1342,20,-31,-466,42
-1,1411,1550,-139,-9,-17,58
-1,1707,1723,-16,4,165,52
1,1845,1458,387,1,120,69
-1,1611,1862,-251,-2,-190,66
-1,1573,1594,-21,-5,-47,45
1,1736,1753,-17,-2,106,85
-1,1495,1477,18,-11,-132,42
-1,1477,1495,-18,-2,212,66
-1,1305,1704,-399,-2,-193,78
-1,1800,1721,79,-9,-132,64
-1,1838,1698,140,0,-274,144
-1,1466,1688,-222,-1,2,52
1,1484,1488,-4,-2,86,65
1,1498,1294,204,1,190,98
1,1646,1306,340,12,335,44
1,1454,1461,-7,-2,-24,69
1,1693,1348,345,1,261,85
-1,1557,1590,-33,-8,-486,76
-1,1066,1350,-284,-2,-189,72
-1,1560,2013,-453,0,-379,108
1,1477,1494,-17,5,292,77
-1,1994,1761,233,0,-25,92
1,1443,1658,-215,0,-20,65
1,1399,1383,16,0,-5,55
-1,1469,1901,-432,0,-26,68
-1,1300,1649,-349,-5,-200,64
-1,1680,1737,-57,0,-49,66
-1,1483,1489,-6,-4,-303,64
1,1542,1439,103,-3,-27,45
-1,1711,1710,1,0,-389,106
1,1491,1662,-171,-2,119,89
-1,1499,1473,26,0,37,78
-1,1246,1502,-256,0,-19,56
1,1372,1454,-82,-8,55,91
1,1890,1906,-16,4,777,111
1,1677,1534,143,0,142,73
-1,1484,1488,-4,1,-298,70
1,1472,1585,-113,-4,247,139
1,1600,1547,53,0,135,125
1,1847,1546,301,1,176,116
0,1656,1572,84,0,47,148
1,1726,1651,75,-2,342,67
-1,1784,1701,83,1,-65,80
1,1460,1207,253,0,85,59
-1,1461,1431,30,1,47,74
0,1610,1631,-21,2,375,129
1,1574,1332,242,0,-9,43
1,1748,1606,142,5,268,65
1,1892,1901,-9,0,-163,137
1,1532,1500,32,0,37,65
1,1903,1482,421,-9,-20,41
1,1498,1474,24,4,133,59
-1,1651,1768,-117,0,-12,44
-1,1310,1485,-175,0,-14,70
-1,1464,1508,-44,-1,257,94
-1,1891,1905,-14,2,81,94
1,1507,1698,-191,0,-2,43
-1,1652,1295,357,-4,-116,98
1,1743,1603,140,1,228,107
-1,1743,1731,12,-2,-102,68
-1,1641,1733,-92,-3,-452,100
-1,1631,1903,-272,0,-160,110
1,1714,1708,6,-1,-10,65
-1,1642,1735,-93,-2,-104,79
-1,1500,1554,-54,1,-20,76
-1,1917,1880,37,-2,27,92
-1,1517,1455,62,2,64,64
1,1782,1494,288,2,129,65
1,1717,1303,414,14,477,59
-1,1585,1518,67,0,-10,90
-1,1449,1465,-16,-6,-93,52
1,1557,1431,126,1,101,66
1,1448,1367,81,-3,43,45
-1,1643,1693,-50,-1,-53,80
-1,1678,1742,-64,-5,-3,64
-1,1440,1386,54,-9,-611,72
0,1504,1414,90,-3,-79,126
1,1501,1543,-42,0,25,67
1,1760,1609,151,9,225,49
-1,1892,1903,-11,-3,-124,100
1,1467,1505,-38,2,-7,57
1,1683,1458,225,1,69,93
1,1682,1525,157,1,56,51
-1,1481,1510,-29,1,-202,68
-1,1528,1443,85,-6,-572,80
-1,1656,1724,-68,-1,-105,72
1,1465,1704,-239,1,23,49
-1,1493,1479,14,-1,158,84
-1,1799,1685,114,-3,-12,66
1,1399,1427,-28,0,342,105
1,1720,1682,38,0,8,57
-1,1041,1309,-268,-2,-79,64
1,1476,1282,194,7,236,55
1,1504,1303,201,15,832,67
1,1490,1482,8,-5,-306,75
1,1457,1567,-110,0,-69,93
0,1751,1618,133,0,-17,143
1,1731,1294,437,4,702,101
-1,1733,1819,-86,-3,-362,68
1,1687,1485,202,-6,-41,75
1,1472,1500,-28,2,161,67
-1,1500,1633,-133,-4,-302,68
-1,1333,1630,-297,-7,-713,82
1,1783,1786,-3,3,99,65
1,1767,1531,236,2,113,63
1,1363,1145,218,9,1253,87
-1,1475,1590,-115,6,187,68
-1,1502,1733,-231,0,60,80
-1,1488,1483,5,5,-92,102
-1,1756,1411,345,1,-249,110
-1,1724,1827,-103,0,-257,166
-1,1225,1477,-252,-3,-180,74
1,1731,1518,213,4,209,59
-1,1414,1412,2,-2,-21,58
-1,1330,1294,36,0,19,84
0,1297,1521,-224,6,503,81
-1,1494,1478,16,-2,-101,60
1,1610,1626,-16,1,44,77
1,1668,1552,116,3,316,79
1,1433,1733,-300,-1,-296,121
-1,1472,1574,-102,-1,-38,60
-1,1522,1596,-74,-11,-60,44
-1,1738,1788,-50,0,36,76
1,1730,1175,555,1,58,79
-1,1481,1502,-21,-7,-402,84
1,1741,1607,134,3,83,53
-1,1639,1566,73,-4,-5,40
-1,1614,1803,-189,0,-163,96
-1,1479,1692,-213,0,-22,76
1,1798,1727,71,0,116,113
1,1421,1276,145,-2,-81,61
1,1500,1766,-266,0,62,67
0,1733,1949,-216,0,-100,106
-1,1693,1808,-115,0,-4,62
1,1772,1623,149,0,119,61
-1,1236,1627,-391,-13,-79,40
1,1739,1459,280,1,88,97
1,1775,1943,-168,0,28,91
1,1147,1309,-162,2,37,41
1,1516,1567,-51,-1,215,85
1,1483,1629,-146,6,384,89
1,1816,1686,130,0,-2,47
-1,1545,1676,-131,-11,-198,101
1,1649,1613,36,3,113,56
1,1522,1601,-79,1,-164,109
1,1720,1424,296,0,92,69
-1,1326,1603,-277,-10,-559,69
-1,1716,1702,14,0,-111,68
-1,1475,1830,-355,0,-219,138
-1,1564,1605,-41,0,-110,118
-1,1565,2040,-475,-6,-105,67
1,1464,1612,-148,2,67,67
1,1503,1303,200,17,518,51
1,1500,1288,212,5,97,41
-1,1678,1530,148,-1,105,96
1,2042,1563,479,0,-3,67
-1,1208,1823,-615,-15,-252,48
-1,1282,1595,-313,3,119,62
-1,1748,1778,-30,-5,-29,56
-1,1454,1726,-272,2,-279,101
-1,1473,1191,282,0,-6,72
-1,1941,1739,202,-3,-11,46
-1,1561,1500,61,-3,-280,80
1,1605,1346,259,-2,242,71
-1,1297,1518,-221,0,-87,79
-1,1715,1602,113,0,-9,76
1,1406,1683,-277,0,-16,59
-1,1111,1278,-167,0,-344,86
-1,1220,1367,-147,-1,-10,48
-1,1621,1833,-212,0,-198,87
0,1138,1381,-243,-4,-479,84
-1,1526,1443,83,1,43,64
-1,1707,1548,159,1,-609,122
1,1608,1595,13,4,195,80
1,2043,1779,264,7,429,70
1,1788,1782,6,0,13,49
-1,1039,1269,-230,-1,-101,74
1,1479,1452,27,6,47,43
1,1413,1654,-241,-4,155,65
-1,1410,1945,-535,-1,3,46
-1,1390,1515,-125,-2,-208,88
1,1640,1512,128,0,55,75
1,1738,1755,-17,1,53,63
0,1774,2048,-274,0,172,91
-1,1501,1380,121,0,-115,100
-1,1337,1297,40,-4,-98,62
1,1490,1514,-24,-2,51,67
1,1595,1443,152,6,686,115
-1,1566,1528,38,0,44,122
-1,1498,1535,-37,-5,-222,72
-1,1732,1699,33,-11,-113,46
1,1951,1409,542,1,59,61
-1,1289,1608,-319,-4,-476,114
-1,1588,1619,-31,0,6,58
-1,1707,1618,89,-1,-124,100
1,1797,1601,196,3,78,59
-1,1774,1574,200,-1,-195,114
1,1632,1550,82,-9,198,119
1,1619,1476,143,-1,14,49
1,1500,1347,153,3,535,87
-1,1350,1316,34,4,144,60
-1,1601,1784,-183,0,-30,60
1,1506,1436,70,0,215,111
-1,1742,1670,72,1,-32,74
1,1593,1653,-60,1,74,81
-1,1396,1811,-415,-2,-44,44
-1,1641,1904,-263,-1,-169,70
-1,1469,1430,39,12,251,42
-1,1330,1417,-87,-1,-139,68
-1,1833,1757,76,3,140,104
-1,1430,1383,47,-1,-232,62
-1,1921,1840,81,3,42,40
1,1351,1338,13,7,214,61
1,1505,1595,-90,-3,91,85
-1,1408,1957,-549,-1,-24,44
-1,1647,1549,98,0,-6,47
1,1787,1699,88,5,125,53
1,1773,1691,82,0,-18,91
1,1790,1543,247,1,19,43
-1,1579,1803,-224,-1,-45,124
1,1488,1503,-15,0,72,65
1,1545,1440,105,-1,3,57
1,1637,1697,-60,-1,-3,65
1,1729,1751,-22,-2,57,73
-1,1369,1773,-404,-5,-502,86
-1,1485,1496,-11,3,56,50
1,1425,1321,104,0,156,77
-1,1539,1795,-256,0,-107,126
1,1555,1538,17,0,11,53
0,1500,1303,197,1,183,113
-1,1405,1967,-562,0,-56,70
-1,1457,1814,-357,-4,-80,51
1,1774,2040,-266,0,515,141
-1,1395,1563,-168,1,182,66
-1,1495,1418,77,1,5,44
-1,1739,1740,-1,-1,-50,118
1,1285,1500,-215,0,-3,65
-1,1553,1607,-54,1,88,102
-1,1410,1365,45,-1,3,42
1,1500,1627,-127,0,68,77
1,1562,1342,220,4,401,69
1,1689,1728,-39,-1,12,51
1,2021,1808,213,1,126,113
1,1474,1274,200,2,32,47
-1,1520,1685,-165,-5,-301,80
-1,1905,1858,47,0,19,108
-1,1500,1682,-182,-2,-119,62
-1,1727,1682,45,-3,-45,50
1,1791,1819,-28,0,241,121
1,1611,1455,156,-1,0,55
1,1782,1088,694,0,67,45
-1,1457,1399,58,-1,-19,52
1,1500,1532,-32,0,3,57
-1,1702,1896,-194,-2,-86,73
1,1666,1847,-181,1,359,101
1,1389,1377,12,-2,-345,137
1,1481,1431,50,-1,48,51
1,1500,1267,233,1,485,99
1,1742,1794,-52,-1,-80,53
-1,1882,2026,-144,0,24,76
-1,1294,1507,-213,-6,-377,74
1,1691,1514,177,10,455,65
1,1842,1190,652,0,-9,54
-1,1627,1632,-5,-2,-146,58
1,2034,1875,159,0,-13,79
-1,1694,1713,-19,0,-1,60
-1,1433,1471,-38,-1,-49,54
-1,1544,1902,-358,-4,-219,72
1,1567,1217,350,-3,-60,87
1,1756,1606,150,5,311,67
-1,1411,1697,-286,0,-111,64
1,1862,1697,165,-1,-5,73
1,1567,1500,67,2,49,57
-1,1563,1527,36,-6,-120,49
-1,1781,1754,27,-6,-283,64
1,1821,1832,-11,-1,29,57
-1,1540,1688,-148,-1,-87,58
-1,1869,2041,-172,-8,-64,40
1,1581,1378,203,2,149,59
-1,1512,1826,-314,-3,-104,54
-1,1629,1700,-71,0,52,84
-1,1459,1437,22,1,27,98
1,1491,1470,21,1,13,65
1,2047,1864,183,1,97,67
-1,1662,1353,309,7,88,40
-1,1297,1355,-58,-2,-27,46
-1,1644,1861,-217,0,-113,107
-1,1685,1882,-197,0,-84,74
-1,1788,1642,146,-3,-12,78
1,1817,1588,229,-1,-27,65
-1,1508,1698,-190,-1,-93,68
-1,1257,1538,-281,-1,-52,60
-1,1379,1400,-21,-7,-497,76
1,1868,1486,382,1,40,47
1,1715,1216,499,-2,-7,43
1,1701,1407,294,-4,257,131
-1,1417,1774,-357,-7,-415,86
1,1756,1291,465,1,52,53
-1,1509,1570,-61,-3,-101,49
0,1826,1714,112,0,-514,114
-1,1585,1690,-105,-1,-376,114
1,1820,1832,-12,2,355,97
1,1802,1764,38,-1,-42,83
-1,1637,1830,-193,-9,-373,64
1,1467,1509,-42,2,118,69
1,1763,1239,524,4,345,67
1,1502,1899,-397,-1,-29,71
-1,1843,1901,-58,1,13,66
1,1319,1603,-284,10,346,57
-1,1488,1356,132,-3,-9,48
-1,1663,2152,-489,-5,-89,72
1,1354,1338,16,2,340,100
-1,1442,1614,-172,-2,-77,56
-1,1587,1592,-5,1,72,76
-1,1480,1447,33,-6,-88,88
-1,1500,1717,-217,-3,-126,94
-1,1689,1607,82,2,-8,78
1,1602,1264,338,6,314,57
1,1616,1875,-259,3,195,77
-1,1467,1469,-2,-8,-187,62
-1,1758,1460,298,-1,-19,46
1,1575,1410,165,0,27,57
1,1370,1494,-124,1,159,145
0,1541,1718,-177,0,-11,114
-1,1772,1425,347,1,25,62
-1,1776,1839,-63,-1,-86,76
1,1471,1500,-29,13,686,61
-1,1795,1657,138,0,-5,88
-1,1281,1253,28,-5,-224,64
-1,1494,1530,-36,2,150,77
-1,1690,1905,-215,3,176,69
1,1837,1630,207,0,414,109
-1,1524,1823,-299,0,-13,50
-1,1821,1822,-1,-2,-5,54
0,2215,2053,162,3,297,104
1,1638,1609,29,1,31,43
-1,1679,1518,161,-1,-112,64
1,1815,1510,305,2,57,49
-1,1210,1562,-352,-1,-79,64
-1,1701,1642,59,0,-32,62
-1,1289,1864,-575,-14,-461,56
-1,1515,1478,37,1,7,54
0,1657,1506,151,4,-365,128
1,1765,1616,149,-1,-43,49
1,1843,1596,247,1,58,141
-1,2058,2209,-151,-1,-371,120
1,1208,1265,-57,-9,-93,49
0,1173,1161,12,0,97,101
-1,1832,1765,67,-3,-85,72
1,1708,1588,120,0,127,95
-1,1622,1647,-25,-4,-425,78
-1,1662,1511,151,-1,5,42
1,1733,1516,217,0,119,97
1,1812,1482,330,3,86,53
1,1836,1811,25,0,533,103
-1,1404,1583,-179,-1,-65,100
-1,1769,1724,45,1,-96,76
1,1646,1528,118,3,44,41
-1,1571,1336,235,1,191,178
1,1751,1535,216,-2,-160,71
1,1709,1651,58,-2,91,145
1,1710,1683,27,1,-4,49
1,1831,1378,453,3,302,85
1,1718,1712,6,3,176,69
1,1355,1512,-157,-3,-56,59
-1,1653,1520,133,8,92,48
1,1351,1581,-230,0,-49,107
1,1484,1578,-94,-8,394,105
1,2218,2051,167,1,96,93
-1,1655,1687,-32,0,0,62
1,1854,1815,39,2,92,78
1,1752,1709,43,0,53,59
-1,1799,1652,147,-2,-82,44
1,1391,1870,-479,-1,570,143
-1,1285,1618,-333,-3,-133,60
-1,1552,1832,-280,-3,-133,58
1,1685,1615,70,2,92,77
1,1605,1614,-9,-4,309,147
-1,1767,1483,284,-4,-244,76
1,1633,1593,40,1,316,75
1,1548,1677,-129,0,-272,99
-1,1668,1496,172,0,16,50
1,1573,1634,-61,-1,285,125
-1,1403,1733,-330,-4,-306,74
1,1458,1831,-373,2,121,91
1,1819,1802,17,-3,60,53
-1,1654,1772,-118,-4,-146,76
-1,1508,1783,-275,-1,-54,68
-1,1627,1564,63,-3,-71,48
1,1638,1690,-52,-3,34,89
1,1772,1384,388,1,177,57
1,1698,1645,53,0,7,77
-1,1324,1447,-123,-1,-134,92
-1,1592,1731,-139,-2,-11,48
-1,1576,1784,-208,0,-19,74
-1,1470,1547,-77,-8,-193,73
1,1455,1453,2,0,-4,57
0,1728,2048,-320,-1,-177,121
1,1848,1412,436,4,208,75
1,1566,1268,298,0,55,61
1,1664,1098,566,4,231,53
-1,1640,1746,-106,-3,-51,54
1,1618,1650,-32,-6,43,65
1,1620,1123,497,12,364,53
1,1757,1742,15,0,2,41
1,1793,1541,252,6,270,65
1,1436,1422,14,2,440,87
1,1561,1312,249,5,289,61
-1,1446,1529,-83,-2,-24,57
1,1792,1829,-37,0,3,77
-1,1085,1740,-655,-3,-319,82
-1,1643,1650,-7,2,72,54
1,1638,1747,-109,-1,-167,115
-1,1800,1570,230,0,-77,64
1,1805,1526,279,0,181,81
1,1635,1708,-73,3,171,75
1,1531,1436,95,4,155,63
0,1442,1275,167,-15,-1183,146
-1,1251,1621,-370,0,2,64
-1,1171,1613,-442,-9,-17,42
-1,1694,1754,-60,0,18,72
1,1503,1538,-35,-1,36,63
-1,1490,1504,-14,-7,-246,58
1,1653,1578,75,-1,6,71
1,1431,1244,187,7,150,41
1,1777,1625,152,1,207,111
1,1413,1403,10,-7,-288,87
-1,1755,1745,10,0,-45,80
1,1740,1084,656,32,674,43
1,1623,1107,516,10,314,47
1,1400,1454,-54,-4,6,51
1,2039,1864,175,0,-147,109
1,1296,1266,30,-5,-92,41
-1,1279,1721,-442,3,74,43
-1,1817,1803,14,-1,-15,46
1,1584,1642,-58,3,22,47
-1,1738,1616,122,-2,-26,44
1,1579,1469,110,-4,-19,77
-1,1683,1848,-165,1,56,72
1,1671,1700,-29,6,112,51
-1,1327,1720,-393,-5,-61,44
1,1269,1261,8,1,635,89
-1,1682,1687,-5,5,215,64
-1,1805,1713,92,-5,8,44
1,1722,1324,398,-3,-112,55
-1,1660,1474,186,4,185,78
1,1735,1698,37,-3,-21,65
1,1949,1856,93,0,160,69
1,1540,1623,-83,0,25,67
1,2093,1887,206,0,23,67
1,1717,1728,-11,-3,-18,45
-1,1574,1498,76,-7,-359,84
-1,1322,1725,-403,-1,-255,72
-1,1530,1579,-49,0,-4,54
-1,1847,1957,-110,-4,-468,112
1,1527,1381,146,4,201,55
-1,1536,1765,-229,3,17,80
-1,1454,1491,-37,0,-22,56
1,1319,1343,-24,2,180,91
-1,1519,1415,104,-12,-152,46
0,1552,1524,28,-1,6,143
-1,1754,1583,171,0,-53,80
1,1700,1856,-156,-1,47,85
-1,1965,1839,126,0,-96,68
1,1714,1315,399,5,206,67
0,1606,1728,-122,-1,119,93
-1,1486,1666,-180,0,11,94
0,1796,1989,-193,0,133,171
1,1434,1093,341,-7,-17,121
1,1822,1576,246,2,421,137
-1,1675,1740,-65,-5,-118,70
1,1696,1813,-117,1,25,41
1,1520,1778,-258,1,23,43
1,1882,1834,48,0,117,81
1,1674,1541,133,0,51,81
1,1841,1716,125,0,244,125
1,1544,1435,109,3,17,41
-1,1421,1855,-434,-1,-19,54
1,1566,1599,-33,-2,507,141
-1,1319,1409,-90,-1,33,72
1,1500,1283,217,0,29,81
-1,1504,1534,-30,2,-643,100
-1,1771,1515,256,-1,-255,94
-1,1798,1712,86,-1,-49,74
-1,1689,1586,103,2,56,44
1,1667,1708,-41,-2,-316,101
1,1418,1309,109,-1,-13,55
-1,1570,1607,-37,4,173,56
-1,1579,1599,-20,0,-9,80
-1,1534,1370,164,7,51,98
1,1746,1466,280,0,140,89
-1,1647,1657,-10,2,-53,70
-1,1854,1599,255,-3,-60,52
1,1488,1707,-219,10,386,54
-1,1521,1501,20,1,61,64
1,1715,1799,-84,0,8,49
-1,1313,1717,-404,3,189,78
-1,1419,1857,-438,0,-12,58
1,1696,1500,196,0,1,55
-1,1561,1460,101,-10,-186,52
1,1583,1754,-171,0,13,75
-1,1872,1826,46,0,-2,64
-1,1824,1749,75,1,50,88
1,1662,1386,276,3,17,41
-1,1749,1701,48,0,6,66
1,1693,1600,93,0,84,80
-1,1838,1860,-22,0,-128,82
-1,1560,1549,11,-1,-297,180
1,1580,1511,69,6,258,61
-1,1463,1751,-288,-2,-113,73
-1,1427,1552,-125,-5,-14,84
1,1738,1639,99,2,-100,97
1,1609,1569,40,-2,-22,47
-1,1357,1565,-208,0,-291,76
-1,1450,1379,71,-6,-545,76
-1,1513,1786,-273,0,-57,62
-1,1729,1724,5,-1,-23,50
-1,1228,1424,-196,-1,-697,134
-1,1640,1500,140,-2,-33,45
-1,1652,1732,-80,1,3,58
1,1593,1357,236,0,3,63
-1,1716,1587,129,1,95,66
1,1879,1235,644,1,268,115
-1,1762,1811,-49,-5,-104,50
1,2027,1618,409,-1,-34,50
0,1493,1666,-173,-1,-630,113
1,1264,1276,-12,2,153,59
1,1613,1746,-133,-6,24,47
1,1714,1512,202,-6,515,117
1,1409,1383,26,0,58,81
1,2218,1643,575,1,276,71
-1,1500,1380,120,-5,-272,78
-1,1417,1402,15,-3,-377,166
1,2100,1784,316,0,21,75
-1,1473,1580,-107,0,-140,96
1,1783,1822,-39,-1,-70,67
-1,1616,2029,-413,0,1,62
-1,1731,1658,73,0,-107,114
-1,1753,1820,-67,-1,-143,100
-1,1657,1534,123,-4,-426,118
-1,1517,1739,-222,-1,-34,56
1,1718,1563,155,1,117,64
1,1284,1263,21,2,110,47
-1,1598,1556,42,0,-3,70
-1,1459,1634,-175,4,-9,70
1,1755,1311,444,3,186,81
-1,1789,1859,-70,-3,-106,54
-1,1880,1936,-56,0,-118,60
-1,1248,1295,-47,-2,-43,52
1,1643,1578,65,9,990,119
1,1768,1614,154,2,175,95
1,1524,1550,-26,4,56,44
1,1743,1533,210,0,98,87
0,2093,1871,222,0,77,131
-1,1220,1276,-56,-6,-911,117
-1,1620,1489,131,1,58,88
1,1306,1234,72,5,111,71
-1,1728,1946,-218,0,-309,114
-1,1652,1553,99,1,168,68
1,1512,1417,95,3,180,79
-1,1557,1673,-116,-5,-79,54
-1,1498,1743,-245,0,-522,118
-1,1638,1589,49,0,-181,72
-1,1666,1845,-179,-4,3,40
1,1309,1757,-448,0,80,111
-1,1222,1316,-94,-7,-277,64
-1,1608,1791,-183,0,-81,100
-1,1585,1568,17,2,31,46
-1,1569,1445,124,-2,-65,54
1,1892,1675,217,1,102,51
1,1869,1781,88,2,79,63
1,1744,1591,153,-1,-80,54
-1,1667,1636,31,-6,-358,68
1,1406,1256,150,-3,-42,45
1,1456,1638,-182,1,101,69
1,1951,1723,228,-1,8,57
-1,1343,1407,-64,1,-235,84
1,1201,1333,-132,-8,-199,55
1,1742,1842,-100,0,39,59
1,1813,1646,167,3,19,45
-1,1521,1447,74,-6,-420,146
1,1725,1500,225,-4,23,57
-1,1595,1580,15,2,46,70
1,1852,1660,192,1,351,95
-1,1680,1702,-22,-5,-13,40
0,1731,1772,-41,0,817,112
1,1317,1220,97,-1,-39,55
1,1956,1718,238,6,192,67
1,2104,1602,502,0,90,89
1,1452,1345,107,3,106,61
-1,1703,1983,-280,0,-74,100
0,1412,1550,-138,5,205,115
-1,1574,1500,74,2,40,64
-1,1568,1548,20,0,15,69
1,1361,1406,-45,5,245,63
-1,1585,1750,-165,2,78,72
1,1725,1464,261,0,45,77
1,1770,1732,38,3,17,59
-1,1772,1879,-107,-2,-10,64
-1,1552,1825,-273,-6,-349,92
-1,1655,1575,80,-1,-83,90
1,1334,1200,134,-5,-72,55
-1,1713,1961,-248,-6,-43,44
1,1344,1220,124,1,294,76
-1,1722,1780,-58,-1,238,98
1,1792,1771,21,0,44,117
-1,1601,2106,-505,0,-92,92
1,1520,1428,92,-2,22,53
1,1405,1429,-24,4,195,76
1,1966,1708,258,-2,84,70
-1,1295,1672,-377,2,-237,88
-1,1334,1418,-84,-9,-176,76
1,2085,1835,250,0,-36,83
1,1700,1607,93,2,55,57
-1,1815,1816,-1,-11,-269,136
-1,1376,1374,2,-1,-89,52
-1,1590,1879,-289,1,-207,92
1,1639,1908,-269,-1,25,57
1,1820,1887,-67,0,48,55
-1,1654,1858,-204,-1,-189,88
1,1732,1333,399,1,44,98
-1,1643,1568,75,0,-139,118
1,1545,1416,129,1,21,65
-1,1778,2058,-280,-1,-101,62
-1,1461,1640,-179,9,359,126
-1,1473,1492,-19,-2,-124,92
1,1587,1519,68,3,191,63
-1,1430,1460,-30,1,45,56
1,1712,1765,-53,-9,65,99
1,1790,1871,-81,1,28,74
-1,1803,1670,133,-2,-46,96
-1,1392,1704,-312,0,22,72
1,1720,1500,220,3,294,61
-1,1830,2091,-261,-3,-159,56
1,1525,1413,112,0,-11,51
-1,1970,1810,160,1,-57,72
0,1756,1987,-231,-1,-60,103
1,1500,1605,-105,0,-27,59
-1,1667,1600,67,2,68,94
1,1729,1585,144,0,96,111
1,2107,1449,658,0,-3,47
1,1578,1117,461,2,305,119
1,1460,1500,-40,4,543,157
1,1848,1803,45,0,12,63
1,1708,1714,-6,0,73,55
1,2096,1825,271,0,168,79
1,1346,1307,39,0,285,87
0,1648,1587,61,5,364,99
-1,1954,1794,160,0,-14,60
0,1598,1708,-110,3,332,112
1,1565,1273,292,0,525,73
-1,1409,1553,-144,-4,-79,42
1,2108,1728,380,1,46,67
-1,1325,1406,-81,4,11,140
-1,1231,1443,-212,-8,-255,54
1,1583,1448,135,0,20,61
1,2100,1820,280,-1,55,101
1,1560,1374,186,5,256,59
1,1826,1796,30,3,52,47
1,1796,1677,119,-4,-66,57
1,1438,1616,-178,0,148,97
1,1459,1508,-49,4,71,41
1,1810,1702,108,0,-15,59
-1,1292,1428,-136,-5,-142,52
1,1870,1642,228,1,169,75
-1,1752,1724,28,-9,-45,84
-1,1500,1620,-120,-1,-24,62
1,1462,1371,91,8,446,85
-1,1694,1817,-123,1,-34,60
0,1455,1503,-48,0,-784,231
-1,1286,1735,-449,-6,-205,82
1,1618,1417,201,6,267,59
1,1646,1155,491,6,393,73
1,1560,1402,158,2,102,67
1,1299,1385,-86,1,-36,63
-1,1721,1880,-159,0,29,76
-1,1482,1429,53,-3,-329,88
-1,1441,1758,-317,1,-1,88
-1,1686,1815,-129,3,108,74
1,1585,1720,-135,-3,-75,97
-1,1657,1917,-260,-1,-250,104
1,1648,1472,176,3,88,53
-1,1665,1629,36,1,-12,56
-1,1403,1436,-33,1,-15,56
1,1588,1566,22,0,1,67
1,1525,1493,32,3,225,64
0,1804,1647,157,0,-68,231
-1,1801,1883,-82,-8,-354,94
-1,1613,1603,10,-2,-73,52
-1,1896,1715,181,-2,53,90
1,1705,1602,103,4,90,47
1,1778,1602,176,0,19,67
1,1631,1669,-38,-2,-52,49
1,1945,1626,319,0,-4,53
-1,1471,1304,167,-5,-71,48
1,1735,1741,-6,0,-3,51
1,1484,1411,73,9,304,54
-1,1246,1414,-168,-6,-232,70
-1,1713,1653,60,-1,-1,68
0,1737,1715,22,0,90,157
1,1826,1405,421,5,185,89
1,1454,1351,103,1,22,51
-1,1566,1598,-32,1,65,60
-1,1730,1865,-135,-4,-13,44
-1,1837,1873,-36,-2,-205,82
-1,1595,1786,-191,-2,-46,125
1,1575,1536,39,4,64,41
1,1481,1443,38,-1,-122,81
-1,1737,1766,-29,-2,-120,60
-1,1449,1223,226,-2,-59,64
-1,2111,2031,80,0,-9,62
1,1594,1713,-119,0,-9,77
-1,1356,1371,-15,-12,-196,48
-1,1746,1684,62,0,5,68
1,1458,1368,90,1,14,43
1,1375,1586,-211,3,260,133
-1,1402,1829,-427,-4,-37,40
-1,1730,1746,-16,1,-42,64
-1,1791,1892,-101,-2,-149,60
1,1793,1590,203,-2,40,49
1,1485,1447,38,-4,2,55
1,1657,1643,14,0,59,65
-1,1581,1586,-5,0,-16,66
1,1560,1500,60,6,161,47
-1,1701,1878,-177,-9,-202,64
1,1285,1326,-41,-6,-177,79
-1,2046,2093,-47,0,-32,70
1,1755,1648,107,2,30,40
-1,1347,1667,-320,0,-1,40
-1,1073,1538,-465,-4,-261,64
-1,1779,1958,-179,-1,-18,50
1,1402,1281,121,11,204,53
1,1457,1356,101,-5,3,67
-1,1155,1230,-75,-8,-360,66
-1,1522,1706,-184,-8,-156,58
1,1623,1634,-11,2,270,127
-1,1799,1709,90,-3,-100,43
-1,1750,1888,-138,0,-24,56
-1,1742,1660,82,-3,-56,58
-1,1605,1712,-107,0,35,76
-1,1287,1365,-78,-3,-131,62
-1,1500,1740,-240,-3,-100,58
1,1900,1584,316,-4,84,71
1,1756,1720,36,-2,48,183
0,1500,1626,-126,0,59,86
-1,1456,1733,-277,-4,-401,79
-1,1516,1940,-424,-3,-65,102
-1,1095,1465,-370,-14,-751,66
1,1597,1608,-11,0,-9,55
1,1617,1534,83,-2,-33,63
1,1782,1506,276,5,260,81
0,1492,1589,-97,-2,-224,97
-1,1254,1319,-65,-3,-201,78
-1,1723,1595,128,0,17,68
-1,1720,2133,-413,0,-113,104
-1,1345,1262,83,-6,-535,72
-1,1723,1605,118,1,33,60
1,1653,1472,181,4,443,91
1,1942,1713,229,0,-8,93
1,1586,1671,-85,-3,-19,55
1,2136,1718,418,-3,-11,45
-1,1581,1903,-322,0,22,82
1,1467,1594,-127,2,82,95
-1,1514,1613,-99,-4,-33,62
1,1922,1825,97,0,39,73
1,1716,1536,180,0,94,71
-1,1570,1821,-251,0,-21,76
-1,1774,1697,77,0,142,130
1,1600,1656,-56,0,6,65
0,1737,1800,-63,3,402,127
-1,1590,1518,72,-12,-626,70
0,1817,1931,-114,0,-107,144
-1,1625,1467,158,-4,-50,48
-1,1505,1709,-204,-8,-261,58
1,2108,1652,456,-4,-78,63
1,1883,1827,56,1,47,77
-1,1729,1609,120,0,-15,42
1,1741,1723,18,-1,90,65
1,1906,1577,329,0,75,83
-1,1575,1533,42,0,-32,74
1,1499,1500,-1,2,73,65
1,1470,1650,-180,0,-4,49
1,1714,1711,3,0,42,85
-1,1642,1927,-285,-2,-65,48
1,1698,1626,72,-2,-71,53
1,1249,1428,-179,1,852,116
-1,1561,1528,33,4,69,106
-1,1574,1910,-336,0,-13,52
-1,1605,1368,237,0,-72,86
-1,1649,2110,-461,-4,-48,70
-1,1787,1891,-104,-1,-104,84
1,1507,1324,183,7,269,55
1,1699,1725,-26,2,80,61
1,1395,1586,-191,-4,84,71
-1,1634,1735,-101,1,29,70
1,1755,1638,117,4,392,81
-1,1931,1900,31,-5,-241,74
1,1370,1372,-2,3,278,63
-1,1468,1092,376,-3,-120,48
-1,1714,1692,22,-3,-26,44
0,1739,1710,29,-1,-188,122
-1,1756,1541,215,0,-16,70
-1,1566,1315,251,0,-287,134
1,1947,1712,235,0,109,95
1,1913,1571,342,-4,105,92
-1,1513,1623,-110,-4,-37,42
1,1528,1536,-8,1,361,111
-1,1588,1623,-35,-2,-549,160
-1,1708,1454,254,0,-5,100
1,1331,1365,-34,-3,-224,75
-1,1505,1953,-448,-7,-160,68
1,1701,1663,38,0,22,71
-1,1756,1707,49,-2,-30,58
-1,1654,1797,-143,0,-103,144
1,1564,1485,79,-1,66,119
-1,1500,1638,-138,-6,-244,84
-1,1568,1916,-348,-1,-77,84
-1,1899,1777,122,-4,-277,80
1,1886,1646,240,2,208,103
-1,1721,1743,-22,0,2,42
1,1764,1541,223,-1,150,85
1,1754,1710,44,-3,-2,71
-1,1501,1957,-456,0,-3,66
-1,1479,1466,13,0,16,66
-1,1412,1580,-168,-2,-181,78
1,1777,1559,218,0,1,51
-1,1716,1919,-203,-4,-50,40
-1,1713,1699,14,-2,-165,128
-1,1499,1959,-460,-3,-163,78
1,1763,1442,321,14,832,71
1,1574,1477,97,0,7,65
1,2112,1609,503,1,45,56
-1,1482,1579,-97,-7,-307,64
-1,1432,1225,207,-5,-223,54
1,1320,1413,-93,-1,-44,65
-1,1335,1547,-212,-2,-176,84
1,1573,1292,281,12,882,75
-1,1438,1767,-329,-3,-440,94
-1,1316,1521,-205,1,-12,62
-1,1647,1634,13,0,35,68
1,1457,1429,28,11,701,79
-1,1711,1702,9,-10,-119,42
-1,1497,1960,-463,-5,-353,88
1,1527,1427,100,-1,-23,71
-1,1583,1469,114,1,-146,68
1,1775,1884,-109,5,334,71
1,1711,1645,66,4,387,131
1,1664,1601,63,0,35,57
1,1368,1518,-150,9,144,53
1,1678,1700,-22,6,93,43
-1,1612,1626,-14,0,-2,48
1,1795,1738,57,0,14,77
0,1891,1638,253,0,606,138
1,1356,1337,19,-1,313,111
-1,1770,1713,57,-2,-34,40
-1,1632,1770,-138,0,37,72
-1,1711,1817,-106,1,39,70
-1,1435,1141,294,3,25,44
-1,1495,1962,-467,0,-81,86
1,1711,1925,-214,0,51,69
-1,1652,1438,214,-12,-113,40
1,1688,1726,-38,4,330,95
-1,1561,1629,-68,-1,165,74
1,1936,1812,124,3,510,71
1,1700,1472,228,1,45,61
-1,1602,1637,-35,-4,-113,54
1,1554,1501,53,-1,6,56
-1,1933,1893,40,-1,-94,66
1,1497,1119,378,12,828,77
-1,1494,1964,-470,-13,-77,42
-1,1777,1624,153,-6,-395,98
-1,1607,1605,2,2,101,92
1,1554,1421,133,0,7,45
1,1869,1789,80,-2,50,51
0,1207,1792,-585,-1,157,100
-1,1714,1700,14,0,-203,96
-1,1788,1943,-155,-8,-400,90
1,1532,1311,221,3,-158,87
-1,1492,1966,-474,-2,-186,86
1,1648,1592,56,-1,-47,81
1,1786,1500,286,-1,-3,41
1,1643,1457,186,-3,-52,65
1,1794,1615,179,3,389,97
1,1878,1781,97,0,-6,53
-1,1643,1761,-118,0,40,88
1,2113,1351,762,2,44,51
1,1181,1178,3,-2,0,81
-1,1379,1468,-89,-5,-193,68
1,1553,1490,63,-1,-26,65
1,1936,1803,133,-1,-4,79
1,1583,1658,-75,-1,68,93
-1,1490,1968,-478,-1,-62,62
-1,1729,1575,154,0,42,78
-1,1790,1425,365,-3,-30,48
-1,1596,1784,-188,-10,-208,50
-1,1413,1265,148,-4,-391,124
1,1712,1634,78,0,-6,55
-1,1769,1466,303,-2,-116,66
-1,1488,1970,-482,-2,-77,68
1,1772,1886,-114,1,719,139
-1,1417,1437,-20,1,21,58
1,1644,1596,48,0,191,75
-1,1465,1601,-136,-4,-130,66
1,1553,1369,184,1,174,63
1,1311,1566,-255,1,201,81
1,1884,1467,417,-1,137,93
-1,1776,1721,55,-1,-43,68
-1,1720,1562,158,-6,-216,54
-1,1716,1643,73,0,-51,66
-1,1116,1501,-385,-8,-439,66
1,1486,1972,-486,-1,292,99
1,1578,1617,-39,0,721,141
1,1749,1658,91,-1,-85,107
-1,1647,1906,-259,-6,-103,78
-1,1587,1654,-67,-2,-113,60
1,1496,1531,-35,4,3,97
1,1616,1650,-34,10,225,45
1,1692,1744,-52,-1,-23,103
1,1562,1594,-32,4,492,101
-1,1510,1478,32,0,-25,70
-1,1306,1318,-12,-2,-58,52
1,1663,1578,85,4,277,65
1,1950,1757,193,1,42,69
1,1764,1624,140,3,673,117
1,1944,1733,211,-3,-134,87
-1,1559,1312,247,0,-186,128
-1,1384,1526,-142,-2,-199,120
1,1630,1628,2,2,78,45
-1,1143,1193,-50,-1,178,102
1,1796,1728,68,0,-4,47
-1,1570,1672,-102,-8,-149,40
-1,1751,1955,-204,0,-227,108
1,1886,1943,-57,-1,-91,97
1,1492,1502,-10,2,429,85
1,1509,1517,-8,-5,137,119
-1,1643,1803,-160,-11,-482,62
1,1627,1592,35,-3,449,97
1,1790,1591,199,-3,335,171
1,1680,1562,118,2,322,81
1,1579,1824,-245,-3,18,47
-1,1704,1500,204,0,-18,102
-1,1592,1714,-122,0,-45,65
-1,1371,1420,-49,0,-6,96
1,1944,1760,184,3,589,119
1,1770,1616,154,0,134,69
0,1498,1497,1,0,-48,60
-1,1649,1825,-176,-2,-42,46
-1,1445,1430,15,0,-328,123
1,1484,1379,105,-1,92,107
1,1961,1746,215,-1,593,115
-1,1500,1600,-100,-18,-476,54
-1,1327,1389,-62,-1,-58,60
1,1371,1460,-89,-6,115,83
1,1799,1855,-56,0,26,105
1,1555,1688,-133,5,117,41
1,1716,1535,181,-3,83,65
-1,1521,1606,-85,0,-141,84
-1,1741,1966,-225,0,-68,52
-1,1777,1608,169,0,-31,88
1,1689,1841,-152,0,7,75
-1,1637,1721,-84,0,-190,109
-1,1415,1584,-169,-3,29,52
1,1526,1545,-19,0,36,61
-1,1601,1644,-43,-3,3,48
-1,1624,1848,-224,-4,-102,60
-1,1601,2048,-447,-10,-99,42
1,1654,1599,55,0,15,51
1,2046,1949,97,-2,-6,61
0,1096,1163,-67,1,-116,79
-1,1543,1628,-85,-9,-53,44
1,1663,1590,73,-3,493,145
1,2048,1619,429,1,20,43
1,1690,1614,76,1,445,143
-1,1421,1695,-274,1,161,62
1,1637,1535,102,6,169,53
-1,1671,1581,90,-3,-715,184
1,2052,1617,435,3,29,45
-1,1434,1595,-161,-5,-64,62
1,1601,1425,176,-1,307,73
1,1974,1794,180,0,145,75
-1,1538,1553,-15,-2,-156,88
1,1539,1371,168,0,7,55
1,1453,1716,-263,-1,-1,79
1,2094,1801,293,0,73,77
1,1801,1531,270,0,15,65
-1,1980,1798,182,1,81,70
1,1231,1590,-359,-1,-90,65
-1,1365,1609,-244,0,-7,62
1,1699,1593,106,0,121,83
-1,1354,1405,-51,-4,-22,42
-1,1623,1674,-51,-2,-53,48
-1,1620,1894,-274,1,8,52
-1,1757,2104,-347,-6,-383,100
-1,1289,1569,-280,-3,-178,66
1,1434,1342,92,3,372,79
-1,1684,1613,71,-3,1,108
-1,1507,1311,196,-1,-7,42
-1,1550,1593,-43,0,6,52
-1,1279,1722,-443,-10,-191,68
-1,1658,1788,-130,-18,-478,78
-1,1844,1955,-111,-8,-112,44
1,1605,1539,66,-5,-56,55
-1,1658,1788,-130,0,0,56
1,1805,1446,359,1,343,72
-1,1529,1616,-87,-4,-40,48
-1,1339,1085,254,0,-141,62
-1,1563,1450,113,-3,-75,64
-1,2107,1926,181,-1,-85,58
1,1565,1540,25,-1,582,145
1,1546,1228,318,4,241,59
-1,1746,1955,-209,-8,-11,160
1,1627,1520,107,0,17,61
-1,1817,1500,317,-1,-24,44
-1,1651,1678,-27,-3,-285,70
-1,1663,1667,-4,-3,-400,88
-1,1465,1616,-151,-8,-223,76
1,1656,1674,-18,4,961,201
-1,1444,1548,-104,0,4,72
1,2037,2092,-55,-1,-7,43
-1,1960,1727,233,1,-59,98
-1,1684,1709,-25,-3,-35,46
1,1101,1274,-173,-2,448,81
1,1500,1595,-95,2,16,77
-1,1550,1477,73,-2,-406,98
-1,1611,1850,-239,-1,-34,90
-1,1965,1963,2,-2,-113,62
-1,1667,1662,5,-2,-102,66
1,1662,1667,-5,1,258,93
-1,1986,1615,371,1,-209,148
-1,1856,1815,41,-9,-28,42
-1,1385,1505,-120,2,38,56
1,1657,1674,-17,3,149,71
1,1787,1943,-156,0,195,105
1,1662,1668,-6,1,514,161
-1,1556,1435,121,-3,-152,91
-1,1529,1622,-93,-3,-222,82
-1,1657,1673,-16,-2,-477,118
1,1633,1492,141,0,50,67
-1,1534,1637,-103,-7,-247,54
1,1500,1712,-212,1,56,53
-1,1813,1700,113,-5,30,162
1,1857,1606,251,1,96,109
-1,1712,1500,212,-1,8,48
-1,1684,1647,37,1,48,56
1,1665,1564,101,3,81,59
-1,1630,1730,-100,-5,-90,52
-1,1486,1393,93,-1,-13,45
1,1659,1672,-13,-2,-11,41
1,1712,1637,75,4,126,53
1,1669,1660,9,8,466,71
-1,1625,1668,-43,-6,-44,78
1,1897,1650,247,0,9,48
1,1417,1640,-223,4,1173,149
1,1559,1721,-162,0,-9,63
-1,1469,1484,-15,2,139,68
-1,1689,1640,49,-11,-741,112
1,1525,1143,382,11,191,47
-1,1451,1542,-91,0,32,78
-1,1706,1674,32,-1,-37,80
1,1694,1746,-52,3,329,73
-1,1627,1760,-133,-4,-744,134
-1,1556,1739,-183,0,-17,62
1,1477,1416,61,2,16,45
1,1677,1707,-30,13,491,55
1,1688,1693,-5,-1,4,43
-1,1693,1688,5,8,234,40
1,1414,1382,32,3,133,79
-1,1652,1681,-29,0,141,98
0,1486,1306,180,0,-67,125
-1,1740,1767,-27,-3,-205,60
-1,1530,1319,211,-3,-172,100
-1,1757,1902,-145,1,-129,150
1,1389,1161,228,10,84,41
-1,1767,1808,-41,0,-235,134
1,1608,1368,240,2,457,121
1,1746,1550,196,0,94,57
1,1837,1974,-137,-1,-65,81
1,1506,1500,6,-1,45,41
1,1448,1620,-172,-2,96,73
1,1500,1212,288,6,309,65
-1,1355,1323,32,-4,-149,66
-1,1312,1481,-169,-5,-509,76
1,1528,1314,214,0,13,117
1,1730,1709,21,1,177,105
0,1882,1885,-3,-3,-326,133
1,1737,1668,69,-2,-76,71
1,1487,1305,182,4,687,117
-1,1616,1851,-235,-11,-579,76
1,1525,996,529,8,258,45
-1,1205,1736,-531,-10,-276,56
-1,1465,1604,-139,-2,-183,72
1,1545,1752,-207,-1,-17,79
1,1463,1757,-294,9,511,69
1,1928,1885,43,1,34,73
-1,1574,1500,74,-3,-358,101
-1,1299,1493,-194,1,208,114
1,1616,1669,-53,-1,-71,69
-1,1542,1672,-130,0,6,58
1,1737,1203,534,1,227,93
1,1876,1938,-62,3,54,59
-1,1425,1433,-8,0,-23,52
1,1526,994,532,15,366,45
-1,1737,1645,92,-1,-115,112
-1,1781,1778,3,-3,-65,130
-1,1635,1656,-21,-1,-41,74
1,1723,1482,241,0,35,71
1,1925,1888,37,1,145,105
1,1499,1293,206,3,104,47
1,1541,1077,464,8,385,59
-1,1646,1584,62,2,55,50
1,1626,1444,182,3,399,111
-1,1287,1504,-217,5,-214,122
-1,1694,1696,-2,-7,-85,46
0,1448,1329,119,-2,-513,166
-1,1206,1535,-329,-1,-41,52
-1,1879,1935,-56,-1,-45,60
1,1733,1562,171,0,81,93
-1,1615,1710,-95,-2,-111,88
-1,1944,1870,74,1,-47,78
-1,1509,1564,-55,-1,-24,70
1,1965,1774,191,0,49,87
-1,1605,1294,311,-16,-377,43
-1,1864,1658,206,0,-46,96
1,1632,1328,304,9,650,81
-1,1564,1611,-47,-5,-380,86
-1,1883,1931,-48,0,33,74
-1,1500,1801,-301,-13,-412,50
1,1616,1633,-17,1,83,63
-1,1769,1338,431,0,15,92
0,1731,1851,-120,0,202,150
1,1549,1414,135,0,39,101
1,1398,1515,-117,-2,180,67
1,1500,1741,-241,0,778,127
-1,1335,1526,-191,-9,-187,42
1,1805,1598,207,3,379,87
1,1642,1694,-52,0,119,65
1,1763,1389,374,2,-17,53
1,1406,1557,-151,-1,107,53
1,1635,1690,-55,0,22,83
1,1592,1810,-218,-1,219,89
1,1682,1797,-115,5,780,113
1,1427,1454,-27,-6,-407,159
-1,1627,1911,-284,0,-255,159
1,1792,1612,180,0,-15,59
1,1354,1766,-412,0,23,61
1,1779,1696,83,-1,-102,65
-1,1696,1779,-83,-2,-35,48
1,1670,1697,-27,-1,88,113
0,1789,1688,101,0,39,132
1,1440,1356,84,-4,55,63
-1,1605,1799,-194,-1,-14,42
-1,1513,1673,-160,-2,-721,160
1,1691,1786,-95,3,177,103
-1,1151,1483,-332,-5,-122,64
1,1804,1599,205,3,15,41
1,1457,1450,7,11,506,61
-1,1634,1761,-127,2,5,42
1,1770,1705,65,2,143,89
1,1593,1810,-217,0,-18,53
-1,1798,1960,-162,1,6,58
1,1543,1471,72,-9,226,89
1,1541,1500,41,-1,457,113
1,1961,2139,-178,0,265,139
1,1792,1612,180,1,21,51
1,1749,1607,142,-3,-76,71
-1,1479,1875,-396,-1,9,48
1,1558,1546,12,1,185,83
-1,1606,1798,-192,0,26,50
1,1606,1372,234,3,317,85
1,1344,1400,-56,0,27,41
-1,1626,1759,-133,0,-24,104
-1,1593,1780,-187,-1,26,68
-1,1528,1679,-151,-1,-123,74
1,1499,1517,-18,-3,-514,123
1,1631,1553,78,0,-5,87
-1,1787,1587,200,1,-29,42
-1,1721,1500,221,-4,-271,114
1,1587,1787,-200,0,25,69
1,1966,1804,162,-1,-34,47
1,1768,1606,162,1,15,57
1,1832,1685,147,0,2,55
0,1980,1948,32,0,-161,117
-1,1837,1717,120,-1,-32,46
-1,1598,1775,-177,-1,-3,46
1,1315,1147,168,9,234,61
1,1680,1837,-157,2,196,77
-1,1696,2050,-354,0,1,44
-1,1965,1847,118,0,-56,102
1,1621,1582,39,6,171,50
1,2054,1687,367,1,405,115
1,1331,1221,110,3,144,69
1,1769,1797,-28,0,12,61
1,1473,1585,-112,1,66,77
-1,1531,1643,-112,-2,-71,48
1,1512,1493,19,-5,-119,59
1,1493,1442,51,0,254,88
1,1859,1957,-98,-2,-41,55
1,1500,1786,-286,3,95,63
-1,1638,1661,-23,0,-67,76
-1,1523,1725,-202,-1,-534,104
-1,1839,1635,204,0,-8,66
1,1551,1450,101,0,-6,69
-1,1573,1599,-26,-3,-29,42
-1,1594,1762,-168,-3,-136,74
1,1458,1539,-81,-5,357,79
1,1611,1830,-219,3,37,47
1,1548,1655,-107,-2,1,45
-1,1641,2057,-416,-5,-36,40
1,1669,1564,105,3,45,47
-1,1377,1657,-280,-5,-153,69
-1,1944,1893,51,-2,-49,102
1,1602,1610,-8,0,-18,59
1,2059,1580,479,5,170,59
1,1500,1791,-291,3,269,95
1,1771,1682,89,-1,-17,83
1,1524,1314,210,-2,319,99
-1,1581,1810,-229,-1,-115,82
-1,1517,1731,-214,-2,-53,60
0,1316,1383,-67,0,-224,117
1,1747,1550,197,1,122,93
-1,1525,1661,-136,0,-455,104
-1,1484,1344,140,0,-255,122
1,1763,1762,1,-4,60,85
1,1922,1932,-10,0,-129,83
-1,1659,1581,78,0,-72,64
1,1427,1432,-5,0,11,43
1,1815,1556,259,0,51,123
-1,1447,1318,129,-4,-41,46
-1,1670,2215,-545,-8,-57,88
-1,1684,1628,56,0,-10,129
1,1323,1313,10,0,-57,71
-1,1921,1946,-25,0,-21,48
-1,1669,1545,124,3,96,64
1,1595,1327,268,0,28,65
-1,1512,1812,-300,-1,-2,44
0,1683,1627,56,-4,-235,156
-1,1749,1774,-25,-4,-8,56
-1,1189,1591,-402,0,-13,48
-1,1226,2217,-991,-3,-38,42
1,1639,1421,218,0,361,121
1,1724,1767,-43,2,89,61
1,1471,1477,-6,-1,198,139
1,1931,1829,102,3,51,67
1,1627,1321,306,1,189,117
-1,1636,1490,146,-7,-168,65
-1,1187,1594,-407,-4,-204,60
1,1363,1596,-233,-1,-36,59
-1,1506,1618,-112,-6,-46,46
-1,1462,1838,-376,-1,-165,68
-1,1585,1571,14,-2,-40,72
1,1185,1383,-198,3,-9,53
-1,1069,1367,-298,-20,-798,54
1,1318,1506,-188,-1,106,69
1,1627,1498,129,6,92,55
0,1820,1627,193,0,-125,131
-1,1534,1515,19,0,-14,52
1,1490,1635,-145,-1,14,57
1,1527,1682,-155,1,47,63
1,1752,1569,183,3,52,49
1,1482,1296,186,0,97,77
-1,1649,1800,-151,-6,-94,52
1,1617,1506,111,-7,-165,67
1,1309,1467,-158,0,-42,57
1,1611,1542,69,0,124,81
-1,1807,2066,-259,-1,-29,148
-1,1398,1736,-338,-7,-293,56
-1,1375,1502,-127,-9,-192,54
1,1562,1508,54,5,575,89
1,1453,1226,227,6,198,49
-1,1498,1626,-128,-3,-79,56
1,1573,1560,13,-1,-37,115
-1,1156,1372,-216,-2,-389,72
0,2000,1911,89,0,-11,71
1,1630,1449,181,4,128,77
-1,1458,1431,27,-2,-20,42
1,2071,1684,387,0,-3,67
1,1390,1486,-96,-2,-86,63
-1,1386,1386,0,-7,-140,54
-1,1500,1672,-172,-1,-39,56
-1,1583,1653,-70,0,-40,58
-1,1498,1571,-73,-1,-342,96
-1,1488,1738,-250,0,3,88
-1,1373,1510,-137,-1,-5,46
1,2073,1831,242,0,212,132
-1,1413,1674,-261,-7,-408,76
-1,1486,1465,21,-3,-73,48
1,1784,1452,332,0,82,57
-1,1543,1550,-7,-7,-690,96
-1,1405,1274,131,4,13,44
1,1826,2078,-252,-1,10,49
1,1580,1488,92,1,101,71
-1,1643,1647,-4,0,-257,98
-1,1446,1312,134,0,-113,96
1,1476,1472,4,-7,55,91
-1,1877,1550,327,3,71,136
1,1874,1678,196,1,155,75
1,1450,1285,165,8,105,43
1,1756,1678,78,-1,50,63
-1,1455,1432,23,-3,-463,130
1,1438,1636,-198,0,16,47
1,1939,1821,118,1,10,41
-1,1997,2074,-77,-5,-48,42
1,1453,1341,112,0,15,41
1,1645,1434,211,2,28,41
-1,1574,1451,123,0,-3,48
1,1686,1633,53,0,94,145
1,1404,1389,15,2,68,55
1,1334,1383,-49,1,22,43
0,1484,1743,-259,-2,73,121
1,1458,1469,-11,5,839,107
1,1524,1445,79,1,93,97
1,1814,1684,130,-7,110,101
1,1428,1651,-223,1,89,73
-1,2084,1987,97,0,-55,94
1,1619,1468,151,1,224,133
1,1728,1620,108,2,1083,153
-1,1451,1432,19,-1,-13,70
0,1399,1481,-82,6,387,87
0,1466,1559,-93,-2,-125,120
1,1610,1058,552,5,326,69
-1,1633,1447,186,-2,57,100
-1,1442,1444,-2,0,-28,66
1,1345,1329,16,-1,4,45
-1,1957,2068,-111,-1,-46,78
1,1735,1219,516,0,-12,59
-1,1491,1500,-9,0,-43,68
1,1478,1437,41,-1,216,103
-1,1479,1415,64,-5,2,40
-1,1624,1693,-69,-1,11,76
1,1446,1473,-27,4,309,87
1,1383,1443,-60,1,21,49
1,1702,1615,87,0,118,67
1,1483,1611,-128,7,305,53
1,1641,1564,77,2,219,79
-1,1464,1616,-152,-7,-212,68
-1,1431,1455,-24,0,-8,42
-1,1710,1606,104,-1,-68,70
1,1626,1211,415,-8,92,91
-1,1341,1689,-348,-1,-32,60
-1,1658,1849,-191,-10,-483,72
1,1452,1500,-48,4,343,121
1,1768,1024,744,9,325,51
-1,1471,1803,-332,-1,-31,44
-1,1671,1460,211,-1,-147,65
-1,1449,1581,-132,-3,-150,54
-1,1498,1545,-47,0,-207,72
1,1620,1696,-76,0,60,55
1,1438,1597,-159,4,91,49
-1,1265,1466,-201,-1,5,42
1,1778,1584,194,1,358,139
1,1683,1650,33,-3,-78,61
1,1648,1561,87,0,371,101
1,1582,1421,161,1,761,183
-1,1522,1365,157,-2,-34,58
1,1479,1654,-175,-2,31,78
1,1456,1477,-21,-2,135,155
-1,1844,2160,-316,0,-13,50
1,1581,1850,-269,-1,-10,53
-1,1488,1644,-156,2,89,56
-1,1444,1663,-219,-1,-240,98
1,1857,1653,204,1,111,83
1,1693,1717,-24,0,13,47
-1,1979,1549,430,0,37,64
-1,1750,1776,-26,0,-75,76
1,2164,1841,323,-9,-89,65
1,1435,1483,-48,-1,39,55
1,1333,1226,107,8,1057,111
1,1469,1377,92,-2,8,56
1,1634,1681,-47,1,78,63
-1,1624,1715,-91,0,10,60
-1,1517,1465,52,1,16,58
1,1768,1205,563,7,219,49
-1,1500,1429,71,0,14,51
-1,1571,1955,-384,-7,-413,80
1,1879,1962,-83,1,18,57
-1,1646,1698,-52,0,-8,112
-1,1357,1415,-58,-4,-209,106
1,1548,1658,-110,-3,12,43
1,1958,1642,316,2,149,91
1,1861,1637,224,4,92,49
1,1725,1467,258,1,170,93
1,1866,1794,72,2,28,45
0,1615,1653,-38,-2,-158,169
1,1784,1875,-91,0,45,89
-1,1216,1581,-365,0,52,70
1,1769,1470,299,3,400,68
-1,1647,1773,-126,-3,-103,60
1,1497,1319,178,0,93,73
1,1819,1626,193,0,9,61
1,1962,1472,490,0,133,67
-1,1612,1668,-56,1,-88,70
1,1423,1301,122,-1,-2,55
-1,1813,1849,-36,-1,-409,94
1,1875,1596,279,1,330,87
0,1946,1843,103,-3,-208,80
-1,1825,1621,204,-9,-388,92
-1,1575,1535,40,-2,-63,64
1,1729,1516,213,0,142,69
-1,1808,1919,-111,0,-1,50
-1,1538,1442,96,3,41,52
1,1705,1668,37,0,174,75
-1,1858,1803,55,5,440,126
-1,1655,1828,-173,-4,-313,80
1,1872,1954,-82,0,128,120
1,1643,1562,81,7,469,97
1,1588,1692,-104,-1,35,63
-1,1471,1500,-29,0,-74,62
-1,1807,2168,-361,0,-34,82
-1,1424,1347,77,-2,-16,44
1,1816,1846,-30,2,206,93
-1,1391,1358,33,-10,-475,80
1,1791,1410,381,1,51,41
-1,1734,1784,-50,-6,-171,50
-1,1835,1829,6,1,34,60
0,1804,2217,-413,1,285,148
-1,1367,1573,-206,0,-98,82
1,1784,1337,447,-5,38,52
1,2058,1707,351,-2,149,85
1,1509,1470,39,1,186,107
1,1794,1725,69,5,124,53
1,1841,1824,17,-9,148,109
1,1661,1463,198,-2,-133,81
-1,1628,1521,107,-5,-29,86
-1,1623,1583,40,-5,-316,70
1,1640,1743,-103,0,371,77
1,1592,1901,-309,-8,-51,45
0,1814,1852,-38,0,-139,131
1,2061,1943,118,0,107,101
0,1814,2201,-387,1,13,130
1,1851,1815,36,-6,89,136
1,1811,1708,103,0,1,41
-1,1496,1356,140,0,19,48
-1,1716,1803,-87,-1,-44,44
-1,1634,1638,-4,-1,-41,62
1,1596,1610,-14,-1,-239,81
1,1783,1609,174,2,426,90
1,1518,1338,180,-3,95,151
-1,1536,1613,-77,-2,-94,52
-1,1805,1861,-56,-4,-288,90
-1,1700,1819,-119,-4,-326,84
1,1458,1724,-266,4,135,55
1,1526,1254,272,5,191,61
1,1458,1311,147,1,-62,117
-1,1774,1506,268,2,-99,114
1,1553,1602,-49,0,-73,83
-1,1871,1796,75,-2,-753,118
1,2127,1659,468,0,29,61
-1,1164,1824,-660,-15,-611,54
0,1616,1663,-47,-2,-59,106
-1,1826,1693,133,3,179,64
-1,1415,1317,98,-6,-230,48
1,1809,1857,-48,-3,714,121
1,1470,1657,-187,6,257,63
-1,1293,1703,-410,1,18,58
-1,1482,1511,-29,-3,-145,74
1,1786,1717,69,4,497,133
-1,1622,1621,1,3,32,44
1,1767,1527,240,-1,-41,49
-1,1500,1662,-162,-2,-20,60
-1,1958,1816,142,1,-5,70
1,1641,1492,149,0,-1,103
1,1844,1821,23,2,137,57
1,1430,1585,-155,-1,43,64
-1,1343,1339,4,-3,-60,40
-1,1542,1418,124,3,44,70
-1,1407,1840,-433,-6,-325,60
1,1482,1502,-20,1,48,55
-1,1571,1945,-374,-3,-101,55
-1,1534,1416,118,-2,-143,86
-1,1538,1614,-76,0,-87,82
-1,1404,1386,18,2,33,66
1,1494,1667,-173,-4,-61,59
-1,1456,1492,-36,-1,-34,56
-1,1778,1567,211,-1,101,92
-1,1850,1962,-112,0,-26,92
-1,1840,1727,113,2,-109,56
1,1568,1528,40,3,179,57
1,1489,1110,379,-3,-95,43
1,1437,1459,-22,0,-146,71
-1,1547,1504,43,3,81,52
-1,1405,1348,57,0,-67,76
1,1908,1606,302,0,69,78
1,1511,1446,65,0,133,71
1,2101,1908,193,2,46,49
1,1528,1571,-43,-1,-42,52
-1,1611,1689,-78,-7,-49,42
1,1633,1571,62,1,70,55
1,1744,1779,-35,1,43,41
-1,1358,1459,-101,0,-209,84
-1,1104,1492,-388,-20,-610,54
-1,2010,1739,271,-2,-110,66
1,1563,1592,-29,-2,73,131
-1,1801,1590,211,2,70,138
0,1766,1756,10,-4,-35,121
1,1658,1720,-62,0,593,145
0,1518,1578,-60,0,-123,143
0,1601,1558,43,0,227,137
-1,1720,1797,-77,0,10,68
0,1554,1570,-16,-3,-423,140
1,1436,1528,-92,2,86,71
0,1897,1581,316,-6,-414,93
-1,1374,1567,-193,-1,-3,58
1,1756,1766,-10,4,374,73
0,1148,1209,-61,0,-943,248
1,1815,1440,375,1,38,45
1,1741,1661,80,1,215,77
1,1730,1389,341,1,133,73
-1,1566,1960,-394,0,-21,64
-1,1590,1868,-278,-3,-26,56
0,1751,1873,-122,0,59,97
1,1645,1562,83,2,48,43
1,1756,1766,-10,2,33,43
1,1503,1451,52,1,256,85
-1,1651,1511,140,-3,-281,93
1,1881,1585,296,0,39,51
1,1516,1524,-8,-2,-29,43
-1,1536,1743,-207,-3,-284,86
-1,1971,1843,128,-1,35,108
1,1705,1510,195,4,19,41
-1,1671,1370,301,-1,-32,66
-1,1563,1484,79,4,39,48
1,1470,1388,82,1,305,95
1,1785,1610,175,2,109,59
-1,1686,1893,-207,-2,-24,40
-1,1382,1361,21,0,-386,130
0,1441,1519,-78,1,25,151
1,1598,1538,60,-5,11,93
-1,1698,1602,96,0,-15,64
1,1513,1350,163,4,81,42
1,1714,1619,95,1,21,57
1,1654,1548,106,0,110,73
-1,1447,1576,-129,0,-121,50
-1,1656,1735,-79,0,-52,68
-1,1593,1493,100,-3,-45,45
-1,1490,1674,-184,-1,-179,54
1,2142,1837,305,0,-23,107
-1,1683,1737,-54,1,-28,68
1,1302,1453,-151,-2,-51,59
-1,1520,1622,-102,1,6,40
1,1594,1405,189,-5,-113,89
1,1317,1247,70,16,894,67
-1,1181,1304,-123,2,18,60
0,1656,1500,156,0,-172,115
-1,1499,1717,-218,0,-50,50
-1,1434,1397,37,-1,-329,102
1,1515,1443,72,2,61,57
1,1824,1575,249,4,101,61
1,1520,1392,128,2,-85,77
-1,1539,1521,18,-8,-487,106
1,1632,1310,322,10,441,79
1,1549,1491,58,-8,97,63
-1,1711,1570,141,0,-37,108
1,1583,1425,158,1,101,51
-1,1854,1921,-67,-3,-202,80
-1,1434,1529,-95,1,23,62
1,1929,1826,103,0,-28,109
-1,1577,1449,128,-3,-120,64
1,1773,1858,-85,-1,-49,60
-1,1552,1512,40,1,41,48
-1,1516,1839,-323,-1,-26,46
1,1746,1764,-18,0,39,84
-1,1630,1796,-166,-5,-26,48
-1,1563,1557,6,0,2,54
1,1607,1529,78,2,14,47
1,1949,1748,201,0,17,85
-1,1394,1366,28,1,169,78
1,1542,1425,117,-1,-38,61
-1,1312,1603,-291,-8,-87,40
1,1548,1438,110,-1,-14,43
-1,1192,1536,-344,-13,-652,58
-1,1754,1803,-49,0,2,46
-1,1338,1437,-99,0,-30,54
1,1685,1320,365,0,15,56
1,1768,1620,148,7,247,59
1,1645,1570,75,0,31,63
-1,1295,1190,105,-3,-322,111
-1,1540,1500,40,5,44,40
1,1750,1758,-8,0,68,66
0,1654,1659,-5,0,-170,224
1,1651,1340,311,-1,145,139
-1,1814,1745,69,-2,-73,64
-1,1527,1660,-133,-6,-331,66
-1,1527,1630,-103,0,-2,48
1,1385,1754,-369,-1,-55,75
1,1616,1520,96,-1,-10,43
1,1609,1740,-131,0,-101,101
-1,1524,1527,-3,1,-13,50
1,1284,1521,-237,0,815,179
-1,1560,1599,-39,-4,-521,100
1,1343,1308,35,2,161,65
1,1774,1506,268,1,40,55
-1,1551,1705,-154,-2,-90,52
-1,1686,1857,-171,0,11,46
-1,1502,1778,-276,-1,-14,48
-1,1636,1540,96,-1,-17,76
1,1748,1810,-62,-1,-267,131
0,1673,1941,-268,0,13,86
0,1782,1498,284,-2,-54,144
-1,1863,1680,183,0,-26,98
-1,1602,1577,25,9,543,100
1,1429,1313,116,0,41,73
1,1519,1616,-97,0,26,61
1,1803,1867,-64,-5,45,95
1,1808,1667,141,1,265,81
-1,1448,1541,-93,-3,-107,66
0,1479,1424,55,0,72,133
-1,1381,1486,-105,-1,-104,54
-1,1692,1568,124,-2,-288,78
-1,1145,1572,-427,0,-255,98
-1,1744,1600,144,-7,-20,49
-1,1654,1681,-27,-3,-77,60
1,1733,1405,328,4,343,87
1,1796,1589,207,-2,53,41
-1,1697,1756,-59,0,19,50
-1,1444,1250,194,-9,8,61
1,1583,1452,131,1,16,99
-1,1746,1430,316,-4,-4,40
1,1399,1602,-203,1,82,77
1,1801,1584,217,3,102,47
-1,1696,1847,-151,-1,-17,50
-1,1298,1193,105,0,-152,120
-1,1644,1653,-9,0,38,90
1,1501,1705,-204,-3,-6,49
-1,1712,1544,168,1,-156,96
1,1188,1430,-242,4,214,43
1,1570,1523,47,-11,-414,119
1,1716,1937,-221,-1,123,105
-1,1579,1807,-228,0,4,40
1,1548,1513,35,0,116,69
-1,1238,1378,-140,-11,-847,106
1,1912,1823,89,1,41,55
-1,1315,1628,-313,3,261,78
1,1743,1717,26,1,397,132
-1,1520,1549,-29,-11,-316,62
1,1743,1978,-235,-1,-12,115
1,1519,1655,-136,0,3,53
-1,1427,1689,-262,3,17,54
1,1533,1613,-80,-2,429,91
-1,1391,1656,-265,-2,-291,104
1,1556,1606,-50,0,22,99
-1,1831,1689,142,0,-96,108
0,1609,1727,-118,1,152,88
-1,1500,1402,98,-10,-557,90
1,1518,1613,-95,-3,-83,59
1,1632,1140,492,4,73,45
1,1646,1490,156,-1,6,43
1,1801,1394,407,11,290,49
-1,1497,1639,-142,2,35,45
1,1637,1594,43,-1,-6,43
1,1982,1737,245,-4,-87,137
1,1690,1713,-23,4,134,63
1,1423,1217,206,0,37,65
1,1290,1196,94,0,-58,47
0,1805,1920,-115,0,-265,205
-1,1644,1503,141,-8,-61,40
-1,1305,1448,-143,0,-467,94
-1,1585,1416,169,-2,-145,70
1,1207,1210,-3,-6,58,147
-1,1533,1634,-101,-2,2,62
-1,1547,1698,-151,-2,-526,88
1,1430,1429,1,-1,-35,65
1,1411,1269,142,-1,106,59
1,1558,1515,43,0,-30,77
1,1547,1547,0,6,68,43
1,1903,1679,224,0,56,55
-1,1842,1613,229,2,68,52
-1,1804,1491,313,-11,-541,78
1,1793,1782,11,0,81,107
-1,1601,1559,42,-4,-36,64
-1,1787,1961,-174,-1,-119,88
-1,1336,1654,-318,-3,-63,50
1,1593,1568,25,2,-3,47
-1,1577,1812,-235,0,-19,40
1,1728,1403,325,-2,-58,45
1,1933,1855,78,1,84,51
-1,1576,1517,59,1,-35,80
1,1280,1486,-206,-1,-9,45
1,1434,1500,-66,3,71,47
1,1808,1572,236,3,427,153
1,1418,1133,285,3,359,65
1,1559,1644,-85,-7,-279,65
-1,1701,1908,-207,1,2,51
-1,1414,1489,-75,-1,-54,66
-1,1688,1738,-50,-2,-86,74
1,1471,1248,223,-3,142,79
1,1352,1284,68,9,535,91
-1,1634,1666,-32,0,-5,71
1,1917,1813,104,0,99,65
-1,1468,1409,59,-3,-66,54
1,1356,1427,-71,1,116,65
-1,1493,1631,-138,1,118,112
1,1599,1853,-254,-1,-22,49
1,1564,1394,170,-4,387,145
1,1704,1610,94,-5,29,81
1,1505,1500,5,7,363,75
-1,1568,1737,-169,0,-114,76
-1,1923,1884,39,-1,-40,50
1,1580,1244,336,3,67,49
0,1977,1912,65,0,42,204
-1,1374,1500,-126,-2,-205,74
1,1813,1646,167,-1,0,67
-1,1443,1449,-6,1,48,64
-1,1846,1925,-79,-1,-88,72
1,1737,1692,45,-8,-311,67
1,1579,1432,147,0,514,81
-1,1512,1623,-111,0,-9,44
1,1498,1405,93,-1,32,69
-1,1216,1742,-526,-10,-147,64
-1,1636,1819,-183,0,373,106
1,1584,1386,198,-2,-39,57
-1,1618,1696,-78,-1,-131,84
-1,1214,1617,-403,-3,-261,80
1,1390,1301,89,4,305,91
-1,1679,2054,-375,-1,-309,128
1,1432,1518,-86,-1,-225,85
1,1422,1500,-78,0,189,63
-1,1265,1395,-130,1,157,88
1,1299,1490,-191,3,7,45
-1,1914,1894,20,0,-82,84
-1,1616,1688,-72,0,-16,106
1,1744,1385,359,0,8,49
-1,1590,1372,218,-12,-247,54
1,1387,1370,17,3,221,58
-1,1819,1712,107,-3,-63,58
1,1747,1518,229,0,130,115
-1,1530,1586,-56,-9,-163,49
1,1639,1682,-43,1,141,73
0,1759,1925,-166,0,28,70
1,1486,1277,209,1,64,55
-1,1613,1631,-18,-1,-96,66
1,1570,1177,393,-1,259,115
-1,1522,1513,9,-2,-58,62
1,1713,1652,61,-1,-1,47
0,1933,1838,95,-3,52,104
-1,1751,1500,251,-1,-270,90
1,1522,1346,176,1,124,81
1,1314,1498,-184,6,481,75
1,1361,1316,45,-2,126,97
1,1571,1335,236,-1,-8,47
1,1556,1427,129,3,284,81
1,1726,1805,-79,2,59,65
1,2084,2118,-34,0,-22,79
-1,1204,1621,-417,-4,-193,66
-1,1456,1289,167,-1,-45,60
-1,1652,1497,155,0,-60,73
1,1843,1507,336,-3,51,99
0,1713,1831,-118,0,-10,73
-1,1628,1825,-197,0,40,78
-1,1559,1680,-121,-1,-485,86
1,1836,1670,166,1,234,75
-1,1576,1391,185,-6,-166,48
-1,1709,1987,-278,-3,-420,110
-1,1425,1586,-161,1,24,74
1,1617,1492,125,1,477,105
1,1831,1620,211,-9,-335,59
1,1643,1722,-79,1,48,63
1,1509,1478,31,0,636,141
1,1752,1377,375,0,14,63
1,1636,1739,-103,0,136,165
1,1650,1913,-263,-1,-49,71
-1,1286,1330,-44,-3,-111,85
1,1559,1433,126,-1,-156,87
-1,2106,2116,-10,-3,-96,78
1,1500,1450,50,4,172,59
-1,1677,1740,-63,-4,-36,74
-1,1738,1710,28,-7,-662,119
1,1836,1613,223,-1,-42,55
1,1491,1489,2,3,210,67
-1,1820,1653,167,-1,-39,60
-1,1507,1626,-119,-2,-126,98
-1,1730,1788,-58,0,11,46
1,1431,1309,122,2,48,43
-1,1341,1559,-218,2,-391,130
1,1476,1348,128,8,91,43
-1,1606,1841,-235,0,-12,94
-1,1755,1664,91,0,-35,56
-1,1306,1439,-133,1,-480,112
1,1441,1652,-211,-4,-22,49
1,2046,1843,203,-2,-53,74
1,1658,1350,308,-2,33,47
1,1635,1572,63,8,284,61
-1,1566,1500,66,2,102,66
1,1545,1511,34,0,91,81
-1,1505,1446,59,0,-51,86
-1,1720,1658,62,-4,-139,82
-1,1461,1606,-145,-5,-172,58
1,1851,1593,258,-1,-33,55
1,1697,1668,29,1,493,143
-1,1729,1532,197,-2,-288,76
1,1803,1711,92,3,84,55
1,1677,1740,-63,7,58,41
0,1681,1749,-68,0,120,79
1,1452,1457,-5,0,-12,69
-1,1475,1625,-150,0,-21,64
0,1587,1855,-268,-1,98,118
-1,1881,1740,141,0,-21,96
0,2142,2095,47,0,1,100
-1,1384,1308,76,-1,0,54
1,1651,1301,350,-1,85,69
-1,1403,1465,-62,-1,-218,115
1,1772,1227,545,1,69,61
-1,1557,1563,-6,4,95,60
-1,1709,1656,53,0,-6,74
-1,1520,1521,-1,-12,-164,94
1,1687,1500,187,1,64,95
0,1504,1846,-342,-4,27,71
-1,1530,1603,-73,-9,-174,52
0,1317,1290,27,-1,-371,154
1,1841,1744,97,-1,63,141
1,1702,1713,-11,0,44,57
-1,1500,1918,-418,0,-2,58
-1,1185,1542,-357,-3,-232,90
-1,1591,1852,-261,3,48,68
-1,1837,2051,-214,-2,-55,54
-1,1561,1500,61,0,-9,62
-1,1705,1864,-159,-3,-278,92
-1,1615,1630,-15,-4,-235,90
1,1545,1574,-29,-6,-109,63
1,1691,1777,-86,-9,78,151
1,1678,1669,9,-6,-38,45
1,1599,1857,-258,0,-16,49
1,1774,1355,419,2,252,107
1,1722,1726,-4,1,308,101
1,1632,1459,173,-4,-128,63
-1,1407,1921,-514,0,-31,54
1,1659,1298,361,5,185,57
-1,1831,2057,-226,0,21,70
-1,1372,1418,-46,-3,-172,134
1,1837,1618,219,3,197,69
-1,1771,1562,209,-1,-9,40
1,1506,1455,51,2,366,93
1,1922,1406,516,4,103,47
-1,1558,1579,-21,-2,-193,66
1,1465,1515,-50,4,-5,71
1,1742,1756,-14,-6,-202,87
-1,1661,1574,87,-3,-135,70
-1,1404,1923,-519,-6,-44,48
-1,1662,1746,-84,-2,38,58
-1,1565,1457,108,3,90,42
1,1747,1706,41,0,66,65
-1,1295,1492,-197,1,-8,42
-1,1700,1500,200,-1,-109,76
-1,1630,1843,-213,0,14,64
1,1425,1589,-164,1,25,41
1,1925,1403,522,8,230,49
-1,1669,1696,-27,0,6,76
1,1754,1585,169,-3,-5,55
1,1803,1825,-22,-8,87,72
-1,1459,1492,-33,2,-142,86
1,1757,1379,378,0,1589,167
-1,1919,2106,-187,0,-90,126
1,1811,1122,689,0,-23,47
1,1848,1574,274,5,18,41
1,1445,1395,50,-4,-118,63
-1,1692,1549,143,1,-80,102
-1,1402,1926,-524,0,-179,102
1,1509,1488,21,-9,-106,45
-1,1852,1570,282,-1,-115,58
-1,1152,1329,-177,-11,-424,64
1,1804,1689,115,1,34,55
-1,1393,1332,61,-8,-190,54
1,1833,1588,245,6,41,45
-1,1312,1577,-265,1,-11,56
0,1658,1721,-63,-1,-411,130
-1,1572,1442,130,-1,-118,54
1,1837,1584,253,-3,199,134
1,1550,1500,50,5,66,47
-1,1757,1615,142,0,26,64
1,1776,1755,21,0,88,89
1,2098,1849,249,0,437,155
-1,1400,1928,-528,-6,-136,46
1,1682,1477,205,5,304,89
-1,1761,1685,76,-5,-72,68
1,1842,1579,263,5,253,56
1,1520,1432,88,6,66,47
1,1724,1353,371,4,154,85
1,1588,1647,-59,0,259,93
1,1468,1512,-44,8,224,47
1,1846,1575,271,-7,-16,41
1,1812,1816,-4,5,160,55
-1,1655,1698,-43,-8,-656,104
1,1652,1460,192,12,193,43
1,1302,1601,-299,4,66,51
1,1840,1348,492,1,131,67
-1,1580,1784,-204,-7,-246,62
1,1851,1571,280,-1,364,65
-1,1696,2062,-366,-4,-302,74
1,1513,1527,-14,0,303,95
-1,1481,1375,106,-5,-119,66
0,1714,1661,53,-3,494,150
1,1688,1895,-207,0,-46,115
1,1822,1726,96,-1,327,151
1,1557,1513,44,0,175,115
-1,1745,1789,-44,0,-56,74
1,1716,1741,-25,2,38,45
-1,1330,1556,-226,-1,45,58
1,1525,1698,-173,-3,4,45
-1,1545,1488,57,-1,-193,83
1,1583,1570,13,-1,-6,43
1,1472,1320,152,1,67,61
-1,1343,1621,-278,2,-29,88
-1,1509,1530,-21,1,-80,114
0,1950,1859,91,3,461,152
-1,1844,2102,-258,-1,-111,84
1,1742,1735,7,1,53,73
-1,1284,1373,-89,-6,-586,68
1,1804,1825,-21,2,95,61
-1,1745,1913,-168,-10,-185,76
-1,1377,1540,-163,-10,-724,90
1,1528,1521,7,-2,-58,43
-1,1658,1912,-254,-3,-221,90
1,1567,1583,-16,8,137,51
-1,1862,1947,-85,-12,-187,82
1,1581,1571,10,2,86,53
-1,1362,1567,-205,-1,-455,108
-1,1684,1578,106,-2,-29,42
1,1640,1604,36,0,-11,43
-1,1702,1726,-24,0,-599,130
-1,1205,1257,-52,0,152,66
-1,1342,1638,-296,-3,-585,104
-1,1304,1503,-199,-3,-255,74
1,1919,1730,189,-1,-12,45
-1,1662,1536,126,-6,-190,70
1,1463,1300,163,-4,-351,83
-1,1470,1558,-88,-5,-110,51
-1,1821,1763,58,-1,-52,74
1,2107,1840,267,9,336,61
1,1812,1816,-4,-2,-40,87
1,1393,1361,32,1,393,119
1,1541,1489,52,-2,-43,53
-1,2069,2065,4,-1,-150,84
1,1550,1245,305,0,146,71
1,1669,1397,272,0,50,59
0,1659,1653,6,2,63,53
-1,1526,1430,96,1,-97,64
1,1685,1564,121,7,218,59
1,1679,1737,-58,0,170,83
-1,1465,1729,-264,-9,-325,66
-1,1621,1562,59,0,-1,49
0,1783,1767,16,1,1,138
1,1473,1464,9,1,43,65
-1,1723,1576,147,1,98,74
-1,1647,1846,-199,0,-235,118
-1,1818,1981,-163,-2,-30,54
1,1482,1215,267,0,38,81
-1,1850,1609,241,-1,-371,140
-1,1604,1500,104,-1,-113,178
1,1455,1500,-45,0,-14,85
-1,1715,1864,-149,-3,-182,74
1,1557,1693,-136,-2,-45,107
-1,1617,1551,66,-3,-160,106
1,1818,1943,-125,0,4,70
-1,1707,1591,116,-2,-303,94
1,1664,1629,35,1,245,89
1,1560,1490,70,0,8,121
1,1557,1587,-30,-1,2,85
-1,1438,1476,-38,-10,-631,90
-1,1828,1966,-138,0,-20,78
-1,1657,1592,65,0,-103,88
1,1632,1816,-184,0,51,98
-1,1575,1746,-171,0,-64,88
1,1676,1578,98,0,176,91
-1,1846,1821,25,-1,-51,108
1,1705,2179,-474,0,8,71
-1,1408,1527,-119,-3,-54,62
-1,1621,1733,-112,0,-47,126
1,1585,1470,115,6,301,75
1,1693,1691,2,0,42,47
1,1348,1426,-78,15,561,71
1,1522,1441,81,2,15,43
-1,1260,1509,-249,1,98,100
1,1468,1422,46,-2,-23,45
-1,1704,1605,99,2,-34,54
1,1569,1481,88,0,5,53
1,1412,1219,193,8,302,68
1,1500,1686,-186,-1,-15,55
1,1206,1486,-280,-1,104,97
1,1811,1875,-64,-1,235,161
-1,1493,1484,9,-1,-12,42
1,1500,1753,-253,0,-23,57
1,1832,1834,-2,0,45,73
-1,1377,1685,-308,-2,-328,83
1,1646,1572,74,8,291,71
-1,1690,1676,14,-1,-257,106
-1,1303,1843,-540,-6,-96,48
-1,1917,2037,-120,-5,-59,52
1,1704,1512,192,4,177,65
1,1361,1383,-22,-4,-68,71
-1,1793,1544,249,-2,-42,44
1,1646,1708,-62,1,95,109
1,1825,1760,65,-2,15,41
1,1581,1354,227,6,225,57
1,1563,1462,101,0,509,147
1,1921,1482,439,3,262,69
1,1686,1400,286,5,87,41
-1,1767,1783,-16,-1,28,70
1,1835,1751,84,5,57,41
1,1740,1563,177,2,269,115
-1,1692,1822,-130,0,3,58
1,1453,1533,-80,0,66,150
-1,1678,1688,-10,-7,-560,100
-1,1287,1514,-227,-1,0,42
1,1563,1654,-91,1,726,165
-1,1773,1871,-98,-3,-5,42
-1,1504,1845,-341,-2,-149,84
1,1843,2080,-237,1,7,45
-1,1844,1912,-68,-3,8,46
-1,1500,1448,52,0,-235,98
1,1880,1479,401,2,211,89
1,1490,1603,-113,1,59,51
-1,1484,1428,56,-2,-201,64
1,1991,1766,225,-1,-27,55
-1,1575,1569,6,-6,-122,47
1,1535,1428,107,-3,-27,41
-1,1590,1313,277,-6,-621,90
1,1477,1570,-93,4,771,123
1,1674,1500,174,-2,2,53
1,1449,1348,101,7,193,55
-1,1664,1889,-225,-3,-290,102
1,1593,1569,24,2,-84,97
-1,1772,1854,-82,-4,-33,40
1,1668,1699,-31,1,148,87
-1,1557,1848,-291,-19,-497,50
-1,1519,1437,82,-3,-188,68
-1,1557,1747,-190,0,-39,109
-1,1520,1662,-142,-7,-354,92
-1,1794,1756,38,0,-36,81
1,1691,1641,50,-3,33,57
-1,1451,1454,-3,1,46,70
1,1650,1707,-57,-1,11,57
-1,1726,1686,40,2,50,56
1,1830,1996,-166,1,42,67
-1,1620,1540,80,-3,-28,56
1,1720,1761,-41,3,48,47
-1,1814,1737,77,0,-105,74
1,1442,1355,87,-1,-5,45
1,1680,1699,-19,-1,24,91
1,1852,1553,299,1,272,115
-1,1631,1577,54,0,-20,55
-1,1405,1602,-197,-1,-9,52
-1,1531,1500,31,-4,-18,52
1,1879,1880,-1,-1,92,81
-1,1802,1491,311,-6,-729,98
1,1247,1399,-152,2,56,49
-1,1866,1910,-44,-1,-130,90
-1,1669,1513,156,0,-84,86
-1,1504,1654,-150,0,-90,90
-1,1411,1419,-8,0,-28,50
1,1347,1451,-104,-8,-107,43
1,1833,1895,-62,-4,-23,42
-1,1590,1618,-28,-2,-94,72
-1,1677,1754,-77,0,-477,212
-1,1687,2150,-463,-2,-100,92
-1,1477,1893,-416,-2,-17,48
1,1454,1283,171,15,342,49
-1,1296,1542,-246,-4,-1262,120
-1,1485,1653,-168,-1,-70,64
-1,1259,1536,-277,-8,-221,48
-1,1583,1571,12,0,-11,64
1,1880,1845,35,-6,-253,63
1,1649,1705,-56,0,58,99
1,1965,1733,232,-4,26,61
1,1385,1500,-115,8,130,47
-1,1435,1361,74,0,-27,50
-1,1549,1856,-307,-1,-330,96
-1,1691,1685,6,0,-62,102
1,1658,1547,111,1,198,97
1,1789,1507,282,12,212,49
-1,1338,1383,-45,0,-402,128
-1,1769,1781,-12,-5,-8,86
-1,1529,1653,-124,0,-319,114
-1,1669,1500,169,1,12,88
0,1491,1384,107,-1,27,121
-1,1523,1608,-85,1,338,106
1,1839,1987,-148,0,-13,103
1,1464,1440,24,7,322,75
-1,1552,1644,-92,-5,-142,52
-1,1375,1420,-45,-5,-5,41
1,1365,1228,137,9,747,137
-1,1725,1628,97,-6,-188,58
1,1513,1436,77,7,654,109
-1,942,1901,-959,-8,-354,60
1,1852,1580,272,0,-5,65
-1,1460,1829,-369,-2,-311,66
1,1661,1497,164,8,667,103
1,1549,1254,295,7,607,81
1,1842,1595,247,1,64,75
1,2152,1749,403,-3,1,47
-1,1479,1659,-180,-2,-18,46
1,1703,1480,223,0,39,93
1,1690,1414,276,0,42,99
1,1780,1532,248,-1,457,109
1,1984,1840,144,-1,-48,55
-1,1680,1922,-242,-3,-97,60
-1,1665,1500,165,-1,-15,54
-1,1400,1453,-53,-3,-107,72
-1,1329,1432,-103,-3,-118,56
0,1843,1778,65,-2,-91,108
1,1631,1500,131,2,228,53
0,1373,1370,3,0,16,136
-1,1576,1856,-280,-1,-154,118
1,1521,1661,-140,0,1,53
1,1711,1643,68,-1,-209,83
0,1254,1614,-360,1,-48,119
1,1291,1506,-215,1,94,113
0,1855,1788,67,-1,-51,116
1,1473,1532,-59,2,120,77
0,1381,1694,-313,-3,4,84
1,1680,1696,-16,-4,-34,43
-1,1792,1757,35,-4,-162,66
1,1859,1919,-60,-2,0,41
1,1444,1436,8,2,16,41
1,1667,1432,235,3,123,101
1,1599,1387,212,1,283,139
-1,1793,1891,-98,-3,-228,92
1,1532,1548,-16,0,301,129
-1,1676,1926,-250,-1,-8,52
-1,1780,1838,-58,-11,-133,40
-1,1473,1596,-123,0,19,82
-1,1664,1728,-64,-8,-632,102
-1,1794,1693,101,0,-543,112
-1,1579,1848,-269,0,-10,76
-1,1503,1568,-65,0,-102,82
1,1713,1500,213,0,457,119
-1,1490,1667,-177,-2,-338,76
1,1423,1452,-29,5,213,71
-1,1971,1664,307,0,56,80
-1,1529,1653,-124,-3,-181,72
-1,1742,1931,-189,-4,-119,54
-1,1638,1978,-340,-2,-61,50
1,1863,1770,93,-1,-2,47
-1,1427,2085,-658,-5,-478,126
1,1781,1708,73,0,745,153
1,1506,1547,-41,0,4,45
-1,1403,1483,-80,-4,-11,90
1,1770,1779,-9,2,135,73
1,1326,1608,-282,4,195,77
1,1634,1720,-86,1,162,119
1,1783,1494,289,1,-7,73
-1,1677,1654,23,1,31,58
1,1663,1734,-71,-3,-49,59
-1,1474,1475,-1,0,12,58
-1,1874,2077,-203,0,-114,88
0,1693,1800,-107,-2,-234,131
-1,1725,1948,-223,-2,-336,92
-1,2095,1834,261,-5,-133,52
1,1269,1556,-287,-4,85,91
-1,1839,1789,50,0,-50,66
1,1466,1441,25,-9,448,93
1,1658,1440,218,0,37,57
-1,1479,1427,52,-8,-186,62
-1,1920,1953,-33,-1,-17,74
0,1374,1427,-53,0,-432,114
-1,1410,1694,-284,-2,-125,102
1,1972,1855,117,0,6,55
-1,1500,1671,-171,1,-204,110
-1,1479,1759,-280,-1,-52,51
-1,1455,1441,14,-3,-29,58
-1,1331,1709,-378,-1,-233,98
1,1673,1484,189,5,492,93
1,1610,1640,-30,0,25,87
1,1899,1830,69,1,151,73
-1,1801,2086,-285,-5,-132,74
1,1656,1437,219,0,217,143
-1,1463,1556,-93,4,-163,62
-1,1247,1382,-135,3,65,81
-1,1889,1906,-17,0,48,56
-1,1626,1779,-153,-2,-316,96
1,1868,2075,-207,-1,13,95
0,1737,1854,-117,1,25,86
-1,1729,1683,46,-2,-69,66
1,1706,1648,58,2,41,41
1,1292,1564,-272,2,27,45
1,1558,1629,-71,-1,115,91
1,1389,1622,-233,-9,15,129
-1,1662,1687,-25,-7,-499,118
1,1712,1328,384,6,147,59
-1,1979,1847,132,3,102,62
-1,1788,1751,37,0,-218,192
-1,1798,1950,-152,-4,-131,60
1,2083,1869,214,4,115,49
1,1371,1216,155,-2,-48,81
-1,1666,1686,-20,-1,-70,125
-1,1488,1697,-209,-4,-67,48
1,1622,1571,51,-1,-182,105
1,1791,1720,71,3,39,45
1,1491,1795,-304,-2,-113,91
1,1948,1787,161,1,-20,85
1,1596,1387,209,4,207,83
1,1845,1673,172,11,356,47
1,1495,1622,-127,-1,119,87
1,1347,1429,-82,1,203,113
1,1531,1782,-251,0,15,51
-1,1836,1878,-42,0,-36,92
-1,1478,1425,53,-1,-24,44
-1,1917,1852,65,-1,-157,88
1,1775,1620,155,6,117,58
-1,1588,1750,-162,0,18,42
1,1711,1800,-89,2,352,129
-1,1543,1694,-151,-3,-163,66
1,1476,1221,255,0,-29,65
1,1699,1336,363,1,44,53
-1,1796,1922,-126,-1,10,62
-1,1454,1494,-40,-12,-707,75
-1,1375,1509,-134,0,13,52
-1,1908,1850,58,-4,-320,116
1,1677,1891,-214,-6,15,41
0,1772,1834,-62,0,6,89
-1,1544,1876,-332,0,-154,158
1,1427,1558,-131,-1,-10,55
1,1677,1825,-148,1,125,69
-1,1490,1420,70,-1,-135,76
1,1632,1431,201,0,5,61
1,1930,1786,144,-4,-30,63
1,1724,1095,629,1,321,75
-1,1440,1522,-82,-6,-107,64
-1,1293,1418,-125,1,-25,58
1,1708,1588,120,0,43,47
1,1648,1474,174,1,39,55
1,1888,1638,250,0,-1,109
-1,1547,1438,109,-4,-71,52
1,1788,1773,15,0,9,41
1,1481,1381,100,2,87,49
1,1780,1936,-156,1,92,77
1,1695,1387,308,1,8,59
1,1518,1444,74,-3,715,151
1,1781,1619,162,7,83,43
-1,1679,1741,-62,0,12,88
1,1367,1203,164,4,10,75
1,1724,1799,-75,2,513,109
1,1425,1638,-213,3,487,93
-1,1921,1795,126,9,259,66
-1,1384,1378,6,3,27,126
1,1852,1633,219,1,197,131
-1,1634,1893,-259,0,16,96
-1,1500,1500,0,-5,-128,50
0,1441,1429,12,-2,-43,118
-1,1445,1516,-71,1,-117,84
-1,1489,1251,238,0,-4,52
1,1434,1528,-94,-3,6,61
-1,1810,1906,-96,-8,-139,46
-1,1444,1570,-126,1,17,44
1,1715,1513,202,1,29,53
1,1780,1492,288,8,209,59
1,1620,1444,176,-4,-70,63
1,2090,1914,176,3,232,63
-1,1718,1957,-239,0,-60,86
1,1693,1352,341,2,238,73
-1,1305,1739,-434,-3,-240,58
-1,1468,1654,-186,-1,-15,64
1,1664,1520,144,-3,31,71
0,1450,1500,-50,3,482,139
-1,1436,1623,-187,0,18,48
-1,1908,2096,-188,0,-40,60
-1,1788,1696,92,-1,-65,62
1,1360,1607,-247,0,420,129
-1,2009,1813,196,2,-149,76
1,1434,1621,-187,1,89,73
-1,1563,1488,75,-2,-34,82
1,1774,1832,-58,0,-125,129
1,1671,1529,142,6,260,58
-1,1437,1626,-189,-1,-37,54
1,1898,1629,269,0,-9,91
1,1837,1903,-66,1,317,151
1,1607,1510,97,3,118,55
-1,1336,1540,-204,-2,-196,130
0,1485,1044,441,6,993,226
1,1476,1338,138,0,151,99
-1,1485,1450,35,2,-53,106
-1,1525,1436,89,1,34,54
-1,1902,1826,76,0,-110,98
1,1715,1500,215,4,96,45
1,1665,1488,177,1,36,47
1,1632,1605,27,0,-1,61
-1,1529,1564,-35,3,67,82
1,1625,1902,-277,-1,46,109
-1,1300,1359,-59,2,-280,94
-1,1840,1899,-59,0,-4,46
1,2192,2068,124,0,-28,79
-1,1513,1518,-5,1,5,121
1,1696,1653,43,3,75,49
1,1594,1643,-49,0,-71,159
1,1475,1500,-25,4,449,87
-1,1504,1636,-132,-4,-25,43
-1,1785,2155,-370,-1,-150,92
-1,1831,1908,-77,1,-16,52
1,1349,1461,-112,-1,-85,59
-1,1571,1612,-41,-1,-59,111
1,1660,1463,197,4,156,61
-1,1566,1433,133,-3,-216,90
1,1822,1917,-95,7,155,47
1,1750,1871,-121,-2,56,46
-1,1345,1604,-259,0,25,62
-1,1584,1597,-13,0,-66,76
1,2158,1783,375,0,47,65
-1,1244,1350,-106,-7,-242,68
-1,1677,1769,-92,-1,-14,44
1,1498,1670,-172,2,307,135
-1,1836,1903,-67,0,-253,140
-1,1341,1453,-112,-3,-99,66
1,1882,1644,238,-3,-55,49
-1,1436,1544,-108,0,-10,70
-1,1678,1577,101,1,0,70
1,1439,1386,53,0,-35,102
-1,1630,1607,23,0,-29,54
-1,1322,1436,-114,-2,-512,96
-1,1209,1328,-119,1,-2,40
-1,1640,1887,-247,0,-100,100
-1,1780,1765,15,-1,-38,66
1,1483,1464,19,1,94,65
-1,1734,1594,140,0,-45,48
-1,1059,1474,-415,0,-169,62
1,1706,1500,206,2,284,69
-1,1906,1833,73,2,119,61
0,1368,1290,78,10,1443,133
-1,1619,1618,1,0,-121,108
-1,1501,1498,3,0,1,42
0,1777,1668,109,5,219,81
-1,1500,1502,-2,2,54,86
1,1776,1787,-11,-2,118,119
1,1477,1138,339,6,372,67
1,1797,1553,244,2,71,79
0,1846,1894,-48,-5,-315,120
-1,1645,1683,-38,1,-1,40
-1,1510,1500,10,-4,-245,66
1,1801,1676,125,0,10,101
-1,1633,1612,21,-3,-69,44
1,1830,1991,-161,0,5,55
0,1892,1635,257,1,310,196
1,1475,1473,2,-2,-17,53
-1,1531,1407,124,0,-229,118
1,1725,1680,45,7,220,87
1,1901,1838,63,7,287,49
-1,1458,1666,-208,-8,-106,48
1,1629,1693,-64,-12,-371,97
1,1447,1364,83,2,274,109
-1,1508,1500,8,0,9,54
1,1918,1820,98,0,31,67
-1,1585,1625,-40,1,21,56
1,1858,1774,84,5,198,59
1,1579,1502,77,-3,-164,89
-1,1812,1926,-114,3,10,42
-1,1540,1880,-340,-7,-106,68
1,1389,1561,-172,0,5,47
1,1672,1774,-102,-1,-61,105
-1,1761,1829,-68,0,-405,144
1,1805,1933,-128,-3,-139,53
-1,1416,1430,-14,-11,-486,62
-1,1473,1610,-137,0,22,72
1,1861,1621,240,1,6,51
1,1512,1590,-78,3,74,57
1,1680,1642,38,0,-2,43
-1,1495,1608,-113,0,-180,94
-1,1777,1914,-137,0,136,84
-1,1521,1462,59,1,28,48
-1,1820,1919,-99,1,16,46
1,1698,1509,189,-2,38,78
1,1576,1527,49,-1,156,59
-1,1710,1952,-242,0,-332,116
-1,1812,1927,-115,-8,10,42
-1,1632,1690,-58,-3,-304,92
-1,1642,1884,-242,0,35,68
1,2073,1878,195,1,78,60
-1,1517,1586,-69,-3,-53,42
-1,1407,1500,-93,0,-34,52
1,1116,1490,-374,0,-36,109
1,1720,1646,74,3,57,50
1,1372,1198,174,-4,-79,55
-1,1648,1784,-136,-1,-153,114
-1,1507,1401,106,4,154,50
1,1327,1270,57,-2,-59,71
1,1934,1616,318,-5,247,95
1,1655,1547,108,5,58,49
-1,1494,1331,163,0,-31,90
-1,1487,1500,-13,2,-74,78
-1,1255,1574,-319,-8,-246,54
1,1511,1563,-52,-1,693,131
-1,1489,1384,105,-7,-6,40
1,1889,1637,252,5,290,97
1,1205,1261,-56,8,253,57
1,1699,1623,76,2,389,91
-1,1411,1367,44,-2,-1,48
-1,1325,1611,-286,3,-148,68
-1,1616,1699,-83,1,3,42
-1,1613,1937,-324,0,-6,82
-1,1328,1514,-186,5,218,62
1,1395,1434,-39,-2,75,57
-1,1845,1975,-130,1,59,54
1,1778,1905,-127,1,21,49
-1,1475,1304,171,0,3,62
-1,1706,1919,-213,-2,-343,82
1,1500,1441,59,5,531,97
-1,1756,1882,-126,-8,-170,42
0,1614,1708,-94,-1,-457,104
1,1759,1687,72,1,67,107
-1,1868,2078,-210,-1,-120,76
1,1874,1652,222,1,159,127
-1,1252,1577,-325,0,-119,63
1,1708,1608,100,2,45,59
-1,1398,1541,-143,3,47,58
0,1705,1602,103,-1,-28,129
1,1544,1559,-15,0,283,117
-1,1284,1318,-34,-2,-418,86
-1,1479,1609,-130,-1,-15,54
-1,1649,1641,8,-1,-241,136
-1,1705,1617,88,1,267,122
1,1770,1923,-153,1,104,67
0,1809,1769,40,-1,34,132
-1,1031,1197,-166,-12,-928,84
1,1751,1689,62,0,107,107
1,1400,1500,-100,0,376,75
1,1475,1405,70,-3,-1,103
1,1647,1879,-232,-1,44,95
-1,1644,1726,-82,0,10,44
1,1413,1381,32,0,32,57
-1,1434,1399,35,-3,-27,44
-1,1223,1238,-15,3,19,58
0,1472,1402,70,0,-1045,141
1,1440,1417,23,1,36,77
1,1396,1432,-36,3,111,74
1,1520,1373,147,13,481,53
1,1558,1493,65,-1,-1,56
1,1206,1604,-398,5,670,89
1,1460,1629,-169,5,358,77
1,1868,1219,649,-2,-46,63
-1,1551,1716,-165,0,-49,104
-1,1631,1691,-60,-3,-66,64
1,1748,1838,-90,-1,-45,69
1,1543,1777,-234,0,21,57
1,2084,1860,224,2,34,53
1,1341,1463,-122,-1,39,63
1,2134,1862,272,0,9,49
1,1760,1801,-41,3,38,49
1,1816,1539,277,9,487,73
-1,1629,1728,-99,-3,-151,56
1,1715,1746,-31,2,18,42
-1,1468,1349,119,-11,-132,42
-1,1310,1405,-95,-4,-405,94
-1,1634,1735,-101,0,-114,100
1,1666,1695,-29,0,15,63
-1,1329,1712,-383,-1,-209,64
-1,1583,1661,-78,-2,-451,90
-1,1727,1802,-75,0,-48,76
1,1547,1717,-170,14,468,57
1,1412,1473,-61,2,73,61
-1,1499,1500,-1,-7,-183,54
1,1418,1435,-17,4,156,49
1,1450,1547,-97,10,333,45
1,1621,1486,135,1,90,93
1,1560,1568,-8,3,476,111
1,1831,1660,171,-3,-377,99
1,1615,1786,-171,0,-78,95
1,1518,1270,248,-3,-88,53
1,1626,1571,55,-2,58,65
0,1346,1364,-18,1,449,135
1,1656,1209,447,3,289,61
1,1592,1414,178,13,411,51
1,1423,1595,-172,-2,-199,67
-1,1365,1457,-92,-3,26,84
-1,1325,1189,136,-1,-179,148
1,1854,1838,16,0,220,87
1,1745,1743,2,2,51,63
-1,1741,1532,209,1,6,76
-1,1775,1734,41,0,-182,110
1,1523,1486,37,5,13,93
1,1593,1512,81,3,184,69
-1,1705,1486,219,0,-147,92
-1,1560,1635,-75,-1,-87,96
1,1640,1842,-202,0,374,139
1,1704,1551,153,-1,-16,59
0,1719,1330,389,-4,-91,105
-1,1369,1452,-83,-1,-438,98
-1,1389,1431,-42,4,-20,90
1,1570,1427,143,1,72,53
-1,1791,1757,34,1,-16,62
1,1679,1393,286,4,169,63
1,1817,1732,85,0,60,113
1,1546,1694,-148,-1,-1,51
-1,1605,1522,83,-7,-253,68
-1,1547,1262,285,-2,-445,112
-1,1265,1392,-127,0,-56,62
1,1644,1550,94,0,15,105
-1,1349,1311,38,-2,-319,64
-1,1576,1617,-41,-2,-415,94
-1,1657,1635,22,-4,-87,56
-1,1308,1415,-107,-8,-332,71
-1,1549,1723,-174,0,1,48
1,1438,1454,-16,-8,-224,57
1,1527,1502,25,0,242,111
-1,1496,1497,-1,0,-52,80
-1,1770,1779,-9,1,-435,134
1,1062,1265,-203,9,716,87
-1,1354,1425,-71,0,12,42
-1,1470,1824,-354,-4,-191,86
1,1911,1657,254,9,219,53
-1,1359,1710,-351,-1,-32,78
1,1712,1250,462,13,744,63
1,1408,1489,-81,0,78,53
-1,1436,1533,-97,-8,-107,42
1,1568,1468,100,-6,60,89
1,1724,1500,224,0,41,79
-1,1207,1334,-127,0,-8,90
1,1951,1711,240,1,110,75
1,1591,1416,175,0,25,65
-1,1652,1826,-174,-1,-44,68
1,1413,1483,-70,-3,303,101
-1,1577,1500,77,1,-31,72
0,1731,1762,-31,-5,-99,115
-1,1478,1500,-22,-2,-75,62
-1,1089,1325,-236,-3,-79,44
-1,1194,1460,-266,-12,-183,42
-1,1500,1911,-411,1,-185,100
-1,1447,1408,39,1,10,44
-1,1576,1728,-152,-2,-502,92
-1,1442,1321,121,2,33,46
1,1646,1540,106,0,13,101
-1,1512,1571,-59,-5,-57,49
1,1772,1777,-5,-3,-48,53
0,2137,2091,46,1,-5,102
0,1476,1298,178,0,-125,123
-1,1726,1851,-125,0,-145,90
-1,1832,1476,356,0,24,70
1,1585,1614,-29,-5,42,105
1,1472,1532,-60,-3,89,55
1,1432,1402,30,0,55,57
-1,1653,1713,-60,1,46,74
-1,1503,1901,-398,1,-22,54
1,1916,1678,238,-5,-44,45
1,1766,1783,-17,1,128,97
1,1620,1458,162,7,176,45
1,1536,1139,397,-1,4,57
1,2136,1547,589,4,519,63
1,1529,1344,185,2,288,79
-1,1654,1813,-159,1,49,72
-1,1706,1326,380,0,-321,126
1,1569,1424,145,-1,-135,103
1,1735,1553,182,0,159,65
-1,1327,1430,-103,-2,-457,84
1,1674,1736,-62,0,10,93
-1,1951,2137,-186,0,-18,76
-1,1519,1544,-25,1,-125,94
-1,1396,1749,-353,-8,-91,50
1,1731,1652,79,-3,402,163
-1,1075,1288,-213,-7,-97,48
1,1560,1561,-1,-1,178,60
-1,1622,1506,116,2,-357,106
1,1449,1729,-280,4,201,61
-1,1707,1718,-11,0,-162,104
-1,1909,1775,134,-1,21,46
-1,1723,1644,79,0,-60,114
-1,1509,1578,-69,-6,-74,46
1,1435,1533,-98,-4,156,77
-1,1648,1560,88,-1,-177,118
1,1759,2011,-252,-4,-417,141
-1,1198,1465,-267,-1,-174,84
-1,1703,1776,-73,-7,-328,68
-1,1642,1605,37,-10,-72,42
-1,1470,1483,-13,-2,-293,134
-1,1790,1886,-96,-1,-29,58
-1,1576,1741,-165,0,-525,182
1,2178,2117,61,-1,-82,95
1,1538,1540,-2,0,-11,69
-1,2110,2080,30,-1,-8,78
1,2156,1629,527,-1,56,75
1,1904,1804,100,7,259,65
-1,1828,1865,-37,1,-125,114
-1,1067,1328,-261,-2,-19,44
1,1898,1782,116,2,306,87
-1,1785,1664,121,-6,-48,42
-1,1535,1429,106,1,-10,62
-1,1500,1639,-139,0,-6,40
-1,1663,1636,27,-1,4,68
-1,1394,1352,42,0,-5,72
1,1628,1820,-192,0,36,61
-1,1678,1770,-92,-5,-581,118
1,1632,1613,19,0,42,45
1,1945,1654,291,0,0,53
-1,1467,1332,135,0,13,56
1,1709,1650,59,1,62,135
-1,1774,1909,-135,-5,-130,58
-1,1793,1912,-119,1,23,56
-1,1662,1710,-48,0,16,56
1,1392,1442,-50,0,183,93
1,1550,1423,127,-2,-38,63
1,1585,1647,-62,1,133,67
-1,1435,1747,-312,1,14,48
1,1463,1220,243,4,134,67
-1,1380,1759,-379,-10,-161,42
0,1660,1450,210,2,277,133
-1,1778,1670,108,-1,31,64
-1,1449,1520,-71,-7,-219,54
1,1919,1767,152,-3,-44,57
1,1536,1595,-59,15,603,61
-1,1782,2106,-324,0,-172,144
-1,1647,1572,75,0,-1,52
1,1726,1500,226,1,62,75
1,1739,1636,103,3,784,103
-1,1529,1627,-98,0,-2,52
1,1248,1373,-125,-1,-68,85
1,1657,1518,139,0,22,43
0,1732,2095,-363,0,3,175
-1,1279,1389,-110,0,-281,102
1,1194,1120,74,5,195,65
-1,1428,1750,-322,0,57,92
1,1364,1323,41,-5,-27,47
-1,1633,1608,25,0,-7,104
-1,1632,1929,-297,0,-35,66
1,1735,1195,540,7,250,53
-1,1267,1875,-608,-3,-603,106
-1,1521,1779,-258,0,-8,58
1,1590,1617,-27,-2,120,83
-1,1440,1528,-88,-3,-110,54
-1,1421,1358,63,-7,-118,42
1,1957,1653,304,0,60,107
-1,1933,1628,305,0,-232,76
1,1696,1905,-209,-1,38,85
1,1783,1516,267,1,287,131
-1,1761,1952,-191,0,-11,76
-1,1556,1680,-124,-3,-83,66
1,1684,1592,92,0,54,59
-1,1639,1709,-70,-6,-186,58
1,1069,1203,-134,2,62,45
-1,1534,1385,149,-4,-439,160
-1,1636,1649,-13,0,-145,114
-1,1356,1641,-285,-10,-63,40
-1,1719,1937,-218,-1,-41,48
1,1621,1620,1,1,29,91
-1,1196,1307,-111,-17,-593,64
-1,1711,1907,-196,-11,-637,76
1,1647,1572,75,1,60,51
1,1860,1719,141,3,85,53
1,1915,1697,218,2,61,49
-1,1737,1740,-3,0,-56,120
-1,1303,1322,-19,0,-534,123
1,1689,1900,-211,1,-167,93
1,1465,1521,-56,1,4,45
1,1755,1680,75,4,120,53
-1,1685,1922,-237,-10,-91,46
0,1187,1144,43,11,469,105
-1,1381,1597,-216,-1,-16,40
1,1807,1717,90,-3,15,137
-1,1406,1528,-122,-3,-69,62
-1,1504,1554,-50,1,-147,130
1,1581,1654,-73,0,-2,49
-1,1588,1459,129,-3,-563,172
-1,1432,1537,-105,-4,-57,46
1,1664,1934,-270,-2,-433,123
-1,1632,1508,124,-2,-7,46
-1,1107,1222,-115,-8,-177,40
1,1577,1609,-32,0,-226,69
-1,1224,1658,-434,-4,-38,142
-1,1317,1606,-289,1,51,52
-1,1670,1764,-94,1,7,64
1,1174,0,1174,0,18,69
-1,1500,1198,302,3,27,50
1,2110,1779,331,2,105,47
-1,1573,1820,-247,-2,-182,98
1,1499,1500,-1,6,382,67
-1,1501,1723,-222,1,422,98
1,1660,1625,35,1,27,45
1,1910,1704,206,0,553,135
-1,1597,1614,-17,2,40,58
-1,1672,1713,-41,1,-133,92
-1,1618,1610,8,-9,-82,88
-1,1658,1631,27,0,10,42
1,1877,1262,615,0,104,111
1,1560,1587,-27,0,20,51
-1,1713,1617,96,0,-26,72
-1,1772,1662,110,1,-130,78
1,1707,1882,-175,0,-3,49
1,2083,1479,604,0,158,63
-1,1586,1633,-47,-1,-34,60
-1,1568,1652,-84,-2,-171,76
-1,1514,1382,132,-4,-207,72
-1,1642,1926,-284,1,17,56
-1,1693,1917,-224,-9,-602,82
-1,1449,1481,-32,-11,-745,88
-1,1186,1614,-428,-10,-81,46
-1,1646,1644,2,4,205,92
1,1677,1758,-81,3,68,69
-1,1315,1186,129,2,66,98
1,1924,1683,241,0,27,67
-1,1584,1654,-70,-1,0,42
-1,1622,1607,15,1,0,58
-1,1578,1727,-149,-1,-136,68
1,1648,1323,325,8,88,41
1,1500,1216,284,3,26,43
1,1960,1741,219,0,11,75
-1,1559,1661,-102,4,-57,88
1,1271,1150,121,8,749,173
-1,1674,1929,-255,-17,-256,44
-1,1865,2052,-187,-3,-44,72
-1,1122,982,140,-3,-685,108
-1,1775,2114,-339,0,214,164
1,1723,1522,201,0,13,63
1,1935,2004,-69,-4,22,93
1,1498,1651,-153,2,63,69
-1,1745,1691,54,-5,-186,74
1,1616,1696,-80,1,343,121
-1,1801,1558,243,1,7,52
-1,1942,1724,218,0,4,62
1,1618,1610,8,2,222,98
1,1666,1669,-3,13,261,99
1,1736,1663,73,3,200,79
-1,1723,1765,-42,0,2,72
-1,1929,2084,-155,-1,-73,72
1,1991,1952,39,-9,605,133
-1,1514,1624,-110,-3,10,52
1,1784,1706,78,-2,-9,76
1,1495,1384,111,-1,-22,47
1,1837,1646,191,6,76,43
-1,1704,1732,-28,0,164,112
0,1415,1369,46,1,-1,85
1,1825,1734,91,-1,-43,81
-1,1658,1687,-29,3,73,48
-1,1378,1435,-57,-4,-299,78
-1,1535,1397,138,-6,-66,60
-1,1224,1328,-104,-5,-257,64
1,1520,1652,-132,-2,-107,91
1,2058,1859,199,0,3,79
1,1940,2001,-61,-1,2,119
1,1437,1683,-246,2,62,69
1,1705,1648,57,1,22,41
-1,1629,1867,-238,1,20,52
-1,1535,1478,57,-2,-33,56
1,1599,1637,-38,6,190,59
-1,1652,1773,-121,0,-140,67
-1,1583,1543,40,-5,-100,50
-1,1280,1580,-300,-17,-252,40
1,1554,1391,163,-1,-37,95
-1,1210,1575,-365,-6,-81,40
1,1391,1333,58,3,52,45
1,1630,1735,-105,0,-6,47
1,1713,1539,174,0,125,67
1,1742,1694,48,7,51,41
-1,1699,1657,42,1,-18,102
1,1734,1736,-2,5,175,60
-1,1908,1624,284,0,-331,150
1,1712,1644,68,-2,85,91
-1,1577,1988,-411,-3,-87,92
-1,1184,1409,-225,0,35,82
-1,1640,2093,-453,0,-11,79
1,1500,1500,0,1,43,43
1,1476,1555,-79,-3,151,117
1,2029,1923,106,0,27,69
-1,1491,1555,-64,3,-719,142
-1,1465,1720,-255,-2,-106,64
1,1624,1494,130,1,132,87
-1,1635,1726,-91,-1,-76,78
1,2144,1629,515,9,557,77
1,1990,1575,415,0,13,67
1,1570,1545,25,3,43,43
1,1634,1542,92,5,250,65
0,1551,1569,-18,-2,-236,191
-1,1755,1690,65,-3,-110,58
1,1570,1500,70,4,418,117
-1,1376,1504,-128,2,158,90
1,1637,1594,43,1,64,91
-1,1654,1706,-52,-6,-191,56
-1,1508,1414,94,-4,-216,72
-1,1525,1719,-194,-2,-73,56
1,1402,1500,-98,-11,-245,65
-1,1573,1992,-419,0,198,72
1,1640,1767,-127,0,49,145
-1,1500,1628,-128,-3,-29,42
1,2117,1868,249,3,280,97
-1,1731,1375,356,3,98,52
-1,1575,1629,-54,0,-87,77
1,1511,1337,174,11,460,59
1,1581,1350,231,0,2,41
-1,1421,1697,-276,0,-22,54
1,1860,1694,166,1,111,69
-1,1377,1637,-260,0,20,50
1,1570,1556,14,1,10,46
1,1966,1772,194,2,158,95
1,1994,1571,423,-2,-7,53
-1,1345,1474,-129,-5,-351,72
-1,1370,1413,-43,-7,-147,42
-1,1760,1584,176,-8,-1325,146
-1,1725,1512,213,0,-15,78
1,1415,1538,-123,4,64,59
-1,1754,1692,62,-4,-112,52
1,1178,1005,173,-4,30,57
1,1853,1745,108,0,-29,53
1,1683,1687,-4,-2,-14,83
1,1356,1643,-287,-1,279,91
-1,1420,1444,-24,3,-212,78
-1,1569,1996,-427,1,219,76
-1,1747,1602,145,0,-594,100
-1,1742,2064,-322,-3,-101,58
1,1456,1337,119,2,342,97
-1,1257,1683,-426,-1,-587,134
-1,1346,1586,-240,-1,-95,64
-1,1616,1367,249,0,-517,148
-1,1577,1673,-96,10,56,120
1,1600,1737,-137,4,160,105
-1,1705,1740,-35,0,-179,106
1,1603,1621,-18,1,-137,79
-1,2158,1587,571,-10,-830,90
-1,1544,1567,-23,-3,-211,72
-1,1643,1701,-58,-7,-142,50
1,1998,1567,431,-1,-12,51
-1,1716,1930,-214,0,-37,84
-1,1255,1487,-232,-11,-320,42
-1,1639,1565,74,0,-107,82
-1,1461,1400,61,1,4,40
1,1913,2013,-100,-1,19,81
-1,1525,1545,-20,2,142,74
-1,1367,1716,-349,-1,-195,84
1,1703,1675,28,7,149,55
1,1716,1615,101,-2,-121,77
1,1732,1604,128,-1,78,67
-1,1862,2122,-260,-11,-168,44
1,1549,1708,-159,-1,-89,69
-1,1842,2136,-294,-3,-417,96
-1,1565,2000,-435,-1,-40,58
-1,1596,2095,-499,-2,-24,41
-1,1751,1695,56,-1,-30,80
1,1513,1185,328,3,67,47
1,1607,1727,-120,0,75,93
1,1616,1593,23,8,621,87
1,2067,1739,328,1,39,45
-1,1569,1597,-28,-1,-95,59
1,2097,1670,427,0,83,46
-1,1537,1716,-179,-5,-59,74
-1,1711,1552,159,-5,-293,132
1,1687,1786,-99,-1,25,85
1,2002,1563,439,1,3,51
1,1806,1787,19,-3,1,43
1,1423,1359,64,-4,-148,75
-1,1268,1097,171,0,75,112
1,1590,1341,249,1,169,69
-1,1636,1689,-53,-5,-59,70
1,1631,1418,213,0,-4,41
1,2127,1857,270,0,37,71
1,1707,1737,-30,0,2,53
1,1638,1565,73,12,331,51
1,2141,1778,363,0,-4,69
1,1748,1591,157,0,31,65
-1,1668,1633,35,3,51,42
-1,1561,2004,-443,-3,-201,72
-1,1664,1861,-197,0,7,68
-1,1663,1733,-70,-11,-231,96
-1,1702,1626,76,-4,-149,58
1,1648,1552,96,2,131,55
-1,1481,1691,-210,-1,-173,92
1,1285,1307,-22,0,15,52
-1,1777,1766,11,-2,-28,46
1,1408,1454,-46,-2,-78,67
1,1583,1252,331,1,36,65
1,1914,2070,-156,-5,19,85
1,1640,1685,-45,4,473,135
-1,1438,1489,-51,-1,-166,68
-1,1657,1752,-95,-3,-3,48
1,1517,1182,335,8,580,89
1,2006,1559,447,9,266,57
-1,1775,2144,-369,-1,-50,78
1,1534,1337,197,11,344,49
1,1935,1710,225,0,-12,49
1,1725,1932,-207,0,42,99
1,1728,1646,82,-1,126,73
1,1552,1401,151,2,-8,57
-1,1736,2076,-340,-6,-306,82
1,1648,1566,82,1,17,53
-1,1659,1800,-141,-1,-155,154
-1,1665,1712,-47,-3,-321,88
-1,1569,1551,18,0,-9,62
-1,1745,1613,132,-7,-138,58
-1,1695,1867,-172,-2,-64,58
1,2147,1773,374,-1,-14,55
1,1669,1652,17,-2,-92,61
1,1739,1541,198,-2,-30,65
-1,1263,1454,-191,-1,-81,58
1,1778,1750,28,3,43,41
1,2010,1555,455,-1,-34,65
1,1697,1571,126,0,-12,41
1,1687,1245,442,-2,391,123
1,1838,2145,-307,0,126,117
-1,1548,1740,-192,-10,-258,48
-1,1579,1511,68,0,-43,62
-1,1657,1534,123,-8,-706,92
-1,1852,2100,-248,-2,-154,88
1,1456,1601,-145,-2,-76,75
-1,1705,1943,-238,0,10,62
-1,2166,2150,16,-6,36,80
-1,1554,2012,-458,0,-125,88
1,1704,1589,115,3,199,79
1,1521,1395,126,7,631,97
0,1548,1598,-50,0,115,117
0,1943,1746,197,0,309,143
-1,1736,1664,72,-2,-24,56
1,1641,1682,-41,2,67,67
1,2124,1934,190,0,12,81
-1,2079,2012,67,2,131,84
1,1623,1379,244,2,369,81
-1,1383,1337,46,4,-154,86
1,2164,2149,15,2,98,51
-1,1302,1310,-8,-2,-72,44
1,1595,1202,393,10,302,57
-1,1973,1705,268,0,2,58
1,1655,1554,101,7,328,63
-1,1475,1809,-334,-2,-99,72
1,2013,1552,461,-2,-24,47
-1,1908,2131,-223,-1,-18,58
1,1701,1608,93,0,22,73
1,1789,1623,166,1,42,61
-1,1178,1500,-322,-5,-111,55
-1,2054,1931,123,1,32,82
1,1673,1543,130,5,252,45
0,1331,1540,-209,-4,-801,106
1,1329,1368,-39,1,37,53
1,1441,1338,103,1,26,45
-1,1550,2015,-465,0,54,92
-1,1563,1556,7,1,-385,164
1,2137,1888,249,0,66,49
0,1428,1716,-288,2,31,117
-1,1682,1534,148,2,-186,84
-1,1702,1807,-105,-1,-87,91
1,1601,1574,27,-1,84,67
1,1712,1677,35,0,12,67
-1,1524,1565,-41,-2,-71,46
-1,1663,1703,-40,0,-379,90
-1,1871,1958,-87,0,-36,70
1,1678,1656,22,0,123,73
1,1423,1478,-55,0,44,59
1,2017,1548,469,-4,-222,65
0,1727,1873,-146,0,22,87
1,1722,1655,67,4,670,125
1,1664,1553,111,2,219,87
-1,1198,1597,-399,-16,-525,52
-1,1617,1795,-178,-12,-99,52
-1,1876,1898,-22,1,47,110
1,1966,1841,125,0,403,101
-1,1234,1614,-380,4,398,90
1,1537,1374,163,4,284,57
-1,1546,2019,-473,2,43,52
-1,1418,1625,-207,-4,-194,100
1,1760,1752,8,-1,-34,57
1,1553,1508,45,-1,-16,53
-1,1710,2105,-395,0,-37,87
1,1332,1291,41,3,239,91
-1,1673,1544,129,-1,-95,80
-1,1309,1364,-55,-12,-294,50
1,2021,1544,477,-2,-64,65
1,1644,1612,32,0,90,103
-1,1328,1448,-120,-1,-8,70
1,1747,1559,188,1,165,65
1,1667,1723,-56,0,-3,45
-1,1575,1515,60,0,-81,78
1,1618,1496,122,6,240,117
0,1847,1707,140,1,524,118
1,1655,1562,93,0,83,89
-1,1741,1771,-30,-4,-71,54
1,1349,1370,-21,3,167,63
-1,1853,1575,278,-4,-157,56
-1,1542,2022,-480,3,288,80
-1,1506,1778,-272,0,-153,68
-1,1500,1466,34,-2,-89,50
1,1688,1625,63,-6,-61,71
1,1709,1736,-27,0,-13,51
1,1816,1694,122,-1,-56,49
-1,1642,1472,170,3,114,66
-1,1665,1552,113,-3,-34,62
-1,1686,1680,6,0,12,74
1,1550,1488,62,7,109,41
-1,1316,1451,-135,-3,-273,64
1,1563,1586,-23,-5,-47,45
1,1713,1779,-66,-1,-36,55
-1,1780,1730,50,-6,-414,126
1,1946,1751,195,-3,-40,51
-1,1817,1755,62,3,122,54
-1,1557,1710,-153,-2,-29,54
-1,2024,1541,483,-8,-1020,86
-1,1652,1552,100,1,-69,72
-1,1499,1629,-130,10,364,74
1,1648,1569,79,0,142,73
-1,1478,1626,-148,-11,-194,60
-1,1374,1437,-63,-14,-597,68
1,1704,1690,14,3,122,55
-1,1317,1270,47,0,-7,58
-1,1623,1761,-138,-4,-58,58
-1,1704,2038,-334,-2,-262,92
1,1482,1252,230,-3,-202,67
-1,1544,1663,-119,0,-155,98
-1,1711,1911,-200,1,-74,106
1,1490,1500,-10,3,-37,41
-1,1522,1813,-291,-1,-54,83
1,1398,1282,116,0,-126,85
1,1492,1564,-72,-1,-70,71
1,2041,1701,340,-1,153,83
-1,1604,1692,-88,1,-34,64
-1,1819,1596,223,-3,-87,56
1,1715,1679,36,3,177,75
-1,1893,1616,277,2,-14,72
1,1312,1113,199,1,395,91
-1,1698,2044,-346,-4,-268,96
-1,1466,1345,121,-7,-165,66
1,1500,1600,-100,2,48,49
-1,1672,1700,-28,-1,-190,84
1,1356,1214,142,1,83,79
-1,1366,1620,-254,-4,-143,58
-1,1250,1886,-636,0,-55,98
-1,1987,1816,171,-1,-252,142
-1,1801,1798,3,-1,-94,82
-1,1606,1517,89,-1,-281,90
1,1549,1695,-146,0,231,163
-1,1634,1855,-221,-1,-170,86
1,1284,1305,-21,26,372,45
-1,1587,1577,10,-1,-133,76
-1,1754,1728,26,-3,-74,42
1,1304,1835,-531,0,-58,95
1,1582,1409,173,-2,-10,43
0,1449,1509,-60,0,-250,188
1,1548,1804,-256,0,-12,59
1,1513,1210,303,21,911,65
-1,1767,1591,176,-1,31,54
1,1500,1526,-26,2,230,59
-1,1591,1732,-141,-1,-26,64
1,1908,2128,-220,0,-3,40
-1,1446,1500,-54,-20,-327,48
0,1377,1582,-205,-5,-313,124
1,1678,1565,113,15,250,45
1,1682,1477,205,0,23,45
-1,1565,1678,-113,-12,-706,78
-1,1078,1551,-473,0,-2,64
-1,1832,2084,-252,-3,-41,58
1,1671,1629,42,-2,500,95
1,1650,1439,211,0,635,141
1,1550,1505,45,10,664,101
-1,1588,1538,50,1,-20,94
1,1452,1799,-347,0,-15,129
1,1686,1557,129,3,240,89
1,1498,1731,-233,0,46,85
1,1725,1595,130,0,173,75
1,1619,1681,-62,1,20,49
1,1648,1688,-40,1,66,49
0,2109,1924,185,0,65,110
-1,1133,1528,-395,-4,-119,96
1,1625,1357,268,0,43,47
1,1568,1361,207,7,284,55
-1,1393,1318,75,0,-151,62
1,1435,1711,-276,4,112,63
-1,1519,1641,-122,-9,-15,40
1,1736,1840,-104,-1,17,81
-1,1074,1648,-574,-1,-41,50
1,1587,1632,-45,-1,598,109
1,1535,1645,-110,-3,-83,61
1,1663,1669,-6,0,-16,59
1,1596,1585,11,7,51,47
1,1593,1377,216,-11,266,107
1,1649,1511,138,3,241,79
-1,1957,1919,38,-1,-58,76
-1,1681,1486,195,2,20,60
1,1646,1865,-219,0,39,65
1,1532,1449,83,0,9,41
-1,1658,1675,-17,0,77,68
-1,1433,1514,-81,-5,-29,40
1,1620,1601,19,0,-88,73
-1,1442,1597,-155,-5,-171,62
1,1554,1726,-172,-9,-403,75
1,1832,1666,166,0,-17,53
-1,1648,1687,-39,-5,-297,78
1,1630,1553,77,1,196,103
1,1500,1687,-187,2,170,83
-1,1504,1656,-152,1,-75,124
-1,1629,1716,-87,-4,-89,48
1,1495,1230,265,0,160,69
1,1646,1318,328,-2,26,43
1,1775,1602,173,0,132,69
1,1297,1267,30,1,445,115
-1,1773,1696,77,-1,-37,46
1,1697,1638,59,1,175,77
1,1609,1701,-92,1,40,65
0,1502,1574,-72,-8,-255,126
-1,1579,1581,-2,5,89,54
1,2104,1945,159,-1,11,67
-1,1658,1843,-185,1,104,70
1,1525,1425,100,10,437,60
1,1708,1479,229,-1,122,104
1,1713,1576,137,1,100,59
1,1829,1607,222,-1,2,45
1,1705,1788,-83,0,-7,77
-1,1629,1707,-78,-10,-119,48
1,1598,1392,206,6,245,55
-1,1465,1815,-350,1,-24,76
1,1877,1447,430,-1,131,97
-1,1561,1405,156,-14,-96,40
1,1697,1493,204,-4,-4,45
-1,1781,1932,-151,-1,-106,50
-1,1688,1582,106,-6,-227,88
1,1848,1498,350,2,27,43
-1,1590,1649,-59,-2,-411,114
1,1897,1500,397,0,17,57
-1,1542,1639,-97,-1,-7,90
-1,1759,1888,-129,-10,-103,92
1,1573,1462,111,-4,-10,46
1,1487,1703,-216,1,157,69
-1,1676,2111,-435,0,-33,73
1,1592,1572,20,1,37,63
-1,1315,1554,-239,0,13,44
-1,1649,1751,-102,-1,-1,68
1,1750,1709,41,3,40,63
1,1495,1852,-357,-1,826,155
1,1421,1545,-124,-1,-53,49
-1,1481,1355,126,-3,35,74
1,1800,1185,615,2,168,69
1,1601,1835,-234,0,34,53
1,1499,1280,219,0,31,57
-1,1147,1387,-240,-14,-197,42
1,1320,1474,-154,0,406,105
1,1538,1569,-31,3,91,51
1,1535,1565,-30,0,-49,69
1,1516,1673,-157,-1,191,95
1,2113,1939,174,0,246,97
1,1410,1364,46,2,329,111
-1,1445,1879,-434,-1,-90,78
-1,1454,1581,-127,0,22,64
-1,1648,1532,116,-4,-173,96
-1,1603,1710,-107,-3,-181,82
1,1721,1751,-30,4,147,55
-1,1565,1612,-47,-1,-8,42
-1,1719,2063,-344,0,-95,96
-1,1828,1971,-143,0,-229,154
-1,1813,1768,45,0,-197,88
1,1738,1550,188,2,359,85
-1,1684,1505,179,-1,-121,70
-1,1308,1273,35,-3,-150,102
-1,1654,1530,124,0,-237,106
-1,1716,1944,-228,-1,-115,58
1,1653,1619,34,0,43,61
-1,1184,1800,-616,-4,-139,92
-1,1827,1515,312,-2,-9,44
1,1823,1621,202,0,42,77
1,1775,1455,320,-1,77,57
1,1740,1480,260,0,273,117
1,1931,1933,-2,-1,70,67
1,1801,1589,212,0,152,65
-1,1550,1633,-83,-3,-29,42
-1,1719,1462,257,2,12,42
-1,1401,1436,-35,-1,291,64
-1,1595,1427,168,-1,-141,66
1,1489,1364,125,0,187,87
-1,1738,1939,-201,0,-96,104
1,1366,1605,-239,-1,-186,71
-1,1583,1806,-223,-1,-20,48
-1,1814,1618,196,-1,-95,124
1,1667,1617,50,7,191,59
1,1785,1082,703,7,175,47
-1,1767,1726,41,0,5,96
1,1716,1450,266,0,43,43
1,1922,2090,-168,0,-53,73
1,1652,1698,-46,-2,-37,47
-1,1745,1804,-59,0,-24,80
1,1811,1577,234,0,-16,73
1,1945,1733,212,1,29,55
1,1978,1820,158,0,2,51
-1,1709,1550,159,1,71,60
1,1739,1734,5,-2,-34,49
-1,1041,1550,-509,0,-40,80
-1,1659,1578,81,-1,-365,87
1,1413,1364,49,0,292,129
-1,1720,1830,-110,-6,47,40
1,1444,1480,-36,-2,-56,45
-1,1513,1346,167,-3,-102,54
-1,1593,1693,-100,-5,-54,60
-1,1815,1755,60,-1,-152,68
-1,1620,1630,-10,-1,-62,86
-1,1279,1553,-274,-2,-45,52
1,1684,1520,164,-3,-3,67
-1,1727,1950,-223,0,-275,100
-1,1609,1663,-54,0,30,66
1,1814,1984,-170,1,34,55
1,1759,1641,118,-2,168,85
0,1982,1822,160,5,-667,137
-1,1656,1710,-54,3,-27,106
1,1734,1567,167,0,87,71
-1,1981,2119,-138,-1,400,136
-1,1470,1622,-152,0,0,54
-1,1448,1705,-257,-6,-231,76
1,1102,1287,-185,0,12,65
-1,1542,1616,-74,-2,-355,96
-1,1687,1687,0,-4,-56,43
1,1266,1414,-148,3,240,65
1,1545,1638,-93,0,102,127
1,1955,1722,233,-9,127,139
1,1896,1751,145,-4,74,47
1,1616,1581,35,-2,66,61
1,1968,1830,138,1,60,71
-1,1358,1675,-317,-3,-114,78
-1,1570,1508,62,-9,-177,54
1,1642,1462,180,0,19,67
-1,1722,1617,105,-5,-27,44
-1,1463,1623,-160,-3,-56,52
-1,1624,1596,28,2,-551,138
-1,1803,1768,35,1,70,58
-1,1500,1690,-190,-3,-79,72
1,1513,1675,-162,1,102,85
1,1595,1636,-41,0,-20,59
1,1561,1268,293,7,184,49
-1,1551,1624,-73,-1,-150,68
-1,1443,1463,-20,-2,-96,114
1,1606,1275,331,-3,160,85
1,1791,1573,218,2,-2,71
1,1206,1741,-535,-1,55,99
-1,1717,1960,-243,0,-36,108
-1,1581,1606,-25,0,-11,93
-1,2070,2127,-57,-1,42,80
-1,1365,1777,-412,-8,-779,94
1,1253,1224,29,-2,29,65
-1,1823,1843,-20,0,257,114
-1,1568,1492,76,-5,-310,77
1,1217,1517,-300,10,635,77
-1,1600,1699,-99,0,-84,94
1,1612,1456,156,2,142,57
1,1795,1742,53,-1,-58,119
-1,1457,1478,-21,0,42,60
-1,1610,1556,54,0,-54,44
-1,1564,1263,301,-2,-324,76
1,1495,1629,-134,2,40,43
-1,1744,1749,-5,0,31,64
1,1534,1709,-175,-4,-76,65
-1,1546,1658,-112,-7,-115,56
1,1285,1296,-11,3,277,71
-1,1644,1500,144,-8,-115,44
1,1557,1491,66,6,504,103
-1,1624,1559,65,0,-40,64
-1,1633,1422,211,3,60,70
0,1618,1712,-94,-5,-61,96
-1,1785,1695,90,-4,-61,70
-1,1447,1500,-53,-2,-17,42
1,1568,1610,-42,1,52,53
-1,1433,1541,-108,-1,-101,64
1,1767,1851,-84,0,59,67
-1,1560,1626,-66,0,40,48
-1,1598,1581,17,0,-77,64
1,1358,1480,-122,1,48,69
1,1707,1584,123,0,302,111
1,1786,1666,120,0,-428,185
-1,1521,1542,-21,0,124,90
1,1593,1586,7,-1,32,85
1,1691,1551,140,1,147,77
-1,1793,1362,431,-3,-236,76
1,1447,1276,171,8,481,87
-1,1621,1585,36,1,-80,109
1,1582,1700,-118,-2,233,75
0,1714,1500,214,0,75,112
1,1446,1456,-10,-2,23,41
-1,1416,1570,-154,-1,0,66
1,1648,1500,148,1,55,63
-1,1761,1632,129,-5,-358,72
1,1709,1772,-63,1,189,109
-1,1781,1834,-53,0,5,72
1,1576,1604,-28,6,398,71
-1,1795,1588,207,1,-241,118
-1,1379,1288,91,-8,-897,104
1,1569,1480,89,6,272,67
1,1859,1678,181,2,177,73
-1,1544,1699,-155,0,-13,92
-1,1794,1658,136,0,-39,76
1,1674,1749,-75,0,44,61
1,1566,1571,-5,1,23,83
1,1812,1714,98,1,71,79
-1,1429,1306,123,-3,-43,46
1,1626,1686,-60,-6,-330,85
-1,1692,1648,44,0,-15,50
0,1443,1612,-169,-5,-840,170
1,1566,1403,163,0,122,69
0,1465,1373,92,-9,-59,168
1,1500,1425,75,-1,-255,107
-1,1779,1674,105,-2,-11,100
1,1855,1815,40,0,266,125
1,1453,1357,96,3,124,63
1,1556,1433,123,-1,-175,85
-1,1342,1568,-226,1,120,70
-1,1493,1656,-163,-4,-927,152
-1,1778,1985,-207,0,-56,72
1,1604,1651,-47,-2,125,87
0,1706,1537,169,-6,-719,176
1,1801,1610,191,-3,112,133
-1,1627,1919,-292,-3,-176,76
-1,1446,1711,-265,-4,-133,76
1,1765,1689,76,9,256,55
1,1709,1530,179,1,172,93
-1,1611,1723,-112,-2,-513,102
1,1760,1846,-86,3,-90,85
-1,1571,1681,-110,-1,-57,57
-1,1271,1632,-361,-1,-45,48
-1,1641,1672,-31,-3,-225,88
-1,1509,1883,-374,-2,-334,94
-1,1680,1773,-93,-1,-264,100
-1,1386,1640,-254,-3,-102,77
-1,1153,1673,-520,0,21,80
1,1873,1666,207,5,520,91
-1,1704,1803,-99,-2,-88,62
-1,1922,1391,531,7,157,46
-1,1732,1626,106,2,6,70
-1,1421,1814,-393,-1,-318,113
1,1295,1391,-96,1,69,69
-1,1672,1733,-61,0,-420,120
-1,1781,1672,109,0,-42,66
1,1324,1523,-199,2,203,71
-1,1577,1571,6,0,-87,96
1,1362,1431,-69,-4,-79,65
1,1917,1491,426,0,-11,47
-1,1465,1406,59,-1,-8,54
1,1718,1640,78,1,200,69
1,1821,1866,-45,0,1,45
1,1716,1127,589,7,123,47
-1,1596,1694,-98,-1,-35,66
1,1771,1602,169,2,211,71
1,1430,1413,17,1,30,73
1,1843,1773,70,-3,-44,71
1,1542,1701,-159,-1,257,159
1,1452,1506,-54,2,88,57
-1,1376,1428,-52,-3,-299,90
1,1788,1829,-41,2,117,69
-1,1631,1726,-95,-2,-17,43
1,1563,1608,-45,2,54,57
1,1441,1539,-98,-1,35,73
1,1560,1555,5,-9,-111,43
1,1470,1492,-22,4,42,40
-1,1734,1623,111,0,51,80
1,1201,991,210,-3,-47,51
1,1610,1307,303,1,10,75
1,1930,1833,97,-1,-6,43
-1,1704,1588,116,-3,-105,80
-1,1734,1886,-152,-3,-184,74
-1,1331,1347,-16,-9,-1154,122
1,1717,1437,280,0,295,165
0,1630,1662,-32,0,218,148
-1,1436,1493,-57,4,383,104
-1,1764,1852,-88,-2,-68,62
1,1477,1420,57,-4,-7,65
-1,1358,1418,-60,1,-12,58
1,1720,1638,82,2,300,95
1,1669,1380,289,0,188,99
1,1733,1828,-95,-3,-18,85
1,1592,1641,-49,-1,645,151
1,1672,1404,268,4,134,51
-1,1693,1878,-185,0,-5,46
1,1447,1094,353,0,515,135
-1,1684,1558,126,3,-643,186
1,1825,1937,-112,0,-10,59
1,1432,1316,116,2,306,103
1,1458,1917,-459,0,-66,72
-1,1629,1729,-100,-5,-572,114
-1,1458,1391,67,-4,-60,46
1,1443,1544,-101,-2,92,71
-1,1416,1823,-407,-1,-131,74
1,1100,1310,-210,14,387,51
1,1607,1449,158,1,24,55
-1,1861,1756,105,0,2,48
-1,1623,1617,6,1,-237,136
1,1781,1629,152,4,504,115
-1,1366,1410,-44,-2,94,52
1,1583,1488,95,0,123,71
1,1661,1631,30,3,438,127
1,1699,1576,123,3,322,75
-1,1616,1588,28,-3,-135,58
1,1774,1723,51,0,57,109
-1,1923,1840,83,1,-41,74
1,1737,1621,116,-1,125,57
-1,1431,1607,-176,0,-22,64
1,1486,1349,137,2,400,95
1,1605,1572,33,4,292,87
1,1440,1513,-73,0,7,69
1,1811,1847,-36,-1,-9,53
1,1722,1767,-45,0,102,135
1,1292,1122,170,2,55,49
0,1622,1788,-166,-3,-81,77
0,0,980,-980,0,591,97
1,1524,1525,-1,-1,71,103
-1,1405,1444,-39,-3,-27,76
-1,1614,1744,-130,0,-203,88
1,1537,1896,-359,-4,27,125
-1,1486,1456,30,-6,-112,48
-1,1481,1646,-165,-4,-73,42
-1,1370,1503,-133,-2,-83,66
-1,1420,1356,64,2,33,84
1,1516,1399,117,2,745,127
-1,1631,1879,-248,1,5,95
-1,1449,1699,-250,2,89,56
1,1783,1627,156,1,90,69
1,1751,1607,144,2,110,53
1,1703,1444,259,0,37,87
0,1893,1615,278,0,36,90
-1,1414,1598,-184,0,-488,116
1,1474,1596,-122,0,122,100
1,1722,1683,39,0,4,56
1,1576,1461,115,0,370,93
1,1579,1566,13,-4,-111,61
-1,1440,1669,-229,0,0,40
0,1614,1514,100,4,215,109
-1,1440,1708,-268,2,31,40
-1,1602,1620,-18,-9,-714,88
1,1712,1435,277,-6,-35,47
-1,1449,1701,-252,-1,-53,60
-1,1831,2116,-285,0,-35,70
-1,1758,1883,-125,1,34,62
-1,1799,1701,98,1,54,66
-1,1623,1885,-262,-5,-304,90
1,1575,1502,73,1,86,81
1,1244,1564,-320,12,370,49
-1,1631,1591,40,-9,-531,70
1,1611,1878,-267,2,8,93
-1,1570,1677,-107,-3,-186,75
1,1691,1456,235,-2,-93,85
-1,1452,1343,109,1,85,62
-1,1402,1903,-501,-5,-153,60
1,1583,1359,224,0,-66,71
1,1890,1619,271,2,75,53
-1,1576,1640,-64,1,-56,92
1,1468,1734,-266,-3,-13,41
-1,1688,1707,-19,-9,83,100
1,1701,1446,255,-4,-57,57
0,1751,1620,131,0,569,177
1,1436,1394,42,0,-11,137
-1,1510,1577,-67,-5,-251,66
1,1434,1375,59,-8,15,91
-1,1514,1562,-48,-4,-111,54
-1,1442,1706,-264,2,13,42
-1,1857,1658,199,-1,-197,92
1,1904,1400,504,2,568,111
1,1485,1563,-78,-1,-70,99
-1,1432,1617,-185,-8,-400,84
-1,1300,1711,-411,0,-104,86
1,1407,1405,2,-1,273,135
0,1629,1611,18,1,76,71
-1,1713,1785,-72,-3,-199,90
-1,1605,1674,-69,-4,-183,76
1,1767,1624,143,0,53,49
0,1922,1766,156,0,-56,83
1,1434,1401,33,0,20,67
-1,1708,1629,79,0,-80,126
-1,1728,1975,-247,-2,-60,68
-1,1610,1841,-231,3,74,58
1,1574,1675,-101,0,-25,97
-1,1686,1950,-264,-3,-36,50
1,1524,1570,-46,-1,434,161
-1,1522,1611,-89,-6,-230,70
1,1590,1448,142,0,22,67
-1,1774,2177,-403,0,-25,120
1,1406,1398,8,9,124,47
-1,1399,1614,-215,6,-164,134
-1,1434,1501,-67,0,-112,64
1,1055,1090,-35,7,583,74
1,1612,1629,-17,1,35,89
1,1659,1480,179,1,122,81
0,1718,1678,40,0,-114,161
1,2181,2121,60,1,31,53
1,1845,1723,122,2,97,61
1,1772,1761,11,1,40,42
1,1482,1676,-194,0,-4,51
1,1486,1505,-19,1,285,65
-1,1894,1681,213,-8,-84,46
-1,1431,1569,-138,-1,-55,62
1,1620,1393,227,1,218,93
1,1355,1287,68,7,509,71
0,1678,1456,222,1,305,85
-1,1750,1783,-33,0,-127,98
1,1366,1446,-80,7,27,41
1,1770,1918,-148,0,79,135
-1,1318,1575,-257,0,-2,54
-1,1642,1827,-185,-1,-5,82
1,1301,1444,-143,2,736,107
1,1620,1502,118,6,208,57
1,1388,1625,-237,0,413,119
-1,1595,1493,102,-2,-68,68
1,1415,1406,9,5,646,99
-1,1716,1875,-159,-3,-91,126
-1,1547,1626,-79,0,-52,92
-1,1499,1690,-191,2,167,94
0,1575,1400,175,-1,-253,108
1,1386,1657,-271,6,180,45
-1,1524,1654,-130,-3,-637,106
-1,1818,2180,-362,0,42,110
-1,1793,2147,-354,-4,-55,94
-1,1429,1380,49,2,-85,62
1,1860,1935,-75,1,214,79
-1,1906,1833,73,0,-122,84
1,1224,1510,-286,3,667,87
1,1441,1571,-130,4,446,93
-1,1747,1573,174,2,27,58
-1,1557,1537,20,-3,-9,42
-1,1466,1673,-207,0,-57,60
0,1653,1560,93,-1,75,70
-1,1429,1609,-180,-1,-160,80
-1,1729,1549,180,1,-76,108
-1,1679,1717,-38,0,-15,76
1,1653,1793,-140,0,-52,113
1,1430,1357,73,-3,-353,129
-1,1523,1502,21,2,-67,81
-1,1559,1603,-44,0,-181,146
-1,1370,1332,38,-1,11,48
1,1796,1703,93,1,91,55
-1,1371,1468,-97,-14,-154,42
1,1560,1183,377,2,444,97
1,2110,1828,282,-3,68,89
1,1564,1651,-87,-1,-78,63
1,1701,1622,79,0,7,77
1,1470,1405,65,4,360,87
1,1768,1422,346,5,108,45
1,1580,1361,219,1,33,45
1,1611,1652,-41,0,16,53
1,1860,1665,195,-3,-59,101
-1,1477,1484,-7,-6,-180,53
-1,1249,1492,-243,1,-38,52
-1,1384,1433,-49,5,373,106
1,1506,1538,-32,-6,-91,55
-1,1639,1756,-117,0,-81,66
-1,1444,1468,-24,-2,-175,82
1,1648,1688,-40,-7,-293,71
-1,1526,1601,-75,-3,-38,50
1,1210,1021,189,9,3,41
1,1420,1423,-3,0,-3,51
1,1916,1364,552,3,176,80
1,1613,1709,-96,0,21,71
-1,1464,1637,-173,-1,-200,66
-1,1681,1432,249,-4,-47,42
1,1479,1395,84,0,79,61
-1,1272,1385,-113,-1,-77,122
1,1586,1384,202,1,-11,49
-1,1640,1625,15,0,-7,44
-1,1311,1419,-108,1,46,57
1,1771,1786,-15,0,25,65
1,1537,1321,216,4,210,63
1,2139,1974,165,3,2,40
1,1996,1960,36,-1,-12,47
-1,1660,1866,-206,0,-22,88
-1,1656,1755,-99,0,-38,64
-1,1731,1770,-39,0,-192,92
-1,1496,1608,-112,-2,-280,108
1,1723,1608,115,-4,93,89
1,1695,1627,68,7,693,97
1,1791,1397,394,4,78,53
1,1643,1637,6,0,-10,75
-1,1450,1478,-28,-10,-447,66
-1,1244,1206,38,1,46,41
1,1526,1371,155,1,166,67
-1,1518,1617,-99,3,536,134
1,1866,1824,42,-1,-14,45
1,1264,1195,69,-2,233,133
1,1417,1409,8,2,146,52
-1,1167,1457,-290,0,-616,88
1,1872,1654,218,0,-12,53
-1,1434,1694,-260,-1,-14,42
1,1792,1904,-112,3,188,55
-1,1484,1648,-164,-4,-57,68
-1,1618,1704,-86,0,-231,72
-1,1420,1280,140,-1,-45,88
1,1488,1343,145,4,182,77
1,1434,1355,79,28,802,55
1,1664,1626,38,2,60,77
-1,1439,1431,8,0,-295,136
-1,1871,1805,66,0,-129,64
1,1555,1500,55,-1,-25,57
-1,1600,1731,-131,0,30,94
1,1700,1444,256,9,453,69
-1,1654,1924,-270,-1,-32,58
-1,1398,1430,-32,0,-12,60
-1,1564,1626,-62,0,98,90
-1,1818,1843,-25,-7,-297,70
1,1658,1490,168,-1,-33,55
1,1365,1349,16,14,286,47
1,1721,1774,-53,-1,-38,53
1,1622,1702,-80,0,23,87
1,1783,1196,587,-7,-240,161
0,1895,2020,-125,-3,-52,111
1,1688,1550,138,2,479,121
-1,1621,1974,-353,0,-143,80
1,1794,1922,-128,0,-77,91
-1,1331,1412,-81,-1,-34,90
-1,1302,1500,-198,-2,-14,62
-1,1342,1590,-248,-4,-128,50
-1,1864,1808,56,-4,-13,44
-1,1815,1879,-64,-4,-72,58
-1,1532,1611,-79,-1,3,44
1,1217,1225,-8,-6,-53,61
-1,1425,1397,28,2,12,86
-1,1571,1793,-222,0,-4,48
1,1820,1839,-19,0,17,53
1,1650,1785,-135,0,-57,95
-1,1405,1444,-39,1,41,84
-1,1236,1374,-138,-2,-12,48
-1,1579,1714,-135,1,5,58
1,1450,1505,-55,3,175,65
-1,1817,1504,313,-3,-347,106
-1,1309,1514,-205,0,-51,42
-1,1413,1490,-77,0,-31,86
-1,1645,1620,25,2,145,112
1,1351,1296,55,0,30,53
-1,1503,1633,-130,-14,-96,40
1,1735,1384,351,0,19,63
1,1410,1257,153,5,282,87
-1,1439,1545,-106,-4,-16,40
-1,1705,1949,-244,-1,-417,138
0,1542,1430,112,-3,-44,122
1,1500,1590,-90,-2,16,46
-1,1478,1644,-166,-2,-32,52
1,1734,1567,167,-8,367,119
-1,1548,1461,87,3,118,48
-1,1554,1872,-318,0,-62,64
1,1831,1751,80,8,190,65
-1,1726,1649,77,-3,-99,54
1,1493,1485,8,-1,-214,93
1,1381,1178,203,0,609,117
-1,1567,1427,140,0,38,96
-1,1468,1442,26,-1,-5,44
1,1640,1496,144,3,91,67
1,1526,1611,-85,-5,4,75
-1,1742,1839,-97,-12,-154,44
1,1610,1328,282,-1,-108,59
1,1208,1232,-24,-4,-154,73
-1,1476,1292,184,7,84,40
-1,2006,1816,190,0,-43,80
-1,1847,1734,113,2,108,74
1,1770,1665,105,0,187,103
-1,1667,1595,72,6,127,46
1,1231,1394,-163,0,97,103
-1,1625,1624,1,-1,-333,110
1,1371,1346,25,0,27,53
0,1628,1484,144,0,124,97
-1,1503,1458,45,0,-470,90
-1,1905,1730,175,-6,-313,94
1,1489,1599,-110,2,1120,93
-1,1326,1352,-26,-1,131,82
-1,1749,1833,-84,1,11,44
-1,2015,1797,218,0,-32,60
1,1496,1122,374,-2,137,59
1,1784,1808,-24,5,0,51
-1,1841,1740,101,-3,-122,56
-1,1739,1551,188,-8,-164,44
1,1572,1468,104,3,134,47
-1,1459,1542,-83,-2,-27,44
0,1489,1647,-158,-10,-373,76
1,1651,1580,71,0,0,40
1,1613,1487,126,-4,283,167
0,1700,1431,269,-3,-519,94
0,1141,1386,-245,-5,-79,64
-1,1598,1544,54,-1,-71,96
-1,1319,1866,-547,-3,-55,62
1,1332,1791,-459,0,-12,41
1,1745,1824,-79,0,-91,89
1,1500,1143,357,17,833,73
-1,1671,1668,3,2,-15,84
-1,1659,1399,260,-11,-236,72
-1,1551,2162,-611,-8,13,58
-1,1501,1504,-3,-1,78,54
1,1730,1530,200,-1,154,69
-1,1595,1533,62,0,15,50
1,2089,1746,343,1,94,74
1,1515,1489,26,0,-3,45
-1,1443,1450,-7,-4,-165,66
1,1615,1476,139,2,203,77
-1,1796,1636,160,0,-70,104
1,1828,1804,24,-1,63,79
1,1721,1568,153,0,-57,46
1,1471,1621,-150,0,215,117
-1,1478,1526,-48,-15,-346,42
-1,1329,1623,-294,-3,-156,106
1,1409,1523,-114,0,-13,43
1,1398,1129,269,-1,-18,43
-1,1641,1685,-44,4,157,78
1,1797,1778,19,0,40,63
1,1535,1797,-262,4,493,83
-1,1450,1478,-28,-5,-61,42
0,1754,1838,-84,0,-275,150
1,1867,1316,551,1,119,67
1,1310,1330,-20,-8,-164,55
-1,1605,1504,101,-8,-552,126
1,1794,1628,166,-2,31,51
-1,1351,1422,-71,-6,-237,58
-1,1624,1642,-18,-7,-343,82
-1,1800,1581,219,0,28,56
-1,1735,1524,211,-6,-153,96
1,1516,1454,62,0,14,55
-1,1380,1620,-240,-5,-426,70
1,1767,1807,-40,-1,-142,103
1,1445,1554,-109,1,81,51
1,1748,1844,-96,-1,-95,119
-1,1743,2092,-349,0,-17,74
1,1096,1693,-597,-4,-103,47
-1,1197,1468,-271,-1,-79,58
-1,1561,1728,-167,2,-89,92
1,1713,1686,27,0,3,67
-1,1785,1962,-177,-1,-290,122
-1,1447,1721,-274,-3,-96,58
-1,1467,1567,-100,3,-46,60
-1,1472,1368,104,-1,-16,46
-1,1512,1660,-148,2,18,44
-1,1327,1599,-272,0,-370,93
1,1592,1532,60,0,447,131
1,1830,1762,68,-9,-298,55
1,1780,1503,277,3,299,73
-1,1459,1611,-152,-3,-69,52
1,1501,1509,-8,2,271,67
0,1811,1758,53,1,9,113
-1,1419,1492,-73,-9,-395,96
1,1439,1288,151,6,296,95
-1,1313,1868,-555,-5,-217,62
-1,1624,1376,248,1,23,42
-1,1593,1622,-29,1,-193,126
-1,1753,1839,-86,1,140,62
0,1723,1951,-228,0,-13,114
1,1796,1642,154,11,1139,91
-1,1402,1445,-43,2,12,48
-1,1965,1830,135,-6,-48,44
-1,1575,1742,-167,-3,-30,82
1,1284,1333,-49,7,243,59
1,1864,1919,-55,-1,39,57
-1,1219,1565,-346,-4,-465,72
1,1440,1524,-84,7,1052,95
1,1515,1601,-86,1,224,73
1,1293,941,352,2,252,89
1,1802,1614,188,0,-213,171
-1,1663,1625,38,-1,-64,60
-1,1539,1669,-130,-1,-85,78
1,1870,1310,560,4,56,41
-1,1795,1780,15,0,-47,64
-1,1695,1634,61,-3,-264,104
-1,1725,1506,219,-1,16,132
-1,1183,1603,-420,-1,-2,78
1,1734,1555,179,0,22,79
-1,1730,1995,-265,-5,-68,76
1,1808,1592,216,2,53,63
-1,1562,1756,-194,1,51,106
1,1612,1439,173,-5,77,65
-1,1473,1321,152,2,13,76
1,1587,1540,47,6,981,109
1,1760,1809,-49,-5,-81,97
-1,1977,2095,-118,-2,-176,98
-1,1905,1876,29,1,-46,94
-1,1631,1246,385,1,-7,58
-1,1845,1945,-100,0,-34,52
1,1944,1574,370,1,161,101
-1,1666,1784,-118,0,51,78
1,1127,1470,-343,-9,-272,79
1,1811,1722,89,1,112,125
-1,1307,1871,-564,-1,-83,84
-1,1248,1453,-205,-5,-359,78
-1,1641,1542,99,-2,-159,82
1,1762,1557,205,-1,-9,70
1,1523,1597,-74,2,420,149
1,1815,1565,250,5,135,57
1,1748,1553,195,0,445,107
1,1454,1417,37,5,209,49
1,2001,1551,450,0,183,109
-1,1568,1572,-4,-2,-153,60
-1,1459,1634,-175,-1,-44,72
-1,1791,1784,7,-10,-169,66
1,1611,1365,246,4,331,71
1,1738,1475,263,2,139,113
-1,1443,1396,47,-12,-241,52
1,1439,1437,2,1,77,71
-1,1551,1768,-217,-3,-93,54
1,2003,1546,457,1,32,47
1,1584,1546,38,3,161,101
-1,1956,1837,119,-10,-53,50
-1,1587,1954,-367,0,-40,103
-1,1888,2009,-121,0,-210,74
1,2005,1541,464,-3,-16,41
1,1788,1899,-111,0,97,103
-1,1505,1548,-43,-5,-307,76
1,1774,1546,228,0,130,95
1,1701,1134,567,15,643,59
0,1323,1463,-140,0,55,91
-1,1796,1772,24,0,7,44
1,2007,1536,471,0,247,111
-1,1962,2110,-148,0,-14,54
1,1872,1304,568,0,59,87
0,1566,1533,33,1,63,88
1,1583,1556,27,-3,-43,49
1,1417,1501,-84,6,51,40
-1,1441,1452,-11,1,105,66
-1,1466,1639,-173,0,-568,144
1,1795,1780,15,0,3,47
1,1529,1593,-64,5,407,73
1,1748,1632,116,2,103,65
1,1947,1532,415,4,88,51
1,1512,1414,98,5,265,57
-1,1276,1456,-180,1,124,56
-1,1541,1780,-239,0,-71,116
0,1850,2175,-325,-2,-91,163
1,1531,1366,165,3,269,107
-1,1513,1526,-13,0,-2,40
-1,1409,1426,-17,-11,-206,56
1,1377,1509,-132,2,150,93
1,1792,1727,65,4,76,41
1,1431,1440,-9,-2,-62,63
-1,1455,1327,128,0,-181,82
1,1502,1555,-53,-2,-30,45
1,1783,1785,-2,0,159,77
-1,1259,1602,-343,-2,-319,98
-1,1133,1738,-605,-11,-711,65
1,1515,1523,-8,2,53,47
-1,1537,1593,-56,-5,-1003,222
-1,1464,1590,-126,-2,-115,70
-1,1955,2018,-63,-1,-181,88
0,1529,1616,-87,3,689,115
-1,1851,1936,-85,-1,-113,114
1,1526,1495,31,10,135,45
-1,1331,1532,-201,0,-158,61
1,2113,1751,362,1,128,87
1,1645,1629,16,-1,-107,97
1,1547,1831,-284,-2,-201,89
1,1566,1498,68,-1,630,133
1,1721,1624,97,-1,184,71
-1,1619,1740,-121,-1,0,56
-1,1492,1533,-41,-4,-346,80
-1,1503,1727,-224,0,18,64
-1,1811,1566,245,-3,-407,102
-1,1527,1558,-31,1,10,58
1,1539,1626,-87,4,425,77
-1,1605,1990,-385,-1,-247,112
-1,1090,1383,-293,-9,-439,130
1,1522,1368,154,12,347,59
1,2116,1756,360,0,-14,73
1,1947,1918,29,2,34,75
-1,1553,1479,74,1,78,58
1,1655,1646,9,-5,-322,85
1,1422,1423,-1,0,15,55
-1,1526,1578,-52,0,-342,78
1,1557,1752,-195,2,197,95
-1,1593,1784,-191,-1,-367,122
-1,1566,1651,-85,-1,1,68
1,1752,2118,-366,-2,611,137
1,1468,1353,115,5,153,59
-1,1600,1616,-16,-2,-56,70
1,1423,1325,98,0,167,59
-1,1605,1476,129,4,-8,76
1,1506,1523,-17,0,-5,53
1,1618,1517,101,-3,-48,43
-1,1565,1660,-95,-2,-151,76
-1,1532,1764,-232,-3,-10,50
1,1666,1692,-26,-2,-116,71
-1,1557,1786,-229,0,-81,62
-1,1568,1603,-35,-1,-60,62
-1,1575,1719,-144,0,0,60
-1,1288,1335,-47,-1,-255,96
1,1908,1957,-49,0,215,125
-1,1509,1648,-139,-4,-80,118
1,1426,1483,-57,0,-153,161
-1,1528,1690,-162,0,-41,66
1,1794,1552,242,-2,82,77
1,1555,1620,-65,6,306,71
-1,1612,1472,140,-9,-165,44
-1,1259,1501,-242,-3,-25,42
1,1511,1410,101,2,132,61
-1,1527,1770,-243,-10,-18,40
-1,1679,1678,1,1,56,112
-1,1833,1798,35,0,-137,98
-1,1547,1802,-255,-2,-77,52
1,1622,1600,22,0,19,67
1,1799,1542,257,4,49,49
1,1591,1628,-37,-3,-6,47
-1,1632,1631,1,-1,-48,62
-1,1433,1441,-8,-2,15,50
1,1517,1496,21,-4,-46,55
-1,1523,1775,-252,0,10,52
-1,1659,1547,112,-7,-183,48
1,1598,1599,-1,-4,-10,59
1,1714,1589,125,-3,-6,45
-1,1626,1658,-32,0,2,68
1,1726,1568,158,7,183,59
-1,1945,1921,24,0,-1,64
-1,1539,1815,-276,-5,-190,72
-1,1344,1249,95,-17,-624,51
1,1585,1845,-260,0,18,93
1,1876,1563,313,3,140,79
-1,1744,1609,135,0,-19,60
1,1605,1743,-138,2,421,101
1,1742,1730,12,0,57,59
-1,1557,1648,-91,-7,-237,56
-1,1581,1722,-141,0,-19,70
1,1821,1535,286,3,143,61
-1,1494,1504,-10,1,-108,92
-1,1518,1780,-262,-1,-27,58
1,1480,1281,199,4,59,69
-1,2003,2097,-94,0,248,102
-1,1616,1694,-78,0,-52,86
1,1669,1557,112,2,62,67
-1,1561,1732,-171,-1,28,68
-1,1607,1559,48,-1,7,56
1,1299,1331,-32,5,720,141
-1,1616,1604,12,0,54,94
-1,1827,1978,-151,0,-77,88
-1,1932,1934,-2,3,14,60
-1,1445,1431,14,-11,-376,62
1,1818,1422,396,-2,84,41
-1,1522,1457,65,-1,-165,154
-1,1514,1785,-271,0,-11,64
-1,1373,1458,-85,0,-267,104
-1,1464,1608,-144,-15,-204,44
-1,1995,1934,61,1,-97,72
1,2106,1817,289,-1,-197,117
-1,1721,1574,147,-1,-123,98
-1,1768,1820,-52,0,2,54
1,1441,1474,-33,1,88,72
1,1615,1316,299,-1,557,91
1,1944,1921,23,-1,-291,97
-1,1336,1457,-121,-3,198,188
1,1551,1519,32,-2,-2,63
-1,1510,1789,-279,2,78,69
-1,1420,1821,-401,1,159,108
1,1811,1686,125,2,110,61
1,1810,1879,-69,3,39,45
1,1519,1631,-112,0,33,49
-1,1456,1465,-9,-1,-33,98
-1,1925,1985,-60,-10,-79,108
-1,1442,1433,9,-1,202,64
1,1756,1515,241,0,-1,47
1,1498,1574,-76,-1,153,97
1,1677,1589,88,0,-22,59
-1,1517,1523,-6,1,-155,80
1,1738,1555,183,-1,46,115
-1,1678,1408,270,-9,-174,56
1,1994,1912,82,3,568,137
1,1711,1822,-111,-2,-152,71
-1,1474,1618,-144,0,66,88
-1,1666,1877,-211,0,-285,114
1,1500,1500,0,4,106,46
-1,1215,1616,-401,-3,-230,138
-1,1829,1278,551,-2,-20,44
-1,1609,1392,217,1,8,58
-1,1871,1911,-40,-4,-177,57
-1,1864,1502,362,1,54,90
1,1594,1610,-16,1,18,49
-1,1573,1533,40,-2,-130,74
1,1339,1412,-73,3,85,53
1,1452,1471,-19,-1,-40,55
-1,1725,1801,-76,-1,-557,116
-1,1510,1658,-148,-5,-223,82
-1,1752,1823,-71,5,121,52
1,1823,1418,405,0,108,67
1,1629,1591,38,2,167,69
1,1274,1371,-97,1,333,99
-1,2110,1900,210,0,-50,70
1,1792,1435,357,16,316,43
-1,1921,1838,83,0,15,88
1,1466,1416,50,-1,67,90
1,1454,1658,-204,0,51,101
-1,1666,1503,163,1,40,98
1,1883,1661,222,0,210,111
1,1480,1561,-81,-4,-98,43
1,1548,1515,33,3,105,56
-1,1743,1833,-90,0,-7,68
-1,1508,1640,-132,-1,-73,60
1,1716,1795,-79,0,140,55
1,1719,1822,-103,0,40,111
-1,1428,1662,-234,3,-32,152
-1,1432,1580,-148,0,-28,70
-1,1416,1199,217,0,-56,106
-1,1520,1648,-128,-11,-240,46
1,1729,1780,-51,1,124,81
1,1653,1482,171,-1,85,127
1,1587,1425,162,-1,16,43
-1,1656,1512,144,0,651,108
-1,1542,1677,-135,-3,-139,60
1,1525,1085,440,7,152,49
1,1556,1732,-176,4,233,123
1,1418,1593,-175,-4,-62,55
1,1741,1766,-25,-1,-86,119
1,1625,1599,26,1,127,87
-1,1696,1743,-47,-1,-74,78
-1,1655,1889,-234,-2,-337,122
1,1729,1861,-132,0,170,139
1,1580,1640,-60,7,543,97
1,1779,1632,147,-5,80,73
1,1477,1368,109,0,32,55
1,1680,1204,476,0,479,153
1,1753,1753,0,1,718,89
-1,1577,1362,215,-1,-15,52
1,1826,1385,441,-1,277,115
-1,1416,1465,-49,-4,-133,62
-1,1581,1641,-60,1,-4,108
1,1989,1735,254,9,277,49
1,1588,1385,203,8,485,109
-1,1764,1741,23,-5,-270,137
1,1841,1531,310,1,60,51
-1,1426,1285,141,-1,-348,66
-1,1626,1617,9,0,-46,58
-1,1747,1649,98,-1,-320,116
-1,1454,1590,-136,-2,-30,52
1,1515,1559,-44,-4,-98,43
1,1501,1500,1,7,474,59
-1,1329,1357,-28,-3,-311,88
1,1653,1545,108,0,4,57
1,1329,1614,-285,1,90,51
1,1487,1727,-240,1,7,45
-1,1744,1982,-238,-5,-173,63
1,1895,1650,245,0,44,119
-1,1797,1594,203,-2,-235,72
1,1400,1377,23,-1,-46,51
-1,1377,1635,-258,-2,-82,96
-1,1752,1754,-2,-1,-119,126
-1,1522,1635,-113,-2,-146,60
-1,1471,1681,-210,-1,-43,60
-1,1570,1522,48,-11,-585,88
1,1742,1908,-166,0,280,103
-1,1740,1987,-247,-1,-44,54
1,1379,1410,-31,-2,-114,81
1,1954,1753,201,5,63,55
-1,1742,1766,-24,-9,36,40
1,1594,1363,231,3,697,107
1,1642,1383,259,-3,-157,75
-1,1505,1692,-187,-1,-82,57
1,1732,1776,-44,4,490,79
-1,1331,1845,-514,-1,-15,50
1,1760,1557,203,0,101,65
1,1648,1349,299,7,187,47
-1,1744,1763,-19,-1,-293,146
1,1860,1612,248,2,54,67
1,1661,1490,171,-1,-21,59
1,1467,1697,-230,10,172,47
1,1390,1599,-209,0,303,75
-1,1345,1486,-141,-15,-435,106
0,1345,1462,-117,0,-94,100
-1,1597,1713,-116,0,39,96
1,1527,1643,-116,-1,-78,79
1,1519,1650,-131,3,78,47
1,1367,1470,-103,2,52,41
-1,1405,1485,-80,-2,-289,108
-1,1500,1489,11,-4,-18,46
1,1893,1758,135,10,273,55
1,1771,1813,-42,-4,-7,89
-1,1959,1748,211,0,-13,90
1,1305,1545,-240,-1,-12,53
-1,1585,1551,34,3,-19,54
1,1653,1581,72,-1,-373,99
-1,1339,1419,-80,-3,-126,68
-1,1552,1529,23,-5,-389,86
1,1482,1420,62,-3,-23,61
1,1734,1774,-40,-9,-430,71
1,1683,1597,86,0,-9,57
1,1651,1572,79,3,120,55
1,1776,1495,281,-1,-36,57
1,1424,958,466,16,497,47
-1,1502,1351,151,-1,-325,164
1,1789,1991,-202,-3,21,85
-1,1745,1762,-17,-7,-314,58
-1,1319,1457,-138,-1,-249,90
1,1797,1621,176,0,87,59
-1,1412,1410,2,0,-95,62
1,1666,1433,233,0,26,71
1,1899,1797,102,1,61,93
1,2161,1564,597,7,386,79
-1,1566,1338,228,1,-46,110
-1,1512,1473,39,1,20,78
1,1444,1640,-196,-2,6,67
-1,1645,1735,-90,0,-127,74
1,1262,1251,11,1,403,81
-1,1735,1772,-37,-1,-119,60
-1,1976,1886,90,-1,-48,58
-1,1615,1805,-190,-1,-241,72
-1,1547,1686,-139,-3,-549,160
-1,1563,2162,-599,0,-27,70
1,1726,1782,-56,12,595,105
-1,1399,1531,-132,-6,-158,62
1,1849,1963,-114,-5,-40,87
-1,1592,1605,-13,1,-17,86
1,1813,1609,204,0,3,65
1,1592,1549,43,-1,-10,63
-1,1429,1531,-102,-4,-4,48
1,1574,1647,-73,-1,255,107
-1,1589,1500,89,-3,-104,47
1,1847,1668,179,0,-6,43
1,2163,1562,601,4,12,89
-1,1578,1604,-26,-7,-545,80
-1,1474,1648,-174,-1,-258,107
-1,1744,2003,-259,-3,-455,105
-1,1738,1769,-31,-3,-65,48
-1,1559,1834,-275,1,28,98
1,1730,1482,248,2,27,73
-1,1491,1534,-43,7,89,40
-1,1572,1365,207,-2,-106,60
1,1789,1907,-118,0,44,57
-1,1551,1539,12,-3,-373,99
1,1518,1398,120,7,113,45
1,1505,1637,-132,1,8,57
-1,1451,1722,-271,-5,-47,54
-1,1729,1780,-51,0,346,124
-1,1396,1526,-130,-3,-58,82
1,1673,1554,119,-5,-93,80
-1,1636,1820,-184,0,24,76
1,1427,1362,65,8,415,67
1,1494,1275,219,2,63,49
-1,1425,1514,-89,0,82,72
-1,1606,1902,-296,1,-301,78
-1,1512,1610,-98,1,-487,106
-1,1593,1731,-138,-1,-53,78
1,1778,1456,322,6,233,71
-1,1684,1579,105,-6,-101,52
1,2007,1949,58,-3,23,79
-1,1326,1235,91,-7,-377,80
-1,1459,1349,110,-1,-6,72
1,1563,1661,-98,-3,-120,49
1,1506,1676,-170,-2,-20,47
1,1827,1630,197,1,117,87
1,1720,1672,48,-10,-184,49
1,1383,1500,-117,6,280,97
1,1800,1657,143,3,275,117
1,1796,1537,259,0,13,61
-1,1854,2168,-314,0,3,48
-1,1881,1873,8,-9,-668,116
-1,1366,1542,-176,-1,-114,72
1,1722,1682,40,-3,-26,79
-1,1805,1680,125,-3,-96,54
-1,1613,1976,-363,-3,-85,53
1,1302,1873,-571,-1,-18,44
1,2009,1851,158,0,19,57
-1,1709,2173,-464,0,-145,88
1,1496,1509,-13,-3,-58,63
1,1474,1658,-184,4,27,43
1,1342,1427,-85,1,153,77
-1,1428,1443,-15,-3,-54,60
-1,1769,2018,-249,0,-68,88
1,1520,1271,249,15,622,63
-1,1339,1557,-218,-6,-118,60
0,2175,1707,468,0,155,107
-1,1462,1249,213,0,-361,126
1,1801,1500,301,0,-13,61
1,1613,1532,81,-2,186,41
-1,1536,1532,4,0,-86,76
1,1648,1644,4,0,22,57
1,1791,1718,73,2,103,57
-1,1354,1766,-412,-6,-41,46
1,1885,1804,81,0,13,102
-1,1550,1764,-214,-5,-175,48
-1,1846,1893,-47,-1,-292,100
-1,1874,1636,238,0,6,86
1,1554,1360,194,-5,171,175
1,1432,1420,12,4,355,79
-1,1609,1642,-33,-4,-69,50
-1,1515,1490,25,-4,-122,62
1,1742,1138,604,2,33,43
1,1770,1545,225,-1,-39,47
1,1608,1982,-374,1,49,57
-1,1603,1705,-102,-3,-153,68
1,1855,2027,-172,-3,-61,89
-1,1551,1459,92,-2,-741,166
1,1534,1623,-89,0,129,83
-1,1567,1478,89,-9,-112,40
1,1462,1429,33,2,242,81
1,1805,1523,282,0,39,99
-1,1427,1399,28,-2,-227,68
-1,1507,1443,64,-2,-222,72
1,1770,1696,74,-3,-63,51
1,1562,1333,229,-3,-48,52
1,1776,1518,258,-1,39,111
1,2003,1946,57,-1,307,131
1,1672,1733,-61,0,260,99
1,1367,1353,14,3,141,93
1,1502,1487,15,1,257,77
1,1702,1358,344,0,19,77
1,1590,1791,-201,0,0,50
1,1487,1530,-43,1,237,81
0,1356,1147,209,-5,-19,131
-1,1595,1653,-58,-1,-195,112
1,1628,1960,-332,2,388,87
-1,1799,1835,-36,0,-21,102
1,1246,1360,-114,16,803,71
-1,1302,1615,-313,0,12,46
1,1936,2012,-76,0,1,85
1,1492,1529,-37,0,-21,57
-1,1712,1668,44,0,130,104
1,1539,1312,227,-3,265,145
1,1720,1685,35,7,90,43
1,1573,1323,250,4,515,89
1,1794,1489,305,5,478,109
-1,1745,1949,-204,-4,-132,48
-1,1443,1447,-4,-1,-5,42
-1,1267,1539,-272,-3,-44,50
-1,1351,1660,-309,0,-41,98
1,1177,1420,-243,1,4,43
1,1871,1613,258,-1,-45,65
-1,1674,1904,-230,-1,-41,44
0,1999,1950,49,-1,210,120
-1,1441,1601,-160,0,-38,72
1,1939,1648,291,9,199,53
-1,1215,1460,-245,-2,-291,74
0,1583,1593,-10,2,465,111
0,1870,1887,-17,0,-150,145
-1,1893,2032,-139,-2,-15,62
1,1725,2023,-298,0,201,107
1,1673,1586,87,0,43,71
1,1850,1539,311,2,35,45
1,1705,1691,14,1,157,79
-1,1553,1609,-56,0,-146,100
-1,1644,1943,-299,0,-441,114
-1,1555,1465,90,1,-361,176
1,1862,1535,327,-3,7,59
1,1641,1544,97,3,118,75
1,1544,1232,312,2,42,51
1,1445,1298,147,6,295,51
-1,1475,1537,-62,5,119,46
1,1346,1459,-113,-1,-33,67
1,1999,1700,299,0,3,65
-1,1745,1961,-216,0,-3,40
-1,1577,1690,-113,0,-81,98
0,1354,1508,-154,1,19,154
-1,1436,1669,-233,-7,-364,66
-1,1469,1510,-41,0,-229,76
1,1516,1605,-89,-2,-31,59
1,1909,1786,123,0,39,77
1,1596,1180,416,-8,-26,43
1,1720,1465,255,5,331,70
1,1606,1739,-133,-2,-61,145
-1,1413,1580,-167,-6,-257,100
1,1740,1707,33,2,35,49
-1,1548,1544,4,-1,-137,68
1,1873,1697,176,0,-85,65
-1,1581,1885,-304,-1,-17,58
-1,1206,1547,-341,-2,-15,54
1,1354,1283,71,0,-16,63
-1,1275,1384,-109,-4,-243,104
-1,1933,2016,-83,1,-43,48
0,1254,1362,-108,3,325,121
1,1451,1463,-12,-1,371,153
-1,1750,1691,59,1,-257,72
-1,1525,1520,5,-6,-297,130
-1,1886,1961,-75,0,2,42
1,1947,1641,306,1,116,65
-1,1460,1739,-279,2,46,56
1,1790,1832,-42,0,-12,73
-1,1847,1907,-60,-2,-60,60
-1,1470,1798,-328,-2,-66,56
1,1716,1586,130,1,469,93
-1,1451,1346,105,7,47,54
-1,1550,1674,-124,-5,-117,48
-1,1450,1347,103,0,0,44
1,1598,1549,49,5,258,57
1,1931,1741,190,0,99,65
-1,1454,1591,-137,0,6,82
0,1520,1451,69,-1,-1,94
-1,1737,1704,33,-1,27,82
-1,2024,1924,100,-5,-174,72
1,1755,1456,299,5,237,85
1,1705,1779,-74,1,15,49
-1,1347,1406,-59,-2,-127,58
-1,1682,1860,-178,-6,-76,50
1,1686,1883,-197,2,78,57
1,1766,1443,323,2,78,47
1,1474,1441,33,18,543,53
-1,1413,1523,-110,-3,-795,132
-1,1970,1877,93,-1,-140,132
-1,1545,1778,-233,-1,-44,42
-1,1690,1716,-26,0,-290,98
-1,1457,1578,-121,-2,-113,112
1,1951,1637,314,2,130,71
-1,1485,1643,-158,0,-4,62
1,1416,1500,-84,7,423,81
-1,1193,1801,-608,-6,-393,98
1,1534,1730,-196,2,133,119
-1,1629,1342,287,-4,-241,144
-1,1429,1929,-500,-10,-108,40
-1,1451,1769,-318,-3,-4,98
-1,1362,1435,-73,0,-3,54
-1,1650,1684,-34,2,37,76
1,1259,1676,-417,-1,-67,81
1,1513,1368,145,2,146,82
1,1783,1538,245,-1,-48,51
-1,1544,1736,-192,2,-44,110
-1,1577,1468,109,2,193,76
-1,1369,1170,199,1,149,128
1,1479,1438,41,4,266,71
-1,1921,1675,246,-3,-487,134
1,1866,1730,136,-3,-62,69
1,1598,1446,152,1,245,95
1,1910,1947,-37,0,1,65
-1,1455,1518,-63,0,-589,125
1,1258,1429,-171,-2,282,171
-1,1588,1730,-142,-1,-163,94
0,1724,1709,15,0,-61,101
1,1500,1673,-173,1,405,125
0,1379,1316,63,-3,-708,171
1,2003,1379,624,0,-209,89
1,1781,1448,333,7,410,83
1,1659,1433,226,2,18,52
-1,1940,1770,170,1,-7,89
-1,1629,1723,-94,10,129,48
1,1768,1377,391,3,300,99
1,1947,1802,145,1,-7,55
1,1583,1589,-6,1,100,75
-1,2011,1873,138,0,-63,84
-1,1471,1459,12,-1,2,72
-1,1656,1780,-124,0,-138,61
-1,1884,2045,-161,0,22,50
1,1640,1539,101,2,126,61
-1,1911,1551,360,1,-549,170
-1,1734,1844,-110,-1,-8,46
0,1209,1540,-331,2,23,110
-1,1444,1791,-347,0,1,62
-1,1449,1312,137,3,120,72
1,1495,1370,125,6,223,55
-1,1868,1770,98,0,-23,116
1,1852,2004,-152,1,213,115
-1,1801,2113,-312,0,132,104
0,1660,1535,125,0,-879,136
1,1710,1720,-10,-1,92,105
-1,1500,1385,115,-1,-13,44
1,2051,1877,174,0,-13,43
1,1826,1350,476,0,7,47
1,1743,1581,162,-9,51,81
1,1519,1631,-112,1,175,57
1,1578,1445,133,8,646,77
-1,1558,1735,-177,0,-15,52
-1,1440,1605,-165,-6,-179,59
1,1801,1440,361,-1,131,57
-1,1803,1520,283,-6,-183,54
1,1984,1869,115,4,68,41
1,1890,1829,61,1,50,74
-1,1889,1996,-107,0,-16,84
-1,1527,1439,88,-1,-158,90
-1,1484,1526,-42,-2,-162,93
-1,1870,2058,-188,0,9,70
1,1861,1994,-133,2,96,69
1,1648,1543,105,-3,-27,67
-1,1696,1870,-174,-2,-235,72
1,1352,1361,-9,2,487,95
-1,1319,1358,-39,0,-5,62
1,1542,1425,117,1,89,83
1,1795,1956,-161,0,17,101
-1,1571,1693,-122,-1,3,54
-1,1743,1940,-197,0,77,48
1,1975,1877,98,-1,17,43
-1,1548,1782,-234,0,-53,82
-1,1437,1809,-372,0,206,88
-1,1868,1985,-117,1,-189,112
1,1149,1042,107,-3,42,49
-1,1637,1717,-80,-3,-10,88
0,1668,1673,-5,-2,146,114
-1,1433,1678,-245,-1,-203,123
1,1711,1728,-17,0,24,103
1,1994,1860,134,1,130,107
1,1186,1384,-198,4,89,67
1,1642,1549,93,1,83,57
1,1551,1437,114,3,82,51
1,1701,1533,168,4,289,77
-1,1542,1489,53,4,22,46
1,1783,1409,374,14,330,44
1,1657,1539,118,2,-67,73
0,2064,1863,201,-5,-53,113
-1,1561,1669,-108,-1,48,62
-1,1881,2003,-122,-3,-58,50
-1,1467,1531,-64,0,-75,42
1,1434,1327,107,11,393,55
-1,1467,1803,-336,1,8,46
-1,1672,1668,4,2,-37,58
-1,1540,1727,-187,9,724,96
1,1657,1545,112,3,399,111
-1,1717,2003,-286,-3,-137,62
-1,1504,1528,-24,-12,-615,80
-1,1275,1429,-154,-8,-320,66
1,1733,1534,199,3,130,65
1,1679,1620,59,-1,20,59
1,2007,1713,294,7,243,61
-1,1545,1571,-26,-3,-460,80
-1,1724,1786,-62,-1,-37,84
-1,1528,1739,-211,-7,-670,104
-1,1594,1549,45,-2,22,66
-1,1347,1399,-52,-3,-187,58
1,1501,1482,19,-1,-116,105
1,1709,2012,-303,-1,128,81
1,1560,1806,-246,1,-4,43
1,1725,1626,99,1,4,43
-1,1870,2058,-188,-4,-80,70
1,1531,1539,-8,-3,53,107
1,2011,1708,303,1,56,65
-1,1786,1901,-115,-9,44,128
-1,1742,1538,204,0,-148,120
1,1500,2046,-546,1,58,51
1,1665,1429,236,0,150,87
1,1529,1431,98,11,113,40
-1,1744,1523,221,1,-277,136
1,1989,1729,260,0,18,53
-1,1774,1583,191,-1,-119,68
1,1541,1457,84,5,392,101
-1,1392,1299,93,-2,-32,54
-1,1740,1527,213,6,91,50
-1,1725,1994,-269,1,61,46
-1,1644,1800,-156,-2,-159,86
0,1442,1359,83,0,485,107
1,1319,1342,-23,0,8,45
-1,1683,1683,0,0,-9,50
1,1541,1726,-185,-2,455,111
-1,1778,1910,-132,0,-40,52
-1,1526,1662,-136,-2,-258,95
-1,1644,1795,-151,-2,-76,70
-1,1999,1720,279,-2,5,110
1,1578,1436,142,2,42,53
1,1268,1424,-156,1,329,83
1,1936,1812,124,3,185,69
-1,1265,1403,-138,0,-5,56
1,1348,1378,-30,2,92,55
1,2064,1863,201,2,133,121
1,1709,1558,151,6,213,59
-1,1541,1680,-139,0,-36,82
-1,1423,1500,-77,-8,-62,40
1,1740,1976,-236,-2,-29,59
1,1986,2026,-40,-1,-25,95
-1,1481,1501,-20,1,-13,98
1,1598,1542,56,2,34,53
-1,1551,1716,-165,2,101,68
-1,1230,1769,-539,-23,-511,44
-1,2014,1954,60,0,107,82
1,1955,1759,196,6,167,51
-1,1466,1511,-45,0,-253,108
-1,1578,1721,-143,-10,-348,68
-1,1709,1711,-2,-11,-223,54
-1,1428,1429,-1,2,177,68
1,1753,1961,-208,0,-5,53
1,1723,1331,392,3,55,53
-1,1586,1500,86,0,5,66
-1,1941,1771,170,-3,-166,58
-1,1474,1544,-70,1,25,56
-1,1424,1842,-418,-5,-80,48
-1,1498,1294,204,0,-22,84
-1,1740,1611,129,-1,-307,126
-1,1991,1980,11,-1,-39,66
-1,1690,1529,161,-7,26,72
1,1161,0,1161,17,755,61
1,1788,1922,-134,2,146,71
1,1310,1385,-75,1,26,50
1,1943,1746,197,-3,13,99
-1,1409,1465,-56,-5,-171,56
1,1969,2001,-32,0,134,91
1,1948,1771,177,2,109,77
1,1518,1452,66,0,53,77
1,1857,2069,-212,-2,-100,59
1,1623,1500,123,7,857,125
1,1904,1805,99,0,407,65
-1,1303,1382,-79,-7,-710,100
1,1673,1785,-112,-5,566,117
-1,1671,1723,-52,0,41,72
1,1723,1576,147,-1,-67,83
1,1677,1554,123,-8,-61,51
1,1796,1913,-117,0,-79,75
1,1648,1374,274,1,507,107
-1,1431,1426,5,-6,-199,78
1,1845,1704,141,0,-2,57
1,1955,1729,226,0,29,67
-1,1661,1945,-284,-1,-14,45
1,1733,1662,71,-1,-6,61
-1,1725,1738,-13,-2,-16,48
1,1804,1709,95,0,22,65
1,1876,1463,413,1,1,55
1,1664,1321,343,1,1095,123
1,1896,1811,85,-1,-60,71
-1,1291,1406,-115,-4,-273,60
1,1989,1915,74,0,79,121
-1,1802,1906,-104,-5,-688,76
-1,1182,1464,-282,-3,-121,66
1,1653,1743,-90,0,102,67
1,1221,1211,10,-2,-94,54
1,1570,1799,-229,10,215,49
0,1451,1568,-117,-1,121,148
1,1879,1699,180,3,156,85
-1,1676,1287,389,1,115,86
1,1749,1715,34,2,156,59
-1,1437,1375,62,-1,8,58
1,1409,1417,-8,2,995,133
-1,1786,1924,-138,-6,-282,60
-1,1615,1478,137,0,176,74
1,1500,1500,0,0,12,61
-1,1546,1684,-138,-1,-231,117
1,1954,1809,145,3,191,81
-1,1639,1198,441,-16,-339,40
-1,1667,1683,-16,-1,-3,40
-1,1324,1550,-226,-4,-558,77
-1,1556,1725,-169,-3,-133,68
1,1931,1779,152,4,335,71
0,1688,1728,-40,-1,-29,102
-1,1772,1494,278,1,67,60
-1,1291,1312,-21,1,-97,88
-1,1693,1885,-192,-1,-106,78
1,1190,1293,-103,0,60,55
1,1658,1761,-103,2,37,53
-1,1772,1939,-167,0,-142,90
1,1343,1723,-380,-2,-50,125
-1,1762,1801,-39,-1,-456,152
-1,1192,1278,-86,-1,-46,66
1,1680,1594,86,0,5,43
1,1500,1332,168,5,71,43
1,1612,1595,17,-1,217,87
-1,1430,1564,-134,-1,-39,72
-1,1705,1759,-54,-2,-1,40
1,1233,1616,-383,11,163,47
-1,1946,1766,180,-7,-453,78
1,1892,1688,204,0,16,55
0,1735,1536,199,1,79,184
-1,1443,1468,-25,-3,-49,54
-1,1275,1423,-148,-9,-371,100
-1,1783,1928,-145,0,-59,58
-1,1585,1746,-161,-1,-244,106
1,1670,1674,-4,-1,-47,91
-1,1371,1277,94,-14,-511,56
1,1935,1776,159,14,382,73
-1,1950,1702,248,-2,-91,72
1,1539,1482,57,0,35,69
1,1802,1635,167,0,-1,47
-1,1652,1928,-276,-1,-158,70
1,1178,1424,-246,1,32,57
1,1692,1606,86,-2,-71,51
1,1377,1469,-92,3,365,103
-1,1399,1160,239,-3,-149,64
1,1769,1942,-173,1,164,65
1,1422,1404,18,-1,252,77
1,1687,1617,70,0,85,69
-1,1932,1680,252,2,-136,68
-1,1593,1267,326,-3,-185,62
1,1695,1474,221,1,152,59
1,1421,1604,-183,0,-1,95
-1,1729,1736,-7,-1,-59,92
1,1323,1500,-177,4,263,99
1,1357,1495,-138,5,89,49
-1,1460,1292,168,2,51,46
1,1924,1786,138,8,502,81
0,1500,1409,91,0,127,150
0,1375,1474,-99,2,50,42
0,1657,1678,-21,0,0,79
-1,1562,1809,-247,0,-13,54
-1,1698,1914,-216,1,93,84
1,1933,1648,285,2,20,43
-1,1778,1932,-154,-6,-504,92
1,1406,1202,204,13,646,63
-1,1791,1511,280,0,-127,126
1,1394,1555,-161,2,142,61
1,1919,1693,226,-2,32,53
-1,1343,1431,-88,2,7,44
-1,1606,1904,-298,-3,-165,90
1,1808,1629,179,-1,-27,77
-1,1939,1772,167,-10,-151,48
-1,1688,1924,-236,-2,-149,68
-1,1644,1937,-293,-10,-228,52
1,1701,1553,148,-1,55,63
-1,1788,1922,-134,-6,-529,99
1,1812,1585,227,1,119,67
1,1630,1227,403,6,81,43
1,1929,1683,246,0,19,53
1,1702,1592,110,1,140,85
-1,1379,1310,69,-2,-17,52
-1,1566,1813,-247,0,-47,104
-1,1588,1659,-71,-8,-478,68
-1,1590,1724,-134,-4,-166,57
1,1912,1581,331,2,54,53
-1,1195,1411,-216,-4,-438,120
1,1930,1781,149,-3,7,55
1,1439,1329,110,7,452,77
-1,1549,1393,156,-1,-109,71
1,1352,1332,20,3,708,111
1,1700,1482,218,1,64,59
1,1933,1818,115,6,104,49
1,1607,1645,-38,0,346,137
-1,1774,1937,-163,0,-55,76
1,1941,1578,363,-3,7,51
1,1640,1562,78,-2,71,57
1,1919,1562,357,-2,8,65
1,1944,1767,177,1,259,91
1,1541,1384,157,-2,56,67
0,1941,1810,131,-5,-379,106
1,1614,1413,201,1,10,53
1,1815,1778,37,1,147,103
1,1761,1950,-189,-3,-61,41
-1,1546,1926,-380,0,-165,86
-1,1733,1937,-204,0,162,96
1,1932,1778,154,-1,2,57
-1,1553,1649,-96,-1,-82,86
1,1662,1467,195,0,-104,91
1,1501,1493,8,-1,-21,45
1,1451,1468,-17,0,-44,77
1,1710,1757,-47,3,127,62
-1,1561,1656,-95,0,12,68
-1,1771,1939,-168,-10,-188,80
1,1324,1532,-208,-1,-40,55
-1,1409,1391,18,4,231,74
1,1726,1943,-217,0,5,63
1,1984,1246,738,2,265,71
1,1447,1321,126,2,25,45
1,1946,1765,181,-4,120,69
1,1925,1747,178,-1,-42,61
-1,1391,1347,44,0,73,64
-1,1931,1533,398,2,128,74
-1,1809,1916,-107,-8,-178,50
-1,1372,1416,-44,-4,-168,66
-1,1759,1952,-193,-3,-76,60
-1,1740,1931,-191,6,55,46
1,1360,1464,-104,0,-165,141
-1,1727,1726,1,-7,-19,48
-1,1266,1397,-131,-7,-159,42
1,1937,1733,204,2,11,83
1,1958,1753,205,-6,941,139
1,1475,1427,48,4,233,77
1,1737,1715,22,-1,-31,55
-1,1664,1490,174,-1,-432,84
-1,1688,1768,-80,0,-12,48
-1,1636,1892,-256,-1,-150,67
-1,1483,1574,-91,-9,-233,54
-1,1727,1942,-215,0,-2,68
1,1679,1814,-135,4,77,51
-1,1825,2089,-264,0,5,94
1,1658,1545,113,-1,13,45
1,1748,1964,-216,0,26,77
-1,1500,1761,-261,-5,-103,52
1,1470,1397,73,-2,40,55
0,1454,1278,176,0,627,109
-1,1945,1765,180,-2,-88,62
-1,1705,1948,-243,0,-585,116
1,1259,1343,-84,0,213,76
-1,1406,1515,-109,-5,-269,76
1,1777,1665,112,-2,-28,47
-1,1782,1928,-146,0,-15,64
0,1984,1800,184,0,-116,121
0,1952,1701,251,1,74,95
-1,1508,1648,-140,-1,-21,58
1,1935,1775,160,4,454,99
1,1707,1945,-238,-4,-154,59
0,1915,1944,-29,3,246,112
1,2002,1709,293,0,80,87
-1,1402,1522,-120,-2,-107,79
1,1560,1416,144,-3,-136,79
1,1568,1729,-161,0,342,107
-1,1712,1604,108,-10,-69,92
1,1344,1452,-108,0,242,109
-1,1462,1516,-54,-1,-18,50
-1,1696,1644,52,-2,-635,136
1,1419,1604,-185,0,-17,67
-1,1805,1742,63,-1,-69,62
-1,1603,2007,-404,-4,-117,64
-1,1480,1515,-35,3,-25,64
-1,1636,1372,264,-2,-31,44
-1,1352,1863,-511,-1,12,44
1,1671,1448,223,0,18,47
1,1705,1605,100,-1,51,129
1,1569,1756,-187,-1,-3,73
-1,1634,1594,40,0,15,66
1,2095,1983,112,1,28,63
1,1511,1595,-84,4,567,101
1,1414,1238,176,0,71,53
-1,1476,1600,-124,-7,-276,56
1,1587,1530,57,0,339,127
-1,1623,1658,-35,-2,-576,82
1,1797,1681,116,6,477,109
1,1668,1525,143,3,380,93
-1,1452,1185,267,2,-88,70
-1,1545,1619,-74,0,-61,110
-1,1423,1676,-253,-2,-279,84
-1,1393,1616,-223,-5,-321,100
-1,1443,1465,-22,-3,183,64
1,1729,1867,-138,-5,37,49
-1,1622,1658,-36,0,-10,60
1,1619,1332,287,3,231,107
-1,1338,1319,19,-9,-480,74
-1,1521,1665,-144,0,23,74
0,1373,1425,-52,2,93,142
-1,1587,1757,-170,2,51,82
1,1680,1419,261,-1,111,57
-1,1804,1605,199,-4,-354,144
1,1974,1842,132,-3,-1,53
1,1543,1680,-137,1,52,79
1,1436,1435,1,0,0,75
-1,1506,1268,238,-7,-854,118
1,1863,1612,251,3,162,63
-1,1622,1630,-8,0,29,40
-1,1415,1685,-270,-2,-122,94
1,1404,1383,21,2,107,55
1,1597,1520,77,0,183,171
1,1433,1217,216,-6,269,115
1,1585,1029,556,3,360,71
1,1833,1784,49,-1,-15,41
1,1876,1608,268,1,59,67
1,1512,1252,260,10,178,45
-1,1664,1982,-318,2,1,152
1,1468,1392,76,0,394,97
-1,1237,1434,-197,0,13,72
-1,1534,1541,-7,-1,-45,40
-1,1331,1327,4,-4,-102,70
1,1668,1482,186,-1,119,91
1,1844,1594,250,1,6,41
1,1265,1456,-191,0,10,61
-1,1888,1911,-23,0,-8,64
-1,1689,1411,278,-6,-430,102
-1,1740,1767,-27,-1,0,46
-1,1540,1573,-33,1,28,42
1,2013,1600,413,-1,131,81
1,1416,1388,28,0,54,47
-1,1422,1448,-26,-11,-123,46
1,1492,1688,-196,-2,-19,41
1,1495,1500,-5,6,529,85
1,1622,1672,-50,0,16,55
-1,1276,1404,-128,-5,-276,58
-1,1423,1375,48,-1,18,64
1,1722,1588,134,0,-1,79
-1,1298,1256,42,-11,-212,54
1,1590,1389,201,2,95,101
-1,1430,1670,-240,-6,-247,63
1,1605,1400,205,1,57,73
-1,1532,1525,7,-1,-160,80
-1,1463,1414,49,1,30,60
1,1440,1222,218,6,341,69
1,1583,1530,53,1,145,65
-1,1477,1458,19,-8,-267,76
1,1380,1376,4,2,295,131
-1,1757,1835,-78,0,-5,87
0,1860,1698,162,0,-248,119
1,1857,1500,357,-3,491,139
-1,1509,1499,10,-1,-388,148
1,1674,1425,249,4,86,53
1,2026,1702,324,0,62,67
1,1810,1028,782,3,448,79
-1,1525,1671,-146,-2,-130,56
-1,1986,1882,104,-1,-94,66
1,1636,1652,-16,0,-30,57
-1,1703,1847,-144,0,-76,90
1,1285,1189,96,6,103,55
-1,1558,1661,-103,-1,-39,64
-1,1679,1531,148,0,-18,50
1,1611,1421,190,7,338,65
1,1376,1521,-145,0,134,79
1,1651,1592,59,2,64,43
-1,1326,1695,-369,0,9,48
1,1737,1698,39,2,172,63
-1,1606,1864,-258,-1,-14,40
-1,1586,1401,185,-1,-86,78
1,1427,1211,216,1,-2,45
1,1419,1410,9,1,129,99
-1,1387,1329,58,0,-123,94
-1,1207,1540,-333,-1,-115,52
1,1538,1612,-74,5,421,72
1,1465,1415,50,3,127,69
1,1616,1744,-128,1,23,49
-1,1774,1969,-195,0,-131,116
-1,1727,1525,202,0,-51,106
1,1400,1630,-230,0,122,59
-1,1730,2019,-289,-1,-201,110
1,1793,1678,115,-1,-1,45
1,1518,1508,10,3,230,89
1,1696,1874,-178,-1,98,61
1,1539,1429,110,-1,1298,151
1,1815,1517,298,-1,47,87
-1,1294,1373,-79,-5,-270,64
1,1896,1758,138,0,19,49
-1,1383,1595,-212,-1,-5,62
1,1666,1605,61,-1,-94,87
-1,1583,1661,-78,-1,-53,54
1,1640,1648,-8,-1,-20,43
-1,2164,1837,327,-1,-110,98
-1,1369,1375,-6,3,56,78
1,1432,1138,294,-15,-308,55
1,1503,1412,91,3,167,51
1,1640,1287,353,-2,15,83
-1,1755,1865,-110,-2,-61,68
-1,1476,1503,-27,-2,-83,52
1,1461,1418,43,0,30,43
-1,1879,2136,-257,0,-269,116
-1,1604,1801,-197,-3,-327,156
1,1500,1536,-36,3,181,57
-1,1581,1729,-148,-1,-16,41
-1,1417,1507,-90,3,22,80
1,1844,1547,297,2,360,101
-1,1693,1938,-245,0,-89,68
-1,1713,1668,45,0,185,140
1,1478,1500,-22,7,150,47
-1,1551,1545,6,-3,-521,106
1,1348,1270,78,2,18,47
1,2143,1870,273,0,107,65
-1,1671,1976,-305,0,-21,58
1,1636,1652,-16,-1,-12,45
-1,1285,1408,-123,-7,-157,57
1,1427,1420,7,0,-68,111
1,1639,1328,311,-1,-25,43
-1,1862,1922,-60,8,223,40
-1,1714,1865,-151,-2,-543,142
-1,1491,1498,-7,1,-41,56
1,1861,1574,287,0,48,60
-1,1659,1943,-284,-2,-30,70
1,1931,1844,87,7,427,73
1,1450,1077,373,2,76,77
-1,1436,1528,-92,-2,-111,56
1,1391,1312,79,1,232,123
1,1601,1377,224,2,65,61
0,1386,1338,48,1,139,107
-1,1416,1505,-89,-7,-159,54
-1,1688,1748,-60,-12,-435,118
1,1587,1513,74,-3,-161,89
1,1828,1939,-111,0,112,81
1,1629,1349,280,10,504,59
-1,1599,1660,-61,0,-72,74
1,1409,1515,-106,0,86,101
1,1211,1356,-145,-5,-20,55
1,1854,1564,290,0,-52,71
-1,1438,1368,70,4,76,52
1,1787,1790,-3,3,99,54
1,1514,1554,-40,2,102,71
-1,1421,1547,-126,-1,-135,60
-1,1751,1571,180,2,61,78
-1,1640,1648,-8,2,-27,54
1,1560,1861,-301,1,19,67
-1,1430,1418,12,-2,-3,40
-1,1498,1860,-362,-1,-143,76
1,1534,1375,159,1,11,45
-1,1480,1551,-71,0,-92,60
1,1656,1613,43,0,247,75
-1,1513,1848,-335,-6,-365,82
0,1390,1813,-423,-2,-276,142
1,1281,1342,-61,-1,35,91
1,1827,1580,247,1,86,69
-1,1529,1392,137,-2,-64,76
-1,1564,1540,24,5,107,74
1,1384,1540,-156,2,40,69
1,1346,1305,41,-5,-136,63
1,1747,1735,12,-3,-190,89
-1,1954,1831,123,-1,-95,77
-1,1576,1835,-259,0,-7,56
1,1870,1587,283,1,182,85
-1,1372,1606,-234,-6,-182,66
-1,1726,1497,229,-1,-69,64
1,1545,1455,90,3,41,45
1,1707,1500,207,0,166,74
-1,1368,1540,-172,-3,-126,56
-1,1423,1501,-78,-6,-167,54
1,1842,1571,271,1,41,59
1,1524,1400,124,-3,17,57
1,1471,1302,169,2,43,53
1,1638,1631,7,-3,-183,87
-1,1821,1528,293,1,-217,92
1,1386,1513,-127,0,547,129
-1,1407,1513,-106,0,0,72
1,1412,1413,-1,0,725,99
1,1567,1849,-282,3,22,59
1,1622,1552,70,4,98,45
1,1659,1629,30,0,7,45
1,1418,1532,-114,2,101,53
-1,1295,1415,-120,-7,-140,48
1,1685,1203,482,0,6,51
-1,1353,1409,-56,-3,-55,68
-1,1621,1818,-197,0,-87,88
-1,1324,1536,-212,-2,-68,40
1,1508,1622,-114,0,128,65
1,1398,1391,7,2,42,41
1,1691,1430,261,2,71,59
-1,1534,1444,90,1,-190,92
0,1393,1500,-107,0,-105,130
-1,1534,1526,8,0,32,54
-1,1712,1714,-2,0,-259,140
1,1827,1600,227,0,401,117
0,1523,1456,67,-1,-21,210
1,1400,1319,81,0,98,81
1,1256,1554,-298,-1,1,66
1,1708,1425,283,0,-202,85
1,1611,1367,244,6,247,55
-1,1404,1385,19,-8,-419,88
-1,1726,1800,-74,-3,-68,90
1,1287,1387,-100,5,491,158
-1,1560,1852,-292,-6,-144,53
1,1419,1631,-212,0,3,97
1,1709,1674,35,1,12,59
-1,1419,1593,-174,1,-29,60
-1,1722,1835,-113,0,21,60
-1,1312,1546,-234,-12,-220,78
-1,1517,1629,-112,-1,-123,144
-1,1619,1669,-50,-1,-7,70
0,1609,1523,86,0,101,118
-1,1438,1571,-133,-2,-170,68
1,1552,1545,7,5,616,121
-1,1066,1664,-598,-8,-163,50
-1,1590,1532,58,0,5,56
-1,1806,1567,239,-1,-139,94
1,1398,1343,55,1,227,91
1,1402,1423,-21,2,83,55
-1,1716,1694,22,0,33,64
-1,1477,1477,0,-1,-129,82
-1,1712,1500,212,-3,-62,60
-1,1787,1846,-59,0,-5,90
1,1665,1061,604,3,135,57
1,1548,1500,48,16,463,55
1,1452,1413,39,0,3,57
-1,1547,1538,9,0,-314,122
1,1551,1306,245,1,33,67
1,1446,1394,52,-1,51,63
1,1604,1408,196,2,70,57
1,1947,1678,269,1,262,97
1,1536,1381,155,-4,37,51
1,1852,1402,450,6,68,41
1,1544,1583,-39,-3,44,63
-1,1521,1468,53,-1,1,56
1,1532,1778,-246,9,111,49
-1,1041,1097,-56,-5,-283,67
1,1536,1463,73,3,238,81
-1,1666,1860,-194,-2,10,80
-1,1555,1572,-17,-1,-475,148
-1,1705,1706,-1,-8,-121,46
1,2034,1686,348,3,331,79
1,1853,1515,338,1,43,51
1,1693,1450,243,-1,-13,51
1,1399,1391,8,4,1443,135
-1,1735,1606,129,-1,-21,86
-1,1400,1542,-142,0,-95,58
1,1504,1530,-26,3,174,99
1,1431,1429,2,2,24,49
1,1560,1766,-206,0,224,143
-1,1650,1952,-302,3,12,42
-1,1694,1717,-23,0,174,94
1,1641,1460,181,-3,-91,87
-1,1553,1556,-3,-2,-50,54
1,1386,1489,-103,-1,-138,93
-1,1057,1666,-609,-4,-202,52
-1,1731,1440,291,1,-372,100
-1,1371,1650,-279,1,26,52
1,1697,1735,-38,0,12,52
1,1679,1609,70,-3,-12,83
-1,1376,1602,-226,0,-66,74
-1,1400,1475,-75,-14,-190,54
-1,1550,1536,14,-2,-18,54
1,2044,1856,188,1,25,57
-1,1421,1445,-24,-1,-69,62
1,1758,1861,-103,0,28,72
1,1572,1788,-216,2,7,43
-1,1351,1291,60,-14,-461,60
1,1656,1454,202,3,327,101
1,1302,1367,-65,1,-77,43
-1,1622,1720,-98,-1,-365,156
1,1602,1661,-59,-2,-44,47
-1,1618,1658,-40,-5,-208,54
0,1320,1312,8,-4,-129,119
-1,1408,1513,-105,-4,-144,64
-1,1973,1949,24,0,-22,84
1,1913,1748,165,0,167,103
1,1785,1858,-73,0,293,123
-1,1511,1504,7,-4,-71,46
1,1762,1720,42,-1,-62,65
-1,1624,2040,-416,0,-207,88
1,1444,1554,-110,-1,-49,71
1,1688,1677,11,1,-14,103
-1,1425,1543,-118,-1,-415,142
1,1464,1603,-139,1,528,93
-1,1540,1552,-12,-2,115,90
-1,1614,1741,-127,0,-129,60
1,1762,1620,142,0,-14,65
-1,1717,1711,6,-1,-9,40
-1,1268,1406,-138,-15,-128,40
-1,1458,1529,-71,-4,-156,50
-1,1509,1840,-331,0,-279,70
1,1748,1681,67,0,271,129
-1,1774,1756,18,0,-135,144
-1,1385,1677,-292,-2,-15,50
1,2043,1622,421,2,148,87
-1,1520,1225,295,1,11,62
-1,1442,1401,41,1,-22,94
-1,1520,1400,120,-4,-171,78
1,1609,1348,261,4,215,77
1,1783,1712,71,-2,-91,71
1,1862,1722,140,11,446,73
-1,1578,1641,-63,-3,-1033,136
1,1779,1709,70,-2,-17,117
-1,1951,1972,-21,-10,-15,40
-1,1160,1635,-475,-7,-444,78
-1,1539,1462,77,-3,-44,94
-1,1617,1760,-143,-13,-525,70
-1,1521,1637,-116,-7,-178,50
-1,1261,1729,-468,-2,-78,64
1,2142,1483,659,-1,69,129
-1,1436,1588,-152,3,99,84
1,1743,1669,74,1,270,97
-1,1291,1409,-118,-1,-78,66
-1,1500,1586,-86,0,-5,44
-1,1437,1537,-100,-1,-222,82
-1,1698,1620,78,0,23,76
0,1904,1931,-27,0,37,117
0,1732,1519,213,1,-8,95
1,1370,1452,-82,-2,-35,47
1,1983,1940,43,0,157,119
-1,1590,2048,-458,0,-34,82
1,1313,1402,-89,4,91,55
1,1728,1473,255,3,171,67
1,1774,1898,-124,-4,-77,55
-1,1447,1432,15,-1,-63,58
1,1657,1710,-53,1,84,67
1,1415,1336,79,3,47,41
0,1595,1428,167,0,-651,162
-1,1525,1726,-201,0,-176,122
0,1658,1709,-51,-1,36,138
1,1871,1635,236,0,1,45
1,1721,1894,-173,5,339,105
-1,1381,1476,-95,0,-196,70
1,1624,1597,27,0,-39,99
-1,1259,1752,-493,-13,-121,40
1,2160,1895,265,-2,-194,85
1,2050,1778,272,0,-71,77
-1,1344,1613,-269,-3,-88,48
1,1478,1620,-142,-2,-25,59
1,1931,1992,-61,-1,-95,127
-1,1615,1666,-51,2,46,46
1,1732,1519,213,1,275,87
-1,1445,1448,-3,3,7,64
1,1771,2055,-284,-1,-7,101
1,1698,1669,29,0,-3,63
-1,1683,1680,3,-3,50,48
-1,1930,1905,25,-9,-62,68
1,1895,1882,13,-2,-16,53
-1,1257,1340,-83,-1,-315,106
-1,1546,1637,-91,-4,-51,46
-1,1650,1568,82,0,-13,88
-1,1514,1737,-223,0,-66,100
-1,2030,1804,226,0,-13,78
0,1423,1514,-91,0,273,168
1,1768,1692,76,6,821,93
1,1707,1659,48,2,259,101
-1,1332,1605,-273,-1,9,44
1,1791,1841,-50,0,58,71
-1,1659,1708,-49,-1,-3,42
-1,992,1772,-780,-4,-86,48
-1,1877,1820,57,-2,-126,62
1,1683,1778,-95,6,139,57
-1,1500,1504,-4,-1,-15,40
-1,1340,1389,-49,-4,-289,74
1,1417,1516,-99,0,365,77
1,1313,1319,-6,0,-19,82
1,1924,1545,379,0,18,61
0,1835,2006,-171,-3,-23,104
-1,1591,1732,-141,-7,-284,66
1,1791,1919,-128,-2,-73,103
1,1787,1172,615,3,171,69
1,1773,1835,-62,2,81,126
1,1980,1943,37,-9,5,87
1,1618,1346,272,6,392,103
1,1429,1220,209,3,168,69
-1,1492,1389,103,-3,-53,40
1,1660,1753,-93,0,125,79
1,1605,1636,-31,-4,165,103
-1,1688,1772,-84,-4,-103,68
1,1916,1954,-38,1,-16,63
1,1871,1908,-37,-2,-65,76
1,1582,1602,-20,0,8,61
-1,1500,1429,71,1,20,48
1,2000,1844,156,1,30,57
-1,1611,1648,-37,0,-101,74
-1,1739,1646,93,0,6,52
-1,1381,1640,-259,-1,-93,76
1,1782,1679,103,1,17,47
0,1650,1717,-67,-1,-222,137
-1,1584,1578,6,-4,-99,48
1,1660,1650,10,0,12,81
-1,1324,1845,-521,0,-9,82
-1,1778,1832,-54,2,47,76
-1,1505,1435,70,-3,-48,64
1,1601,1658,-57,1,7,41
-1,1529,1403,126,-2,-213,98
-1,1605,1609,-4,-1,7,52
1,1563,1362,201,1,66,49
-1,1347,1509,-162,0,37,42
1,1833,2009,-176,0,-2,71
0,1861,1601,260,1,880,120
1,1435,1329,106,0,-41,77
0,1934,1989,-55,5,299,111
1,1808,1635,173,3,233,67
-1,1645,1847,-202,0,13,78
-1,1213,1573,-360,-13,-164,42
-1,1932,1928,4,0,-283,78
-1,1668,1706,-38,-4,-112,88
1,1870,1444,426,2,89,187
-1,1543,1589,-46,-1,-48,76
-1,1660,1725,-65,-1,-34,54
-1,1456,1419,37,-4,-387,98
1,1511,1425,86,3,543,121
1,1426,1539,-113,-1,14,77
1,1987,1859,128,-1,45,53
-1,1687,1798,-111,0,48,46
-1,1575,1667,-92,0,-456,104
1,1559,1490,69,2,346,125
1,1603,1650,-47,0,-6,95
1,1330,1399,-69,7,86,46
-1,1380,1854,-474,-1,-55,48
-1,1341,1553,-212,-1,-317,110
-1,1694,1791,-97,-2,1,42
-1,1938,1913,25,0,8,70
1,1742,1516,226,-2,-29,57
-1,1794,1734,60,-1,33,62
-1,1805,1905,-100,-1,57,76
1,1442,1273,169,1,276,103
1,1686,1799,-113,-2,0,101
1,1672,2030,-358,-1,2,83
1,1597,1652,-55,-2,-86,53
1,1848,1856,-8,0,5,89
1,1853,1561,292,2,78,57
-1,1785,1764,21,-1,-125,102
1,1447,1456,-9,4,217,75
1,1624,1618,6,4,93,51
1,1590,1703,-113,7,306,69
1,1927,1627,300,0,14,51
1,1997,1557,440,4,102,55
1,1622,1027,595,8,440,67
-1,1988,1935,53,0,-54,116
-1,1616,1637,-21,0,-158,78
1,1785,1700,85,6,116,45
-1,1857,1865,-8,2,-30,82
-1,1510,1747,-237,1,-47,86
1,1715,1567,148,0,373,111
-1,1286,1325,-39,-5,-136,42
-1,1749,1727,22,0,14,94
-1,1432,1440,-8,1,-247,110
-1,1692,1793,-101,0,40,66
1,1377,1081,296,1,10,73
1,1692,1841,-149,-2,-85,51
-1,1674,1460,214,3,211,112
-1,1556,1999,-443,0,-147,100
-1,1343,1422,-79,-1,-185,87
-1,1605,1648,-43,0,-175,110
0,1586,1545,41,0,-98,64
-1,1628,1816,-188,-2,-156,63
1,1801,1684,117,0,21,61
-1,1432,1444,-12,2,-492,96
-1,1933,1927,6,-1,-329,90
1,1881,1709,172,1,35,59
-1,1480,1639,-159,0,0,58
1,1752,1506,246,0,-5,43
-1,1676,1821,-145,0,-36,86
1,1657,1715,-58,0,9,49
-1,1417,1520,-103,0,-93,136
-1,1324,1769,-445,-4,-336,80
-1,1517,1568,-51,-2,-739,118
-1,1626,1107,519,-6,-261,56
0,1559,1336,223,0,-48,145
1,1467,1560,-93,1,-133,123
-1,1501,1756,-255,-6,-453,82
1,1649,1722,-73,-5,-31,63
-1,2009,1890,119,-1,-51,110
-1,1691,1915,-224,0,-4,62
-1,1670,1830,-160,0,189,80
-1,1803,1703,100,-7,-354,112
1,1594,1025,569,10,409,63
0,1913,1948,-35,0,611,122
1,1760,1496,264,2,-75,127
1,1931,1459,472,4,281,83
-1,1896,1881,15,1,5,84
-1,1489,1509,-20,0,20,92
1,1912,1990,-78,0,-46,85
1,1448,1433,15,3,482,111
1,1797,1769,28,2,354,125
-1,1938,1922,16,0,192,106
-1,1606,1931,-325,-3,6,72
1,1664,1838,-174,0,0,73
-1,1584,1561,23,-3,-367,96
-1,1721,1784,-63,-7,-208,54
-1,1711,1843,-132,0,30,94
1,1686,1738,-52,0,-224,91
-1,1793,1712,81,-4,-68,50
-1,1479,1741,-262,0,-29,74
-1,1198,1418,-220,-10,-482,64
-1,1492,1765,-273,-11,-229,52
1,1973,1931,42,0,27,57
1,1981,1817,164,2,285,87
1,1725,1780,-55,3,226,53
1,1529,1409,120,0,23,59
1,1484,1413,71,7,147,81
-1,1596,1626,-30,2,55,52
-1,1917,1985,-68,-4,-81,50
-1,1672,1810,-138,4,-76,44
-1,1680,1865,-185,0,6,88
-1,1023,1327,-304,-16,-137,40
-1,1595,1677,-82,0,-421,100
1,1588,1554,34,-1,-4,41
1,1336,1259,77,5,214,51
-1,1340,1412,-72,2,32,62
1,1825,1746,79,2,76,64
-1,1421,1456,-35,3,91,56
-1,1431,1297,134,-6,-344,80
1,1639,1529,110,7,396,63
-1,1828,1745,83,-2,-47,50
-1,1914,1927,-13,0,-96,70
-1,1774,1665,109,-1,4,50
-1,1389,1074,315,-1,-837,158
-1,1500,1622,-122,-3,-319,114
-1,1506,1537,-31,-4,-195,56
1,1996,1871,125,1,122,75
1,1988,1674,314,-1,-5,43
-1,1598,1543,55,-5,-34,40
-1,1822,1814,8,1,112,92
-1,1679,1760,-81,1,46,84
-1,1404,1493,-89,-3,-9,52
1,1730,1432,298,2,-27,47
1,1671,1269,402,-5,58,71
1,1676,1331,345,1,47,73
1,1671,1992,-321,0,-7,47
1,1807,1759,48,1,319,133
-1,1521,1668,-147,0,-10,56
-1,1863,2005,-142,-1,-95,70
1,1385,1488,-103,5,392,83
0,1593,1605,-12,-4,-183,144
-1,1653,1849,-196,1,0,42
-1,1662,1776,-114,0,-49,54
1,1686,1975,-289,2,609,113
1,1544,1394,150,2,123,80
1,1818,2009,-191,1,130,69
-1,1844,1834,10,-1,-717,106
0,1573,1573,0,0,20,77
1,1466,1386,80,-3,26,49
-1,1536,1514,22,5,222,86
1,1904,1737,167,3,122,79
-1,1670,1769,-99,0,-560,116
-1,1856,2013,-157,-4,-145,70
1,1894,1884,10,-3,-23,55
1,1716,1658,58,-1,75,129
1,1905,1838,67,0,85,75
1,1582,1589,-7,0,34,83
-1,1632,1423,209,0,-2,60
-1,1510,1708,-198,0,-82,96
-1,1106,1404,-298,-6,-194,55
-1,1236,1346,-110,-14,-88,40
-1,1831,1738,93,-6,-334,104
1,1777,1662,115,3,98,63
1,1323,1500,-177,8,158,41
1,1496,1330,166,-4,-75,53
-1,1602,1355,247,-7,-256,80
-1,1947,1937,10,0,0,52
-1,1705,1917,-212,-1,9,56
-1,1882,1407,475,2,-85,98
1,1500,1475,25,0,-19,71
-1,1463,1829,-366,-3,-94,70
1,1437,1391,46,0,-40,56
1,1856,1785,71,0,103,89
1,1910,1725,185,0,2,65
-1,1589,1775,-186,-9,-297,68
1,1818,1730,88,1,41,59
1,1817,1654,163,-1,-34,59
1,1942,1294,648,0,25,53
1,1744,1545,199,-3,-34,45
1,1671,1639,32,2,32,41
-1,1189,1633,-444,-7,-141,62
1,1921,1609,312,-5,-81,55
1,1854,1837,17,0,78,108
1,1589,1384,205,2,199,101
-1,1414,1412,2,0,-157,68
1,1604,1396,208,-3,-114,69
-1,1381,1593,-212,-2,-241,100
1,1918,1733,185,6,245,54
-1,1486,1722,-236,-1,-31,52
-1,1333,1984,-651,-2,-84,64
-1,1563,1498,65,1,-12,96
1,1897,1202,695,-2,178,69
-1,1585,1799,-214,3,-62,111
0,1427,1355,72,-2,-129,108
1,1568,1400,168,-3,27,67
1,1566,1616,-50,3,260,79
-1,1510,1747,-237,-2,-126,74
-1,1442,1594,-152,0,-4,56
1,2057,1964,93,0,68,63
-1,1773,1800,-27,-2,-63,56
1,1693,1408,285,0,37,57
1,1727,1925,-198,0,148,67
1,1533,1272,261,4,125,49
1,1558,1575,-17,-1,224,107
1,1874,2128,-254,3,124,57
-1,1634,1756,-122,1,-38,58
-1,1387,1294,93,-4,-226,84
1,1603,1578,25,1,312,83
-1,1744,1899,-155,0,-57,62
1,1599,1376,223,0,370,101
-1,1481,1750,-269,-2,-383,88
1,1752,1837,-85,0,-28,69
-1,1403,1448,-45,-3,-181,66
-1,1332,1447,-115,0,13,60
-1,1623,1694,-71,0,8,44
1,1742,1511,231,3,264,85
1,1549,1726,-177,0,422,109
0,1925,1904,21,0,-47,121
-1,1500,1717,-217,-1,-170,58
1,1496,1314,182,0,47,51
-1,1827,1865,-38,0,-33,140
1,1953,1686,267,0,-1,73
-1,1220,1614,-394,-9,-112,94
1,2037,1856,181,0,8,53
-1,1405,1379,26,0,-287,148
1,1626,1540,86,3,168,75
1,1924,1766,158,2,206,109
1,1595,1630,-35,-2,-53,51
-1,1952,2068,-116,-3,-21,80
-1,1366,1603,-237,-1,-123,50
-1,1444,1324,120,-3,-229,62
1,1385,1273,112,10,331,49
1,1689,1839,-150,0,20,41
1,1776,1798,-22,1,153,71
1,1484,1445,39,-2,70,111
1,1477,1564,-87,0,-13,55
1,1777,1748,29,2,321,75
-1,1737,1923,-186,0,3,58
-1,1383,1330,53,0,-1,48
-1,1674,1965,-291,-2,-86,57
-1,1761,1507,254,1,9,48
1,1583,1586,-3,0,32,75
1,1567,1392,175,0,198,75
1,1393,1575,-182,6,705,83
1,1891,1614,277,3,118,69
-1,1383,1697,-314,0,14,40
1,1705,1532,173,1,115,53
-1,1441,1500,-59,-1,-40,58
-1,2151,2267,-116,-3,-193,78
1,1609,1101,508,1,31,51
1,1406,1444,-38,0,-29,47
-1,1667,1973,-306,5,413,104
-1,1524,1601,-77,0,-71,70
-1,1635,1517,118,-4,-11,40
-1,1439,1500,-61,-6,-285,54
-1,1503,1768,-265,1,-53,76
1,2276,2140,136,1,54,65
1,1647,1431,216,17,612,50
-1,1600,1477,123,-6,-100,48
1,1496,1435,61,3,309,73
-1,1175,1471,-296,-8,-445,82
-1,1997,1642,355,0,46,74
1,1753,1506,247,0,27,56
1,1744,1398,346,1,101,55
1,1492,1722,-230,7,150,48
-1,2130,1976,154,0,-335,112
1,1736,1826,-90,-2,-60,101
-1,1600,1769,-169,-2,-60,40
1,1941,1731,210,3,164,65
1,1790,1491,299,-1,257,93
-1,1976,2014,-38,1,-44,54
1,1993,2109,-116,0,112,71
1,1839,1958,-119,0,106,69
-1,1500,1648,-148,-21,-207,40
-1,2024,1965,59,0,-30,64
1,1620,1440,180,-4,217,73
-1,1694,1813,-119,2,11,54
1,1636,1469,167,1,339,97
-1,2089,2008,81,0,-31,44
1,1670,1557,113,2,41,63
1,1510,1351,159,-4,-61,79
-1,1311,1426,-115,-5,-338,72
1,1610,1588,22,-2,93,99
1,1895,1831,64,6,220,73
-1,2023,2071,-48,-2,-179,80
-1,1858,2011,-153,0,-12,118
1,1566,1722,-156,-1,-117,77
1,1845,1785,60,0,-42,79
1,2083,2013,70,-5,272,97
1,1273,1290,-17,1,64,53
-1,1494,1628,-134,0,31,52
-1,1415,1677,-262,0,-97,66
-1,1492,1586,-94,-3,-75,52
1,1752,1752,0,0,-27,47
-1,1424,1478,-54,-5,-212,58
-1,1870,2076,-206,-1,-125,104
1,1363,1572,-209,4,92,47
1,1558,1410,148,-3,213,80
1,1626,1305,321,-4,256,93
-1,1824,2003,-179,-3,-46,48
1,1495,1339,156,0,37,55
1,1547,1726,-179,0,8,67
1,2009,1663,346,-3,-36,71
-1,2095,1824,271,1,65,108
1,1608,1578,30,5,171,55
-1,1285,1576,-291,-1,-24,52
1,1622,1375,247,0,15,59
-1,1910,2073,-163,0,-463,106
1,1765,1705,60,-1,-69,91
-1,1660,2012,-352,-8,-118,60
-1,1037,1627,-590,-3,-359,94
1,1500,1492,8,0,127,67
1,1426,1361,65,2,164,81
1,1855,1945,-90,-1,-43,59
1,2081,1883,198,-1,-2,43
-1,1818,1606,212,0,-174,120
-1,1506,1428,78,-1,-445,112
0,1619,1563,56,-4,416,104
-1,1562,1616,-54,-5,-405,90
0,1404,1583,-179,0,-182,129
-1,1322,1338,-16,-4,-166,60
-1,1487,1576,-89,-2,-48,60
-1,1862,2088,-226,-2,-86,70
-1,1571,1800,-229,-5,-447,84
1,1626,1387,239,0,6,59
-1,1629,1589,40,0,33,80
1,1286,1359,-73,1,81,67
-1,2018,2094,-76,-1,-43,54
0,1626,1553,73,1,131,113
1,1631,1414,217,5,63,45
-1,1932,2082,-150,4,79,86
1,1114,1164,-50,14,226,41
1,1869,1500,369,-3,-87,79
-1,1563,1682,-119,0,-30,74
-1,1318,1420,-102,2,-93,90
1,1145,1127,18,3,357,63
-1,1638,1500,138,-7,-362,80
1,1479,1606,-127,3,202,72
0,1776,1535,241,-1,67,134
1,1500,1469,31,0,533,153
-1,1602,1655,-53,0,-450,102
-1,1628,1487,141,1,67,70
-1,1450,1686,-236,-1,-46,84
-1,1311,1628,-317,-4,-242,78
1,1555,1624,-69,0,198,89
-1,1409,1636,-227,-3,-178,69
1,1616,1465,151,2,251,99
1,1174,1106,68,1,-62,45
-1,1594,1503,91,0,-208,78
1,1776,1521,255,6,493,71
-1,1382,1631,-249,2,-60,64
1,1403,1565,-162,0,-8,53
-1,1404,1300,104,-6,-174,49
0,1755,1805,-50,0,-71,114
-1,1801,1735,66,0,-99,104
1,1601,1202,399,0,262,99
-1,1539,1746,-207,-1,-44,54
1,1846,1631,215,1,25,49
-1,1557,1484,73,-10,-190,42
-1,1564,1618,-54,1,1,52
1,1516,1445,71,0,3,45
-1,1790,1757,33,2,32,110
-1,1208,1274,-66,-1,-114,62
-1,1610,1568,42,1,-271,116
-1,1438,1705,-267,1,-41,68
1,1761,1472,289,4,170,57
1,1462,1334,128,0,-5,147
1,1768,1161,607,-1,-12,43
-1,1890,1665,225,-1,48,76
1,1759,1925,-166,-5,-209,115
1,1497,1543,-46,3,76,47
1,1712,1624,88,-1,-38,189
0,1541,1674,-133,4,207,111
-1,1580,1597,-17,-4,-92,52
-1,1626,1851,-225,-4,-152,58
1,1772,1484,288,1,268,69
-1,1518,1580,-62,-3,-1113,138
1,1779,1759,20,-1,-23,69
-1,1516,1598,-82,-1,-103,60
-1,1448,1401,47,2,54,54
-1,1534,1603,-69,2,14,90
1,1537,1391,146,-1,-8,49
-1,1776,1731,45,0,-86,94
-1,1549,1419,130,0,-293,134
-1,1387,1434,-47,2,169,78
1,1636,1405,231,0,213,81
-1,1804,1757,47,0,-16,58
1,1782,1480,302,1,110,63
-1,1608,1276,332,-2,385,144
1,1664,1258,406,1,124,105
-1,1553,1338,215,0,8,54
-1,1769,1696,73,-2,-245,75
1,1308,1156,152,2,59,41
-1,1910,1776,134,0,190,86
1,1680,1544,136,7,127,53
-1,1887,1792,95,0,-639,106
1,1550,1621,-71,-1,34,45
0,1528,1492,36,-3,-19,147
-1,1756,1876,-120,-2,-134,146
-1,1702,1856,-154,0,44,58
1,1670,1672,-2,2,37,69
-1,1219,1589,-370,0,-36,106
-1,1090,1311,-221,-7,-548,65
-1,1380,1377,3,-9,-662,84
-1,1572,1416,156,0,-78,76
1,1895,1861,34,-1,38,87
-1,1256,1384,-128,-12,-103,40
1,1789,1709,80,0,98,97
-1,1507,1524,-17,1,-18,40
1,1905,1537,368,-1,25,65
1,1641,1590,51,0,-28,91
-1,1314,1478,-164,2,-108,90
-1,1749,1914,-165,-1,-119,60
1,1409,1504,-95,0,56,65
-1,1351,1510,-159,-4,-384,112
1,1660,1591,69,6,79,48
1,1400,1216,184,-1,258,80
-1,1321,1843,-522,-4,-254,60
-1,1372,1549,-177,-3,-5,48
1,1743,1534,209,0,79,65
1,1305,1655,-350,10,515,85
-1,1403,1317,86,0,26,118
-1,1260,1627,-367,-11,-144,46
-1,1853,1845,8,0,7,104
1,1621,1452,169,5,925,161
-1,1500,1582,-82,0,-290,78
1,1721,1794,-73,0,10,57
1,1669,1414,255,1,208,107
-1,1500,1555,-55,0,-96,58
-1,1497,1555,-58,-1,-38,72
-1,1748,1841,-93,0,22,66
-1,1433,1535,-102,0,2,42
1,1446,1627,-181,-5,-308,87
1,1911,1865,46,1,-6,65
-1,1360,1619,-259,-2,-218,76
1,1740,1850,-110,0,-490,129
-1,1463,1691,-228,-4,-24,45
1,1922,1159,763,6,227,57
-1,1688,1849,-161,-2,-46,96
-1,1700,1798,-98,0,-33,82
-1,1308,1677,-369,2,-2,74
1,1474,1240,234,1,22,42
-1,1252,1366,-114,4,467,70
-1,1922,1834,88,-10,-383,92
-1,1642,1543,99,-1,-179,122
-1,1360,1406,-46,-2,-228,104
-1,1499,1589,-90,0,-76,86
1,1487,1453,34,-1,-37,47
1,1367,1414,-47,1,-21,121
1,1905,1792,113,1,77,69
1,1736,1368,368,9,642,93
-1,1410,1320,90,1,-119,68
-1,1113,1682,-569,-4,-235,70
-1,1500,1314,186,1,38,44
-1,1670,1712,-42,-1,30,66
-1,1849,1859,-10,0,-171,98
1,1480,1630,-150,1,467,113
1,1432,1443,-11,3,563,87
-1,1597,1474,123,-1,-73,62
-1,1806,1692,114,-7,-757,104
1,1589,1406,183,3,466,85
-1,1432,1275,157,-2,-145,58
1,1640,1448,192,-1,-22,75
1,1800,1549,251,0,15,59
1,1621,1356,265,-1,17,49
-1,1620,1876,-256,-3,-84,58
-1,1601,1581,20,-7,-167,64
-1,1898,1914,-16,0,-21,52
1,1561,1525,36,2,60,59
1,1863,1693,170,-5,-26,41
-1,1516,1582,-66,-3,-837,162
-1,1652,1584,68,-2,-9,44
1,1497,1500,-3,2,160,123
-1,1504,1431,73,0,-12,58
-1,1615,1883,-268,0,-63,50
1,1690,1665,25,-1,217,99
1,1961,1109,852,1,54,55
-1,1096,1395,-299,-2,20,40
-1,1889,1838,51,-2,-411,96
1,1726,1638,88,-1,-25,50
1,1728,1642,86,1,-12,77
1,1939,2016,-77,1,29,45
1,1622,1633,-11,0,10,93
-1,1624,1835,-211,-6,-146,58
-1,1532,1383,149,-2,-90,68
1,1686,1530,156,5,175,63
-1,1796,1901,-105,-1,-58,96
1,1731,1447,284,-3,-87,59
-1,1257,1392,-135,-6,-22,42
0,1544,1747,-203,3,807,177
-1,1660,1545,115,0,-34,92
-1,1550,1654,-104,0,-57,138
-1,2003,1953,50,-3,-105,68
1,1573,1605,-32,1,76,56
-1,1730,1699,31,0,1,40
-1,1481,1427,54,-1,-261,158
-1,1660,1834,-174,1,-105,82
1,1399,1176,223,-1,-6,47
1,1436,1352,84,1,303,93
-1,1442,1695,-253,-5,-135,64
-1,1595,1583,12,-1,-54,70
1,1475,1410,65,-1,-26,115
-1,1462,1417,45,-1,-60,68
-1,1701,1526,175,1,75,60
1,1965,1990,-25,0,6,79
1,1805,1736,69,-3,-29,41
1,1533,1388,145,6,493,135
1,1610,1366,244,4,24,42
-1,1347,1526,-179,-1,-47,56
-1,1538,1403,135,-2,-40,48
-1,1727,1626,101,-6,-396,92
-1,1523,1540,-17,-4,-68,68
0,1909,1788,121,0,76,120
-1,1538,1633,-95,-6,-384,72
-1,1621,1534,87,-2,-398,100
-1,1727,1780,-53,1,-40,80
-1,1554,1500,54,-3,-109,65
-1,1713,1641,72,7,190,58
-1,1404,1529,-125,3,205,84
-1,1391,1496,-105,-3,-64,60
1,1840,1654,186,-1,-147,101
1,1517,1588,-71,8,288,67
1,2095,1841,254,0,143,109
1,1757,1399,358,-1,-64,71
-1,1700,1712,-12,-4,-244,76
-1,1741,1550,191,-7,-311,54
1,1366,1500,-134,5,70,49
1,1555,1675,-120,0,3,43
1,1740,1583,157,3,-6,41
1,1537,1396,141,-1,-37,87
-1,1822,1790,32,-1,6,80
1,1836,1717,119,2,105,53
1,1693,1539,154,1,85,73
1,1932,1602,330,-3,131,97
1,1593,1570,23,1,48,45
-1,1687,1723,-36,-8,-649,103
1,1512,1399,113,6,287,63
-1,1791,1905,-114,-1,-55,60
-1,1978,1977,1,0,-77,76
1,1542,1550,-8,-5,415,107
-1,1615,1619,-4,-7,-147,62
1,1389,1544,-155,-9,126,67
1,1845,1541,304,4,151,65
1,1683,1724,-41,-3,-97,97
-1,1517,1498,19,4,118,74
1,1574,1530,44,0,70,77
1,1988,1967,21,3,25,43
-1,1469,1471,-2,-3,-124,64
1,1710,1733,-23,0,112,113
-1,1537,1568,-31,1,-263,172
1,1800,1499,301,-3,0,45
1,1527,1405,122,-5,-141,71
1,1678,1561,117,-4,144,71
-1,1549,1606,-57,-1,-54,68
1,1535,1341,194,0,111,83
1,1765,1510,255,1,53,57
-1,1564,1594,-30,1,231,104
1,1912,1784,128,-3,43,69
1,1685,1553,132,2,662,101
1,1459,1844,-385,0,201,111
1,1769,1739,30,-9,-26,75
-1,1398,1535,-137,12,516,100
-1,1529,1351,178,-2,-40,46
-1,1520,1391,129,-13,-148,62
1,1558,1603,-45,0,-34,41
1,1850,1617,233,-1,-35,103
-1,1766,1805,-39,-2,-254,102
-1,1339,1584,-245,-5,-177,85
1,1856,1496,360,1,72,45
-1,1604,1531,73,1,30,60
1,1545,1692,-147,14,164,45
-1,1593,1586,7,-6,-134,45
1,1806,1721,85,3,52,63
-1,1458,1482,-24,0,-20,44
1,1542,1390,152,-10,-230,47
1,1677,1562,115,4,973,115
-1,1649,1846,-197,-1,-52,48
1,1390,1430,-40,-1,-40,77
-1,1493,1859,-366,-7,-171,50
-1,1545,1590,-45,0,6,56
-1,1501,1589,-88,-6,-395,120
1,1954,1851,103,1,16,59
1,1662,1482,180,0,411,143
1,1988,1805,183,2,146,101
1,1684,1554,130,-1,152,61
1,1643,1468,175,4,65,47
-1,1634,1552,82,1,-89,81
1,1600,1535,65,-1,7,65
1,1490,1524,-34,0,149,95
-1,1459,1470,-11,-7,-525,88
1,1691,1546,145,8,400,61
1,1556,1377,179,2,104,53
-1,1448,1438,10,-3,-95,68
-1,1429,1502,-73,0,-90,86
-1,1701,2031,-330,-6,-791,106
-1,1216,1454,-238,-14,-303,46
-1,1698,1539,159,-1,-127,120
-1,1525,1609,-84,0,-43,72
-1,1102,1589,-487,0,-136,104
1,1808,1731,77,0,8,55
0,1371,1562,-191,0,262,94
1,1619,1544,75,2,110,99
-1,1237,1451,-214,-4,-85,49
1,1417,1404,13,10,177,41
1,1618,1516,102,0,83,71
1,1995,1618,377,0,159,107
1,1821,1604,217,0,132,93
1,1603,1586,17,4,221,73
-1,1668,1571,97,1,64,66
-1,1370,1619,-249,1,-281,154
1,1381,1435,-54,-4,-277,113
1,1556,1376,180,-2,95,57
-1,1917,1780,137,0,0,52
-1,1508,1626,-118,2,396,74
0,1570,1451,119,0,378,154
-1,1521,1608,-87,0,146,76
1,1698,1708,-10,1,86,131
-1,1598,1954,-356,-3,-300,70
1,1505,1373,132,0,29,45
1,1598,1539,59,2,440,99
-1,1854,1769,85,1,48,102
1,1370,1563,-193,6,643,93
1,1631,1322,309,3,83,53
-1,1584,1579,5,-4,-168,64
1,1723,1068,655,8,147,51
-1,1392,1466,-74,-5,-133,54
1,1649,1565,84,0,125,107
-1,1398,1240,158,4,118,56
1,1576,1614,-38,0,529,135
-1,1719,1999,-280,0,-289,112
-1,1470,1530,-60,0,12,90
-1,1437,1500,-63,-4,-113,50
1,1545,1388,157,-3,437,83
1,1490,1471,19,5,722,97
-1,1795,1902,-107,-3,-95,84
-1,1829,1862,-33,-3,-99,96
0,1322,1713,-391,-2,-281,98
1,1460,1501,-41,-1,-273,65
-1,1435,1483,-48,-17,-545,52
-1,1364,1513,-149,4,48,41
1,1628,1448,180,0,19,85
-1,1500,1804,-304,1,265,84
1,1518,1355,163,4,74,49
1,1678,1438,240,1,7,47
-1,1381,1552,-171,-1,73,52
1,1512,1367,145,-2,9,45
-1,1956,2004,-48,-11,-185,62
-1,1804,1750,54,-1,-361,88
-1,1643,1551,92,0,-154,88
-1,1696,1851,-155,0,33,48
-1,1461,1491,-30,-5,-141,58
1,1812,1875,-63,1,269,95
1,1559,1558,1,7,829,83
1,1465,1496,-31,18,1603,113
1,1879,1730,149,2,1,57
-1,1602,1588,14,-1,-706,118
1,1817,1833,-16,-7,-24,52
1,1910,1787,123,1,60,53
-1,1590,1572,18,1,-1,88
1,1859,1947,-88,0,117,103
1,1547,1571,-24,-12,-244,49
-1,1489,1841,-352,1,8,76
-1,1409,1722,-313,1,-121,104
-1,1543,1598,-55,6,70,56
1,1420,1395,25,12,328,49
-1,1320,1365,-45,-8,-659,92
1,1335,1495,-160,11,238,41
-1,1451,1549,-98,-4,-162,64
-1,1545,1812,-267,-4,-49,44
1,1433,1683,-250,0,34,87
-1,1382,1256,126,-8,-289,82
1,1558,1559,-1,1,28,79
1,1999,1933,66,0,-3,49
1,1725,1687,38,-4,84,69
1,1383,1249,134,1,16,53
-1,1455,1566,-111,-2,-175,124
-1,1486,1553,-67,1,-20,78
-1,1455,1520,-65,-1,-79,80
-1,1876,1847,29,0,-123,72
-1,1519,1590,-71,0,204,84
1,1396,1254,142,-1,-16,51
1,1548,1570,-22,-2,-141,87
-1,1780,1917,-137,-1,-16,44
1,1564,1453,111,0,4,61
-1,1710,1583,127,-1,-323,180
1,2007,1862,145,0,-11,55
1,1723,1764,-41,0,40,57
1,1484,1318,166,-2,-53,43
-1,1307,1367,-60,0,-186,72
-1,1462,1667,-205,-1,27,44
1,1590,1651,-61,-5,17,119
-1,1446,1578,-132,4,399,88
-1,1558,1560,-2,-2,-122,82
1,1751,1432,319,2,199,95
1,1858,1652,206,3,168,69
1,1924,1854,70,0,128,91
1,1924,1773,151,0,13,61
-1,1390,1678,-288,-4,-135,48
1,1507,1550,-43,0,-14,55
1,1534,1629,-95,0,364,141
1,1813,1436,377,2,131,59
1,1345,1431,-86,3,160,61
-1,1571,1546,25,-16,-670,86
1,1590,1472,118,2,18,49
-1,1843,1933,-90,-9,-861,112
1,1608,1530,78,0,-25,63
-1,1465,1603,-138,-7,-286,64
1,1560,1710,-150,2,40,43
1,1510,1350,160,1,67,69
-1,1384,1309,75,-5,-89,52
1,1727,1351,376,0,-81,101
1,1941,1833,108,1,12,47
-1,1559,1559,0,-13,-381,88
1,1518,1441,77,-1,-35,99
1,1568,1596,-28,2,148,73
-1,1479,1452,27,0,-133,68
1,1367,1552,-185,-5,-75,55
1,1599,1675,-76,-1,38,73
1,1628,1623,5,1,58,69
-1,1824,1949,-125,0,-59,68
-1,1766,1930,-164,0,3,46
1,1664,1615,49,0,8,69
1,1386,1375,11,0,31,85
1,1570,1547,23,4,162,69
-1,1621,1865,-244,1,69,84
-1,1428,1755,-327,1,-60,70
1,1637,1603,34,3,593,95
-1,1956,1816,140,0,134,72
-1,1582,1597,-15,0,-72,78
-1,1310,1399,-89,0,-42,113
-1,1936,1760,176,-2,-142,84
-1,1568,1549,19,-3,-81,50
1,1838,1678,160,12,310,53
1,1516,1519,-3,0,10,57
1,1758,1500,258,4,260,61
-1,1565,1586,-21,-1,-25,54
1,1817,1833,-16,8,355,73
1,1561,1556,5,0,-164,101
-1,1544,1866,-322,-3,-76,40
1,1509,1227,282,0,178,81
1,1527,1528,-1,-3,-152,71
-1,1578,1517,61,-3,-424,100
1,1883,1492,391,0,417,105
-1,1226,1284,-58,-1,37,60
1,1597,1551,46,1,73,55
-1,1927,2014,-87,2,-74,76
-1,1588,1245,343,-1,3,50
-1,1494,1355,139,-2,-41,54
1,1384,1654,-270,0,304,103
-1,1391,1593,-202,-6,-437,88
1,1674,1565,109,1,-19,55
-1,1671,1845,-174,-1,-154,126
-1,1672,1926,-254,-7,-100,42
1,1583,1580,3,-2,143,77
-1,1763,1754,9,-6,-335,70
1,2024,1920,104,2,76,77
1,1919,1855,64,-3,-31,57
1,1863,2022,-159,0,25,79
-1,1359,1296,63,-10,-246,52
0,1694,1498,196,-3,-192,113
-1,1423,1829,-406,-4,-114,60
-1,1835,1607,228,0,-80,70
1,1846,1928,-82,0,-13,67
-1,1329,1365,-36,1,29,60
0,1398,1516,-118,0,-66,144
-1,1528,1531,-3,0,-486,88
-1,1808,1656,152,1,162,70
-1,1500,1414,86,-1,-47,46
-1,1443,1568,-125,0,-46,96
-1,1385,1359,26,0,-339,152
1,1611,1638,-27,-1,3,43
-1,1682,1557,125,-1,-26,68
-1,1730,1668,62,0,-4,44
-1,1913,2032,-119,-1,65,82
1,1569,1595,-26,2,265,89
-1,1870,1597,273,-5,-106,48
-1,1539,1597,-58,0,66,62
1,1472,1207,265,3,239,87
-1,1773,1765,8,0,46,84
1,1216,1128,88,-1,-105,77
-1,1598,1386,212,-3,-49,44
1,1462,1407,55,0,271,129
-1,1802,1577,225,1,-159,92
1,1471,1502,-31,6,126,51
-1,1436,1586,-150,2,29,56
-1,1390,1556,-166,-4,-142,56
-1,1399,1688,-289,-2,-93,62
1,1784,1721,63,1,42,60
1,1627,1624,3,3,769,147
-1,1600,1785,-185,0,-106,72
-1,2007,1820,187,0,12,80
1,1207,1112,95,0,-5,45
1,1429,1500,-71,4,93,41
1,1319,1409,-90,8,274,57
1,1667,1334,333,-5,-63,57
-1,1744,1836,-92,0,88,146
-1,1898,2048,-150,2,14,60
1,1535,1503,32,-1,-8,51
1,1731,1857,-126,-2,52,93
1,1839,1991,-152,0,-391,117
-1,1420,1527,-107,-2,-243,116
1,1798,1585,213,3,245,75
1,1337,1713,-376,0,81,54
1,1565,1423,142,5,222,57
-1,1667,1843,-176,1,-284,94
1,1870,1831,39,-1,47,65
1,1975,1856,119,0,30,57
1,935,0,935,3,141,59
-1,1762,1755,7,-6,-144,46
1,1438,1561,-123,0,15,65
1,2056,1892,164,-4,-271,87
1,1395,1138,257,3,196,73
0,1983,1848,135,1,427,91
1,1430,1461,-31,-1,275,171
1,1805,1662,143,-3,-24,79
-1,1751,1781,-30,-2,-21,122
-1,1333,1497,-164,-3,11,84
-1,1510,1469,41,-1,-203,82
1,1852,1979,-127,0,-39,83
-1,1780,1501,279,0,-259,154
-1,1562,1383,179,0,-274,149
1,1791,1609,182,2,65,79
1,1500,1253,247,4,729,107
-1,1482,1405,77,1,21,58
-1,1225,1553,-328,-8,3,42
1,1681,1616,65,1,28,45
1,1661,1849,-188,0,396,81
1,1393,1398,-5,0,66,76
1,1698,1453,245,5,352,81
-1,1886,2063,-177,-3,-103,104
-1,1774,1894,-120,-3,-256,127
-1,1474,1218,256,-4,-80,44
1,1553,1495,58,0,169,75
1,1500,1163,337,-1,-5,45
0,1483,1554,-71,-6,-129,49
1,1549,1102,447,3,785,107
1,1815,1655,160,3,202,77
1,1821,1882,-61,0,5,75
-1,1539,1596,-57,-2,-28,106
-1,1420,1399,21,0,6,74
1,1442,1468,-26,1,130,79
0,1691,1560,131,-9,-710,100
1,1458,1339,119,-4,-38,63
1,1640,1708,-68,-2,258,109
1,1537,1330,207,8,473,65
-1,1517,1595,-78,-4,-75,54
1,1901,1566,335,1,246,95
-1,1399,1264,135,0,-166,86
1,1677,1575,102,0,88,77
-1,1634,1595,39,-3,-83,68
-1,1421,1490,-69,-1,-89,75
1,1440,1344,96,7,399,100
1,2069,1880,189,2,16,53
1,1218,1569,-351,-5,1,49
-1,1505,1827,-322,-4,-141,56
1,1323,1802,-479,-1,-71,75
1,1741,1743,-2,1,38,45
1,1824,1649,175,3,20,49
-1,1465,1297,168,0,-26,110
1,1503,1326,177,1,426,99
1,1405,1542,-137,0,391,139
-1,1502,1710,-208,0,-64,78
1,1454,1491,-37,1,27,69
-1,1438,1702,-264,-1,-110,84
1,1529,1612,-83,-1,21,83
1,1951,1751,200,1,78,63
-1,1115,1580,-465,1,30,56
1,1585,1592,-7,0,20,61
1,1416,1281,135,-6,-134,55
-1,1874,2038,-164,-1,-18,50
0,1494,1518,-24,0,59,139
1,1517,1239,278,1,299,143
1,1957,1745,212,2,122,59
-1,1516,1480,36,1,138,84
-1,1450,1603,-153,0,51,116
1,1486,1579,-93,3,77,41
1,1551,1471,80,-2,-15,71
-1,1732,1752,-20,-1,46,74
-1,1740,1962,-222,-3,-148,62
1,1687,1607,80,2,177,97
1,1657,1147,510,-4,-72,49
1,1736,1725,11,0,-21,53
-1,1320,1376,-56,-7,-255,68
1,1967,1734,233,-1,-31,49
-1,1884,2027,-143,0,-18,114
1,1842,1643,199,2,85,51
1,1400,1249,151,10,706,69
-1,1707,1509,198,0,180,104
0,1647,1425,222,2,1167,153
-1,1587,1582,5,-3,66,78
1,1697,1444,253,-2,22,61
-1,1301,1529,-228,3,-101,75
-1,1729,1972,-243,1,-229,82
-1,1161,1477,-316,-3,-119,48
-1,1287,1572,-285,-6,-992,98
-1,1546,1499,47,1,-106,76
1,1460,1598,-138,-1,-70,79
0,1420,1296,124,-3,-253,111
-1,1239,1603,-364,-6,-174,60
-1,1976,1725,251,0,1,86
1,1503,1119,384,10,330,61
1,1725,1638,87,0,49,69
-1,1234,1527,-293,-3,-163,52
-1,1466,1540,-74,-2,-166,66
-1,1500,1835,-335,-2,-46,54
-1,1156,1500,-344,-10,-118,44
-1,1850,1907,-57,-6,-470,86
-1,1546,1608,-62,-1,-74,70
1,1672,1578,94,0,-7,43
0,1744,1958,-214,-1,-153,137
0,1476,1582,-106,1,-275,139
1,1500,1604,-104,8,406,77
-1,1534,1549,-15,-3,-80,62
1,1493,1658,-165,-5,-226,61
1,1412,1508,-96,0,101,83
-1,1295,1486,-191,-1,-35,44
0,1838,1773,65,0,103,122
1,1418,1491,-73,1,31,75
1,1696,1599,97,-4,-12,53
1,1884,1721,163,4,37,41
1,1604,1533,71,-2,-205,77
-1,1745,1957,-212,0,-13,48
-1,1563,1562,1,-6,-142,49
1,1311,1274,37,0,14,43
1,1681,1782,-101,-4,-91,67
1,1568,1407,161,3,247,64
-1,1098,1444,-346,-2,-703,88
1,2034,1758,276,0,38,49
-1,1536,1230,306,-4,4,82
0,1206,1276,-70,-2,423,137
-1,1224,1502,-278,-15,-408,54
1,1734,1641,93,-5,207,137
-1,1838,1437,401,0,-146,77
-1,1746,1685,61,1,-166,140
-1,1148,1597,-449,-2,-33,40
-1,1270,1537,-267,-13,-173,44
1,1507,1551,-44,0,-4,51
-1,1349,1526,-177,-7,-113,44
1,1704,1320,384,4,432,109
-1,1643,1642,1,-11,-279,46
1,1685,1890,-205,2,122,85
1,1722,1695,27,1,47,57
-1,1520,1538,-18,0,-55,88
1,1625,1439,186,0,227,67
0,1939,1917,22,0,-33,129
1,1534,1313,221,-2,399,125
-1,1141,1643,-502,-4,-70,50
1,1835,1653,182,3,57,55
-1,1747,1842,-95,-4,-201,80
-1,1554,1548,6,1,-98,98
-1,1461,1495,-34,-10,-66,40
-1,1532,1342,190,0,-20,52
-1,1513,1571,-58,-1,-105,80
1,1458,1139,319,-2,-3,47
-1,1509,1845,-336,-4,-42,40
1,1729,1689,40,0,-112,93
-1,1631,1632,-1,0,171,98
-1,1537,1498,39,1,-269,104
1,2038,1873,165,0,164,73
-1,1522,1644,-122,-1,-59,114
1,1250,1265,-15,-3,-44,83
1,1642,1619,23,-2,254,109
-1,1433,1647,-214,1,-371,106
-1,1125,1467,-342,5,347,122
-1,1564,1823,-259,-1,-15,54
1,1652,1608,44,4,87,41
-1,1549,1424,125,6,201,64
-1,1450,1500,-50,0,-12,124
1,1662,1599,63,3,84,55
1,1593,1451,142,0,-33,91
1,1470,1120,350,12,789,85
1,1671,1589,82,11,274,49
1,1867,1812,55,1,62,97
-1,1525,1972,-447,-7,-47,40
1,1679,1581,98,7,869,105
-1,1740,1515,225,-2,-600,80
-1,1694,1420,274,0,46,50
-1,1702,1679,23,1,-31,68
1,1888,1766,122,0,136,95
1,1713,1378,335,5,694,93
-1,1264,1567,-303,-5,-35,46
-1,1263,1700,-437,1,-127,76
-1,1515,1581,-66,1,111,76
1,1687,1572,115,5,987,123
1,1758,2095,-337,-3,-82,75
-1,1133,1923,-790,-6,-257,60
-1,1523,1539,-16,0,-15,64
-1,1421,1421,0,-2,-289,108
-1,1694,1565,129,-1,48,54
-1,1803,1876,-73,0,-106,72
-1,1680,1580,100,1,46,50
1,1690,1754,-64,1,909,143
-1,1100,1384,-284,-1,-46,72
-1,1444,1601,-157,9,55,40
1,1461,1554,-93,7,113,51
1,1666,1594,72,1,465,99
-1,1970,1691,279,1,49,56
1,1553,1435,118,-1,-160,79
1,1698,1610,88,3,17,41
-1,1785,1700,85,5,64,64
1,1046,1126,-80,5,313,79
1,1409,1222,187,1,187,64
1,1521,1712,-191,5,58,51
1,1474,1483,-9,2,125,89
1,1622,1763,-141,1,156,115
1,1659,1711,-52,2,113,99
1,1816,1435,381,2,362,91
1,1963,1643,320,3,157,73
0,1402,1406,-4,-8,-234,65
1,1271,1319,-48,0,274,101
-1,1405,1346,59,5,321,88
1,1703,1706,-3,0,357,73
-1,2063,1888,175,-1,-109,78
0,1745,1696,49,0,22,116
-1,1339,1471,-132,-3,-98,54
1,1573,1519,54,-1,-26,57
1,1689,1553,136,0,-17,69
1,1772,1616,156,0,-41,69
1,1923,1917,6,0,-2,77
-1,1691,1768,-77,0,-15,52
-1,1725,1769,-44,0,-1,64
1,1493,1295,198,7,823,91
1,1762,1693,69,0,-30,59
-1,1713,1726,-13,-2,-77,47
1,1776,1682,94,-1,523,157
1,1671,1472,199,0,-6,47
1,1454,1770,-316,1,97,63
-1,1905,2044,-139,-1,106,76
1,1487,1672,-185,0,615,125
1,1226,1958,-732,5,278,63
1,1681,1674,7,1,33,44
-1,1671,1847,-176,-1,-43,102
1,1676,1724,-48,6,95,67
-1,1714,1643,71,-2,-47,66
1,1432,1534,-102,-1,136,85
1,1671,1806,-135,0,45,79
-1,1674,1784,-110,-2,-254,94
1,1709,1824,-115,2,45,41
-1,1651,1613,38,0,-3,132
1,1699,1612,87,4,186,57
1,1778,1538,240,-5,-27,49
-1,1310,1436,-126,-4,-171,58
1,1903,1936,-33,0,-4,93
1,1594,1509,85,0,45,61
1,1498,1385,113,-6,-68,51
1,1604,1707,-103,-6,65,89
-1,1696,1568,128,1,20,68
1,1687,1471,216,-3,-21,43
-1,2052,1898,154,0,-100,150
-1,1583,1350,233,-1,-24,122
-1,1771,1882,-111,0,37,70
1,1663,1691,-28,4,170,75
-1,1749,1705,44,-4,-168,64
1,1791,1666,125,0,72,79
-1,1714,1887,-173,0,-21,106
-1,1693,1618,75,4,-73,102
1,1716,1537,179,0,-44,71
-1,1604,1647,-43,-3,-102,66
-1,1775,1966,-191,-1,69,168
1,1807,1693,114,1,-17,49
1,1907,1807,100,0,94,67
-1,1666,1668,-2,0,-6,52
1,1429,1638,-209,0,-3,67
1,1633,1437,196,6,286,53
1,1766,1638,128,-5,-14,69
-1,1684,1862,-178,0,-4,70
-1,1625,1545,80,-2,-71,52
1,1692,1442,250,5,144,49
-1,1659,1798,-139,-2,-28,48
-1,1689,1621,68,-5,-59,52
-1,1705,1418,287,-2,-56,44
1,1680,1655,25,0,45,55
-1,1634,1677,-43,-3,-57,46
1,1737,1665,72,-1,-59,99
-1,1593,1774,-181,-1,-29,45
-1,1913,2034,-121,-2,36,90
1,1680,1583,97,0,230,95
1,1533,1548,-15,1,214,81
1,1686,1625,61,8,272,47
1,1680,1675,5,1,245,97
1,1652,1589,63,0,80,69
1,1986,1924,62,0,175,159
1,1747,1350,397,-4,26,43
1,1646,1812,-166,2,30,51
-1,1700,1349,351,-3,35,102
0,1057,1119,-62,-9,-631,82
-1,1848,1829,19,-1,-85,59
-1,1430,1641,-211,-2,-135,94
-1,1780,1561,219,2,-144,88
1,1744,1483,261,-1,301,94
1,1696,1691,5,-1,-57,91
1,1583,1818,-235,-1,54,57
1,1682,1629,53,15,1105,95
1,1418,1390,28,2,70,51
1,1708,1637,71,0,-47,69
1,1777,1644,133,0,-136,109
1,1575,1689,-114,0,58,87
-1,1390,1539,-149,-3,-155,76
-1,1390,1443,-53,-2,-212,78
1,1763,1626,137,-2,-2,41
1,2043,1906,137,0,-5,45
1,1620,1691,-71,-1,-112,57
-1,1505,1314,191,0,-35,58
-1,1541,1488,53,-1,24,108
1,1678,1632,46,-1,17,43
-1,1697,1743,-46,2,115,58
-1,1637,1787,-150,-4,-225,60
-1,1645,1763,-118,2,-309,80
1,1508,1490,18,0,139,93
1,1623,1687,-64,10,582,83
1,1722,1375,347,1,788,127
1,1707,1751,-44,-2,-91,73
1,1692,1523,169,2,146,75
1,1269,1517,-248,-2,-81,63
-1,1630,1797,-167,2,36,62
-1,1348,1749,-401,8,166,48
-1,1565,1894,-329,-7,-177,56
1,1674,1874,-200,0,57,121
1,1771,1612,159,-1,-39,72
1,1915,1875,40,0,8,121
1,2027,1970,57,0,-1,49
1,1647,1746,-99,1,203,125
1,1656,1802,-146,1,41,59
-1,1806,1624,182,-3,-267,76
1,1610,1337,273,12,77,40
-1,1482,1567,-85,-2,-234,108
1,1763,1381,382,-6,230,79
-1,1788,1740,48,-2,-392,74
1,1587,1778,-191,1,196,95
-1,1477,1573,-96,0,-38,56
1,1703,1877,-174,0,-3,67
-1,1741,1978,-237,1,35,46
-1,1664,1690,-26,-2,-61,94
1,1589,1599,-10,-1,34,85
-1,1655,1490,165,-14,-92,44
1,1788,1751,37,0,93,57
1,1716,1576,140,-5,3,77
1,1515,1271,244,4,368,69
-1,1428,1563,-135,0,-7,52
-1,2095,1910,185,0,-69,130
1,1791,1584,207,-1,27,49
-1,1800,1776,24,0,9,70
-1,1839,1988,-149,1,1,44
1,1562,1531,31,0,-5,43
1,1684,1639,45,-1,-63,95
1,1975,1897,78,0,-15,77
-1,1925,1865,60,1,18,100
1,1728,1507,221,3,89,57
1,1893,1666,227,-1,-84,65
-1,1907,2051,-144,-8,-59,42
1,1571,1512,59,-2,-78,53
0,1700,1856,-156,0,-79,121
-1,1208,1354,-146,-9,-136,40
-1,1299,1299,0,7,337,44
1,1621,1769,-148,1,141,139
1,1498,1519,-21,0,212,81
1,1362,1528,-166,0,10,45
-1,1805,1801,4,0,62,68
1,1698,1516,182,8,218,61
-1,1309,1249,60,1,146,66
-1,1502,1629,-127,0,-60,103
1,2059,1900,159,0,83,89
1,1566,1494,72,2,44,69
1,1687,1500,187,4,235,79
-1,1370,1725,-355,-4,-498,88
1,1545,1656,-111,0,200,103
-1,1769,1972,-203,-6,-565,102
1,1812,1794,18,0,182,103
-1,1733,1780,-47,-1,-16,102
-1,1289,1354,-65,-5,-122,104
-1,1328,1594,-266,-2,-140,84
-1,1565,1603,-38,-2,-389,84
1,1700,1654,46,0,6,41
-1,1307,1540,-233,-5,-428,78
1,1878,1943,-65,-2,9,55
-1,1661,1899,-238,4,66,52
1,1625,1528,97,0,-58,75
1,1732,1587,145,0,25,58
-1,1912,1851,61,-2,249,120
1,1784,1823,-39,-4,159,169
-1,1263,1653,-390,0,0,56
1,1536,1435,101,-1,307,129
1,1645,1762,-117,-5,-2,91
1,1783,1723,60,1,12,57
1,1854,1811,43,1,31,55
1,1658,1503,155,3,110,59
1,1385,1405,-20,-3,-71,59
1,1644,1709,-65,-3,47,83
1,1704,1600,104,1,21,44
-1,1888,1984,-96,1,37,62
1,1690,1360,330,0,-15,99
-1,1714,1723,-9,-2,-194,82
1,1810,1796,14,0,358,105
1,1713,1795,-82,0,171,73
1,1361,1196,165,-2,87,97
-1,1421,1572,-151,-1,-44,50
-1,1616,1632,-16,-6,-345,62
-1,2074,2066,8,0,-96,86
1,1519,1343,176,11,664,69
1,1747,1683,64,1,-13,47
-1,1580,1775,-195,-1,-382,102
0,1983,1890,93,0,-31,117
1,1503,1505,-2,1,116,83
-1,1785,1821,-36,-4,-57,86
-1,1739,1921,-182,1,44,82
-1,1312,1458,-146,-3,-388,96
0,1866,1934,-68,1,230,136
1,1904,1656,248,-9,113,111
1,1664,1661,3,0,18,91
1,1571,1615,-44,-4,14,53
-1,1915,1713,202,0,10,64
-1,1618,1631,-13,-1,-883,142
-1,1363,1716,-353,-1,-14,62
-1,1661,1757,-96,-3,-5,77
-1,1831,1776,55,0,-31,70
1,1723,1773,-50,-4,-114,57
-1,1282,1541,-259,1,-86,64
1,1594,1297,297,5,262,57
-1,1555,1632,-77,0,-373,126
1,1799,1864,-65,6,101,47
-1,1547,1693,-146,-1,-50,84
-1,1494,1797,-303,-6,-148,48
-1,1602,1321,281,-7,-140,57
-1,1507,1715,-208,-4,-172,64
-1,1788,2131,-343,0,-18,56
0,1765,1642,123,-1,-485,167
1,1717,1494,223,0,5,49
1,1761,1704,57,0,79,113
-1,2078,1879,199,0,16,56
-1,1597,1785,-188,-4,-139,86
-1,1485,1548,-63,1,45,80
1,1252,1277,-25,0,46,49
1,1905,1706,199,1,81,83
1,1394,1397,-3,8,107,47
-1,1710,1976,-266,0,26,96
1,1585,1563,22,-2,-38,45
-1,1423,1414,9,0,43,46
-1,1485,1868,-383,-3,-283,146
1,1551,1814,-263,0,8,53
1,1909,1726,183,2,232,107
1,1797,1851,-54,-1,-30,55
1,1700,1581,119,0,29,143
-1,1697,1657,40,0,-178,96
1,1380,1302,78,4,225,49
1,1526,1430,96,5,148,65
1,1980,1706,274,6,263,73
-1,1899,1931,-32,-1,-92,114
1,1489,1282,207,8,1529,111
1,1523,1363,160,1,50,104
-1,1591,1778,-187,-11,-192,46
-1,988,1444,-456,-8,-204,50
1,1395,1373,22,2,59,42
-1,1650,1761,-111,0,-25,98
1,1733,1500,233,14,734,65
-1,1278,1642,-364,2,225,96
1,1352,1224,128,5,380,57
-1,1730,1854,-124,-1,13,70
0,1702,1984,-282,0,248,136
1,1784,1586,198,0,15,59
1,1389,1416,-27,7,250,47
1,1801,1491,310,2,100,55
-1,1352,1546,-194,0,-121,126
1,1386,1076,310,6,175,43
1,1293,1611,-318,3,373,75
-1,1502,1588,-86,0,49,68
-1,1580,1789,-209,-3,283,96
-1,1781,1728,53,-6,-354,74
-1,1186,1368,-182,-1,-27,44
1,1919,1897,22,0,-5,45
-1,1769,1634,135,-2,-229,112
-1,1977,1709,268,1,-30,94
1,1465,1296,169,2,564,101
1,1676,1852,-176,3,230,53
-1,1274,1596,-322,0,-1,44
-1,1719,1796,-77,0,-22,138
1,2061,1934,127,0,-7,47
1,1871,1483,388,5,226,73
1,1557,1476,81,2,87,55
1,1404,1500,-96,-1,11,53
1,1720,1916,-196,8,58,41
-1,1752,1451,301,-2,-85,56
1,1700,1668,32,0,3,95
1,1892,1660,232,0,-15,71
-1,1728,1958,-230,0,-77,82
1,1803,1849,-46,0,0,41
-1,1731,1795,-64,1,71,60
-1,1354,1562,-208,-3,-50,50
-1,1737,1498,239,-2,-49,88
-1,1264,1401,-137,-2,-129,82
1,1526,1409,117,2,417,113
1,2068,1927,141,0,14,67
-1,1733,1652,81,-10,-141,52
1,1963,1723,240,3,120,49
1,1534,1500,34,17,903,71
-1,1598,1767,-169,-13,-40,40
-1,1447,1519,-72,-2,-84,58
1,1804,1722,82,-1,-20,59
1,1568,1348,220,3,38,51
1,1897,1737,160,-2,-18,101
-1,1789,2078,-289,-1,-202,110
-1,1837,1827,10,-6,-51,44
1,1718,1968,-250,0,-18,61
-1,1359,1593,-234,-1,-158,50
1,1659,1618,41,1,47,61
1,1732,1435,297,4,770,97
-1,1865,1896,-31,0,3,158
1,1457,1344,113,4,237,53
-1,1617,1540,77,0,-347,128
-1,1360,1439,-79,-2,-105,60
-1,1173,1440,-267,-1,23,50
-1,1203,1454,-251,3,-266,76
-1,1436,1647,-211,0,8,48
-1,1584,1513,71,3,-77,77
1,1523,1318,205,7,305,69
-1,1326,1441,-115,0,-158,118
-1,1736,1729,7,-9,-254,56
0,1957,1880,77,0,0,128
-1,1524,1637,-113,0,-242,97
1,1605,1559,46,2,136,61
-1,1420,1608,-188,1,5,66
1,2098,1765,333,2,133,81
-1,1585,1739,-154,-1,-37,49
-1,1374,1511,-137,-5,-291,76
-1,1448,1738,-290,2,-365,80
1,1696,1422,274,0,6,41
-1,1788,1990,-202,0,15,86
-1,1474,1686,-212,-5,-341,66
1,1480,1560,-80,-4,-32,59
-1,1381,1500,-119,-5,6,42
-1,1896,2141,-245,-1,-69,66
-1,1449,1351,98,0,-269,158
-1,1669,1482,187,0,-255,106
-1,1426,1644,-218,-10,-371,66
-1,1282,1585,-303,-4,-75,40
-1,1868,2025,-157,-1,-35,72
-1,1709,1726,-17,1,279,132
1,1249,1298,-49,-4,-88,61
1,1685,1516,169,9,560,63
-1,1697,1789,-92,0,-22,54
1,1809,1864,-55,3,36,43
-1,1703,1547,156,1,119,108
-1,1387,1739,-352,2,-223,88
-1,1666,1616,50,-1,-132,80
1,1449,1318,131,0,54,81
1,1500,1500,0,2,114,57
1,1642,1624,18,1,30,63
1,1452,1458,-6,2,422,78
1,1116,1282,-166,17,409,43
-1,1528,1506,22,-3,-222,68
-1,1614,1883,-269,-2,-106,74
1,1619,1500,119,11,615,75
1,1739,1577,162,0,9,65
1,1439,1546,-107,5,171,57
1,2071,1611,460,3,144,65
-1,1375,1473,-98,-5,-207,84
-1,1865,1780,85,0,-27,80
1,1660,1474,186,0,6,41
1,1500,1373,127,0,-54,73
-1,1690,1870,-180,-1,-57,70
-1,1417,1736,-319,-3,-73,52
1,1518,1367,151,2,94,49
1,1701,1683,18,-1,-35,73
-1,1511,1566,-55,1,144,56
1,1448,1351,97,3,26,45
0,1311,1456,-145,0,23,110
1,1860,1757,103,0,-23,71
-1,1573,1758,-185,-7,-88,44
1,1445,1567,-122,0,113,93
-1,1350,1380,-30,-1,-76,56
1,1414,1313,101,-1,-29,47
-1,1665,1694,-29,-1,-328,88
1,1609,1399,210,2,85,53
1,1877,1682,195,0,357,137
1,1266,1145,121,0,8,49
1,1691,1689,2,1,213,105
1,1691,1464,227,2,300,80
1,1724,1529,195,0,263,89
1,1500,1359,141,8,405,55
1,1907,1685,222,0,82,69
-1,1625,1627,-2,-1,-31,52
1,1262,1172,90,5,420,75
1,1686,1214,472,-1,150,67
-1,1662,1354,308,9,526,64
1,2121,2146,-25,2,147,99
-1,1614,1638,-24,3,-397,184
-1,1630,1653,-23,0,-213,78
1,1452,1315,137,1,104,97
-1,1342,1456,-114,0,134,86
1,1311,1444,-133,2,467,126
1,1517,1293,224,0,30,53
-1,1789,1922,-133,-4,-62,50
-1,1614,1653,-39,-6,-148,52
-1,1696,2038,-342,-1,-309,102
-1,1354,1394,-40,-4,-389,86
-1,1390,1339,51,4,175,64
-1,1273,1615,-342,-8,-99,46
-1,1680,1953,-273,-1,-8,42
1,1679,1884,-205,-1,-68,119
-1,1421,1655,-234,-2,-7,54
-1,1604,1648,-44,5,-36,122
1,1958,1676,282,0,67,105
1,1918,1702,216,-1,17,75
1,2001,1860,141,-3,29,43
1,1162,1603,-441,-9,-109,47
1,1356,1623,-267,-1,58,53
-1,1708,1762,-54,-3,4,62
-1,1782,1827,-45,-2,-74,54
-1,1612,1640,-28,0,-23,44
1,1373,1277,96,12,1172,85
-1,1372,1494,-122,-11,-439,60
-1,1640,1930,-290,0,16,74
1,1132,1274,-142,4,-148,91
1,1694,1496,198,3,186,85
-1,1264,1889,-625,-4,-213,58
1,1288,1522,-234,1,27,59
1,1750,1703,47,0,-129,77
-1,1672,1594,78,4,100,56
-1,1599,1515,84,1,-75,104
1,1782,1556,226,-1,10,43
1,1837,1740,97,1,65,63
-1,1447,1447,0,-1,8,46
0,2133,2133,0,0,-59,109
-1,1211,1688,-477,-1,86,70
-1,1933,2041,-108,-1,-18,42
1,1395,1308,87,0,84,94
1,1660,1468,192,0,396,103
-1,1726,1760,-34,0,-22,56
1,1846,1732,114,1,17,51
1,1619,1264,355,2,194,79
1,1863,1695,168,0,10,85
1,1747,1785,-38,-1,-14,53
1,1601,1403,198,9,440,67
-1,1430,1281,149,3,66,66
1,2049,1925,124,0,96,75
1,1618,1404,214,1,44,63
-1,1854,1724,130,-3,-34,60
-1,1571,1742,-171,-8,-104,44
0,1518,1650,-132,-2,145,143
1,1627,1664,-37,0,179,137
1,1650,1394,256,1,269,99
-1,1742,1950,-208,0,-95,64
1,1552,1789,-237,-2,-4,47
-1,1327,1474,-147,-9,-141,47
0,1782,1699,83,-3,-28,105
-1,1918,2057,-139,-1,-440,122
1,1700,1671,29,-1,-23,55
-1,1739,1838,-99,-2,-30,58
-1,978,1378,-400,-14,-290,50
1,1677,1604,73,7,147,51
-1,1917,1913,4,-3,-190,112
-1,1661,1852,-191,-6,-77,54
-1,1438,1462,-24,0,-82,84
1,1564,1463,101,-2,-4,117
-1,1299,1404,-105,-1,-388,98
1,1696,1761,-65,-1,185,68
1,1618,1626,-8,-2,196,89
1,1607,1727,-120,2,344,103
-1,1451,1559,-108,-1,-96,84
1,1693,1500,193,0,-154,91
-1,1665,1579,86,0,-9,88
-1,2133,2133,0,-2,-14,74
-1,1458,1547,-89,0,-4,46
-1,1558,1479,79,1,317,92
-1,1635,1861,-226,-1,-103,90
-1,1777,2008,-231,-3,-52,64
-1,1259,1537,-278,-1,-153,78
1,1759,1780,-21,0,-26,69
1,1450,1455,-5,13,246,47
1,1702,1732,-30,0,505,149
-1,1431,1364,67,5,185,58
-1,1392,1521,-129,1,-7,64
1,1689,1209,480,5,403,67
1,1621,1421,200,1,742,101
1,1262,1399,-137,-4,-63,41
-1,1771,1899,-128,-3,-116,68
-1,1428,1485,-57,-1,-548,82
-1,1698,1524,174,1,12,54
-1,1429,1524,-95,-3,-63,44
1,1962,1867,95,0,361,129
1,1871,1925,-54,1,65,51
-1,1399,1699,-300,0,-91,112
-1,1737,1790,-53,0,-119,98
1,1770,1716,54,0,51,73
1,1974,1846,128,0,-34,109
-1,1689,1771,-82,-1,12,54
0,1619,1683,-64,1,98,107
1,1659,1820,-161,-1,633,167
-1,1623,1890,-267,0,73,56
-1,1469,1430,39,-6,-129,252
1,1442,1658,-216,2,94,69
-1,1856,1971,-115,0,-121,138
1,1641,1527,114,8,318,45
-1,1267,1396,-129,-1,-456,78
-1,1413,1292,121,1,75,64
1,1694,1842,-148,2,193,75
-1,1380,1319,61,3,48,40
-1,1514,1522,-8,-14,-207,53
1,1648,1536,112,-4,-2,49
0,1925,1905,20,-1,-30,154
1,1703,1351,352,5,191,59
1,1472,1431,41,0,27,69
-1,1450,1843,-393,-1,20,84
1,1887,1383,504,3,122,53
-1,2150,1912,238,-3,-206,82
-1,1517,1565,-48,-5,-249,80
-1,1675,1846,-171,-1,-44,56
1,1536,1439,97,4,137,45
-1,1622,1521,101,-1,-478,110
-1,2145,2122,23,0,-28,62
-1,1981,1804,177,-2,-15,46
-1,1794,1641,153,0,-59,100
1,1954,1799,155,3,59,44
-1,1472,1587,-115,1,-15,94
0,1663,1862,-199,0,3,111
1,1270,1459,-189,-6,-164,51
-1,1692,1821,-129,0,77,68
-1,1320,1706,-386,1,-92,92
1,1541,1310,231,8,544,81
1,1383,1349,34,1,356,107
-1,1484,1271,213,-2,-171,68
-1,1298,1888,-590,-3,-244,68
-1,1532,1653,-121,-1,-25,60
-1,1301,1897,-596,-3,-185,62
-1,1072,1170,-98,1,69,68
-1,1444,1461,-17,-5,-406,66
-1,1479,1348,131,2,43,53
-1,1854,1668,186,3,38,46
1,1680,1621,59,1,-67,89
-1,1676,1620,56,0,31,48
-1,1511,1489,22,1,54,56
-1,1605,1780,-175,1,35,70
-1,1675,1655,20,-9,-151,104
-1,1685,1833,-148,-2,-32,50
-1,1640,1460,180,1,24,56
-1,0,1185,-1185,-4,-541,70
-1,1682,1580,102,0,73,80
1,1465,1686,-221,-3,-14,191
-1,1443,1677,-234,-3,-146,70
-1,1672,1849,-177,-1,-232,90
-1,1727,1934,-207,-2,-27,48
-1,1451,1572,-121,-1,-52,104
1,1649,1422,227,0,-10,55
-1,1256,1403,-147,-4,-231,78
-1,1551,1791,-240,-5,-112,50
1,1333,1367,-34,2,24,47
-1,1288,1619,-331,-4,-284,80
-1,1663,1667,-4,5,115,132
1,1979,2133,-154,1,224,127
-1,1531,1627,-96,-1,-29,64
1,1709,1706,3,-3,-91,63
-1,1930,2128,-198,0,-85,92
1,1442,1290,152,-12,2,149
1,1508,1467,41,3,797,139
1,2018,1933,85,0,17,71
0,1935,1894,41,0,38,106
-1,2013,1867,146,0,38,50
1,1694,1658,36,-2,-72,47
-1,1580,1700,-120,-1,1,74
1,1367,1418,-51,4,136,56
-1,1669,1852,-183,-1,-51,88
1,2135,1924,211,2,18,41
-1,1476,1623,-147,-4,-367,90
-1,1857,2142,-285,0,-43,100
-1,1608,1557,51,0,-260,122
1,1709,1468,241,7,68,43
1,1786,1661,125,3,60,63
-1,1506,1500,6,-2,-263,106
1,1329,1284,45,-1,533,129
1,1657,1666,-9,1,57,47
1,1622,1394,228,-1,28,73
1,1700,1859,-159,1,220,59
-1,1534,1435,99,-1,-4,44
1,1919,2141,-222,0,-4,75
-1,1721,2064,-343,0,-89,68
1,1264,1487,-223,0,-2,55
-1,1595,1668,-73,-3,-95,48
-1,1882,1997,-115,-6,-287,78
-1,1611,1696,-85,2,0,54
-1,1679,1655,24,-4,49,106
1,1546,1358,188,-4,103,101
-1,1360,1840,-480,0,-1,50
1,2050,1716,334,0,31,85
-1,1338,1438,-100,2,-48,64
-1,1680,1746,-66,-7,-295,92
1,1574,1479,95,2,223,93
1,1447,1406,41,1,47,77
1,1842,1357,485,4,51,41
1,1896,1630,266,2,13,43
-1,1244,1441,-197,2,7,96
-1,1677,1655,22,-2,-85,64
-1,1424,1499,-75,-1,-99,58
1,2054,1713,341,0,-218,155
-1,2005,1875,130,-4,-140,102
-1,1469,1567,-98,0,-855,140
1,1708,1573,135,4,32,43
1,1793,1607,186,1,-10,111
-1,1676,1586,90,0,-44,120
1,1796,1542,254,0,139,67
-1,1657,1667,-10,6,469,148
-1,1649,1571,78,1,-87,70
1,1638,1837,-199,-6,-423,89
-1,1363,1447,-84,-4,-114,47
1,1595,1406,189,7,312,69
-1,1851,1708,143,0,-113,100
1,1490,1500,-10,0,10,69
-1,1589,1771,-182,-4,-372,96
1,1964,1726,238,2,253,141
1,1662,1492,170,0,36,83
-1,2007,1895,112,-1,-1,86
1,1327,1397,-70,14,127,41
1,2063,1842,221,0,-65,75
1,1800,1479,321,1,307,121
-1,1511,2042,-531,-1,-446,110
-1,1800,1677,123,0,7,62
-1,1525,1744,-219,-1,-126,64
1,1516,1401,115,-1,142,75
1,1591,1360,231,2,409,101
1,1476,1354,122,-3,-76,57
-1,1666,1456,210,-6,-80,40
-1,1488,1785,-297,-9,-117,58
-1,1827,1910,-83,-4,-36,92
-1,1660,1688,-28,1,-4,40
0,1727,1500,227,5,4,130
-1,1640,1503,137,-4,-91,52
1,1520,1579,-59,1,40,47
-1,1919,1807,112,0,-230,138
-1,1395,1520,-125,-1,-69,86
1,1750,1520,230,1,109,87
-1,1514,1862,-348,1,-95,91
1,2044,1483,561,1,27,119
-1,1544,1440,104,-2,-81,60
-1,1393,1500,-107,-9,-233,52
1,1969,1838,131,0,188,175
-1,1498,1762,-264,0,-22,84
1,1702,1396,306,-1,-33,51
1,1678,1535,143,-3,-71,53
1,1840,1905,-65,1,417,113
-1,1358,1633,-275,-2,-154,78
-1,1985,1900,85,1,11,62
1,1891,1599,292,1,146,73
-1,1798,2003,-205,-1,-465,116
-1,1320,1679,-359,-2,34,52
-1,1828,1302,526,0,-593,136
1,1699,1682,17,0,70,123
1,1668,1777,-109,-1,-21,61
1,1573,1356,217,1,170,67
0,1959,1944,15,1,21,96
-1,1323,2045,-722,-3,-638,110
-1,1521,1625,-104,1,-8,44
-1,1531,1658,-127,-1,-249,94
-1,1917,1971,-54,0,-6,64
-1,1515,1755,-240,0,-21,56
-1,1302,1600,-298,-2,-296,82
0,1511,1526,-15,0,-328,165
1,1483,1338,145,2,245,87
1,1738,1626,112,-3,-3,67
1,1572,1392,180,5,225,79
-1,1699,1590,109,1,43,90
-1,1322,2045,-723,-5,-85,50
1,1761,1510,251,4,47,51
1,1383,1449,-66,7,338,69
-1,1494,1770,-276,0,-106,120
-1,1614,1444,170,-4,-147,78
1,1945,1959,-14,1,91,113
1,1341,1445,-104,0,139,57
1,1467,1819,-352,1,24,79
-1,1500,1729,-229,-8,-140,48
0,1605,1684,-79,-2,-189,129
-1,1446,1281,165,-2,77,60
1,1860,1500,360,2,-2,41
-1,1736,1528,208,-1,-705,130
-1,1794,1600,194,0,-65,62
1,1266,1367,-101,-1,-18,59
1,1551,1535,16,0,58,75
1,1723,1734,-11,0,1,51
-1,1468,1481,-13,-6,-440,134
-1,1506,1766,-260,-2,-59,52
1,1977,1646,331,3,633,85
-1,1512,1589,-77,-3,-163,54
1,1436,1397,39,6,367,73
-1,1385,1578,-193,-6,-183,68
1,1635,1540,95,8,70,44
1,1665,1808,-143,1,26,77
-1,1649,1734,-85,-1,-107,72
-1,1723,1777,-54,-3,-209,68
1,1524,1348,176,3,479,99
-1,1682,1607,75,2,-19,64
-1,1709,1602,107,0,7,54
-1,1682,1476,206,-1,1,56
1,1503,1460,43,2,45,53
-1,1188,1371,-183,-5,-67,42
-1,1948,1956,-8,0,88,104
-1,1671,1669,2,-1,52,122
-1,1500,1198,302,-10,-266,80
1,1490,1406,84,3,28,45
-1,1490,1606,-116,0,1,54
1,1896,1511,385,0,-12,61
-1,1544,1717,-173,-11,-167,48
1,1643,1503,140,0,-20,63
1,1981,1650,331,-3,-25,97
1,1584,1380,204,1,102,83
1,1793,1714,79,1,96,85
-1,1422,1621,-199,-1,-297,138
1,1970,1501,469,-1,102,73
-1,1446,1624,-178,0,-160,60
1,1724,1538,186,-6,-21,57
-1,1389,1248,141,-3,-265,66
-1,1314,1458,-144,-4,-288,70
1,1498,1598,-100,3,169,52
-1,1617,1696,-79,-1,-12,46
1,1500,1545,-45,6,194,57
-1,1943,1980,-37,-1,-162,136
-1,1526,1197,329,-3,-440,130
-1,1619,1483,136,-1,-38,66
1,1966,1937,29,-3,-172,115
-1,1458,1568,-110,-1,-349,100
0,1377,1177,200,-2,-111,125
-1,1667,2046,-379,0,-48,95
-1,1735,2113,-378,-4,-39,40
-1,1705,1808,-103,-1,-113,84
1,1519,1442,77,-3,-71,41
0,1730,1713,17,0,-365,130
1,1680,1354,326,1,64,79
-1,1479,1476,3,1,-97,67
-1,1237,1806,-569,-2,-54,50
1,1512,1542,-30,-2,-179,105
-1,1890,1916,-26,-1,-283,126
-1,1598,1137,461,11,269,42
1,1683,1518,165,1,28,43
1,1821,1697,124,0,1,73
1,1374,1380,-6,4,109,49
1,1634,1608,26,0,76,79
-1,1573,1551,22,-4,-361,70
1,1807,1232,575,4,376,75
1,1590,1416,174,4,236,79
-1,1456,1624,-168,-3,-243,80
1,1645,1357,288,-1,-59,59
1,1461,1353,108,0,275,135
-1,1633,1440,193,4,128,182
1,1650,1605,45,-3,-74,85
1,2051,1868,183,1,11,47
1,1942,1880,62,-1,-48,53
-1,1218,1718,-500,3,-50,48
1,2074,1743,331,0,163,101
1,1773,1809,-36,-8,242,85
-1,1512,1556,-44,0,-3,52
-1,1990,1794,196,0,48,70
1,1928,1976,-48,2,85,67
1,1441,1501,-60,1,176,55
1,1500,1438,62,7,242,61
1,1808,1632,176,1,74,89
1,1626,1487,139,7,242,47
1,1812,1973,-161,-3,-19,83
1,2095,1856,239,0,-76,99
1,1883,1723,160,-1,87,65
-1,1385,1368,17,0,-44,72
-1,1568,1526,42,1,3,64
1,1434,1500,-66,3,294,85
-1,1500,1478,22,-2,-140,146
1,1714,1481,233,1,15,49
1,1681,1624,57,3,96,59
-1,1775,1808,-33,-1,-122,74
1,1523,1342,181,-1,0,69
-1,1739,1841,-102,-1,-21,96
1,2061,1963,98,0,1,49
-1,1690,1832,-142,3,21,102
1,1598,1644,-46,0,128,75
1,1502,1578,-76,-6,-73,51
1,1984,1671,313,0,61,161
1,1689,1648,41,4,44,45
1,2060,1511,549,5,304,73
1,1964,1940,24,0,-66,99
1,1730,1501,229,-3,-23,49
1,1847,1663,184,3,68,47
1,1464,1539,-75,1,279,67
1,1656,1721,-65,0,18,117
-1,1633,1717,-84,-2,-389,104
-1,1764,1813,-49,1,33,64
-1,1486,1908,-422,1,27,60
-1,1736,1694,42,-2,-303,91
1,1843,1684,159,2,297,93
1,1470,1326,144,10,476,59
1,1596,1630,-34,1,102,101
-1,1500,1450,50,1,5,76
-1,1631,1610,21,-2,17,93
1,1481,2073,-592,0,-21,67
1,1188,1371,-183,16,714,75
1,1858,1525,333,0,158,65
1,2071,1815,256,0,18,53
-1,1331,2073,-742,-20,-165,41
1,1725,1290,435,0,-92,77
-1,1529,1566,-37,-13,-931,132
1,1484,1625,-141,0,36,55
1,1930,1974,-44,0,153,115
1,2042,1508,534,0,20,55
-1,2115,1869,246,2,147,64
-1,1554,1293,261,-4,89,40
1,1829,1945,-116,0,-2,81
1,1516,1572,-56,10,311,59
1,1399,1500,-101,5,133,65
-1,1685,1500,185,0,-49,96
-1,1735,1742,-7,-3,-21,46
-1,1902,2093,-191,0,77,86
1,1622,1620,2,0,-10,105
-1,1507,1822,-315,-4,-29,54
-1,1359,1468,-109,0,-323,84
-1,1610,1690,-80,3,40,44
1,1512,1621,-109,0,86,55
-1,1653,1706,-53,-1,-240,106
1,2100,1892,208,-1,50,55
-1,1609,1760,-151,1,-36,47
1,1825,1503,322,0,37,55
-1,1444,1392,52,-1,-176,138
1,1609,1286,323,1,36,49
1,1708,1497,211,3,38,47
1,2044,1865,179,2,88,78
-1,1498,1750,-252,-6,-52,44
-1,1883,2107,-224,-6,-615,106
1,1845,1859,-14,0,60,89
1,1962,1942,20,1,114,101
-1,1727,1660,67,2,181,78
-1,1609,1633,-24,0,-64,66
1,1431,1500,-69,2,27,53
-1,1280,1612,-332,0,-16,64
0,1828,2113,-285,0,747,166
-1,1760,1740,20,-5,119,115
-1,1669,1754,-85,-1,-150,102
1,2117,1810,307,0,36,53
1,1528,1338,190,0,31,43
-1,1519,1564,-45,-1,-210,98
-1,1568,1596,-28,0,5,51
1,2104,1835,269,1,131,111
1,1971,2032,-61,0,6,51
1,1724,1530,194,1,10,43
1,1644,1599,45,3,67,61
1,1347,1437,-90,7,204,71
-1,2052,1958,94,3,285,160
-1,1831,2109,-278,0,150,106
1,1546,1350,196,0,382,99
-1,1440,1462,-22,-1,-415,144
1,2014,1984,30,0,6,49
1,1988,1715,273,0,87,115
-1,1514,1915,-401,0,-415,112
1,1570,1674,-104,-1,-47,97
1,1454,1456,-2,18,489,43
0,2113,1880,233,1,525,149
1,1371,1730,-359,10,404,65
1,1602,1724,-122,0,40,71
-1,1509,1397,112,0,-18,78
-1,1974,2028,-54,-2,3,50
-1,1647,1768,-121,-1,-52,76
-1,1297,1459,-162,-6,-107,40
1,1723,1612,111,0,14,67
-1,1278,1734,-456,-1,7,98
1,1589,1653,-64,-1,-60,79
-1,1318,1424,-106,-1,-68,76
1,1763,1661,102,1,16,63
1,1428,1484,-56,1,48,57
1,1857,1892,-35,0,-8,65
1,1919,1891,28,0,40,61
-1,2041,1965,76,0,-69,166
1,1681,1551,130,-2,513,111
1,1636,1492,144,2,196,91
-1,1231,1425,-194,2,26,67
-1,1020,1653,-633,-3,-902,114
1,1649,1712,-63,-1,-51,85
1,1430,1265,165,0,16,53
1,1616,1338,278,0,166,63
1,1465,1447,18,-1,50,50
1,1413,1326,87,0,64,63
1,1405,1431,-26,2,342,90
-1,1801,1892,-91,-1,-204,124
-1,1445,1466,-21,1,-319,94
-1,1510,1435,75,2,-41,66
-1,1879,2106,-227,-6,-453,126
-1,1709,1617,92,0,-206,120
1,1436,1648,-212,-1,135,113
1,1978,2023,-45,-4,-21,45
1,2111,1874,237,0,175,85
-1,1363,1287,76,-8,-637,78
-1,1473,1674,-201,1,7,62
-1,1640,1602,38,0,-32,74
1,1253,1436,-183,0,563,139
1,1870,1875,-5,0,-13,63
-1,1534,1653,-119,0,7,48
-1,1870,2117,-247,-4,-368,102
-1,2007,1990,17,0,48,100
1,1827,1848,-21,0,367,139
-1,1477,1421,56,0,-15,54
1,1620,1489,131,0,44,69
0,1524,1465,59,1,2,97
1,1735,1274,461,0,87,61
1,1620,1520,100,-1,56,91
-1,1596,1623,-27,1,-445,114
1,2122,1865,257,-1,-76,79
1,1397,1075,322,12,625,53
-1,2002,1992,10,-2,-234,114
-1,1503,1857,-354,-1,-113,66
1,1603,1558,45,0,331,108
1,1480,1474,6,2,42,53
-1,1467,1577,-110,-1,118,132
-1,1679,1698,-19,-3,-105,72
-1,1861,2127,-266,-1,-363,76
-1,1422,1613,-191,-2,-78,76
-1,1190,1631,-441,0,8,56
1,1838,1839,-1,-4,-295,113
-1,1453,1401,52,2,33,52
1,1334,1216,118,0,392,77
1,1985,1832,153,1,138,97
1,1738,1808,-70,-2,-75,73
1,1673,1502,171,0,72,75
1,1671,1702,-31,1,24,53
-1,1912,2117,-205,1,57,118
1,1751,1583,168,0,5,111
0,1899,1825,74,0,126,144
1,1625,1577,48,5,441,129
-1,1472,1534,-62,0,-465,120
1,1647,1757,-110,0,34,103
1,1544,1319,225,2,373,71
1,1520,1511,9,4,-36,105
-1,1871,1886,-15,1,24,52
1,1769,1302,467,3,700,103
-1,1723,1605,118,0,-99,70
-1,1429,1737,-308,1,-405,106
-1,1633,1631,2,-7,-589,92
-1,1908,1896,12,1,39,86
1,1504,1584,-80,-2,-18,113
1,1795,1751,44,-2,135,93
1,1471,1085,386,7,152,45
-1,1773,1771,2,-3,-147,104
-1,1827,1896,-69,-1,-418,82
-1,1624,1226,398,-4,-49,54
-1,1549,1254,295,-3,-158,82
1,1454,1352,102,7,460,113
1,1717,1559,158,0,60,61
-1,1588,1545,43,0,-224,80
-1,1712,1832,-120,2,35,134
-1,2012,1845,167,0,-34,84
-1,1742,1805,-63,0,459,86
-1,1375,1484,-109,-1,1,58
1,1741,1425,316,4,413,121
-1,1516,1479,37,-2,-130,90
1,1218,1236,-18,1,501,95
-1,1927,2100,-173,-10,-232,124
1,1767,1742,25,1,32,49
-1,1342,1244,98,-6,-51,88
-1,1463,1543,-80,-1,-62,66
-1,1536,1749,-213,1,-47,50
1,1356,1394,-38,17,778,81
1,1642,1621,21,1,335,109
-1,1367,1405,-38,-3,-186,64
1,1564,1519,45,-1,423,87
1,1813,1733,80,-2,66,57
-1,1359,1394,-35,0,-5,56
-1,1184,1306,-122,9,305,50
1,1778,1518,260,0,102,53
0,1346,1451,-105,2,43,86
1,1414,1441,-27,4,267,69
-1,1907,2123,-216,-1,-152,92
1,1656,1559,97,0,13,69
-1,1724,1822,-98,1,-37,66
-1,1414,1487,-73,-1,-79,59
1,1584,1530,54,-2,109,61
-1,1242,1413,-171,-1,-11,52
1,1274,1529,-255,5,444,89
1,1723,1691,32,-4,-294,101
1,1664,1563,101,0,71,99
-1,1897,1753,144,0,-2,84
-1,1689,1554,135,2,160,128
-1,1313,1267,46,-2,-299,88
1,1708,1500,208,0,12,61
-1,1471,1390,81,0,-247,118
1,1724,1720,4,0,-114,85
-1,1829,1717,112,-1,-366,120
-1,1414,1577,-163,-3,-126,56
1,2108,1921,187,8,382,61
1,1493,1524,-31,-1,-40,65
1,1383,1458,-75,-1,2,49
1,1401,1512,-111,2,75,65
-1,1266,1386,-120,-10,-462,64
0,1731,1816,-85,3,258,86
0,2080,2109,-29,0,-54,140
1,1552,1449,103,1,262,93
-1,1865,1815,50,-2,-18,40
1,1329,1236,93,-1,50,87
1,1915,2115,-200,0,36,51
1,1611,1652,-41,-3,179,115
-1,1429,1427,2,3,20,46
1,1803,1756,47,-2,-50,63
1,1589,1581,8,9,59,41
1,1816,1448,368,-8,53,57
1,1464,1298,166,-3,79,195
-1,1405,1349,56,1,-455,134
-1,1471,1583,-112,-8,-109,40
1,1813,1733,80,1,19,103
0,1295,1599,-304,-1,-153,78
-1,1454,1600,-146,-3,-38,46
1,1681,1664,17,2,663,109
1,2094,1932,162,1,339,135
1,1591,1463,128,1,288,97
-1,1544,1536,8,-1,-66,66
-1,1804,1331,473,-1,-102,68
1,1367,1500,-133,9,506,75
1,1580,1525,55,5,355,95
-1,1555,1672,-117,-1,-67,56
1,1828,1676,152,1,0,55
1,1725,1821,-96,0,209,95
1,1672,1503,169,3,57,41
-1,1513,1552,-39,-5,-64,62
-1,1447,1741,-294,-8,-92,46
-1,1718,1582,136,-1,-166,130
-1,1235,1485,-250,-8,-202,64
-1,1512,1709,-197,-2,-91,68
-1,1456,1444,12,-1,-157,122
1,1732,1742,-10,1,-16,113
1,1808,1738,70,-1,375,95
1,1381,1525,-144,3,-35,67
1,1509,1294,215,1,200,95
0,2129,2217,-88,-3,107,162
1,1680,1547,133,2,238,99
0,1068,1359,-291,1,483,137
-1,1455,1599,-144,-1,-276,82
1,1841,1641,200,5,274,89
0,1444,1607,-163,2,190,135
-1,1730,1816,-86,0,49,94
-1,1846,2184,-338,0,-51,62
-1,1341,1500,-159,-2,-51,64
-1,1623,1640,-17,-1,-143,62
0,1683,1577,106,1,128,110
0,1550,1600,-50,0,-95,109
1,1824,1722,102,2,-98,89
-1,1379,1520,-141,-3,-184,58
-1,1701,1589,112,0,6,58
-1,1229,1377,-148,0,-381,144
1,1429,1506,-77,1,647,141
1,1678,1595,83,0,6,65
0,1780,1882,-102,0,-53,111
-1,1841,2173,-332,-1,-99,66
1,1632,1111,521,-2,193,87
1,1744,1813,-69,-1,173,65
1,1338,1500,-162,15,417,55
1,1376,1463,-87,6,154,40
1,1449,1602,-153,2,310,75
1,1736,1554,182,-5,73,71
-1,1572,1597,-25,-6,-1201,120
-1,1926,2102,-176,-4,-80,56
1,1691,1654,37,0,3,55
-1,1231,1606,-375,-2,-98,90
1,1714,1713,1,0,-70,73
1,1148,1279,-131,0,-7,78
1,1780,1606,174,14,179,43
1,1974,1814,160,0,107,87
1,2177,1838,339,-1,-30,63
1,1714,1832,-118,0,54,79
1,1651,1671,-20,0,5,41
-1,1993,1825,168,1,-408,116
-1,2214,2131,83,0,-23,90
-1,1613,1650,-37,0,-203,84
1,1506,1311,195,1,13,41
1,1506,1633,-127,2,119,93
-1,1818,1728,90,-2,-326,84
1,1835,1561,274,0,249,89
-1,1509,1397,112,4,155,44
1,1939,1603,336,-1,-10,73
1,1494,1500,-6,6,294,65
1,1599,1787,-188,-5,-78,105
-1,1741,1805,-64,0,211,102
1,1687,1560,127,0,4,41
-1,1616,1881,-265,-5,-364,90
1,1647,1776,-129,-1,-77,135
1,1601,1119,482,1,361,137
-1,1301,1557,-256,-3,-74,46
0,1478,1562,-84,0,68,83
1,1348,1490,-142,-4,-117,41
1,1603,1660,-57,0,-225,131
-1,1844,2146,-302,-1,-24,48
1,1517,1268,249,4,83,45
1,1814,1733,81,-6,-395,73
-1,1594,1658,-64,-1,-261,108
1,1200,0,1200,7,330,61
1,1562,1249,313,8,231,43
-1,1718,1807,-89,0,-40,78
1,1228,1306,-78,-8,-160,55
-1,1975,1985,-10,-5,69,116
1,1697,1417,280,0,-1,61
-1,1216,1565,-349,-2,-195,78
1,1847,1638,209,1,447,111
-1,1144,1458,-314,0,-271,144
-1,1724,1822,-98,-1,-76,64
1,1611,1285,326,5,293,69
1,2150,1841,309,0,36,73
-1,1598,1551,47,-3,-40,76
-1,1686,1476,210,-4,-132,92
1,1829,1560,269,-6,79,53
-1,1574,1191,383,0,-13,60
1,1442,1688,-246,3,598,113
1,1886,1725,161,1,222,81
-1,1504,1449,55,0,-16,54
1,1549,1463,86,0,178,75
-1,1680,1492,188,0,-9,90
-1,1799,1760,39,-1,-213,78
-1,1816,1964,-148,-1,-123,92
-1,1310,1427,-117,-2,-59,50
-1,1556,1833,-277,3,128,64
-1,1202,1527,-325,-18,-764,62
-1,1356,1576,-220,-11,-194,40
1,1713,1600,113,0,18,61
1,1584,1389,195,1,82,57
-1,1509,1365,144,1,28,52
1,1413,1494,-81,-2,57,63
1,1827,1753,74,0,72,63
-1,1296,1581,-285,0,-57,74
1,1837,1551,286,8,220,47
-1,1662,1589,73,0,-104,118
1,1561,1317,244,2,15,45
-1,1648,1839,-191,0,12,82
1,1407,1615,-208,-6,-84,81
1,1243,1293,-50,0,266,87
-1,1592,1721,-129,-2,-441,140
1,1616,1403,213,1,232,67
-1,1473,1543,-70,-4,-152,48
-1,1405,1530,-125,-10,-621,110
-1,1166,1478,-312,-7,-907,88
-1,1290,1566,-276,-1,-27,50
1,1309,1164,145,5,130,67
1,1429,1607,-178,4,561,119
-1,2134,1946,188,0,-15,98
1,1492,1462,30,-2,-16,47
1,1635,1500,135,-2,-37,57
-1,1622,1974,-352,-4,-102,52
0,1553,1845,-292,-3,-409,120
1,1481,1143,338,17,1432,89
-1,1494,1613,-119,0,-131,125
-1,1388,1603,-215,0,-36,70
1,1719,1895,-176,0,-25,63
1,1350,1264,86,0,21,51
1,1570,1268,302,6,873,99
-1,1421,1557,-136,-2,-360,74
-1,1217,1500,-283,1,-319,86
1,1861,1700,161,0,23,65
-1,1124,1485,-361,-15,-365,50
1,1837,1562,275,4,184,71
1,1487,1109,378,4,30,41
-1,1576,1646,-70,-3,-97,44
-1,1169,1435,-266,-9,-648,68
1,1728,1585,143,0,23,55
1,1669,1460,209,6,198,60
-1,1621,1451,170,6,180,56
-1,1670,1839,-169,0,-23,58
1,1962,1586,376,-3,39,59
1,1701,1546,155,3,90,49
1,1490,1095,395,15,1340,103
-1,1441,1396,45,-13,-108,42
-1,1559,1530,29,0,-56,74
-1,1619,1809,-190,-3,-16,44
-1,1515,1585,-70,-8,26,40
-1,1280,1256,24,1,-63,82
-1,1361,1398,-37,-1,-104,74
-1,1655,1663,-8,0,-3,48
1,1574,1552,22,-1,-46,71
1,1512,1502,10,0,170,81
1,1873,1735,138,2,628,139
1,1480,1427,53,5,59,43
-1,1579,1735,-156,0,-96,82
-1,1510,1416,94,2,45,48
1,1634,1655,-21,0,126,59
-1,1316,1350,-34,-1,-130,64
1,1816,1978,-162,8,332,51
-1,1742,1707,35,-1,-145,96
-1,1558,1465,93,-2,-367,83
1,1586,1455,131,0,51,51
1,1594,1505,89,-1,411,117
1,1451,1479,-28,1,674,137
1,1809,1833,-24,0,5,123
-1,1564,1521,43,-1,-102,88
1,1455,1675,-220,-4,-89,53
-1,1469,1398,71,-1,-346,88
1,1886,1500,386,0,28,53
1,1643,1609,34,-1,126,111
1,1401,1350,51,-1,48,77
0,1548,1520,28,-2,-161,135
1,1482,1364,118,8,311,101
1,1643,1646,-3,-1,-61,64
1,1481,1572,-91,1,63,89
1,1694,1564,130,1,-41,43
1,1609,1487,122,-1,-85,64
1,1674,1437,237,1,69,67
1,1820,1821,-1,-1,203,109
-1,1564,1767,-203,-5,-224,66
1,1641,1570,71,1,108,63
1,2118,1845,273,4,23,45
0,1590,1446,144,0,93,97
-1,1585,1732,-147,-3,-216,74
1,1594,1401,193,1,163,71
1,1664,1457,207,-1,-71,65
-1,1540,1708,-168,0,-8,46
-1,1633,1854,-221,-1,-16,50
-1,1430,1302,128,5,306,74
-1,1634,1677,-43,1,-249,154
1,1832,1675,157,0,-10,69
-1,1531,1399,132,-1,-179,68
1,1600,1544,56,-3,-76,49
1,1742,1551,191,5,182,61
-1,1269,1268,1,-2,-262,108
-1,1654,1563,91,-1,-53,116
1,1496,1603,-107,-1,-126,101
-1,1669,1839,-170,1,-73,118
1,1728,1882,-154,-1,-36,77
1,1476,1433,43,0,68,73
1,1611,1584,27,1,39,43
1,1723,1710,13,2,135,95
-1,1684,1698,-14,-1,-146,60
1,1706,1491,215,0,56,63
1,1670,1411,259,13,683,63
-1,1690,1549,141,-2,-255,116
-1,1503,1526,-23,-1,-262,146
1,1567,1471,96,0,60,73
1,1292,1435,-143,2,138,73
1,1727,1672,55,-2,215,103
1,1462,1182,280,2,125,62
1,1393,1366,27,3,16,45
1,1356,1611,-255,2,-210,79
-1,1680,1956,-276,0,-106,66
1,1547,1538,9,-4,-116,93
-1,1350,1315,35,3,93,52
-1,1769,1903,-134,-1,-12,46
-1,1474,1401,73,0,5,40
1,1484,1291,193,1,49,53
1,1671,1625,46,0,310,91
1,1667,1053,614,4,263,81
-1,1422,1286,136,2,25,54
1,2059,1404,655,1,108,93
-1,1352,1851,-499,0,6,56
1,1678,1631,47,1,121,81
-1,1562,1490,72,-3,-213,90
-1,1454,1545,-91,-2,-97,90
-1,1462,1575,-113,0,-35,120
-1,1692,1674,18,1,46,68
-1,1490,1528,-38,-1,-128,72
-1,1414,1460,-46,-6,-241,74
1,1728,1613,115,1,33,104
1,1527,1368,159,2,64,55
-1,1699,1733,-34,-5,-194,60
1,1890,1761,129,1,20,41
-1,1131,1246,-115,0,-308,124
1,1723,1676,47,-9,-83,93
-1,1688,1760,-72,-3,-289,86
-1,1277,1624,-347,3,51,54
-1,1380,1658,-278,-3,-147,80
1,1507,1520,-13,1,294,75
-1,1668,1685,-17,-1,-94,68
-1,1379,1872,-493,-7,-204,52
1,1408,1404,4,4,144,49
-1,1424,1504,-80,-1,-15,62
-1,1562,1852,-290,-4,-255,80
1,1366,1612,-246,2,41,63
1,1587,1424,163,13,89,41
-1,1647,1695,-48,1,43,58
1,1309,1338,-29,6,82,49
1,1633,1873,-240,0,-7,43
1,1725,1564,161,0,91,63
-1,1614,1511,103,0,15,55
1,1281,1302,-21,-5,-87,43
1,1379,1201,178,8,174,123
1,1466,1308,158,0,82,68
1,1582,1163,419,4,-43,79
-1,1487,1521,-34,-5,-70,46
-1,1629,1960,-331,1,148,60
1,1736,1519,217,1,181,99
-1,1679,1752,-73,-5,0,42
0,1508,1574,-66,-2,126,98
1,1754,1725,29,-7,-97,77
1,1534,1460,74,2,329,103
1,1480,1307,173,0,-5,53
1,2053,1856,197,-2,6,51
-1,1679,1775,-96,-1,-125,76
1,1623,1480,143,3,91,73
-1,1710,1681,29,1,-31,122
1,1761,1670,91,10,236,67
-1,1454,1475,-21,-3,-338,82
1,1909,1776,133,-3,-135,79
1,1545,1438,107,-1,22,89
1,1357,1555,-198,2,246,81
1,1584,1533,51,0,-85,99
1,1635,1473,162,6,110,67
1,1735,1627,108,2,58,75
-1,1717,1837,-120,-2,-156,62
1,1670,1272,398,2,56,51
1,1850,2064,-214,0,37,73
1,1593,1385,208,6,128,55
-1,1500,1562,-62,-4,-243,66
-1,1662,1769,-107,0,-291,146
1,1299,1486,-187,3,66,45
1,1558,1581,-23,0,-10,47
-1,1150,1295,-145,-2,-71,42
-1,1646,1467,179,-5,-203,76
1,1764,1715,49,-1,-45,77
1,1159,1294,-135,5,32,47
-1,1328,1393,-65,-10,-352,44
-1,1287,1554,-267,-2,-151,71
-1,1279,1582,-303,-2,-167,84
1,1403,1564,-161,0,51,41
1,1619,1483,136,0,32,65
1,1671,1526,145,2,66,51
-1,1419,1444,-25,1,-16,54
-1,1473,1510,-37,0,-24,74
-1,1630,1476,154,-1,-6,42
1,1777,1654,123,2,206,91
1,1390,1559,-169,-1,-21,57
1,1598,1321,277,-3,-68,55
-1,1379,1598,-219,-1,-13,72
1,1772,1783,-11,1,29,73
1,1570,1523,47,0,17,65
-1,1618,1748,-130,3,62,52
1,1570,1597,-27,1,165,94
1,1916,2005,-89,0,166,93
1,1670,1417,253,0,44,76
1,1492,1395,97,1,14,43
-1,933,1191,-258,-2,-73,44
-1,1678,1601,77,1,-2,48
1,1237,1535,-298,-6,-113,71
-1,1419,1874,-455,-1,-18,46
-1,1409,1316,93,0,-289,108
1,1526,1134,392,3,277,89
-1,1197,914,283,11,226,52
-1,1569,1353,216,-1,-63,62
1,1602,1544,58,0,92,67
1,1515,1500,15,-2,-41,63
1,1370,1696,-326,-3,-99,41
0,1586,1592,-6,5,260,147
1,1332,1522,-190,-3,-161,81
1,1988,1707,281,0,-50,97
-1,1664,1596,68,-1,-44,52
-1,1390,1629,-239,-4,-59,62
1,1509,1522,-13,3,177,77
1,1513,1550,-37,-2,184,101
1,1425,1519,-94,2,137,65
-1,1497,1416,81,-4,-91,62
1,1929,1730,199,0,83,109
-1,1507,1520,-13,5,76,62
1,1514,1259,255,-3,85,87
-1,1523,1411,112,-2,-63,60
1,1651,1614,37,2,27,51
-1,1620,1778,-158,-4,-59,64
-1,1710,1541,169,2,10,116
-1,1580,1497,83,-5,-266,64
1,1334,1395,-61,1,232,101
1,1698,1538,160,0,43,97
-1,1858,1783,75,0,-187,72
1,1509,1514,-5,2,191,85
-1,1152,1412,-260,-8,-154,42
1,1463,1390,73,0,55,117
1,1028,1384,-356,9,76,41
0,1450,1523,-73,-1,7,139
1,1575,1604,-29,0,110,57
1,1423,1387,36,0,-2,45
-1,1386,1433,-47,-3,-234,72
-1,1275,1275,0,2,-99,116
1,1466,1420,46,4,254,71
1,1360,1057,303,6,559,82
1,1541,1360,181,0,251,89
-1,1254,1519,-265,-5,-223,84
-1,1399,1502,-103,3,-11,64
-1,1796,1845,-49,0,-112,82
1,1427,1417,10,4,315,71
1,1455,1442,13,-2,-50,49
-1,1382,1320,62,-6,-427,74
1,1752,1500,252,-1,437,113
1,1934,1784,150,0,15,55
-1,1587,1535,52,-6,-466,88
1,1529,1383,146,1,204,95
-1,1661,1698,-37,-1,9,42
1,1432,1522,-90,4,234,73
1,1520,1568,-48,6,326,59
-1,1430,1592,-162,7,218,86
1,1369,1550,-181,0,39,123
-1,1650,1703,-53,0,-35,68
1,1560,1520,40,0,92,79
1,1785,1877,-92,0,6,95
-1,1777,1941,-164,0,-12,44
1,1503,1400,103,-7,-136,103
1,1524,1613,-89,1,437,127
1,1651,1129,522,6,608,89
-1,1356,1618,-262,-9,-357,56
-1,1558,1574,-16,-1,-78,72
-1,1385,1525,-140,4,137,64
-1,1386,1512,-126,-1,-145,62
1,1401,1523,-122,-10,16,91
1,1668,1680,-12,4,97,51
-1,1372,1461,-89,-5,-501,102
1,1543,1500,43,0,140,73
1,1423,1470,-47,-6,-95,47
1,1771,1606,165,0,581,141
-1,1508,1446,62,6,88,124
1,1587,1537,50,-1,-52,103
-1,1756,1323,433,2,42,86
1,1568,1207,361,-1,6,49
1,1999,1771,228,0,10,45
1,1560,1344,216,1,150,67
-1,1356,1570,-214,-13,2,40
-1,1713,1640,73,0,11,62
1,1622,1352,270,7,267,59
1,1572,1263,309,0,58,55
1,1499,1683,-184,5,314,72
0,1436,1457,-21,0,-774,261
-1,1126,1412,-286,-5,-170,54
-1,1333,1707,-374,-2,-51,58
1,1575,1379,196,3,80,53
1,1351,1396,-45,3,465,109
1,1581,1548,33,-1,-128,55
0,1767,2004,-237,-4,11,119
1,1799,1841,-42,1,113,65
1,1694,1626,68,1,175,60
-1,1538,1604,-66,0,416,146
-1,1424,1604,-180,0,-1,53
1,1506,1417,89,0,17,51
1,1607,1580,27,-4,-40,45
-1,1623,1529,94,3,30,50
-1,1365,1515,-150,-14,-506,72
1,1595,1543,52,10,597,65
-1,1533,1925,-392,-16,-141,42
1,1829,1811,18,0,130,81
-1,1761,1777,-16,-2,-35,53
-1,1543,1595,-52,-11,-833,70
1,1613,1533,80,5,684,109
1,1374,1415,-41,-3,297,97
1,1860,1800,60,-1,142,137
-1,1675,1569,106,0,-20,62
-1,1525,1629,-104,8,-183,126
1,1522,1358,164,10,230,46
-1,1963,1928,35,0,-42,62
-1,1495,1471,24,-2,-75,44
-1,1939,1950,-11,-6,-164,58
1,1644,1517,127,3,871,127
1,1519,1378,141,0,165,87
-1,1773,2103,-330,-2,-30,62
1,1364,1378,-14,0,14,67
0,1962,1929,33,0,-11,95
1,1528,1507,21,0,3,50
-1,1330,1815,-485,0,-78,60
-1,1510,1656,-146,-7,-639,82
-1,1930,1960,-30,0,30,44
1,1537,1195,342,6,280,51
0,1612,1209,403,-1,154,67
1,1668,1503,165,2,297,55
-1,1668,1663,5,-1,-70,60
-1,1437,1457,-20,3,38,70
-1,1647,1770,-123,0,-83,80
-1,1497,1678,-181,8,92,44
1,1275,1364,-89,-3,-131,59
1,1149,1323,-174,5,27,43
-1,1687,1491,196,3,-230,138
-1,1703,1542,161,-1,-164,96
1,1801,1840,-39,-4,-33,85
-1,1610,1560,50,0,-109,94
-1,1510,1511,-1,2,-115,132
-1,1661,1508,153,1,60,68
-1,1376,1457,-81,-1,-440,114
1,1603,1321,282,6,286,51
1,1349,1599,-250,-1,6,53
-1,1523,1637,-114,-2,-110,52
-1,1500,1584,-84,-1,-41,56
-1,1671,1832,-161,-5,-132,53
1,1971,1673,298,-1,39,41
-1,1364,1836,-472,-25,-354,46
1,1777,1639,138,-1,66,65
-1,1659,1508,151,-8,-101,56
1,1818,1607,211,4,231,45
1,1298,1230,68,-7,-281,59
-1,1637,1524,113,-3,-213,90
1,1484,1467,17,-2,-42,43
-1,1483,1526,-43,0,-202,78
1,1497,1589,-92,-1,631,137
-1,1538,1616,-78,-7,-567,138
-1,1515,1500,15,-8,-48,42
-1,1632,1784,-152,-3,-148,58
-1,1289,1396,-107,-5,-110,48
1,1444,1362,82,5,166,45
1,1602,1344,258,8,297,57
1,1628,1669,-41,1,-53,65
1,1824,1210,614,1,97,63
-1,1367,1537,-170,-4,-267,88
-1,1645,1657,-12,-1,-146,74
-1,1467,1507,-40,1,-99,88
-1,1303,1492,-189,-7,-122,44
1,1791,1626,165,0,20,63
1,1667,1631,36,1,118,121
-1,1494,1404,90,-6,-265,108
-1,1221,1871,-650,0,10,40
1,1451,1402,49,-4,-46,61
1,1462,1491,-29,-3,-133,105
1,1360,1374,-14,17,203,41
1,1618,1677,-59,2,-178,71
1,1619,1137,482,2,148,53
-1,1665,1634,31,-1,3,56
-1,1297,1422,-125,-4,-73,40
-1,1634,1665,-31,-5,-138,62
-1,1529,1514,15,0,-44,70
1,1543,1361,182,0,240,69
-1,1118,1603,-485,-5,-84,52
-1,1675,1649,26,-6,-719,94
-1,1606,1471,135,0,-6,48
1,1428,1165,263,4,109,49
-1,1382,1451,-69,-2,-521,142
1,1394,1617,-223,-1,288,101
-1,1621,1644,-23,-1,-37,62
-1,1664,1663,1,-1,-20,78
1,1430,1303,127,10,267,45
1,1630,1828,-198,0,-28,107
-1,1355,1549,-194,1,-218,158
-1,1461,1612,-151,-5,-158,62
1,1662,1643,19,-8,-72,75
1,1591,1569,22,0,49,47
1,1417,1480,-63,0,184,127
1,1872,1832,40,1,65,59
1,1610,1654,-44,0,-25,97
1,1127,1522,-395,-6,-237,65
1,1676,1678,-2,0,513,143
-1,1336,1546,-210,-13,-231,49
1,1687,1591,96,0,35,51
1,1525,1511,14,5,188,55
1,1601,1624,-23,3,148,49
-1,1574,1512,62,-3,-13,62
1,1608,1438,170,0,64,83
-1,1624,1601,23,1,-30,52
1,1623,1111,512,13,436,59
-1,1558,1792,-234,0,-226,165
-1,1603,1638,-35,1,35,62
-1,1613,1611,2,0,-230,102
-1,1349,1555,-206,-1,-128,90
1,1646,1572,74,-3,310,119
1,2029,1072,957,6,321,69
1,1504,1508,-4,1,204,109
-1,1649,1593,56,0,-3,52
-1,1454,1642,-188,-5,-157,64
-1,1393,1325,68,-2,-168,56
-1,1624,1629,-5,0,-310,166
-1,1606,1635,-29,2,-46,106
-1,1884,1820,64,1,21,44
-1,1623,1602,21,-1,-320,108
1,1448,1446,2,-2,212,99
-1,1608,1581,27,1,170,92
-1,1646,1596,50,0,12,76
1,1741,1634,107,0,72,75
1,1460,1515,-55,-1,-1,45
-1,1525,1560,-35,-9,-671,82
-1,1502,1500,2,-2,-112,62
1,1500,1529,-29,1,103,57
1,1609,1633,-24,-10,-112,69
-1,1416,1847,-431,-11,-244,45
1,1613,1648,-35,2,122,59
-1,1475,1263,212,1,76,68
1,1488,1459,29,11,282,45
1,1766,1991,-225,0,2,53
1,1634,1576,58,0,51,91
-1,1620,1620,0,-1,-64,68
-1,1869,1774,95,0,-115,96
1,1614,1455,159,3,173,89
1,1973,1783,190,3,283,101
-1,1499,1438,61,-1,-75,94
1,1687,1996,-309,1,3,71
1,1778,1979,-201,1,169,105
-1,1457,1072,385,0,-114,88
-1,1655,1690,-35,0,13,56
-1,1459,1381,78,-3,-2,42
-1,1289,1801,-512,-1,-28,52
1,1989,1855,134,0,1,81
-1,1710,1420,290,0,10,50
-1,1596,1636,-40,0,-68,88
0,1625,1503,122,-5,-106,224
-1,1485,1609,-124,0,-13,46
0,1751,1876,-125,0,89,114
1,1624,1748,-124,5,113,71
-1,1666,1802,-136,0,-211,90
-1,1620,1448,172,1,-11,78
-1,1809,1658,151,-10,-41,40
1,1378,1571,-193,-1,-27,65
-1,1299,1464,-165,-1,-31,70
-1,1468,1792,-324,-1,-126,74
1,1975,1675,300,-1,276,89
-1,1506,1622,-116,2,21,52
-1,1556,1582,-26,-6,-91,48
1,1645,1587,58,3,335,113
-1,1790,1852,-62,-2,-96,76
1,1979,1671,308,5,191,61
1,1481,1618,-137,-2,-22,45
-1,1604,1764,-160,-5,-74,48
-1,1734,1642,92,0,-73,98
0,1629,1318,311,1,-245,96
1,1221,1329,-108,2,20,49
1,1704,1693,11,1,438,113
1,1795,1465,330,-3,-27,71
0,1230,1472,-242,-3,56,61
1,1325,1433,-108,4,54,45
1,1598,1437,161,1,122,89
1,1603,1497,106,-3,-112,67
-1,1314,1237,77,3,104,72
-1,1292,1439,-147,-6,105,94
1,1990,1811,179,0,226,99
1,1659,1721,-62,3,218,83
-1,1464,1500,-36,0,25,56
1,1462,1605,-143,-2,15,61
1,1473,1429,44,2,685,129
1,2066,1863,203,1,28,51
1,1683,1517,166,4,70,45
1,1640,1644,-4,0,1,41
-1,1862,1802,60,-6,-225,114
1,1451,1362,89,0,93,77
-1,1456,1658,-202,-3,-71,124
1,1708,1675,33,3,194,60
1,1815,1849,-34,0,53,55
1,1672,1632,40,-1,-33,53
-1,1548,1633,-85,0,-139,122
1,1983,1815,168,-7,-196,71
-1,1857,2119,-262,0,-28,60
-1,1285,1626,-341,-9,-370,60
-1,1809,1989,-180,0,-82,74
-1,1694,1614,80,-4,-193,58
1,1837,1500,337,0,385,107
-1,1663,1718,-55,-8,-308,56
-1,1301,1477,-176,-3,-303,70
-1,1483,1498,-15,-5,-242,68
-1,1996,1803,193,1,45,44
-1,1627,1679,-52,-13,-491,68
-1,1679,1627,52,-4,-49,48
1,1819,1840,-21,2,181,75
1,1689,1618,71,-1,-31,59
1,1451,1619,-168,-1,16,81
-1,1589,1431,158,-7,-132,52
-1,1398,1721,-323,-3,-330,96
0,1828,1831,-3,-2,-79,111
0,1708,1601,107,-2,-141,99
1,1727,1652,75,11,214,49
1,1641,1540,101,0,139,69
1,1429,1419,10,1,472,97
1,1573,1500,73,13,450,61
1,1604,1704,-100,7,200,61
1,1831,1828,3,0,404,87
1,1921,1447,474,1,163,95
1,1704,1604,100,1,27,41
1,1472,1510,-38,0,17,63
-1,1674,1610,64,-6,-161,50
1,1674,1610,64,-2,213,71
-1,1282,1456,-174,-1,-84,80
-1,1580,1752,-172,-2,-111,76
-1,1357,1930,-573,-16,-281,44
-1,1808,1682,126,-5,-315,136
1,1684,1601,83,4,160,56
-1,1671,1833,-162,0,-232,150
-1,1593,1693,-100,0,11,66
1,1841,1818,23,0,270,85
1,1469,1595,-126,1,81,75
1,1698,1793,-95,2,114,69
-1,1470,1571,-101,0,-37,49
1,1395,1937,-542,-4,-171,69
1,1574,1342,232,10,266,51
-1,1599,1686,-87,0,-3,40
-1,1701,1585,116,-5,-142,58
1,1686,1599,87,3,25,49
-1,1779,1714,65,-1,-405,180
-1,1591,1695,-104,1,141,72
1,1654,1624,30,-3,-244,79
1,1691,1599,92,0,43,73
-1,1695,1591,104,-2,-16,40
-1,1605,1680,-75,0,-13,42
-1,1579,1800,-221,-1,-377,102
1,1708,1785,-77,-1,264,83
1,1480,1615,-135,1,-92,43
-1,1289,1416,-127,3,76,52
-1,1596,1689,-93,-4,-81,52
1,1697,1588,109,-1,-18,59
-1,1772,1722,50,-1,-508,116
-1,1275,1471,-196,-2,-507,116
1,1485,1559,-74,1,41,169
1,1581,1705,-124,2,210,67
1,1736,1760,-24,2,254,109
1,1705,1581,124,2,96,75
1,1669,1543,126,5,228,57
-1,1690,1574,116,-1,-323,87
1,1761,1749,12,1,40,55
1,1569,1870,-301,2,94,71
1,1734,1618,116,2,60,47
-1,1484,1689,-205,1,34,108
1,1181,1387,-206,-1,136,43
-1,1614,1665,-51,-4,-123,68
-1,1580,1684,-104,7,93,44
-1,1772,1749,23,-3,-243,120
1,1692,1572,120,0,10,55
-1,1579,1596,-17,-1,-38,76
1,1742,1834,-92,0,-14,123
-1,1699,1565,134,-3,-248,64
-1,1470,1454,16,0,75,64
1,1579,1684,-105,0,7,101
1,1700,1677,23,3,169,69
-1,1413,1535,-122,0,-9,62
1,1670,1593,77,-2,-126,95
-1,1115,1295,-180,5,152,62
-1,1585,1679,-94,-10,-399,90
1,1842,1611,231,3,174,64
-1,1687,1577,110,0,-14,48
1,1891,1780,111,5,514,91
1,1251,1500,-249,-2,118,61
-1,1577,1687,-110,-3,-103,74
1,1695,1591,104,-2,-23,41
1,1352,1101,251,-1,-5,47
1,1458,1341,117,-3,-69,73
1,1849,1754,95,0,8,65
1,1479,1365,114,2,78,63
-1,1609,1555,54,0,-39,60
-1,1103,1301,-198,-5,-295,68
-1,0,1210,-1210,-2,-143,48
-1,1677,1710,-33,-1,-58,88
1,1269,1278,-9,0,807,149
1,1482,1579,-97,3,195,77
1,1566,1393,173,2,74,59
1,1616,1799,-183,1,171,71
-1,1024,1541,-517,-8,-92,52
-1,1341,1437,-96,-3,-85,54
1,1746,1813,-67,0,6,75
1,1943,1913,30,1,48,61
1,1332,1404,-72,-1,-151,99
-1,1587,1321,266,-5,-431,128
1,1728,1334,394,-4,-120,53
1,1581,1500,81,0,81,77
1,1396,1288,108,1,40,41
-1,1351,1505,-154,0,-7,60
-1,1482,1491,-9,1,28,54
-1,1298,1421,-123,-8,-982,102
1,1649,1523,126,1,471,107
-1,1376,1387,-11,0,5,44
-1,1670,1526,144,-3,-104,52
1,1785,1888,-103,0,151,111
-1,1496,1195,301,-2,-9,58
1,1735,1562,173,2,461,99
-1,1553,1514,39,-1,-103,100
-1,1938,1663,275,3,342,98
-1,1318,1544,-226,-1,-350,80
-1,1513,1339,174,-1,2,50
1,1547,1022,525,1,221,77
1,1911,1828,83,4,267,91
-1,1446,1378,68,-2,-33,42
-1,1391,1346,45,0,-305,88
1,1488,1502,-14,1,389,143
1,1428,1269,159,3,160,60
1,1798,1798,0,0,8,59
1,1710,1579,131,0,-36,71
1,1588,1446,142,1,159,103
-1,1623,1622,1,0,-4,44
-1,1564,1656,-92,1,13,70
-1,1280,1677,-397,-3,-61,56
1,1554,1473,81,0,10,111
1,1743,1835,-92,2,103,69
-1,1398,1500,-102,-1,-184,72
-1,1320,1518,-198,-7,-135,46
-1,1708,1944,-236,0,-164,90
1,1404,1244,160,-10,-246,57
-1,1731,1903,-172,0,-120,76
1,1666,1516,150,0,14,63
1,1587,1502,85,-2,106,115
-1,1790,1817,-27,-2,-115,66
-1,1642,1680,-38,-12,-348,98
1,1332,1524,-192,7,240,55
1,1563,1303,260,1,157,73
1,1481,1402,79,1,157,101
1,1920,1915,5,-1,-43,77
-1,1754,1824,-70,-3,-51,64
-1,1600,1768,-168,0,344,114
1,1393,1500,-107,7,194,59
0,1358,1378,-20,0,-203,124
1,1595,1500,95,0,19,55
-1,1388,1439,-51,4,228,64
1,1745,1558,187,7,675,103
1,1477,1559,-82,0,10,73
-1,1521,1571,-50,-1,-24,47
1,1214,1075,139,-3,-29,73
-1,1834,2054,-220,0,4,60
-1,1379,1553,-174,-12,-69,41
1,1556,1641,-85,0,-92,81
-1,1824,2022,-198,-1,-25,48
0,1398,1507,-109,0,-511,106
-1,1753,1798,-45,0,-22,64
1,1431,1645,-214,0,-9,57
1,1554,1494,60,6,298,72
1,1930,1761,169,5,83,57
1,1445,1379,66,2,79,45
0,1595,1362,233,1,202,180
-1,1601,1366,235,0,-482,120
-1,1679,1690,-11,-5,-226,70
-1,1531,1460,71,1,-222,74
-1,1255,1504,-249,0,-157,70
1,1909,1724,185,0,-33,93
1,1511,1359,152,1,22,43
0,1500,1500,0,1,107,161
1,1432,1234,198,11,499,65
-1,1432,1510,-78,-5,-219,82
1,1518,1525,-7,-2,-3,79
-1,1574,1636,-62,0,-60,115
1,1448,1374,74,-11,-325,97
-1,1869,1648,221,-4,-270,170
1,1937,1755,182,0,-121,75
-1,1611,1946,-335,-1,-161,70
1,1278,1507,-229,-1,32,91
1,1411,1491,-80,-2,7,55
-1,1680,1588,92,0,30,42
-1,1572,1717,-145,-2,-196,96
1,1700,1669,31,1,7,41
0,1352,1518,-166,-12,-22,129
1,1407,1377,30,8,274,63
1,1742,1493,249,-2,107,114
-1,1643,1982,-339,3,-15,96
1,1455,1562,-107,1,57,51
1,1450,1469,-19,-1,56,48
1,1659,1710,-51,-1,-8,71
0,1525,1596,-71,0,-11,116
1,1297,1327,-30,-1,-54,71
1,1714,1331,383,-2,353,133
1,1424,1627,-203,-3,-48,87
-1,1350,1417,-67,0,-131,76
1,1679,1694,-15,0,23,61
1,1570,1311,259,3,79,53
1,2060,1745,315,1,121,93
-1,1517,1873,-356,0,-85,64
1,1639,1571,68,0,54,71
-1,1471,1319,152,4,165,84
1,1602,1664,-62,2,125,52
-1,1213,1299,-86,0,10,60
-1,1419,1364,55,-3,175,128
-1,1698,1671,27,-3,-15,44
1,1963,1807,156,0,22,61
-1,1966,1749,217,1,64,78
-1,1426,1328,98,-8,-206,60
0,1457,1462,-5,-9,-845,82
1,1474,1339,135,0,26,42
-1,1204,1504,-300,0,-38,82
-1,1425,1202,223,-15,-535,58
0,1956,1608,348,0,116,118
1,1713,1556,157,1,439,87
-1,1683,1686,-3,-3,-156,76
1,1750,1421,329,-11,-119,151
1,1513,1357,156,8,35,41
-1,1563,1705,-142,-2,-39,64
1,1914,1718,196,-4,56,69
-1,1549,1484,65,-2,-135,58
-1,1615,1636,-21,-4,-294,72
-1,2028,2093,-65,-1,-41,54
-1,1361,1412,-51,-4,-173,92
-1,1598,1508,90,-2,-259,82
-1,1703,1731,-28,0,2,66
-1,1881,1989,-108,0,-1,74
1,1691,1650,41,9,841,165
1,1520,1500,20,-5,-100,51
1,1697,1672,25,5,180,69
-1,1302,1763,-461,-4,-392,78
-1,1444,1222,222,7,151,44
1,1634,1180,454,1,295,63
1,1511,1610,-99,-1,-3,89
0,1383,1489,-106,0,-3,120
0,1441,1378,63,-9,-82,47
-1,1747,1976,-229,0,19,88
0,1370,1507,-137,-10,-671,78
0,1555,1572,-17,-1,-201,152
1,1315,1406,-91,-14,-162,57
-1,1500,1518,-18,0,-2,62
1,1504,1451,53,2,29,45
-1,1514,1878,-364,-8,-206,56
-1,1648,1604,44,0,-365,110
-1,1543,1594,-51,1,63,124
1,1527,1457,70,1,277,97
-1,2000,1997,3,0,53,62
0,1648,1562,86,3,522,123
1,1322,1430,-108,5,126,73
-1,1584,1639,-55,-6,-84,48
1,1291,1442,-151,3,101,47
1,1478,1511,-33,1,175,65
1,1602,1440,162,1,507,97
-1,1669,1525,144,0,-132,76
-1,1199,1505,-306,0,2,58
1,1416,1350,66,1,-2,49
1,1439,1329,110,-1,-38,49
1,1722,1726,-4,0,117,75
1,1749,1379,370,0,55,53
1,1712,1631,81,3,338,71
1,1994,1814,180,2,267,97
1,1426,1404,22,2,171,89
-1,1575,1561,14,-2,-24,50
-1,1333,1425,-92,-5,-116,54
1,1616,1929,-313,1,180,119
-1,1853,1538,315,-1,-208,82
1,2118,1707,411,1,13,113
1,1604,1380,224,0,-30,91
-1,1647,1407,240,-11,-209,42
1,1634,1596,38,0,24,83
1,1516,1233,283,-1,176,127
-1,1498,1881,-383,-2,-266,72
1,1741,1862,-121,1,-24,69
-1,1453,1516,-63,-2,-140,60
-1,1874,1983,-109,-1,-22,48
-1,1363,1377,-14,-4,-612,88
1,1433,1318,115,0,181,69
1,1536,1478,58,0,6,59
-1,1305,1395,-90,0,2,50
-1,1296,1645,-349,-5,-115,57
-1,1567,1711,-144,-4,-603,112
1,2108,1793,315,0,1,137
1,1555,1646,-91,2,132,61
1,1565,1484,81,0,60,98
1,1519,1526,-7,-2,6,49
1,1491,1496,-5,0,-62,73
-1,1866,2038,-172,-6,-249,86
-1,1705,2121,-416,-5,-213,53
-1,1447,1580,-133,1,-47,78
1,1689,1748,-59,8,644,131
-1,1586,1645,-59,-5,-32,122
-1,1301,1355,-54,-1,-52,92
-1,1700,1755,-55,-2,-11,46
1,1596,1549,47,0,223,113
-1,1746,1819,-73,4,47,42
0,1394,1558,-164,-3,-1309,122
-1,1546,1458,88,-2,-144,70
1,2123,1703,420,0,-5,59
-1,1625,1500,125,-3,-19,64
-1,1790,2111,-321,0,-16,111
-1,1700,1783,-83,0,-79,158
1,1552,1292,260,7,151,47
1,1994,1760,234,4,95,49
1,1879,1824,55,1,25,95
-1,1835,1616,219,0,-163,148
-1,1654,1749,-95,-1,-34,50
-1,1764,1758,6,0,-321,68
1,1626,1333,293,-1,119,145
-1,1691,1655,36,1,137,88
1,1873,1592,281,1,130,77
1,1626,1287,339,1,184,79
1,1582,1158,424,15,297,41
-1,1648,1636,12,2,-150,120
-1,1813,1888,-75,1,-397,104
1,1401,1556,-155,2,14,45
1,1587,1183,404,0,62,51
1,1751,1434,317,1,222,75
-1,1701,2125,-424,-1,61,76
1,1555,1301,254,0,62,55
1,1540,1420,120,3,297,103
-1,1296,1362,-66,3,125,84
-1,1897,1804,93,-1,60,74
1,1720,1822,-102,1,72,89
0,1643,1787,-144,5,162,57
0,2002,1740,262,0,17,104
1,1700,1767,-67,0,56,71
-1,1445,1515,-70,-3,-195,159
-1,1454,1465,-11,-1,-200,96
-1,2001,1655,346,-1,-147,74
-1,1418,1753,-335,0,14,72
-1,1483,1861,-378,-3,-38,40
1,1736,1500,236,-1,-22,69
1,1448,1301,147,-3,-189,61
1,1819,1883,-64,6,331,83
1,1411,1548,-137,0,-1,43
1,1639,1564,75,2,106,83
-1,1194,1294,-100,-1,-40,56
1,1499,1480,19,0,242,107
0,1481,1522,-41,0,68,57
1,1532,1429,103,0,144,81
-1,1668,1655,13,1,1,48
1,1871,1833,38,0,-139,77
-1,1753,1747,6,-2,-336,118
-1,1392,1783,-391,0,-204,60
-1,1573,1514,59,-1,-110,64
-1,1942,2122,-180,0,270,124
-1,1648,1740,-92,-2,-36,88
0,1653,1770,-117,0,-32,178
1,1708,1404,304,1,122,80
-1,1721,1717,4,-2,-45,50
1,2128,1699,429,-2,74,83
-1,1632,1563,69,-2,-86,67
-1,1822,1880,-58,-4,-891,156
-1,1420,1540,-120,0,-239,116
1,1508,1352,156,1,29,67
-1,1571,1184,387,3,131,54
1,1603,1448,155,0,38,57
1,1517,1331,186,1,170,72
-1,1981,1745,236,1,78,64
-1,1491,1437,54,0,8,46
-1,1568,1482,86,-5,-177,60
-1,1387,1787,-400,-6,-60,48
1,1515,1480,35,-3,-90,51
-1,1692,1784,-92,0,-242,106
-1,1243,1260,-17,1,-7,98
-1,1292,1628,-336,-4,-203,94
-1,1370,1863,-493,1,-21,56
-1,1626,1773,-147,-2,-30,53
-1,1963,2130,-167,2,-119,120
1,2128,1936,192,2,144,81
-1,1336,1515,-179,0,18,78
-1,1808,1582,226,-5,-578,119
0,1810,1701,109,-1,95,128
0,1976,1227,749,-2,277,181
-1,1440,1325,115,-3,-119,62
1,1761,1656,105,0,35,59
1,1814,1667,147,4,162,62
1,1354,1457,-103,1,16,63
-1,1500,1800,-300,1,111,66
-1,1843,1683,160,3,335,116
1,1633,1723,-90,2,33,47
-1,1532,1645,-113,-4,-123,60
1,1293,1596,-303,9,362,62
1,1672,1656,16,0,141,93
-1,1681,1728,-47,-5,-152,78
-1,1617,1478,139,-8,-116,50
-1,1629,1469,160,-5,-162,70
1,1626,1500,126,6,250,55
1,1385,1389,-4,0,206,59
1,1576,1500,76,1,132,57
-1,1445,1518,-73,-5,0,46
-1,1368,1530,-162,-8,-223,56
-1,1552,1531,21,-2,-5,40
1,1836,1815,21,3,158,57
1,1434,1480,-46,-5,-32,45
1,1554,1487,67,5,128,45
-1,1544,1541,3,0,510,130
1,1532,1566,-34,3,40,71
1,1706,1792,-86,0,23,69
-1,1516,1870,-354,-1,-66,56
-1,1518,1927,-409,2,-10,58
1,1626,1399,227,12,101,43
-1,1591,1492,99,0,8,68
1,1505,1323,182,0,-20,119
-1,1413,1562,-149,-5,-103,112
0,1351,1333,18,-1,-219,148
1,1594,1467,127,0,70,56
-1,1394,1631,-237,8,131,54
-1,1738,1445,293,1,103,98
1,1365,1500,-135,-3,-32,45
-1,1807,1864,-57,-4,-372,84
1,1527,1577,-50,3,237,93
1,1929,1516,413,0,12,67
1,1608,1350,258,0,-4,127
1,1500,1500,0,1,136,85
1,1792,1896,-104,-1,26,77
1,1294,1299,-5,-1,-49,95
-1,1319,1874,-555,-1,-525,100
1,1778,1720,58,-2,-52,87
-1,1557,1565,-8,-4,-172,66
-1,1551,1581,-30,-15,-502,76
1,1754,1673,81,0,43,89
1,1684,1683,1,-4,21,47
-1,1963,1608,355,-1,-172,122
1,1635,1389,246,1,65,51
1,1551,1500,51,0,99,79
1,1736,1664,72,1,32,55
-1,1379,1516,-137,-3,-313,74
-1,1500,1500,0,-1,-63,83
-1,1931,1500,431,-1,-309,120
-1,1511,1623,-112,-3,-51,78
1,1763,1876,-113,-1,-73,67
-1,1686,1777,-91,0,-82,120
1,1711,1787,-76,0,89,177
1,1778,1854,-76,-1,42,75
1,1882,1808,74,0,-23,61
-1,1363,1320,43,-12,-451,70
1,1585,1434,151,1,99,67
-1,1528,1544,-16,2,6,42
-1,1465,1500,-35,-3,-513,134
1,1640,1553,87,-9,-6,81
1,1650,1744,-94,-1,66,63
-1,1567,1696,-129,0,1,74
0,1548,1709,-161,-1,99,104
-1,1477,1835,-358,-9,-364,78
0,1337,1500,-163,-1,-29,60
-1,1108,1592,-484,0,69,50
-1,1505,1350,155,-4,-99,60
1,1503,1673,-170,-4,-2,41
1,1631,1555,76,2,108,49
1,1619,1331,288,1,33,48
-1,1329,1838,-509,-1,-9,50
-1,1703,1559,144,-8,-287,78
-1,1649,1658,-9,0,-56,102
1,1374,1399,-25,-2,-113,103
1,1731,1671,60,0,-39,105
-1,1798,1891,-93,-1,-16,56
0,1791,1840,-49,-2,-88,128
-1,1591,1541,50,0,166,88
-1,1285,1457,-172,1,55,62
-1,1662,1917,-255,0,-5,64
-1,1519,1658,-139,-11,-113,95
-1,1303,1662,-359,-6,-298,66
-1,1443,1407,36,0,-96,68
1,1575,1687,-112,0,136,81
1,1869,1561,308,1,76,57
-1,1793,1838,-45,-1,-311,106
1,1569,1512,57,1,241,135
-1,1535,1681,-146,-4,-268,74
-1,1341,1408,-67,-4,-539,108
1,1774,1724,50,2,59,69
1,1773,1640,133,1,454,89
-1,1218,1890,-672,-6,-614,74
-1,1657,1740,-83,-6,-54,42
1,1701,1613,88,0,53,49
1,1279,1251,28,0,-26,65
1,1546,1549,-3,3,83,53
1,1597,1257,340,7,69,40
-1,1389,1526,-137,-5,-107,56
-1,1512,1688,-176,0,-136,73
-1,1611,1583,28,0,-40,72
-1,1432,1420,12,-2,18,58
-1,1416,1714,-298,-4,-183,58
-1,1599,1595,4,-1,-639,118
1,1715,1783,-68,3,510,111
1,1808,1395,413,1,231,105
-1,1543,1517,26,2,34,42
1,1638,1216,422,4,125,53
1,1557,1252,305,0,6,75
-1,1430,1277,153,1,-609,120
-1,1500,1346,154,0,-41,56
-1,1587,1606,-19,-1,-176,56
0,1785,1688,97,0,-217,136
1,2001,1779,222,5,317,67
-1,1494,1578,-84,-2,-435,124
1,1496,1396,100,-11,-363,59
1,1694,1831,-137,-2,-50,51
-1,1464,1594,-130,0,-738,96
-1,1289,1364,-75,-4,-165,63
-1,1770,1727,43,0,-255,144
-1,1190,1924,-734,-11,-308,50
-1,1231,1306,-75,1,-11,72
1,1426,1357,69,12,1020,105
1,1601,1244,357,0,-109,77
-1,1729,1707,22,1,53,55
-1,1766,2038,-272,-8,-193,54
1,1925,1664,261,1,-82,117
-1,1720,1279,441,3,135,108
1,1783,1616,167,0,-93,71
1,1873,1463,410,4,48,41
-1,1610,1790,-180,-4,-70,66
1,1478,1456,22,0,91,111
-1,1238,1604,-366,4,258,86
-1,1718,1663,55,-2,-110,47
-1,1300,1476,-176,-3,-129,88
1,1796,1604,192,0,10,51
1,1739,1758,-19,0,13,126
-1,1432,1587,-155,-1,-152,122
-1,1692,1782,-90,-6,-58,44
-1,1590,1706,-116,1,-284,90
-1,1074,1607,-533,-3,-83,56
1,1834,1724,110,-1,56,61
-1,1334,1422,-88,-4,-117,60
1,1435,1361,74,-2,469,179
-1,1436,1418,18,0,-284,102
1,1363,1526,-163,3,177,95
-1,1300,1455,-155,1,2,70
-1,1259,1390,-131,-23,-754,58
-1,1577,1529,48,-1,-279,116
1,1594,1425,169,4,503,87
1,1419,1508,-89,-1,-72,81
0,1649,1608,41,1,501,122
1,1747,1751,-4,2,47,69
1,1510,1379,131,1,146,83
-1,1419,1648,-229,0,-6,48
-1,1326,1381,-55,-1,-152,78
1,1492,1194,298,1,6,41
-1,1445,1528,-83,-8,-322,56
-1,1748,1809,-61,1,-289,92
1,1206,1500,-294,0,324,77
-1,1320,1462,-142,-3,-177,66
0,1372,1517,-145,4,381,90
-1,1609,1648,-39,0,20,52
1,1461,1262,199,-3,-83,57
-1,1740,1758,-18,1,22,46
-1,1545,1628,-83,-2,-106,54
-1,1500,1424,76,2,110,84
-1,1443,1574,-131,-5,-259,82
1,1858,1825,33,7,491,65
1,1501,1534,-33,0,27,73
-1,1163,1710,-547,1,-239,108
-1,1512,1376,136,-6,-332,94
1,1657,1599,58,3,370,71
-1,1816,1868,-52,-1,-42,52
-1,1868,1816,52,0,-280,98
-1,1768,1730,38,-2,-55,56
-1,1819,1739,80,0,-76,94
-1,1089,1589,-500,0,-148,72
-1,1497,1391,106,-1,-421,110
-1,1807,1877,-70,-2,-52,64
-1,1786,2006,-220,-1,-156,62
0,1997,1972,25,0,-52,123
-1,1886,1798,88,2,65,60
1,1617,1719,-102,-2,-22,49
1,1790,1774,16,2,70,83
0,1742,1756,-14,0,25,146
1,1608,1436,172,-7,-231,57
-1,1405,1483,-78,0,-75,54
-1,1781,2011,-230,2,35,56
-1,1463,1391,72,-1,-37,60
1,1872,1811,61,0,18,83
-1,1228,1125,103,3,149,54
-1,1336,1636,-300,-6,-285,68
1,1562,1234,328,-5,-53,43
-1,1256,1508,-252,-1,-41,58
1,1803,1881,-78,-1,33,59
1,1421,1336,85,9,277,41
-1,2016,1776,240,-1,-78,60
1,1644,1513,131,2,53,61
1,1868,1815,53,1,38,59
1,1491,1396,95,-2,-86,55
-1,1633,1431,202,3,90,48
-1,1498,1658,-160,7,82,46
-1,1795,1798,-3,-4,-123,74
1,1590,1605,-15,5,4,41
-1,1564,1542,22,0,-512,86
-1,1996,1641,355,-4,-407,90
-1,1577,1405,172,-2,-397,142
1,1655,1500,155,4,422,121
1,1394,1329,65,7,394,71
-1,1303,1658,-355,-4,-113,53
-1,1671,1485,186,-1,-32,62
1,1783,1808,-25,-7,51,81
1,1307,1209,98,15,274,47
1,1797,1796,1,4,69,55
-1,1473,1682,-209,3,74,46
0,1756,1742,14,0,45,148
-1,1784,1808,-24,-3,186,114
1,1687,1468,219,-2,-67,55
1,1500,1500,0,4,1185,107
-1,1920,1801,119,0,-147,85
-1,1462,1692,-230,3,203,68
1,1697,1457,240,-1,-22,91
-1,1817,1773,44,-1,-27,60
1,1457,1697,-240,0,297,103
1,1711,1641,70,5,74,40
-1,1634,1314,320,2,-38,76
0,1154,1331,-177,1,105,97
1,1702,1453,249,6,248,69
-1,1300,1663,-363,-5,-276,72
-1,1417,1432,-15,-2,-164,66
1,1323,1131,192,-1,127,86
-1,1448,1706,-258,1,42,82
-1,1400,1269,131,-10,-54,48
1,1562,1550,12,-1,220,129
-1,1632,1721,-89,1,-66,68
-1,1710,1443,267,-1,-188,95
-1,1163,1380,-217,0,-52,64
-1,1463,1715,-252,-4,-33,56
-1,1792,1667,125,-5,-194,76
1,1458,1719,-261,-1,26,99
1,1719,1458,261,0,85,100
-1,1433,1422,11,-1,-499,142
1,1623,1672,-49,1,74,82
1,1728,1449,279,6,251,81
1,1974,1899,75,0,68,149
-1,1732,1445,287,0,-591,108
1,1653,1500,153,0,8,75
-1,1472,1191,281,-6,-433,140
-1,1536,1690,-154,-2,-191,100
-1,1461,1717,-256,0,-2,60
-1,1389,1443,-54,-4,-41,52
1,1683,1496,187,-4,-68,52
-1,1721,1456,265,-9,-125,46
-1,1726,1806,-80,0,14,72
1,1778,1691,87,3,177,89
-1,1456,1721,-265,-1,-54,48
1,1702,1476,226,-5,-120,53
-1,1297,1390,-93,0,-122,56
1,1814,1713,101,-1,50,61
1,1476,1702,-226,0,18,41
1,1464,1467,-3,-1,17,49
0,1575,1635,-60,-2,-170,150
1,1460,1500,-40,6,256,57
1,1821,1701,120,2,24,73
-1,1489,1689,-200,0,35,50
-1,1660,1656,4,0,51,98
1,1552,1523,29,12,714,89
1,1801,1562,239,4,422,105
1,1595,1434,161,6,505,69
1,1828,1690,138,-4,-296,79
-1,1513,1562,-49,-5,-527,92
1,1711,1467,244,-6,-14,45
-1,1572,1503,69,0,-13,130
1,1475,1702,-227,2,61,73
-1,1489,1611,-122,-1,-54,62
-1,1462,1692,-230,11,372,56
-1,1680,1814,-134,-1,-59,60
1,1710,1678,32,0,21,47
1,1697,1456,241,0,-34,97
-1,1304,1468,-164,-8,-762,78
1,1821,1671,150,0,14,89
1,1559,1516,43,0,59,89
1,1806,1371,435,-2,-141,77
1,1452,1366,86,5,140,41
1,1662,1827,-165,2,134,63
1,1702,1451,251,-3,-4,45
0,1507,1568,-61,-1,57,206
-1,1545,1604,-59,-7,-55,48
1,1442,1711,-269,4,371,93
1,1600,1332,268,-2,381,137
-1,1812,1683,129,-4,-108,74
-1,1662,1720,-58,-1,-51,77
-1,1691,1462,229,0,-47,56
-1,1703,1798,-95,-2,-419,76
-1,1567,1598,-31,-1,-49,68
0,1786,1647,139,-1,37,174
1,1806,1692,114,0,-42,67
0,1633,1577,56,-3,-367,128
1,1431,1452,-21,-1,169,82
1,1819,1614,205,-1,-43,79
-1,1672,1547,125,-6,-331,68
1,1676,1233,443,3,178,61
-1,1655,1562,93,-6,-168,62
1,1640,1575,65,-5,7,67
1,1824,1365,459,-1,-12,55
1,1612,1692,-80,-3,-51,63
1,1826,1361,465,1,3,59
1,1344,1500,-156,0,115,81
-1,1420,1278,142,3,14,52
1,1518,1441,77,1,122,93
1,1650,1567,83,3,588,125
1,1659,1558,101,-6,-405,83
-1,1376,1323,53,-5,-489,68
1,1640,1289,351,11,371,43
-1,1668,1551,117,2,-147,82
1,1854,1901,-47,0,25,87
-1,1652,1565,87,-6,-346,76
1,1386,1604,-218,3,136,57
1,1268,1232,36,2,173,47
-1,1724,1990,-266,0,-35,94
-1,1828,1643,185,-5,-133,54
-1,1439,1470,-31,-9,-140,50
-1,1569,1502,67,0,75,90
1,1638,1578,60,-10,-307,55
1,1638,1578,60,-2,61,97
1,1661,1810,-149,0,17,67
1,1294,1231,63,0,617,131
1,1647,1569,78,-9,-108,47
1,1647,1569,78,1,-98,83
1,1637,1408,229,0,97,79
1,1277,1493,-216,-8,-42,41
-1,1794,1998,-204,0,-20,84
-1,1406,1623,-217,-10,-191,76
-1,1452,1132,320,0,-60,62
-1,1888,1799,89,-4,-53,46
-1,1377,1477,-100,-13,-326,48
-1,1296,1402,-106,-5,-208,58
1,1788,1742,46,-1,-19,65
1,1660,1428,232,0,261,95
-1,1458,1398,60,1,-72,84
-1,1350,1364,-14,8,395,65
1,1278,1180,98,7,424,81
-1,1656,1561,95,-7,-520,72
1,1733,1798,-65,-1,-174,89
-1,1995,1720,275,0,-9,64
-1,1579,1632,-53,1,50,54
1,1642,1574,68,0,12,63
-1,1871,1669,202,-1,-53,50
-1,1651,1784,-133,-3,-278,60
-1,1500,1427,73,1,50,46
1,1651,1566,85,0,-186,197
-1,1085,1342,-257,0,12,62
-1,1363,1531,-168,-12,-364,60
1,1792,1359,433,-6,109,81
-1,1412,1332,80,-2,36,80
-1,1668,1550,118,-8,-266,66
-1,1191,1377,-186,1,-22,48
1,1432,1527,-95,3,555,91
1,1642,1234,408,1,200,73
-1,1653,1564,89,0,-181,88
1,1738,1972,-234,0,62,65
1,1640,1569,71,0,-32,81
1,2000,1686,314,0,133,89
1,1630,986,644,3,376,109
-1,1417,1178,239,4,274,88
-1,1577,1609,-32,-1,53,44
-1,1219,1644,-425,0,-8,68
-1,1567,1619,-52,-4,-325,126
-1,1654,1682,-28,-1,41,46
1,1346,1106,240,6,225,49
-1,1359,1427,-68,0,8,56
1,1335,1002,333,13,895,87
1,1490,1329,161,0,69,73
1,1692,1643,49,1,1,47
1,1411,1492,-81,3,65,40
-1,1604,1716,-112,-7,-192,64
-1,977,1351,-374,-1,-310,88
1,1874,1773,101,0,24,60
-1,1558,1645,-87,2,7,42
-1,1197,1265,-68,-3,-90,74
-1,1550,1628,-78,-2,-139,60
1,1635,1633,2,0,-18,63
1,1436,1417,19,-1,217,149
-1,1725,1597,128,0,-51,84
1,1632,1264,368,0,57,55
1,1794,1637,157,-2,-259,83
1,1615,1546,69,9,386,71
-1,1630,1801,-171,2,405,92
-1,1317,1498,-181,-1,32,40
-1,1468,1687,-219,0,-8,98
-1,1643,1430,213,-4,-90,64
1,1538,1801,-263,0,17,45
-1,1665,1772,-107,-5,-240,64
-1,1448,1626,-178,-20,-505,44
1,1560,1183,377,-7,-348,85
0,1437,1522,-85,0,-78,114
1,1314,1354,-40,6,405,75
1,1270,1288,-18,7,216,51
-1,1459,1577,-118,0,5,64
1,1608,1611,-3,-1,-21,59
1,1473,1622,-149,-1,8,83
1,2017,1619,398,6,309,63
-1,1616,2020,-404,-8,-279,66
1,2020,1616,404,1,3,43
1,1548,1400,148,1,23,45
1,2022,1614,408,0,308,67
0,1607,1469,138,0,-29,151
-1,1600,1620,-20,-4,-78,80
-1,1612,2024,-412,-4,-111,52
1,1609,1577,32,7,156,63
-1,1483,1460,23,-5,-12,42
-1,1213,1618,-405,-8,-827,102
-1,1604,1631,-27,-3,-63,52
1,1634,1364,270,-4,-48,61
1,1510,1539,-29,-2,-2,59
-1,1422,1563,-141,-2,23,40
1,1569,1639,-70,0,1689,209
1,1746,1793,-47,-8,29,47
-1,1521,1618,-97,0,-394,92
-1,1631,1590,41,-3,-412,84
1,1780,1759,21,-1,-69,77
-1,1565,1894,-329,-5,-164,60
-1,1581,1625,-44,-3,-287,92
-1,1551,1321,230,-1,-96,92
-1,1791,2026,-235,0,-46,70
-1,1269,1360,-91,11,140,94
0,1572,1377,195,5,343,149
1,1635,1624,11,-7,-150,51
1,1415,1291,124,8,959,89
-1,1773,1751,22,-2,-274,92
1,1625,1656,-31,7,192,45
-1,1657,1839,-182,-2,-41,44
1,1656,1625,31,3,280,69
1,1368,1224,144,7,467,69
-1,1616,1644,-28,0,-235,118
1,1375,1567,-192,3,267,58
1,1897,1844,53,2,89,53
1,1654,1606,48,1,48,51
1,1606,1654,-48,6,1,43
-1,1529,1482,47,-1,-122,78
-1,1642,1596,46,0,-70,80
1,1610,1548,62,10,117,49
-1,1539,1286,253,-11,-625,66
-1,1192,1375,-183,-1,-282,82
1,1532,1571,-39,3,77,49
1,1608,1629,-21,5,289,129
-1,1537,1620,-83,-2,-79,70
1,1282,1476,-194,0,44,57
-1,1328,1520,-192,-2,-96,58
-1,1618,1620,-2,-4,-534,123
1,1866,1919,-53,0,-257,77
1,1283,984,299,6,224,51
1,1835,1906,-71,0,186,67
1,1620,1633,-13,2,182,113
1,1605,1379,226,3,697,113
1,1630,1607,23,1,154,61
1,1373,1482,-109,-6,-9,67
1,1607,1630,-23,-2,-133,51
-1,1373,1690,-317,-8,-829,92
-1,1597,1619,-22,-4,-154,76
-1,1629,1587,42,2,58,44
1,1907,1927,-20,-5,-8,59
1,1461,1626,-165,1,56,49
1,1693,1432,261,1,116,87
1,1388,1369,19,5,489,161
-1,1599,1617,-18,-1,-131,80
1,1572,1634,-62,2,239,63
-1,1589,1627,-38,0,20,60
-1,1884,1725,159,-2,-86,58
-1,1292,1167,125,-4,-109,40
1,1632,1560,72,1,54,69
1,1697,1418,279,0,35,91
0,1627,1589,38,-4,-185,132
-1,1643,1572,71,1,-26,71
1,1684,1629,55,-1,85,71
1,1552,1449,103,-3,-72,107
-1,1579,1637,-58,-10,-282,56
1,1762,1619,143,2,17,59
-1,1570,1646,-76,-14,-111,40
-1,1357,1406,-49,0,-885,141
-1,1694,1702,-8,0,-35,128
1,1583,1654,-71,1,-38,73
-1,1449,1638,-189,-2,-50,58
-1,1628,1872,-244,-3,-187,56
-1,1769,1864,-95,0,-90,64
1,1918,1893,25,2,11,47
1,1641,1596,45,2,430,81
-1,1387,1663,-276,-6,-162,56
-1,1948,1936,12,1,24,50
1,1442,1411,31,-3,250,121
1,1853,1924,-71,4,296,95
1,1773,1877,-104,-1,145,107
1,1503,1680,-177,1,272,64
1,1142,1370,-228,1,109,65
1,1198,1139,59,-8,-110,61
1,1671,1605,66,-3,-16,118
1,1819,1704,115,-3,-74,43
1,1609,1428,181,2,28,53
-1,1648,1832,-184,-9,-241,58
-1,1440,1614,-174,-2,-74,74
1,1474,1400,74,0,132,40
-1,1697,1826,-129,3,-19,98
-1,1750,1817,-67,0,1,62
-1,1500,1458,42,2,8,42
0,1721,1826,-105,0,-29,119
1,1825,1642,183,0,80,71
-1,2118,1839,279,1,8,76
1,1354,1218,136,4,216,73
1,1469,1457,12,6,282,61
1,1663,1589,74,-1,-30,61
-1,1504,1528,-24,-1,-218,136
-1,1583,1392,191,3,55,90
-1,1505,1653,-148,0,10,52
1,1947,1937,10,-1,1,105
-1,1941,1909,32,2,31,62
-1,1578,1593,-15,-6,-268,82
1,1502,1323,179,-2,-12,43
1,1845,1717,128,11,170,45
-1,1304,1856,-552,-11,-653,76
1,1354,1227,127,16,1515,129
-1,1480,1624,-144,0,-30,50
1,1873,1906,-33,0,15,77
1,2092,1991,101,1,13,69
1,1340,1320,20,0,77,69
-1,1526,1476,50,2,82,54
-1,1833,1944,-111,-1,-433,160
-1,1915,2112,-197,1,20,80
1,1861,1690,171,-1,5,93
-1,1758,1832,-74,0,60,82
1,1616,1224,392,-5,-35,103
-1,1934,1908,26,1,77,94
-1,1582,1815,-233,1,-2,72
1,1725,1332,393,2,58,73
1,1774,2060,-286,1,13,69
0,1826,1684,142,-1,-173,104
1,1850,1466,384,14,211,41
-1,1306,1608,-302,-4,-79,68
-1,1927,1957,-30,0,-9,106
1,1620,1434,186,0,50,67
-1,1664,1517,147,-1,-110,86
1,1922,1885,37,0,20,59
-1,1688,1869,-181,-9,-269,68
-1,1826,1741,85,2,48,66
-1,1306,1233,73,1,7,56
-1,2103,2021,82,0,7,78
-1,1633,1518,115,-6,9,172
1,1508,1510,-2,1,430,83
0,1918,1813,105,-7,-59,58
1,1604,1567,37,-1,-12,61
1,1566,1499,67,-1,-38,105
-1,1711,1820,-109,-3,-271,90
1,1609,1719,-110,0,71,69
-1,1202,1362,-160,-7,-297,66
-1,1540,1642,-102,4,240,58
-1,1367,1407,-40,-2,-25,50
1,1699,1719,-20,0,-4,97
-1,1857,1690,167,-3,-113,102
1,1848,1934,-86,0,23,67
1,1422,1478,-56,-1,133,85
-1,1389,1727,-338,-10,-380,100
-1,1409,1561,-152,-7,-305,62
1,1650,1532,118,-5,-170,53
-1,1532,1650,-118,3,178,60
-1,1832,1846,-14,1,-74,88
-1,1825,1810,15,-1,-426,104
-1,1394,1667,-273,-2,-78,52
0,2085,1849,236,0,-128,113
-1,1417,1381,36,-5,10,62
1,1637,1473,164,1,356,123
1,1735,1479,256,-2,320,109
0,1918,1894,24,0,-116,129
1,1318,1650,-332,-1,-77,87
1,1441,1457,-16,-6,-58,59
-1,1657,1525,132,-2,-131,62
-1,1248,2037,-789,-3,-72,48
1,1876,1857,19,2,7,71
0,1239,1500,-261,4,94,78
1,1829,1703,126,0,141,145
0,1818,1914,-96,0,11,93
-1,1400,1410,-10,9,235,56
-1,1519,1538,-19,-5,-58,60
-1,1643,1540,103,1,49,48
-1,1819,1500,319,1,26,78
-1,1494,1539,-45,0,-28,68
-1,1458,1372,86,-8,-1271,122
1,1839,1547,292,0,136,131
-1,1519,1636,-117,-1,43,64
-1,1879,1910,-31,-7,-76,82
-1,1658,1546,112,-9,-301,52
-1,1846,1888,-42,-1,-8,74
-1,1575,1567,8,-1,-337,104
-1,1800,1767,33,-3,-241,98
-1,1483,1267,216,1,21,54
-1,1631,1573,58,-6,-822,120
-1,1449,1458,-9,2,47,64
0,1390,1435,-45,-4,-397,114
1,1902,1836,66,0,10,99
1,1610,1505,105,1,48,46
1,1617,1338,279,9,251,58
-1,1465,1730,-265,-1,-44,42
0,1919,1869,50,-3,115,102
0,1493,1600,-107,-1,3,141
-1,1243,1166,77,-12,-108,44
1,1696,1837,-141,3,71,53
-1,1629,1576,53,-2,-541,102
1,1885,1772,113,2,109,79
-1,1646,1831,-185,0,-112,88
1,1797,1526,271,-1,4,85
-1,1734,1593,141,1,11,42
1,1938,2076,-138,0,140,105
1,1833,1787,46,0,327,109
1,1316,1421,-105,4,231,57
1,1829,2019,-190,0,-14,57
-1,1616,1589,27,-4,-265,58
1,1820,1711,109,0,95,81
1,1844,1544,300,0,56,89
1,2056,1901,155,-4,4,45
1,1582,1413,169,0,2,115
-1,1855,1843,12,0,-636,92
-1,1452,1514,-62,-10,-203,52
-1,1600,1605,-5,0,-1,42
-1,1419,2038,-619,-20,-211,42
1,1564,1428,136,0,20,87
1,1229,1426,-197,3,77,53
1,2065,1893,172,0,419,141
-1,1460,1468,-8,0,-12,44
-1,1434,1612,-178,-2,-53,70
1,1601,1604,-3,-7,-70,81
1,1900,1868,32,-4,-100,79
1,1778,1788,-10,0,62,81
-1,1548,1718,-170,-11,-448,64
-1,1512,1871,-359,-5,-134,50
-1,1599,1731,-132,0,-32,60
-1,1918,1940,-22,0,-15,102
1,1623,1334,289,1,163,65
1,1886,2073,-187,-4,634,99
0,1703,1829,-126,0,-177,156
1,1589,1508,81,2,10,41
-1,1601,1605,-4,4,108,52
-1,1175,1376,-201,-2,-59,62
1,1658,1569,89,-1,-38,77
1,1615,1590,25,14,671,65
0,1853,1768,85,0,-53,119
1,1416,1443,-27,3,-5,55
1,1406,1342,64,0,91,101
1,1392,1286,106,1,34,77
1,1725,1542,183,1,-306,111
-1,1477,2040,-563,-2,-48,94
1,1640,1838,-198,0,36,63
-1,1777,1790,-13,-1,-52,67
-1,1613,1592,21,0,-8,72
1,1505,1386,119,2,89,55
1,1801,1858,-57,0,-33,91
-1,1479,1850,-371,-3,-13,54
-1,1481,1586,-105,-2,10,40
-1,1604,1623,-19,-1,-132,62
-1,1802,1736,66,-3,-267,78
1,1419,1343,76,-1,-60,75
-1,1633,1594,39,-3,-115,56
1,1560,1667,-107,2,102,139
-1,1481,1692,-211,0,-24,64
-1,1499,1606,-107,-2,-101,56
1,1584,1601,-17,-5,-66,71
-1,1217,2041,-824,-10,-133,48
1,2052,1905,147,0,515,89
1,1912,1814,98,1,247,123
-1,1330,1391,-61,1,-100,64
1,1777,1789,-12,0,148,97
1,1605,1621,-16,0,-13,45
0,1955,1873,82,-1,-61,143
1,1621,1605,16,-4,-125,61
-1,1431,1752,-321,-18,-637,66
1,1577,1497,80,10,477,68
-1,1536,1731,-195,-3,-113,62
-1,1787,1956,-169,-1,-47,44
1,1478,1448,30,-5,-312,89
1,2060,1897,163,3,572,89
1,1908,1917,-9,1,38,87
1,1416,1377,39,0,-30,71
-1,1620,1607,13,-4,-140,54
1,1815,1651,164,-2,-60,43
1,1820,1658,162,-1,-3,53
1,1382,1164,218,1,35,41
-1,1395,1663,-268,-3,-171,76
1,1633,1477,156,-1,208,107
-1,1890,2068,-178,-4,-785,110
1,1618,1609,9,2,91,63
-1,1333,1523,-190,-1,-483,124
-1,1335,1737,-402,0,-42,48
1,1509,1567,-58,0,82,65
-1,1245,1721,-476,-2,-77,46
-1,1710,1854,-144,-1,192,82
1,1400,1644,-244,-4,-58,141
-1,1719,1593,126,-7,-452,78
0,1579,1605,-26,-4,-117,144
-1,1626,1621,5,1,-180,140
1,2075,1883,192,1,75,75
-1,1432,2041,-609,-6,-366,60
1,1473,1538,-65,-1,22,43
-1,1413,1744,-331,-5,-294,70
0,1739,1876,-137,-2,-185,112
1,1778,1788,-10,1,50,61
-1,1198,1438,-240,-4,-166,56
-1,1925,1801,124,0,-148,70
1,1640,1470,170,0,52,97
1,1488,1432,56,0,11,67
-1,1632,1616,16,-3,-58,54
1,1426,1403,23,1,100,65
-1,1331,1796,-465,-1,-188,92
-1,1359,1953,-594,-13,-163,48
-1,1596,1574,22,1,2,40
-1,1822,1906,-84,-8,-153,54
-1,1627,1621,6,0,13,70
1,1827,1707,120,4,93,43
-1,1513,1574,-61,-3,-169,84
-1,1439,1594,-155,-1,-434,90
-1,1631,1616,15,2,97,74
-1,1585,1583,2,-1,-134,68
1,1330,1629,-299,0,-22,67
-1,1361,1384,-23,4,150,132
1,1586,1442,144,3,297,90
1,1631,1616,15,5,5,43
-1,1863,1954,-91,-1,-117,124
1,1814,1767,47,1,-38,95
-1,1546,1701,-155,-13,-506,76
1,1804,1922,-118,0,2,95
1,1650,1597,53,3,-7,51
-1,1031,1640,-609,-1,-13,50
-1,1570,1390,180,-2,1,42
-1,1500,1205,295,-6,-148,68
1,1646,1482,164,-1,-60,93
1,1748,1368,380,14,353,57
1,1823,1857,-34,-5,-75,87
1,1627,1418,209,6,271,71
1,1777,1789,-12,-3,111,115
1,1816,1680,136,3,186,77
1,1497,1520,-23,3,86,71
1,1838,1691,147,-3,60,139
1,1410,1442,-32,7,185,55
1,1524,1481,43,10,91,43
1,1595,1574,21,-3,-5,71
0,1593,1562,31,0,55,97
0,1896,1822,74,-4,170,210
1,1278,1327,-49,3,99,45
-1,1598,1776,-178,-1,-29,50
1,1777,1849,-72,0,11,111
-1,1593,1534,59,-2,-11,48
-1,1834,1852,-18,-1,-59,60
-1,1500,1464,36,-13,-218,42
-1,1845,1821,24,-6,-150,90
1,1799,1475,324,1,42,53
-1,1476,1593,-117,-1,36,72
1,1475,1108,367,9,553,79
-1,1508,1531,-23,-5,-29,42
-1,1783,1877,-94,-6,-472,76
-1,1413,1472,-59,-1,101,94
1,1543,1429,114,7,186,57
-1,1500,1404,96,-3,-123,61
1,1589,1443,146,0,89,63
-1,1592,1761,-169,-6,-259,66
1,1700,1671,29,-2,-49,51
1,1553,1547,6,-2,263,157
1,1865,1825,40,2,227,93
-1,1402,1886,-484,0,-20,80
-1,1427,1453,-26,-1,-10,44
-1,1567,1559,8,0,-19,48
1,1662,1711,-49,-1,13,63
-1,1105,1480,-375,1,-15,46
0,1626,1632,-6,2,259,114
-1,1515,1391,124,-1,-109,74
1,1777,1789,-12,1,67,63
1,1770,1683,87,2,108,73
1,1564,1606,-42,5,181,69
1,1697,1673,24,10,326,59
1,1541,1603,-62,-1,-33,67
-1,1888,1775,113,1,-314,134
1,1811,1644,167,0,124,89
1,1585,1409,176,0,171,161
-1,1102,1401,-299,3,168,54
-1,1493,1529,-36,-8,-47,74
1,1845,1671,174,2,43,47
1,1405,1098,307,-1,122,77
1,1833,1871,-38,0,-20,69
-1,1664,1790,-126,-2,-23,44
-1,1481,1403,78,1,-16,48
1,1797,1657,140,13,252,49
-1,1815,1878,-63,0,2,42
-1,1796,1658,138,-5,-85,80
-1,1596,1826,-230,0,90,136
-1,1778,1788,-10,-6,-468,128
-1,1482,1503,-21,-2,-245,97
-1,1650,1682,-32,-2,-301,108
-1,1593,1576,17,1,35,54
1,1412,1091,321,10,80,41
-1,1780,1804,-24,-6,-301,60
1,1598,1500,98,1,35,57
-1,1417,1468,-51,-1,-289,75
0,1497,1493,4,0,-97,145
-1,1436,1587,-151,1,-301,86
1,1757,1830,-73,0,-126,125
1,1641,1695,-54,0,59,94
1,2042,1630,412,0,255,101
1,1087,1415,-328,-9,-256,51
-1,1588,1116,472,-12,-584,74
1,1889,1500,389,3,167,58
1,1372,1282,90,0,40,69
-1,1768,1815,-47,-1,-197,96
1,1846,1788,58,3,11,41
1,1679,1653,26,2,-47,77
-1,1708,1857,-149,-4,-385,86
1,1461,1525,-64,0,-6,67
1,1394,1109,285,16,771,63
1,1643,1692,-49,16,1372,105
1,1327,1448,-121,-3,207,125
-1,1758,1812,-54,0,-160,68
-1,1551,1391,160,1,-170,102
1,2045,1682,363,0,77,98
-1,1865,1701,164,0,-32,118
1,1592,1564,28,11,264,53
-1,1477,1407,70,-1,-143,74
-1,1588,1581,7,0,-31,90
1,1798,1768,30,0,135,103
1,1294,1397,-103,0,-6,41
1,1475,1618,-143,0,68,54
1,1748,1718,30,2,152,81
1,1595,1427,168,7,126,55
1,1825,1847,-22,0,60,114
1,1633,1564,69,0,100,61
1,1478,1644,-166,-1,-61,56
-1,1583,1362,221,-1,-20,50
1,1602,1657,-55,0,301,111
-1,1782,1699,83,-7,-154,76
-1,1655,1559,96,-2,-503,102
1,1421,1464,-43,0,35,83
-1,1591,1836,-245,1,-275,112
-1,1603,1490,113,-4,141,84
-1,1249,1580,-331,-4,-182,76
1,1668,1653,15,-4,308,81
-1,1398,1834,-436,0,-50,52
1,1645,1421,224,0,-1,45
-1,1505,1765,-260,0,-141,64
1,1836,1554,282,1,63,59
1,1477,1215,262,4,149,61
1,1451,1433,18,0,37,59
-1,1658,1656,2,-8,-455,64
-1,1593,1577,16,2,2,80
-1,1493,1672,-179,2,64,58
1,1615,1834,-219,2,-154,95
1,1767,1585,182,-13,-171,73
1,1647,1667,-20,1,769,145
-1,1441,1337,104,-4,-194,64
-1,1758,1808,-50,-6,-404,72
-1,1213,1430,-217,-6,-364,120
0,1506,1415,91,0,481,221
1,1500,1245,255,-5,-673,99
1,1382,1429,-47,1,87,99
1,1570,1580,-10,-13,-299,55
1,1773,1688,85,0,-72,89
1,1845,1655,190,0,0,93
-1,1481,1738,-257,0,-117,84
-1,1679,1395,284,-2,-339,94
-1,1423,1462,-39,0,-152,98
-1,1855,1679,176,-4,-179,118
-1,1650,1851,-201,0,-36,82
-1,1649,1770,-121,-1,-157,110
1,1817,1749,68,1,152,79
1,1932,1758,174,0,51,64
-1,1588,1581,7,1,47,92
-1,1696,1839,-143,-2,-10,47
1,1435,1113,322,-5,-67,107
-1,1506,1857,-351,0,-455,120
-1,1436,1632,-196,0,-725,140
-1,1472,1413,59,-5,-100,80
-1,1487,1678,-191,-1,-54,180
1,1860,1503,357,0,455,108
-1,1342,1274,68,-7,-379,58
1,1709,1575,134,7,105,43
-1,1583,1333,250,-7,-993,114
-1,1813,1754,59,-2,-166,80
1,1254,1673,-419,-2,285,125
1,1863,1568,295,0,1,97
1,1313,1383,-70,-4,-186,55
-1,1546,1743,-197,-2,-235,72
-1,1415,1660,-245,-4,-416,98
-1,1288,1421,-133,-5,-356,72
0,1766,1800,-34,6,241,83
1,1333,1330,3,13,200,45
1,1867,1604,263,0,13,61
-1,1349,1494,-145,2,-34,121
1,1439,1475,-36,3,153,89
-1,1232,1146,86,1,13,46
1,1522,1488,34,2,140,77
-1,1599,1872,-273,-3,-16,76
-1,1540,1749,-209,-7,-258,69
1,1593,1500,93,4,187,59
1,1571,1568,3,-1,34,79
-1,1321,1516,-195,-3,-868,110
-1,1539,1690,-151,-2,-91,68
1,1876,1595,281,2,76,65
-1,1319,1376,-57,-3,-76,72
-1,1544,1604,-60,-4,-173,56
-1,1438,1573,-135,-1,-35,44
1,1782,1565,217,0,6,71
-1,1632,1813,-181,0,-129,118
1,1588,1334,254,-2,-102,59
-1,1481,1684,-203,0,-264,96
1,1599,1192,407,0,5,53
1,1478,1881,-403,3,124,88
-1,1463,1453,10,-2,-199,56
1,1477,1754,-277,0,196,145
-1,1799,1767,32,-2,-27,42
-1,1637,1759,-122,0,-349,146
-1,1575,1410,165,1,76,64
1,1499,1500,-1,3,60,51
1,1580,1431,149,-4,119,67
-1,1703,1665,38,-2,-289,140
-1,1500,1857,-357,-18,-631,56
1,1778,1788,-10,2,126,69
-1,1613,1534,79,4,-85,100
1,1601,1500,101,-6,2,45
1,1860,1402,458,1,-52,91
-1,1466,1452,14,2,-105,80
-1,1317,1606,-289,2,327,98
-1,1409,1310,99,0,-23,54
1,1893,1796,97,-1,-69,69
-1,1531,1255,276,4,214,72
1,1788,1443,345,4,138,63
-1,1497,1862,-365,-5,-135,46
-1,1437,1960,-523,-5,-851,118
-1,1626,1650,-24,1,-600,130
-1,1476,1587,-111,-2,-109,66
1,1865,1886,-21,-4,-47,57
-1,1424,1556,-132,-1,-137,100
1,1420,1423,-3,1,640,89
-1,1565,1875,-310,0,6,52
1,1983,1589,394,2,159,97
-1,1777,1789,-12,-3,-164,66
-1,1689,1630,59,0,4,50
1,1621,1494,127,0,-14,47
-1,1608,2026,-418,0,-21,54
1,1879,1878,1,2,128,99
-1,1791,1770,21,-3,-102,58
-1,1280,1500,-220,-5,-88,46
-1,1799,1767,32,0,-45,110
1,1755,1463,292,2,110,91
0,1867,1892,-25,0,272,148
-1,1616,1500,116,-1,-242,102
1,1765,1769,-4,-1,8,61
1,1486,1638,-152,2,202,73
1,1891,1868,23,-1,44,87
1,1777,1748,29,-1,233,111
1,1605,1839,-234,1,33,57
0,1858,1903,-45,1,247,120
-1,1548,1600,-52,1,-108,140
-1,1592,1460,132,-1,-21,56
-1,1986,1676,310,0,-7,52
-1,1759,1633,126,-5,-107,68
1,1778,1788,-10,1,176,89
1,1778,1531,247,6,11,42
-1,1365,1286,79,-2,-404,90
1,1381,1314,67,0,428,119
-1,1859,1901,-42,0,11,116
1,1712,1582,130,0,130,69
-1,1776,1852,-76,0,-124,76
-1,1606,1502,104,4,60,46
1,1468,1330,138,9,339,63
-1,1603,1901,-298,1,24,46
-1,1537,1333,204,-1,43,118
1,1390,1465,-75,4,311,57
-1,1374,1500,-126,0,-96,104
-1,1624,1742,-118,1,-222,132
0,1592,1328,264,-2,67,89
1,1517,1397,120,0,3,103
1,1574,1719,-145,-1,-81,57
1,1820,1416,404,-9,160,69
-1,1561,1513,48,6,-74,72
1,1964,1713,251,0,173,169
1,1364,1447,-83,5,188,63
-1,1582,1711,-129,0,41,146
-1,1475,1323,152,-1,-25,44
1,1777,1789,-12,1,135,63
1,1861,1767,94,0,-5,57
-1,1951,1912,39,0,-44,90
1,1437,1366,71,0,-100,69
1,1482,1500,-18,3,510,87
1,1587,1456,131,2,154,95
-1,1537,1409,128,-20,-886,68
0,1526,1349,177,-16,-477,74
1,2033,1787,246,1,89,59
-1,1526,1926,-400,-6,-74,46
1,1759,1870,-111,-1,18,115
1,1617,1554,63,0,-44,53
-1,1778,1788,-10,-4,-77,44
-1,1459,1663,-204,-1,-252,107
-1,1459,1385,74,4,93,56
-1,1274,1628,-354,1,39,52
-1,2120,1936,184,-3,-1,40
1,1652,1644,8,1,42,71
-1,0,1185,-1185,0,-5,58
-1,1305,1938,-633,-17,-604,58
1,1903,1793,110,7,42,43
-1,1640,1677,-37,3,89,94
1,1736,1830,-94,0,24,91
1,2072,1817,255,-1,-3,41
-1,1450,1440,10,-3,-180,51
-1,1500,1481,19,12,303,52
-1,1181,1370,-189,-7,-242,66
-1,1890,1989,-99,-5,-126,63
-1,1517,1682,-165,-2,-28,44
-1,1811,2077,-266,-1,-330,80
1,1723,1552,171,-4,-56,53
1,1785,1911,-126,0,20,69
1,1469,1284,185,3,220,75
0,1624,1687,-63,3,997,159
-1,1584,1669,-85,-1,-85,90
-1,1549,1741,-192,-3,-15,44
-1,1272,1347,-75,2,-88,94
-1,1565,1386,179,-1,78,126
1,2081,1806,275,1,93,61
-1,1695,1707,-12,-1,-23,50
-1,1181,1316,-135,0,-70,58
1,1582,1614,-32,-4,-66,69
-1,1597,1704,-107,0,15,68
-1,1733,1713,20,-12,-138,46
-1,1553,1352,201,-3,-294,86
1,1639,1642,-3,-2,118,81
1,1627,1387,240,0,107,51
1,1282,1449,-167,-10,-265,53
-1,1997,1882,115,0,20,106
-1,1801,2085,-284,1,23,98
-1,1297,1461,-164,-4,-185,80
-1,1799,1755,44,-19,-476,56
-1,1828,1987,-159,-2,-64,96
-1,1721,1531,190,-1,5,50
1,1639,1834,-195,0,574,93
-1,1800,2039,-239,1,26,74
-1,1263,1630,-367,-2,-701,138
1,1533,1517,16,0,30,59
-1,1373,1388,-15,2,82,47
1,1797,1685,112,5,253,67
-1,1707,1689,18,0,-70,92
-1,1629,1588,41,-3,-278,82
0,1382,1453,-71,-2,-155,115
-1,1384,1068,316,-7,-99,48
-1,1630,1995,-365,2,127,70
1,2089,1818,271,1,21,53
1,1664,1522,142,1,180,87
1,1815,1670,145,1,-18,107
-1,1346,1387,-41,-1,-145,74
-1,1896,1982,-86,0,-75,68
-1,1732,1549,183,1,27,56
-1,1561,1681,-120,-1,-108,90
1,1451,1384,67,-2,-73,57
1,1330,1433,-103,7,285,61
1,1695,1627,68,0,151,61
-1,1465,1550,-85,1,59,80
-1,1374,1460,-86,2,32,48
-1,1315,1361,-46,-3,-93,45
1,1674,1471,203,-5,-100,67
1,2080,1939,141,-2,142,135
-1,1716,1701,15,0,-18,68
1,1664,1823,-159,0,-50,117
1,1735,1662,73,0,18,55
1,1396,1343,53,1,42,57
1,1812,1750,62,0,110,73
-1,1679,1747,-68,0,-45,64
1,1235,1398,-163,-1,-89,53
1,1357,1477,-120,-4,-111,61
0,1515,1392,123,-6,-411,92
-1,1807,2101,-294,-6,-136,50
-1,1616,1704,-88,0,17,52
1,1633,1363,270,4,335,61
-1,2055,1786,269,0,-181,76
1,1458,1654,-196,0,31,48
1,1991,1888,103,-1,-9,43
1,1713,1705,8,-3,75,71
-1,1278,1475,-197,-3,-57,44
1,1804,1679,125,0,33,95
1,1688,1803,-115,-1,-127,97
1,1713,1606,107,5,359,85
1,1548,1489,59,1,401,109
1,1164,1361,-197,2,155,57
1,1601,1381,220,0,20,87
1,1694,1724,-30,-4,313,81
-1,1718,2105,-387,-2,-123,62
-1,1436,1512,-76,-1,-16,44
1,2028,1965,63,0,30,53
-1,1451,1509,-58,-5,-53,46
-1,1672,1813,-141,-4,-182,60
-1,1708,1789,-81,0,-3,54
1,1442,1419,23,-1,-127,77
-1,1559,1429,130,-4,-133,112
-1,1434,1666,-232,-1,-559,150
1,1838,1677,161,1,110,89
1,1595,1576,19,0,256,101
-1,1870,1731,139,-2,-212,84
-1,1475,1751,-276,1,207,98
-1,1654,1744,-90,0,-19,72
1,1821,1665,156,0,64,121
-1,1568,1730,-162,0,41,62
-1,1696,1797,-101,0,26,46
0,1974,1803,171,0,-128,111
-1,1695,1723,-28,1,56,66
1,1500,1474,26,3,86,63
1,1901,1756,145,-7,32,59
0,1597,1998,-401,3,402,102
-1,1381,1327,54,0,33,54
-1,1747,1855,-108,2,62,64
-1,1659,1829,-170,0,-26,70
1,1686,1520,166,0,9,54
-1,1372,1384,-12,-1,41,52
1,1863,1739,124,-8,24,63
-1,1412,1987,-575,-3,-265,80
1,1805,1608,197,-9,-171,77
-1,1536,1647,-111,-3,-102,56
1,1342,1218,124,7,92,41
1,1733,1685,48,-4,-313,73
-1,1694,1821,-127,0,-51,62
1,1379,1562,-183,-4,-120,61
1,1500,1535,-35,2,397,81
-1,1487,1544,-57,-4,-374,82
-1,1742,2108,-366,-1,-37,70
-1,1719,1932,-213,-3,-112,58
-1,1618,1655,-37,-11,-126,46
-1,1731,1870,-139,0,88,70
1,1602,1811,-209,3,96,57
1,1980,1988,-8,-1,-36,53
1,1956,2038,-82,1,103,95
1,1481,1271,210,4,92,61
-1,1563,1527,36,7,635,96
-1,1464,1355,109,-1,-160,78
-1,1684,1676,8,0,-96,112
1,1829,1422,407,8,190,55
-1,1585,1568,17,0,-29,90
-1,1740,1919,-179,-4,-363,144
-1,1737,1562,175,0,-102,70
1,1877,1724,153,0,-62,83
1,1749,1910,-161,-6,246,123
1,1479,1330,149,3,143,65
-1,1621,1975,-354,0,-12,58
-1,1566,1456,110,-2,-748,88
-1,1741,1823,-82,-1,-190,96
1,1456,1475,-19,3,264,67
1,1752,1646,106,0,5,51
-1,1670,1978,-308,0,-284,92
1,1343,1185,158,17,712,59
-1,1953,1999,-46,-9,-183,48
-1,1500,1654,-154,0,-423,118
-1,1500,1500,0,-12,-206,44
-1,1565,1605,-40,-1,37,94
0,1236,1325,-89,-4,-354,105
-1,1553,1454,99,0,-52,44
-1,1721,1883,-162,0,-51,74
1,1965,1836,129,-6,-106,67
-1,1715,2111,-396,-1,-239,80
1,1666,1355,311,-1,342,99
-1,1638,1604,34,-3,-59,54
1,1685,1527,158,3,73,43
1,1925,1734,191,2,206,85
-1,1671,1845,-174,-3,-63,51
-1,1693,1982,-289,0,100,108
1,1986,2009,-23,-4,-21,47
1,1322,1471,-149,1,185,61
-1,1827,1972,-145,-5,-120,96
-1,1670,1352,318,3,86,68
-1,1662,1337,325,-8,-519,70
-1,1728,1930,-202,0,-279,94
0,1648,1986,-338,0,-426,94
1,1544,1396,148,6,37,43
1,1714,1807,-93,0,-4,81
-1,2000,1997,3,0,-99,66
1,1480,1212,268,-2,223,119
1,1395,1360,35,-6,-74,73
1,963,1084,-121,-4,-125,97
1,1400,1448,-48,-3,-48,51
-1,1926,1669,257,-6,-351,78
-1,1646,1979,-333,-3,2,48
1,1706,1606,100,3,163,91
-1,1551,1760,-209,-2,-636,138
-1,1714,1638,76,-2,-16,76
1,1549,1470,79,0,43,58
-1,1936,1723,213,0,36,60
-1,1674,1820,-146,-2,-48,58
-1,1320,1323,-3,-3,-388,78
1,1895,1713,182,11,201,47
-1,1735,1983,-248,0,54,82
-1,1304,1939,-635,-15,-489,74
-1,1662,1637,25,-3,-149,62
-1,1208,1350,-142,-10,-38,58
-1,1339,1631,-292,-8,-261,86
-1,1471,1487,-16,3,132,52
1,1598,1715,-117,0,638,113
-1,1901,1921,-20,0,-321,168
-1,1642,1988,-346,0,-42,96
1,1668,1518,150,2,15,53
-1,1740,1918,-178,2,-401,132
-1,1446,1654,-208,-1,-17,62
-1,1597,1513,84,0,3,54
-1,1348,1560,-212,1,-14,86
1,1321,1402,-81,1,115,81
-1,1697,1729,-32,-5,-54,80
-1,1608,1500,108,-1,-38,56
1,1615,1543,72,10,1251,123
1,1851,1837,14,2,26,49
1,1834,1732,102,3,162,89
-1,1866,1686,180,0,-8,66
-1,1638,1991,-353,0,-182,62
-1,1604,1708,-104,0,445,116
1,1565,1804,-239,1,56,57
1,1794,1704,90,0,29,87
-1,1544,1484,60,3,-155,120
-1,1635,1995,-360,0,-200,74
1,1392,1546,-154,0,315,103
1,2113,1891,222,6,251,71
-1,1439,1636,-197,-2,-30,46
-1,1725,1924,-199,0,-19,42
1,1677,1748,-71,0,21,57
1,1649,1356,293,3,202,79
-1,1472,1549,-77,1,106,85
-1,1979,1886,93,0,46,92
-1,1987,1769,218,-1,-268,76
1,1674,1524,150,1,55,45
1,1717,1596,121,0,-34,53
1,1735,1691,44,0,21,43
0,2001,1930,71,0,-135,113
-1,1701,1940,-239,0,20,72
0,1413,1431,-18,2,260,88
-1,1969,1816,153,0,-153,94
1,1651,1701,-50,2,72,65
1,1730,1599,131,1,95,91
1,1583,1472,111,2,950,123
1,1589,1725,-136,0,323,111
1,1630,1527,103,3,110,47
1,1753,1672,81,3,95,53
1,1728,1387,341,5,145,51
1,1681,1628,53,2,24,43
-1,1534,1624,-90,-3,-411,144
1,1932,1999,-67,-6,-73,87
-1,1460,1534,-74,-9,-265,58
1,1514,1531,-17,4,87,51
-1,1566,1433,133,2,47,54
-1,1900,1762,138,-1,-76,64
-1,1663,1762,-99,1,-5,54
1,1327,1432,-105,6,222,75
-1,1657,1641,16,-4,-94,66
-1,1580,1470,110,0,-66,82
-1,1408,1442,-34,0,-589,100
-1,1377,1983,-606,-10,-524,66
-1,1885,2164,-279,-6,-260,56
1,1811,1688,123,-1,-218,81
1,1474,1466,8,-3,29,44
-1,1791,1945,-154,-3,-79,52
1,1540,1688,-148,-1,7,55
1,985,0,985,3,278,97
-1,1662,1296,366,-2,-235,82
-1,1376,1984,-608,-4,-198,62
-1,1784,1641,143,1,15,54
1,1690,1666,24,-1,-130,89
-1,1778,1785,-7,0,-2,40
1,1952,1795,157,5,57,47
1,1969,1650,319,5,103,47
1,1985,1626,359,1,15,57
1,1721,1578,143,0,50,99
-1,1789,1959,-170,3,33,44
1,1674,2110,-436,0,61,63
-1,1493,1660,-167,6,251,58
-1,1655,1767,-112,1,-203,82
-1,1656,1769,-113,-6,-294,78
-1,1861,1834,27,0,18,60
-1,1381,2174,-793,-4,-501,86
1,1777,1775,2,0,18,117
1,1971,1877,94,0,151,91
-1,1591,1663,-72,-1,-64,70
-1,1709,1500,209,0,-62,102
-1,1500,1988,-488,-2,-248,72
-1,1451,1791,-340,-1,-126,86
1,1869,1979,-110,1,81,65
1,1839,1990,-151,0,113,93
1,1377,1496,-119,1,161,75
-1,1709,1638,71,0,-9,90
-1,1763,1788,-25,0,46,46
1,1700,1647,53,-5,-56,53
1,1467,1415,52,0,-161,93
-1,1361,1305,56,-3,-343,148
-1,1681,1818,-137,0,18,100
1,1830,1571,259,0,87,85
1,1647,1973,-326,1,73,97
1,1666,1406,260,1,204,63
1,1594,1335,259,1,955,173
-1,1639,1727,-88,-1,-21,56
1,1732,1784,-52,-2,-40,49
1,1541,1778,-237,-2,-87,59
1,1633,1525,108,0,107,71
1,1855,1798,57,0,55,47
-1,1592,1737,-145,0,-73,112
1,1875,1973,-98,2,65,79
-1,1456,1559,-103,0,-39,54
1,1965,1883,82,0,60,83
-1,1750,1696,54,-1,-64,70
-1,1697,1591,106,-5,-121,80
-1,1582,1672,-90,-6,-189,62
1,1707,1463,244,10,419,63
-1,1959,1889,70,-2,-71,63
1,1652,1617,35,4,311,99
1,1707,995,712,7,115,47
1,1418,1333,85,1,217,93
1,1696,1514,182,-4,-477,119
1,1567,1841,-274,-2,299,83
1,1864,1764,100,-2,-105,63
1,1736,1629,107,-9,128,91
1,1670,1579,91,-1,-178,103
-1,1711,1702,9,0,1,82
1,1431,1719,-288,7,311,79
-1,1756,1873,-117,-1,106,112
1,1537,1268,269,0,86,81
1,1922,1545,377,3,-37,41
-1,1955,1892,63,0,182,166
1,1680,1804,-124,0,82,91
1,1825,1674,151,-1,-138,97
1,1951,1666,285,1,145,72
1,1629,1498,131,-3,184,67
1,1702,1748,-46,0,2,41
1,1765,1356,409,0,-7,49
-1,1902,1946,-44,0,-144,78
-1,1880,2284,-404,2,-11,82
1,1673,1576,97,9,422,73
-1,1541,1931,-390,-1,-52,56
1,1565,1518,47,4,553,133
1,1744,1795,-51,-2,139,71
-1,1641,1862,-221,-5,-45,46
1,2286,1878,408,0,53,59
1,1678,1621,57,-2,35,55
-1,1659,1578,81,-3,-521,126
1,1353,1265,88,0,3,73
1,1737,1403,334,1,52,59
1,1500,1176,324,5,290,67
1,1714,1425,289,0,-119,89
-1,1581,1418,163,-3,-88,60
1,1876,1827,49,3,173,67
1,1459,1699,-240,-4,-104,53
0,1613,1519,94,6,234,71
1,1679,2008,-329,0,197,86
1,1688,1685,3,0,274,97
1,1767,1500,267,0,252,77
-1,1490,1486,4,-4,-835,132
-1,1741,1665,76,0,-13,124
-1,1886,1817,69,0,-44,78
1,1694,1787,-93,-1,5,123
1,1752,1356,396,-1,-17,57
1,1500,1662,-162,-4,320,71
-1,1476,1425,51,-2,2,54
-1,1256,1771,-515,0,12,48
1,1717,1568,149,-1,-180,99
1,1663,1525,138,1,49,45
1,1867,1636,231,-2,-5,55
-1,1832,1668,164,-4,-81,76
-1,1653,1646,7,0,19,62
1,1763,1550,213,0,-318,89
1,1518,1464,54,-2,148,61
1,1537,1736,-199,-2,-40,61
1,1255,1367,-112,13,869,79
1,1724,1496,228,7,428,65
1,1478,1541,-63,-3,-19,51
1,1518,1670,-152,0,67,77
1,1845,1414,431,11,487,69
1,1674,1699,-25,1,94,43
1,1845,1543,302,2,80,65
1,1831,1872,-41,5,214,83
1,1720,1606,114,1,18,45
1,1491,1831,-340,-3,13,49
1,1789,1511,278,-2,-18,73
-1,1575,1500,75,-1,-6,58
1,1500,1463,37,0,50,73
1,1684,1434,250,1,9,41
1,1665,1770,-105,2,108,83
1,1657,1641,16,-1,-20,71
1,1849,1526,323,0,10,51
-1,1834,1826,8,-2,-338,104
-1,1490,1528,-38,-6,-227,148
-1,1685,1816,-131,-7,-211,66
-1,1803,1905,-102,-2,-181,72
1,1713,1630,83,3,47,47
-1,1411,1412,-1,-3,-49,44
1,1877,1626,251,0,56,69
-1,1568,1429,139,-8,-79,43
-1,1469,1478,-9,0,-157,70
1,1729,1528,201,-3,-109,71
-1,1913,2119,-206,-6,-231,56
1,1776,1246,530,2,132,69
1,1604,1721,-117,1,19,49
-1,1285,1406,-121,-2,-45,40
1,1734,1730,4,-1,289,85
0,1571,1320,251,-1,-233,125
-1,1630,1667,-37,-1,-63,68
1,1908,1858,50,0,-60,71
1,1780,1719,61,1,22,41
1,1627,1253,374,0,25,64
1,1970,1889,81,0,42,77
1,1314,1336,-22,1,85,77
1,1743,1626,117,1,-14,51
-1,1315,1414,-99,5,89,41
1,1708,1646,62,4,168,51
1,1683,1444,239,3,24,43
1,1459,1289,170,7,162,49
-1,1823,1678,145,-3,-7,48
-1,1701,1601,100,-14,-710,86
1,1855,1509,346,7,416,69
1,1848,1917,-69,1,38,61
-1,1808,1993,-185,-3,-262,77
-1,1522,1592,-70,0,-197,90
1,1750,1569,181,-1,-65,77
-1,1622,1612,10,-3,-72,70
1,1852,1512,340,4,187,73
1,1904,1862,42,1,22,55
1,1621,1716,-95,0,5,97
-1,1999,2125,-126,1,0,58
1,1459,1551,-92,2,81,49
1,1765,1683,82,0,13,53
1,1955,1676,279,5,218,75
-1,1852,1914,-62,-5,3,48
-1,1617,1727,-110,-1,-274,116
1,1914,1852,62,0,8,63
1,1405,1423,-18,3,388,111
1,1791,1507,284,-6,150,83
1,1842,1923,-81,8,573,95
1,1736,1603,133,0,-53,69
-1,1703,1656,47,0,-51,80
1,1742,1567,175,2,180,79
-1,1756,1503,253,5,31,76
-1,1623,1610,13,4,244,146
1,1680,1687,-7,0,194,115
1,1707,1574,133,1,467,119
1,1909,1856,53,-1,-70,81
1,1784,1489,295,2,409,177
0,1406,1457,-51,0,16,92
1,1523,1738,-215,-1,7,93
1,1327,1066,261,-4,8,47
-1,1510,1410,100,-10,-102,41
1,1811,1408,403,0,32,89
1,1673,1524,149,-1,69,111
-1,1536,1688,-152,0,-174,88
1,1846,1919,-73,5,325,97
-1,1498,1914,-416,-4,-31,50
1,1720,1542,178,-1,-213,89
-1,1798,1988,-190,-5,-220,92
1,1824,1175,649,-1,-4,43
1,1960,1691,269,3,183,77
1,1477,1701,-224,4,34,43
1,1469,1278,191,6,396,79
1,1734,1770,-36,0,31,101
-1,1637,1676,-39,0,-83,104
-1,1060,1331,-271,-7,-768,74
1,1122,1154,-32,-5,-231,57
1,1826,1174,652,1,-51,59
1,1694,1689,5,-3,255,117
1,1550,1280,270,4,30,43
-1,1299,1422,-123,0,-73,65
-1,1464,1490,-26,1,-25,64
1,1481,1284,197,1,16,41
1,1792,1486,306,0,25,59
-1,1518,1679,-161,-3,63,98
1,1827,1075,752,12,948,77
-1,1489,1665,-176,-1,-11,50
1,1726,1746,-20,0,-7,49
1,1469,1571,-102,7,200,40
1,1409,1220,189,2,96,51
-1,1584,1626,-42,-4,-57,40
1,1749,1467,282,4,66,47
-1,1212,1685,-473,-1,-399,80
1,1828,1430,398,7,200,43
-1,1569,1612,-43,0,180,80
1,1417,1551,-134,-1,58,81
-1,1529,1456,73,-3,-132,150
-1,1566,1714,-148,-5,-99,43
1,1555,1482,73,0,168,83
1,1738,1734,4,-1,-42,55
-1,1480,1873,-393,0,37,76
-1,1719,1666,53,-1,-36,66
-1,1429,1575,-146,0,6,72
-1,1655,1896,-241,0,5,60
-1,1342,1573,-231,-1,-335,92
-1,1351,1466,-115,0,-20,78
1,1613,1286,327,1,158,73
-1,1695,1863,-168,-1,-133,112
1,1692,1597,95,0,42,61
-1,1713,1812,-99,-2,-49,68
-1,1552,1600,-48,0,-180,80
1,1669,1405,264,0,95,109
1,1886,1656,230,0,-20,81
1,1788,1591,197,4,131,61
-1,1343,1622,-279,3,133,79
1,1773,1493,280,-1,104,61
1,1593,1486,107,0,25,69
1,1679,1737,-58,-1,47,77
-1,1500,1668,-168,-7,-304,62
1,1901,1651,250,-3,43,89
1,1820,1705,115,-1,-16,55
1,1662,1393,269,0,-5,61
1,1920,2075,-155,5,71,49
-1,1310,1382,-72,-4,-551,94
1,1374,1177,197,-1,-88,73
-1,1275,1186,89,-1,-215,80
1,1578,1337,241,-2,65,109
1,1697,1828,-131,10,251,45
-1,1849,1826,23,-1,-95,88
-1,1508,1708,-200,-1,-237,106
1,1344,1487,-143,7,150,53
1,1700,1503,197,1,28,73
1,1706,1790,-84,-1,0,73
1,1303,1421,-118,0,-55,89
1,1876,1478,398,5,64,43
1,1586,1596,-10,0,150,63
1,1723,1692,31,-8,-129,71
1,1813,1712,101,0,41,69
-1,1731,1904,-173,0,-148,101
1,1555,1278,277,10,156,43
-1,1847,1877,-30,0,-32,70
-1,1561,1493,68,-1,-21,50
1,1724,1469,255,0,302,115
1,1719,1476,243,1,177,107
1,1631,1542,89,-1,473,123
1,1421,1472,-51,0,-23,51
-1,1271,1547,-276,-3,-55,50
1,1534,1477,57,1,165,87
-1,1682,1734,-52,-2,-95,82
-1,1683,1652,31,-4,-411,100
-1,1806,1719,87,-8,-58,42
-1,1476,1878,-402,0,-23,58
-1,1776,1804,-28,-2,-23,48
1,1931,1573,358,0,2,79
1,1720,1524,196,0,-93,65
-1,1258,1753,-495,-1,1,52
-1,1256,1448,-192,-6,-25,42
0,1080,1356,-276,0,19,109
1,1706,1767,-61,-1,6,81
-1,1401,1674,-273,-4,-90,50
-1,1733,1793,-60,4,60,42
0,1744,1672,72,-1,-106,147
1,978,1258,-280,-1,-38,67
-1,1815,1766,49,0,5,96
-1,1802,1724,78,-2,-125,56
-1,1709,1891,-182,0,1,51
1,1411,1426,-15,-1,-39,51
-1,1978,2066,-88,0,-59,104
-1,1601,1745,-144,-2,-551,122
-1,1737,1789,-52,-1,-7,48
-1,1482,1608,-126,0,-16,58
1,1911,1725,186,7,236,59
-1,1487,1774,-287,0,23,74
1,1610,1270,340,-1,-4,57
1,1619,1496,123,3,7,40
-1,1798,1728,70,-1,-17,42
-1,1393,1391,2,-2,-117,56
1,1675,1741,-66,1,421,145
1,1800,1906,-106,2,14,57
-1,1474,1421,53,-6,-245,72
-1,1500,1598,-98,-2,-162,71
-1,1741,1785,-44,4,298,64
-1,1393,1512,-119,-1,-49,76
1,1260,1060,200,14,132,41
-1,1730,1807,-77,0,-137,98
1,1678,1397,281,1,25,46
1,1674,1871,-197,0,79,109
-1,1796,1895,-99,-3,-103,70
1,1566,1673,-107,0,92,135
-1,1534,1500,34,-2,-172,84
-1,1795,1731,64,6,-153,106
1,1719,1671,48,1,95,77
1,1428,1405,23,0,88,51
0,2074,1816,258,0,293,150
1,1559,1320,239,5,141,57
-1,1728,1688,40,0,-16,64
-1,1744,1782,-38,0,208,110
-1,1399,1300,99,-2,-2,78
1,1548,1252,296,2,251,67
1,1324,1134,190,9,729,79
-1,1266,1445,-179,-2,-15,44
0,1703,1447,256,0,128,118
1,1721,1541,180,0,-34,75
-1,1616,1815,-199,-1,-18,68
-1,1791,1734,57,-3,-73,56
1,1575,1754,-179,2,15,47
-1,1313,1566,-253,0,-70,60
-1,1619,1581,38,-9,-211,70
1,1632,1594,38,0,388,111
1,1350,1443,-93,3,585,107
-1,1414,1285,129,-2,-187,102
-1,1747,1779,-32,0,58,62
1,1665,1671,-6,3,35,43
1,1646,1562,84,10,361,60
-1,1692,1700,-8,-1,-110,126
1,1719,1454,265,0,171,101
-1,1711,1755,-44,0,-29,72
1,1902,1776,126,-3,17,73
-1,1572,1307,265,0,-903,124
-1,1714,1615,99,0,-41,64
1,1789,1737,52,2,122,63
1,1772,1879,-107,0,63,83
-1,1554,1655,-101,-1,-79,50
1,1685,1389,296,-2,24,49
-1,1395,1439,-44,3,55,106
-1,1727,1483,244,2,-122,86
1,1821,1837,-16,3,213,103
-1,1562,1376,186,-3,-275,100
-1,1728,1798,-70,1,54,56
-1,1811,1366,445,3,100,90
-1,1316,1434,-118,-4,-483,112
1,1729,1589,140,1,44,51
1,1397,1406,-9,-3,18,83
-1,1402,1456,-54,-4,-163,70
-1,1806,1719,87,-3,-217,70
-1,1240,1183,57,1,-68,53
-1,1543,1671,-128,-7,-251,96
-1,1376,1500,-124,-1,-468,88
-1,1168,1380,-212,-12,-485,62
-1,1519,1523,-4,-2,-198,84
-1,1629,2161,-532,0,19,82
-1,1552,1723,-171,-1,-36,112
0,1399,1391,8,-3,179,119
1,1733,1793,-60,0,160,87
1,1510,1708,-198,0,64,87
-1,1386,1689,-303,0,-28,73
-1,1260,1543,-283,0,-215,70
-1,1736,1553,183,-11,-432,64
-1,1582,1756,-174,-4,-36,44
1,1696,1454,242,0,256,143
1,1781,1745,36,-4,-217,97
1,1805,1725,80,0,95,113
-1,1777,1864,-87,-1,-159,90
1,1677,1243,434,9,136,45
1,2162,1620,542,-4,-27,63
1,1585,1697,-112,0,25,47
-1,1709,1546,163,5,147,54
-1,1689,1833,-144,-1,-517,88
1,1735,1790,-55,-2,-70,41
1,1706,1659,47,7,369,79
-1,2030,1672,358,0,-43,80
1,1678,1515,163,-3,257,135
1,1778,1748,30,0,76,81
-1,1384,1291,93,-1,-81,114
0,1651,1364,287,-12,25,140
-1,1693,1612,81,-3,-295,82
1,1953,1843,110,-9,-72,57
-1,1738,1788,-50,0,204,94
1,1698,1595,103,-2,356,151
1,1643,1606,37,-2,-58,43
1,1778,1901,-123,5,93,57
-1,1660,1690,-30,-4,129,98
-1,1454,1319,135,-2,4,40
1,1720,1654,66,3,225,81
-1,1386,1160,226,-6,-270,65
-1,1394,1765,-371,-4,-118,82
-1,1496,1423,73,-2,-257,94
1,1691,1873,-182,-1,-19,95
-1,1624,1727,-103,1,41,66
1,1649,1593,56,-1,-30,43
1,1736,1681,55,1,95,91
-1,1888,1807,81,-2,-44,58
-1,1408,1703,-295,-1,-90,92
1,1980,1683,297,-1,0,41
1,1474,1225,249,2,120,57
-1,1313,1396,-83,-2,-200,74
-1,1690,1589,101,6,150,82
1,1840,1683,157,-1,336,79
-1,1720,1805,-85,-2,-648,94
1,1546,1729,-183,-1,38,59
1,2076,1983,93,0,-51,93
-1,1505,1685,-180,-1,-66,60
-1,1587,1617,-30,-4,-338,110
1,1813,1712,101,-3,-20,71
1,1675,1602,73,0,31,71
1,1701,1613,88,-3,-59,87
1,1558,1442,116,-1,-44,47
-1,1685,1679,6,0,-37,58
-1,1288,1505,-217,0,-138,72
-1,1245,1679,-434,-1,-213,68
-1,1935,1783,152,-1,-65,74
-1,1471,1393,78,0,-3,74
1,1700,1573,127,1,104,71
1,1779,1781,-2,0,293,135
0,1394,1437,-43,-1,-3,116
-1,1704,1821,-117,-5,-87,54
1,1594,1724,-130,-5,-132,51
-1,1679,1320,359,-2,-56,58
-1,1833,1875,-42,-1,-100,63
1,1856,1705,151,-1,37,61
1,1547,1645,-98,1,196,75
1,1699,1375,324,-1,6,41
-1,1615,1526,89,-4,-165,54
-1,1676,1910,-234,0,-47,66
-1,1649,1716,-67,-5,-223,58
1,1646,1607,39,0,85,79
1,1568,1500,68,-1,139,87
1,1976,1584,392,2,133,67
1,1576,1320,256,1,8,67
-1,1973,1963,10,-3,-128,60
-1,1771,1787,-16,0,-37,82
-1,1706,1786,-80,-1,-4,112
-1,1754,2084,-330,-1,-28,48
-1,2047,1920,127,-3,8,40
-1,1691,1760,-69,-2,-309,82
1,2087,1751,336,0,217,81
-1,1729,1836,-107,-1,-64,88
1,1863,1884,-21,-1,-28,81
1,1362,1394,-32,4,122,71
-1,1598,1691,-93,0,-120,58
-1,1722,1915,-193,-3,-248,82
1,1447,1305,142,5,194,55
1,1772,1620,152,0,5,55
-1,1769,1798,-29,-5,-412,64
-1,1253,1463,-210,0,-108,59
1,1601,1482,119,0,246,79
1,1712,1672,40,0,308,125
1,1586,1541,45,-2,-95,83
-1,1545,1582,-37,0,69,72
0,1339,1232,107,5,521,197
1,1562,1354,208,2,218,86
1,1671,1668,3,3,17,50
1,1513,1428,85,-2,-17,51
1,1807,1760,47,-1,99,51
-1,1578,1280,298,-1,-25,62
-1,1365,1709,-344,-4,-38,46
1,1668,1185,483,0,108,55
1,1551,1333,218,12,292,51
1,1682,1584,98,0,-5,53
1,1316,1286,30,2,342,93
-1,1401,1338,63,4,48,40
0,1580,1508,72,1,7,148
1,1724,1590,134,0,40,63
1,1736,1642,94,4,190,61
-1,1500,1475,25,-6,-153,54
1,1934,1715,219,0,157,77
1,1921,1715,206,8,195,45
1,1843,1983,-140,-4,239,91
1,1721,1561,160,0,39,95
-1,1558,1275,283,1,-673,120
1,1725,1640,85,-2,-57,43
1,1749,1816,-67,5,209,60
1,1525,1479,46,2,1,43
1,1474,1609,-135,-2,-60,53
1,1707,1781,-74,-3,-24,95
0,1690,1747,-57,0,35,103
-1,1596,1530,66,-1,199,84
-1,1662,1722,-60,-1,-342,134
-1,1701,1746,-45,-1,-141,78
1,1373,1178,195,-4,20,71
-1,1391,1543,-152,-7,-161,64
1,1592,1535,57,3,196,59
-1,1375,1599,-224,0,-9,42
1,1370,1351,19,3,229,85
-1,1873,2059,-186,-1,-61,56
1,1419,1526,-107,-5,-135,63
-1,1934,1875,59,0,17,72
-1,1451,1537,-86,-1,-520,104
1,1243,1399,-156,3,174,77
-1,1745,1793,-48,0,-120,112
1,1584,1397,187,1,56,63
1,1567,1298,269,1,2,51
-1,1359,1715,-356,0,-34,56
-1,1698,1500,198,-6,-173,132
-1,1676,1462,214,-10,-526,76
-1,1867,1926,-59,0,140,82
1,1633,1745,-112,0,54,65
-1,1845,1750,95,0,11,46
-1,1720,1768,-48,-3,-88,102
-1,1228,1326,-98,-8,-321,89
-1,1619,1743,-124,2,6,44
1,1548,1518,30,-1,151,87
-1,1435,1395,40,-1,-609,102
0,1485,1312,173,16,248,43
-1,1280,1303,-23,-5,30,142
-1,1344,1601,-257,2,18,64
1,1751,1612,139,0,323,95
1,1571,1424,147,0,446,109
-1,1294,1500,-206,-10,-70,48
-1,1376,1336,40,-4,-79,42
-1,1366,1533,-167,-2,-231,80
-1,1384,1387,-3,-2,-689,86
-1,1732,1653,79,0,5,48
-1,1510,1578,-68,-1,-23,108
-1,1727,2059,-332,-2,-193,92
-1,1508,1562,-54,0,-43,50
1,1703,1605,98,1,47,51
-1,1935,1859,76,-2,-45,54
1,1875,1777,98,1,113,73
-1,1499,1509,-10,0,-76,60
-1,1329,1415,-86,-4,-71,58
-1,1554,1717,-163,-1,-483,154
-1,1469,1742,-273,-5,-184,74
-1,1596,1650,-54,-8,-279,68
-1,1666,1718,-52,0,-346,130
1,1556,1587,-31,1,33,67
1,1448,1057,391,5,241,53
1,1649,1657,-8,0,109,89
-1,1477,1587,-110,6,163,56
-1,1822,1600,222,0,27,88
1,1718,1530,188,0,221,159
-1,1605,1809,-204,0,-107,108
-1,1525,1758,-233,0,-220,88
1,1709,1327,382,0,423,85
1,1434,1803,-369,0,12,45
-1,1774,1975,-201,-1,-136,54
-1,1871,1922,-51,-3,-64,56
0,1348,1341,7,2,9,119
-1,1980,1768,212,0,-35,78
-1,1528,1544,-16,-3,-134,54
-1,1654,1556,98,-9,-390,64
-1,1724,1846,-122,0,-265,140
1,1483,1335,148,1,-22,55
1,1499,1501,-2,1,-85,157
1,1671,1245,426,1,0,59
-1,1478,1348,130,-12,-70,40
-1,1786,1970,-184,-4,-275,84
-1,1539,1624,-85,1,53,42
-1,1196,1372,-176,-18,-197,42
1,1674,1241,433,5,353,65
-1,1795,1610,185,2,67,76
-1,1975,1780,195,1,208,110
1,1626,1759,-133,-4,-160,59
1,1703,1520,183,2,501,75
1,1728,1657,71,-4,30,61
1,1564,1517,47,2,157,65
1,1409,1373,36,7,533,75
1,1692,1767,-75,-1,-53,61
-1,1702,1758,-56,-2,7,44
0,1931,1862,69,1,52,95
-1,1687,1621,66,-2,-173,128
-1,1562,1649,-87,-9,-279,104
-1,1692,1926,-234,-3,-58,48
-1,1568,1642,-74,-9,-248,50
-1,1785,2065,-280,0,-15,58
-1,1624,1694,-70,-9,-381,68
-1,1455,1485,-30,5,94,40
-1,1335,1373,-38,-10,-132,46
-1,1490,1391,99,1,-93,95
-1,1725,1594,131,-6,-45,48
1,1678,1500,178,0,24,55
1,1717,1183,534,-4,173,85
1,2069,1781,288,0,111,91
-1,1648,1737,-89,0,-79,68
-1,1394,1321,73,-5,-266,58
1,1606,1656,-50,4,366,93
-1,1728,1640,88,0,3,67
-1,1712,1827,-115,-1,-173,96
1,1593,1709,-116,0,407,127
0,1453,1489,-36,0,49,111
1,1701,1653,48,0,-17,67
1,1541,1418,123,9,950,115
-1,1560,1581,-21,-7,-160,48
-1,1706,1394,312,-1,-37,86
1,1650,1270,380,17,799,85
1,1569,1632,-63,0,40,105
1,1689,1399,290,6,57,47
1,1692,1535,157,1,31,73
1,1448,1522,-74,0,-20,55
-1,1533,1423,110,7,64,66
-1,1800,1962,-162,0,-8,52
1,1718,1788,-70,0,285,113
1,1578,1507,71,-1,-28,75
-1,1695,1727,-32,1,-1,60
1,1916,1877,39,1,3,43
1,1454,1334,120,3,105,50
-1,1424,1576,-152,-8,-679,90
1,1693,1634,59,2,5,41
-1,1484,1293,191,3,108,170
1,1969,1793,176,1,93,77
-1,1542,1589,-47,-1,-287,132
1,1698,1528,170,2,266,67
1,1678,1384,294,5,37,41
-1,1595,1745,-150,0,-16,60
1,1476,1475,1,-3,9,87
1,1519,1548,-29,0,386,107
1,1609,1599,10,1,10,49
1,1975,1787,188,6,148,47
0,1550,1640,-90,-6,-733,118
-1,1723,1645,78,0,-34,62
-1,1445,1617,-172,-1,-18,68
-1,1674,1984,-310,1,-60,62
1,1704,1853,-149,0,52,89
-1,1745,1777,-32,0,9,78
-1,1781,1618,163,2,26,42
-1,1329,1410,-81,-7,-223,60
-1,1684,1949,-265,-3,-250,88
1,1458,1326,132,-2,21,53
-1,1781,1981,-200,-1,-45,52
-1,1356,1417,-61,0,-14,42
1,1348,1524,-176,-1,-50,77
1,1678,1661,17,1,-29,107
1,1915,1647,268,2,87,61
1,1757,1522,235,6,160,49
-1,1867,1926,-59,0,82,96
-1,1987,1953,34,4,3,60
-1,1765,1847,-82,0,-2,85
-1,1321,1550,-229,0,-1,78
1,1687,1703,-16,2,351,67
1,1677,1345,332,19,299,41
-1,1587,1739,-152,0,-6,40
-1,1517,1765,-248,-4,-298,62
1,1589,1874,-285,0,-2,43
1,1966,1893,73,0,-138,97
1,1541,1581,-40,0,-8,55
-1,1683,1693,-10,2,146,64
1,1533,1500,33,22,898,59
1,1488,1454,34,-10,4,97
-1,1775,1974,-199,0,-453,107
1,1732,1634,98,-5,70,95
1,1883,1975,-92,0,2,99
-1,1533,1844,-311,-10,-739,104
-1,1495,1444,51,0,-11,42
1,1704,1730,-26,0,9,77
1,1704,1595,109,0,2,71
1,1980,1769,211,-2,20,49
-1,1581,1601,-20,0,-8,64
-1,1552,1638,-86,0,-20,46
-1,1665,1341,324,7,360,68
-1,1961,1985,-24,-1,-54,47
-1,1070,1803,-733,-16,-677,64
1,1935,1859,76,0,1,95
1,1786,1893,-107,0,182,71
1,1561,1553,8,0,29,81
-1,1427,1596,-169,0,-9,70
-1,1525,1711,-186,-4,-519,106
1,1919,1808,111,3,67,47
-1,1015,1620,-605,-6,-209,66
1,1209,1303,-94,3,22,47
-1,1340,1545,-205,-7,-393,58
1,1988,1671,317,1,371,101
-1,1963,1764,199,0,-100,84
-1,1694,1785,-91,-3,-71,66
1,1646,1732,-86,-2,-149,63
1,1716,1679,37,-1,116,81
1,1477,1539,-62,6,187,58
-1,1996,1950,46,0,25,150
1,1512,1658,-146,1,35,41
-1,1198,1284,-86,-2,-658,100
1,1670,1587,83,1,44,63
-1,1611,1746,-135,0,-17,50
1,1621,1439,182,0,493,127
1,1712,1613,99,2,-4,47
-1,1588,1641,-53,1,4,74
-1,1946,1983,-37,2,-245,114
-1,1683,1717,-34,0,107,84
0,1578,1834,-256,0,2,49
-1,1580,1754,-174,0,-53,60
1,1633,1665,-32,-2,-31,43
-1,1581,1624,-43,-3,-281,86
0,1804,1842,-38,1,-244,150
-1,1438,1604,-166,-1,-454,88
1,1804,1681,123,-1,36,95
1,1444,1498,-54,-3,-7,45
-1,1495,1555,-60,-5,-186,72
-1,1267,1280,-13,-8,-565,124
-1,1190,1289,-99,4,-3,68
1,1993,1936,57,1,66,47
-1,1668,1728,-60,-1,-119,76
1,1848,1530,318,5,290,65
-1,1166,1884,-718,-4,-218,62
-1,1926,2003,-77,-1,-41,90
-1,1655,1651,4,0,-41,68
-1,1565,1426,139,5,55,54
-1,1532,1763,-231,1,6,46
-1,1925,1806,119,-12,-802,82
-1,1536,1363,173,1,-38,64
1,2012,1917,95,0,23,115
-1,1639,1662,-23,1,225,66
-1,1350,1629,-279,-2,-162,82
1,1798,1587,211,4,108,53
-1,1850,1720,130,0,-5,54
1,1919,1812,107,2,-10,41
-1,1628,1825,-197,0,5,66
-1,1659,1945,-286,0,-325,74
1,1657,1579,78,0,20,41
1,1726,1578,148,-2,72,81
1,1625,1673,-48,9,2053,133
-1,1362,1453,-91,-1,34,62
1,1886,1596,290,-2,-30,77
-1,2248,1885,363,0,-11,62
-1,1614,1673,-59,1,8,40
-1,1567,1666,-99,0,-101,72
-1,1642,1660,-18,-4,-135,68
1,1668,1773,-105,-1,-31,59
1,1836,1778,58,3,172,91
1,1534,1400,134,-9,-285,49
1,1841,1665,176,1,29,57
-1,1729,1957,-228,-5,-74,54
-1,1628,1924,-296,0,-203,110
1,1447,1593,-146,0,17,45
1,1592,1890,-298,1,-26,67
0,1632,1726,-94,0,63,103
-1,1617,1500,117,1,-35,72
-1,1614,1628,-14,-1,-112,126
1,2132,1857,275,0,7,67
-1,1420,1283,137,0,-18,58
-1,2006,1991,15,3,16,62
1,1432,1533,-101,2,96,63
-1,1749,1543,206,2,-79,104
-1,1610,1596,14,-3,67,80
1,1271,1737,-466,-1,40,57
1,1432,1070,362,25,889,57
1,1479,1617,-138,6,161,55
-1,1828,1848,-20,0,17,72
-1,1603,1516,87,3,103,58
-1,1419,1429,-10,-1,-240,78
-1,1852,2137,-285,-5,-73,48
1,1541,1410,131,3,161,113
-1,1493,1634,-141,-3,-72,112
1,1660,1786,-126,6,237,67
-1,1382,1342,40,-10,-240,58
-1,1858,1818,40,-8,-56,124
1,1708,1697,11,-3,-131,57
1,2141,1849,292,-2,93,63
1,1560,1698,-138,0,159,71
1,1530,1589,-59,1,94,65
1,1463,1302,161,1,54,54
-1,1312,1245,67,0,52,68
1,1471,1601,-130,3,703,91
1,1979,2012,-33,0,22,95
1,1997,1461,536,0,52,81
-1,1656,2146,-490,-1,-40,50
-1,1830,1846,-16,-3,-93,64
1,1468,1522,-54,3,58,49
-1,1681,1696,-15,2,38,50
-1,1932,1972,-40,1,41,162
-1,1066,1434,-368,6,-210,106
-1,1620,1557,63,-3,-382,132
1,2001,1994,7,0,14,69
0,1683,1711,-28,-3,-183,62
-1,1856,1819,37,0,-350,126
-1,1433,1553,-120,0,-13,102
1,1861,1723,138,0,11,63
1,1708,1670,38,1,277,116
1,1639,1604,35,0,407,155
-1,1831,1845,-14,0,-155,96
-1,1589,1460,129,1,-395,138
1,1753,1667,86,-1,-2,51
1,1672,1651,21,1,53,59
1,1400,1408,-8,-11,-291,100
1,1586,1422,164,1,52,59
1,1981,2011,-30,0,-11,93
-1,1669,1664,5,-8,-8,40
-1,1855,1821,34,-3,-168,104
-1,1091,1368,-277,-3,-112,56
-1,1510,1484,26,0,85,94
-1,1245,1573,-328,-4,-162,70
-1,1710,1684,26,-4,-125,80
1,1981,1923,58,-5,20,105
-1,1833,1863,-30,0,-188,88
-1,1660,1718,-58,4,69,60
1,1569,1539,30,2,228,75
1,1643,1528,115,7,274,56
-1,1364,1424,-60,-6,-791,116
1,1538,1592,-54,4,296,77
1,1540,1463,77,-2,-255,83
-1,1708,1729,-21,-1,-141,118
1,2002,1224,778,0,-16,66
1,1876,1823,53,-3,42,65
-1,1624,1661,-37,0,-53,92
-1,1440,1733,-293,0,1,46
1,1785,1677,108,-3,111,157
0,1656,1477,179,-1,-43,134
0,1814,1887,-73,0,-69,117
-1,1594,1649,-55,0,0,56
1,1728,1651,77,0,-87,89
1,1638,1682,-44,8,93,45
-1,1486,1576,-90,-1,-161,102
-1,1914,1990,-76,0,150,88
1,2003,1565,438,0,14,59
-1,1884,1816,68,-4,-688,108
0,1499,1498,1,-1,57,128
1,1658,1585,73,1,339,93
1,1579,1657,-78,-3,-321,89
-1,1563,2005,-442,2,-103,108
1,1829,1869,-40,2,78,75
1,1372,1332,40,4,379,69
-1,1498,1454,44,-1,-43,58
-1,1397,1359,38,-4,-54,70
-1,1696,1699,-3,0,-84,88
1,1781,1460,321,1,280,99
-1,1453,1715,-262,1,7,46
-1,1882,1837,45,0,68,72
1,1855,1840,15,2,33,47
1,1670,1653,17,0,59,61
-1,1767,1642,125,2,101,76
-1,1551,1591,-40,1,23,54
1,1584,1561,23,0,118,63
1,1998,1906,92,-5,-10,63
0,1564,1525,39,1,254,83
1,1661,1401,260,4,205,71
1,1849,1867,-18,-1,-87,67
-1,1869,1974,-105,0,-189,108
1,2007,1510,497,3,252,57
1,1594,1549,45,12,508,71
-1,1576,1666,-90,-3,-48,46
-1,1854,1859,-5,-3,-119,104
-1,1453,1566,-113,0,-201,120
-1,1750,1688,62,-5,-72,47
1,2006,1965,41,-1,-46,85
-1,1433,1325,108,6,275,86
-1,1675,1568,107,0,-47,112
1,1862,1842,20,0,46,97
1,1380,1274,106,1,35,49
1,1448,1321,127,1,15,77
0,1444,1601,-157,7,816,109
-1,1641,1680,-39,0,-69,82
-1,1752,1752,0,1,-261,116
1,1858,1842,16,0,-11,75
1,1603,1204,399,0,-55,77
1,1724,1616,108,1,91,63
-1,1830,2085,-255,-2,-43,78
1,1832,1868,-36,4,179,60
1,1577,1444,133,2,254,83
1,1526,1563,-37,0,16,75
-1,1737,1709,28,-2,-185,104
1,1606,1433,173,-14,-601,63
1,2013,1499,514,-1,41,41
1,1857,1843,14,2,98,63
1,1596,1564,32,0,16,61
-1,1652,2010,-358,0,-125,84
-1,1344,1306,38,-10,-382,70
1,1477,1388,89,1,130,89
1,1833,1867,-34,-7,-144,83
-1,1582,1661,-79,0,-132,108
-1,1497,2015,-518,-2,-52,70
1,1825,2132,-307,0,439,111
1,1564,1436,128,-3,-78,54
-1,1855,1845,10,1,19,50
0,1326,1615,-289,0,588,299
-1,1576,1496,80,1,55,52
1,1437,1588,-151,-1,16,53
1,1900,1830,70,0,166,131
1,1724,1488,236,0,134,101
1,2016,1496,520,2,86,59
1,1606,1333,273,0,-113,97
1,1444,1499,-55,0,3,47
-1,1845,1856,-11,-3,-127,62
-1,1866,1835,31,-1,-158,90
-1,1494,2018,-524,-4,-178,72
-1,1508,1695,-187,0,-46,82
-1,1959,1789,170,0,-28,76
1,1460,1325,135,1,138,107
-1,1846,1854,-8,0,-31,114
1,1669,1574,95,0,194,109
1,1566,1453,113,-1,44,67
1,1729,1882,-153,-2,-56,69
-1,1763,1657,106,2,51,60
1,1668,1547,121,1,-20,61
-1,1864,1836,28,0,59,88
-1,1593,1732,-139,-4,17,58
1,2020,1508,512,1,73,67
-1,1354,1617,-263,-4,-62,64
1,1500,1684,-184,-1,15,43
1,1500,1495,5,2,194,105
-1,1792,1716,76,0,-119,96
-1,1445,1576,-131,-5,-362,68
-1,1551,1529,22,1,32,53
1,1847,1853,-6,-5,-1,81
1,1596,1297,299,0,34,69
1,1549,1603,-54,1,202,115
-1,1685,1500,185,-6,-195,62
1,1654,1379,275,3,165,55
-1,1857,1843,14,-3,-207,78
-1,1821,1909,-88,-3,-115,104
-1,1581,1671,-90,-1,-223,86
1,1502,1313,189,3,204,73
-1,1945,1676,269,-4,-19,128
1,1639,1668,-29,-1,205,119
-1,1590,1511,79,1,-43,82
-1,1376,1437,-61,-1,-209,80
-1,1593,1672,-79,-1,-35,58
-1,1854,1847,7,1,-7,70
1,1625,1755,-130,0,-35,67
-1,1500,1413,87,-8,-208,56
1,1999,2024,-25,0,17,61
1,1586,1437,149,-6,-23,51
-1,1489,1500,-11,-2,-50,68
1,1501,1445,56,0,112,85
-1,1857,1843,14,-3,-281,92
-1,1577,1507,70,-9,-590,80
-1,2008,2011,-3,0,-3,44
-1,1398,1526,-128,-1,-288,106
-1,1305,1739,-434,0,-85,74
1,2021,1500,521,-1,82,57
-1,1797,1919,-122,-2,-10,46
1,1854,1847,7,5,37,40
1,1468,1276,192,5,151,49
-1,1568,1608,-40,-4,-175,68
1,2021,1993,28,-1,33,103
-1,1314,1765,-451,5,79,76
1,2012,1835,177,3,69,63
-1,1669,1749,-80,1,10,48
-1,1430,1595,-165,0,20,48
-1,1465,1585,-120,0,-61,72
1,1873,1827,46,0,20,50
1,1925,1680,245,3,392,111
1,1622,1349,273,0,421,87
1,1511,1675,-164,-1,-24,93
1,1534,1390,144,-2,62,59
1,1980,2031,-51,0,73,123
-1,1882,2050,-168,-8,-218,58
1,1547,1591,-44,0,55,75
1,1741,1593,148,-1,133,105
1,1383,1541,-158,-3,-22,75
1,1603,1423,180,3,56,49
-1,1263,1359,-96,1,-5,86
-1,1580,1752,-172,-9,-133,44
-1,1255,1474,-219,0,32,94
0,1739,1573,166,4,117,85
1,1442,1265,177,0,6,59
1,1402,1500,-98,6,160,55
-1,1106,1610,-504,3,-34,72
-1,1414,1534,-120,0,-115,122
-1,1486,1593,-107,-2,-149,102
-1,1399,1455,-56,0,76,44
1,1998,1675,323,0,174,117
-1,1545,1628,-83,-2,-163,78
-1,1595,1578,17,0,33,48
1,1781,1583,198,1,45,51
-1,1742,1677,65,0,-405,126
-1,1390,1500,-110,-3,-240,86
-1,1586,1645,-59,0,-176,68
1,1930,1748,182,1,41,47
1,1550,1311,239,5,128,52
1,1873,2084,-211,0,4,73
0,1459,1500,-41,-3,3,106
-1,1352,1294,58,-10,-265,56
0,1387,1513,-126,1,350,116
1,1659,1706,-47,1,21,48
-1,1345,1627,-282,0,-49,66
-1,1327,1607,-280,-17,-457,48
-1,1528,1613,-85,0,-133,104
-1,1559,1563,-4,0,-6,46
-1,1742,1936,-194,0,-37,78
1,1451,1412,39,1,163,75
-1,1737,1861,-124,-16,-456,48
1,1461,1480,-19,0,113,79
-1,1683,1681,2,-12,-904,100
-1,1462,1428,34,-3,-150,66
-1,1690,1729,-39,-1,-202,92
1,1611,1339,272,-9,29,95
-1,1946,1963,-17,0,-37,86
-1,1485,1355,130,0,-169,88
1,1632,1340,292,2,340,103
1,1624,1411,213,0,388,115
-1,1864,1679,185,0,-83,112
1,2002,1631,371,1,135,83
-1,1508,1391,117,0,-20,102
1,1889,1875,14,0,88,95
1,1454,1672,-218,8,386,65
-1,1736,2165,-429,-8,-139,52
-1,1602,1479,123,-3,-899,132
-1,1401,1601,-200,0,7,106
1,1936,1954,-18,-1,-136,98
-1,1900,1500,400,0,206,100
1,1734,1630,104,-5,28,85
-1,1739,1680,59,-3,-471,122
1,1305,1622,-317,8,473,73
1,1335,1636,-301,1,205,115
-1,1847,1822,25,1,13,94
1,1495,1655,-160,-1,440,125
-1,1565,1552,13,-2,-109,49
1,1582,1588,-6,2,270,87
-1,1554,1464,90,-3,-459,120
1,1969,1887,82,2,156,67
-1,1537,1776,-239,-3,-86,56
-1,1417,1565,-148,-1,-16,48
1,1683,1390,293,0,-2,41
1,1743,1519,224,0,-2,53
-1,1407,1491,-84,-3,-391,120
1,1442,1438,4,-2,-63,41
1,1692,1892,-200,1,-5,57
1,1949,2069,-120,-3,-8,77
1,1538,1621,-83,0,-22,83
1,1646,1512,134,6,240,69
1,1875,1709,166,-2,-14,41
-1,1531,1423,108,1,-263,80
-1,1577,1318,259,1,33,60
0,1572,1410,162,0,5,139
-1,1693,1727,-34,-1,-34,72
1,1320,1373,-53,0,20,65
-1,1553,1419,134,-2,-131,104
-1,1788,1440,348,2,75,40
-1,1505,1654,-149,3,129,70
1,2005,1964,41,0,139,75
-1,1639,1558,81,-4,-111,58
-1,1501,2051,-550,0,-249,126
-1,1418,1454,-36,1,109,88
-1,1721,2069,-348,-2,-91,64
1,1573,1501,72,0,473,79
-1,1415,1567,-152,1,-11,44
1,1521,1551,-30,0,843,127
0,1645,1475,170,9,400,70
1,1479,1408,71,0,-9,117
1,1574,1408,166,4,350,77
-1,1419,1579,-160,2,-62,90
-1,1703,1881,-178,0,-1,60
0,1736,1683,53,0,83,147
1,1491,1582,-91,11,188,41
-1,2016,1604,412,-1,-298,122
1,1954,1697,257,0,14,43
1,1567,1506,61,-2,-180,119
1,1471,1517,-46,5,340,71
0,1574,1608,-34,0,157,137
-1,1791,1917,-126,-10,-133,86
1,2112,2052,60,-1,81,119
1,1498,1326,172,0,145,53
1,1744,1595,149,0,16,67
-1,1473,1738,-265,0,-40,58
-1,1640,1777,-137,-1,-96,86
-1,1429,1424,5,-2,-122,54
1,2093,1718,375,1,57,51
1,1475,1759,-284,0,9,46
-1,1692,1958,-266,1,-27,68
1,1496,1577,-81,1,59,77
-1,1880,2087,-207,0,97,86
1,1560,1510,50,21,803,49
-1,1560,1537,23,6,-23,134
-1,1510,1560,-50,-8,-460,118
-1,1489,1319,170,-1,-218,76
-1,1603,1412,191,-5,-5,40
-1,1270,1652,-382,-5,-69,56
1,1563,1511,52,3,431,135
-1,1685,1734,-49,-39,-661,40
1,1570,1500,70,7,574,83
1,1596,1302,294,17,489,49
-1,1724,1848,-124,1,-6,80
-1,1743,1675,68,-1,-184,90
1,1715,1661,54,1,38,103
-1,1993,1688,305,0,-156,68
-1,1560,1500,60,-8,-234,60
-1,1501,1573,-72,-1,-173,66
0,1215,1468,-253,4,1271,170
1,1633,1742,-109,-1,-51,65
-1,1427,1487,-60,1,64,46
-1,1544,1626,-82,2,-86,78
1,1654,1267,387,3,169,69
1,1500,1100,400,-9,-217,85
1,1472,1293,179,0,25,69
1,1582,1491,91,0,71,73
-1,1528,1574,-46,-4,-616,112
1,1688,1731,-43,1,378,121
-1,1300,1374,-74,-2,-387,72
1,1706,1725,-19,1,59,79
0,1574,1528,46,1,424,87
-1,1970,1963,7,-1,-28,52
1,1530,1573,-43,-6,-5,53
-1,1266,1602,-336,-1,-251,68
1,1533,1651,-118,0,241,99
-1,1573,1530,43,0,-35,82
-1,1539,1491,48,-7,-814,94
1,1528,1406,122,0,509,95
-1,1482,1590,-108,0,-53,82
-1,1542,2028,-486,-18,-251,48
1,1505,1418,87,1,493,137
1,2028,1542,486,6,312,81
-1,1872,1923,-51,0,-549,126
-1,1550,1533,17,-17,-753,70
1,2029,1882,147,3,66,41
-1,1285,1360,-75,0,123,80
-1,1599,1474,125,-7,-651,118
1,1589,1592,-3,-1,38,63
1,1876,2037,-161,0,11,61
1,1719,1700,19,0,35,77
-1,1291,1420,-129,1,9,86
1,2018,1891,127,0,21,53
-1,1957,1651,306,0,-145,113
-1,1891,2018,-127,-3,-214,98
-1,1634,1617,17,0,-42,56
-1,1541,1398,143,-3,-145,112
1,1527,1657,-130,-2,73,109
-1,1490,1583,-93,0,-69,64
1,1657,1633,24,1,114,64
1,1560,1470,90,-4,-221,41
0,1470,1490,-20,2,-43,140
-1,1624,1634,-10,0,-12,80
-1,1592,1481,111,-10,-540,86
1,1690,1729,-39,0,249,147
-1,1409,1404,5,-7,-505,82
1,1600,1412,188,-1,-9,55
-1,1401,1622,-221,-1,-142,86
-1,1874,1794,80,1,-133,96
1,1606,1240,366,6,131,47
-1,1935,1592,343,1,8,132
-1,1562,1597,-35,-1,-96,99
-1,1909,1862,47,-9,-342,68
-1,1490,1346,144,-9,-633,146
-1,1600,1716,-116,-1,-271,98
1,1627,1396,231,2,156,87
-1,1771,1883,-112,-1,-138,102
1,1512,1671,-159,-1,-48,81
-1,1500,1561,-61,0,54,108
1,1718,1702,16,2,200,83
1,1750,1620,130,-10,-22,51
0,1639,1461,178,3,64,128
1,1891,1733,158,-2,15,111
0,1599,1668,-69,0,-5,104
-1,1391,1632,-241,-9,-6,40
-1,1613,1723,-110,0,14,83
1,1593,1469,124,3,280,73
0,1705,1898,-193,1,373,124
1,1559,1568,-9,6,252,45
-1,1465,1610,-145,-2,-291,84
1,2016,1757,259,1,8,53
1,1637,1463,174,-7,119,79
1,1636,1347,289,6,190,64
1,1642,1381,261,5,170,57
-1,1275,1418,-143,-3,-148,78
-1,1893,1727,166,-4,-48,48
1,1794,1704,90,1,359,95
-1,1644,1458,186,-2,-1,54
-1,1785,1877,-92,1,-15,66
-1,1377,1646,-269,-1,-9,40
1,1650,1373,277,0,60,65
0,1474,1571,-97,-5,-254,116
-1,1456,1600,-144,0,-24,118
1,1541,1500,41,6,88,41
-1,1524,1462,62,1,-226,110
-1,1368,1654,-286,2,26,64
-1,1220,1361,-141,-6,-118,48
-1,1616,1534,82,0,-34,82
1,1753,1691,62,-1,-33,55
-1,1268,1427,-159,-4,-174,74
1,1611,1532,79,0,65,67
1,1658,1364,294,1,72,69
-1,1250,1462,-212,6,172,61
-1,1360,1662,-302,-16,-157,43
1,1607,1444,163,1,101,77
-1,1434,1828,-394,-9,-108,46
-1,1645,1731,-86,-1,-709,122
1,1474,1500,-26,-1,28,71
1,1831,1396,435,10,258,47
-1,1301,1576,-275,0,-195,100
1,1398,1316,82,5,235,107
-1,1596,1579,17,0,-210,126
0,1584,1591,-7,0,-69,105
1,1791,1759,32,-1,-5,65
-1,1303,1500,-197,1,78,60
1,1309,1323,-14,7,522,81
-1,1434,1613,-179,1,159,72
1,1802,1640,162,0,121,62
1,1581,1664,-83,-1,26,43
1,1666,1357,309,0,0,65
1,1758,1884,-126,-2,-4,45
1,1584,1420,164,4,155,43
-1,1617,1666,-49,7,0,54
-1,1619,1739,-120,-5,-52,48
1,1871,1803,68,-1,-13,49
1,1591,1556,35,0,653,156
-1,1482,1748,-266,-1,-203,130
1,1778,1879,-101,0,47,67
-1,1654,1786,-132,-5,-143,88
1,1553,1510,43,1,42,57
1,1866,1815,51,0,115,85
-1,1103,1353,-250,-3,-109,54
-1,1885,2019,-134,0,-10,90
-1,1834,1630,204,-4,-131,60
1,1492,1545,-53,0,40,67
1,1640,1525,115,6,364,69
1,1792,1875,-83,0,115,87
-1,1531,1510,21,-13,-20,40
1,1620,1535,85,0,205,91
-1,1312,1344,-32,0,-217,74
1,1467,1343,124,3,116,63
-1,1862,1823,39,-4,-100,78
1,1523,1333,190,-1,21,63
-1,1676,1933,-257,0,-68,86
-1,1850,1851,-1,0,26,120
1,1601,1529,72,0,165,125
1,1637,1358,279,-3,-70,51
1,1249,1154,95,10,360,53
1,1601,1500,101,-1,-21,61
-1,1861,1827,34,0,-8,56
1,1858,1752,106,0,-4,89
-1,1354,1640,-286,5,304,78
-1,1628,1612,16,0,-515,178
1,1519,1492,27,6,879,99
1,1851,1850,1,0,65,69
1,1824,1473,351,6,496,93
1,1609,1561,48,0,30,49
-1,1519,1517,2,-1,-561,126
1,1890,1831,59,1,48,79
1,1715,1039,676,1,27,41
1,1644,1349,295,0,0,67
0,1551,1619,-68,-2,196,104
1,1352,1050,302,8,299,55
-1,1475,1786,-311,2,13,44
-1,1345,1807,-462,-3,-158,62
-1,1564,1499,65,-3,28,42
-1,1831,1890,-59,0,-34,60
0,1616,1479,137,3,85,131
1,1517,1555,-38,-3,-149,65
-1,1656,1473,183,-1,-40,52
1,1610,1584,26,0,86,75
1,1636,1490,146,6,142,45
-1,1493,1654,-161,0,-179,182
-1,1378,1408,-30,1,2,122
-1,1598,1597,1,1,91,86
1,1498,1496,2,-1,-60,101
-1,1530,1554,-24,-4,-143,50
1,1907,1763,144,1,203,63
-1,1232,1433,-201,-1,-223,68
1,1846,1662,184,6,223,55
1,1701,1679,22,1,6,73
1,1716,1772,-56,0,32,67
1,1768,1425,343,0,21,57
1,1517,1316,201,1,18,61
1,1433,1460,-27,1,85,47
-1,1545,1748,-203,1,-235,138
-1,1656,1852,-196,-4,-384,92
1,1761,1626,135,1,88,49
1,1280,1378,-98,0,-32,77
-1,1666,1764,-98,-3,-30,44
1,1728,1764,-36,2,7,89
1,1547,1637,-90,5,894,109
1,1637,1640,-3,-3,-69,103
-1,1664,1651,13,-6,-526,86
1,1695,1577,118,0,154,99
-1,1490,1639,-149,1,35,66
-1,1463,1514,-51,3,72,54
1,1625,1295,330,2,158,61
-1,1624,1493,131,2,304,112
1,1588,1511,77,3,206,75
1,1922,1564,358,-3,35,49
1,1662,1652,10,1,249,69
1,1347,1398,-51,1,4,43
-1,1520,1468,52,-2,-22,48
-1,1483,1643,-160,-6,-399,63
1,1608,1587,21,-2,-2,129
1,1717,1955,-238,0,5,49
1,1500,1350,150,1,735,105
1,1439,1225,214,8,477,65
1,1771,1591,180,1,158,65
1,1930,1743,187,0,46,79
1,1612,1570,42,-1,21,57
1,1436,1298,138,-1,-136,82
-1,1246,1290,-44,-14,-557,104
1,1407,1334,73,4,99,51
-1,1506,1393,113,2,20,88
1,1566,1468,98,-2,-44,51
-1,1762,1628,134,-1,-19,44
-1,1733,1736,-3,-6,-250,60
-1,1619,1500,119,-5,-78,49
-1,1341,1500,-159,3,143,54
-1,1711,1573,138,0,-15,50
-1,1648,1752,-104,-2,-150,62
1,1628,1584,44,-2,-29,89
1,1543,1525,18,-1,-128,75
-1,1859,1423,436,-3,-113,60
-1,1651,1670,-19,0,13,67
1,1608,1328,280,1,60,65
-1,1539,1686,-147,-2,-54,50
-1,1458,1560,-102,-1,-2,46
1,1629,1574,55,1,40,49
-1,1428,1491,-63,-7,-395,77
1,1500,1352,148,9,522,77
-1,1501,1482,19,-3,-103,95
1,1609,1500,109,-3,-85,58
1,1641,1695,-54,0,9,76
1,1324,1416,-92,0,-63,45
-1,1208,1294,-86,2,84,50
-1,1483,1619,-136,-4,-340,108
1,1730,1604,126,-3,-9,47
1,1524,1419,105,3,76,53
1,1509,1509,0,-2,-19,45
1,1641,1638,3,1,457,97
-1,1509,1614,-105,-1,-561,124
1,1500,1324,176,1,86,83
1,1501,1407,94,5,200,72
-1,1730,1650,80,-7,-521,94
0,1533,1635,-102,0,1,126
-1,1435,1457,-22,-3,-31,50
1,1741,1646,95,1,553,107
1,1236,1611,-375,7,195,49
-1,1571,1354,217,-2,-152,110
1,1744,1587,157,-2,-25,55
-1,1382,1643,-261,1,-38,66
1,1509,1692,-183,0,-16,59
1,1500,1309,191,-1,-22,49
1,1724,1831,-107,-1,102,93
1,1259,1335,-76,2,88,54
-1,1454,1925,-471,-4,-167,54
1,1448,1682,-234,2,39,46
1,1680,1627,53,0,37,91
-1,1615,1514,101,-6,-199,62
-1,1445,1228,217,1,-11,60
1,1402,1339,63,1,173,93
1,1651,1651,0,2,154,75
1,1553,1514,39,0,174,63
1,1468,1610,-142,0,-45,75
-1,1500,1564,-64,1,32,58
-1,1750,1671,79,-5,-297,102
-1,1390,1509,-119,-2,-376,78
-1,1660,1487,173,-2,3,139
-1,1523,1657,-134,0,56,106
-1,1417,1339,78,-1,-148,52
1,1601,1244,357,5,216,63
1,1580,1841,-261,0,-57,51
1,1357,1029,328,4,541,101
1,1489,1532,-43,0,-4,51
0,1568,1449,119,1,57,51
1,1614,1012,602,10,503,66
-1,1714,1653,61,1,2,70
1,1340,1303,37,-4,-34,47
1,1634,1457,177,10,465,67
1,1648,1664,-16,0,0,99
-1,1836,1470,366,-6,-664,100
1,1444,1524,-80,0,5,45
1,1640,1393,247,-1,-97,53
1,1737,1664,73,-1,31,53
1,1676,1526,150,-1,-213,107
1,1749,1741,8,-2,15,107
-1,1627,1476,151,0,-10,118
1,1557,1558,-1,-2,23,129
-1,1662,1638,24,2,-327,76
1,1521,1693,-172,-1,-113,69
1,1499,1563,-64,1,56,79
1,1521,1587,-66,-1,98,65
1,1519,1501,18,10,242,53
-1,1656,1746,-90,0,9,62
-1,1510,1458,52,-12,-274,54
-1,1595,1827,-232,0,-20,74
1,1497,1502,-5,5,433,81
1,1497,1097,400,-3,0,42
1,1777,1511,266,0,261,85
-1,1339,1482,-143,-15,-234,44
-1,1779,1705,74,0,-235,130
-1,1717,1892,-175,-3,-276,70
-1,1626,1926,-300,-1,-79,104
1,1156,1321,-165,0,26,65
1,1249,1070,179,7,199,56
-1,1640,1761,-121,2,138,84
-1,1471,1496,-25,0,-26,66
-1,1350,1551,-201,-4,-240,68
1,1662,1560,102,3,-48,103
1,1652,1631,21,1,71,65
1,1399,1269,130,0,-73,89
1,1678,1701,-23,6,111,56
1,1650,1650,0,-1,-33,59
1,1491,1562,-71,2,69,49
1,1464,1453,11,0,13,55
1,1700,1500,200,0,8,41
1,1769,1633,136,1,72,79
-1,1564,1642,-78,-3,-18,70
-1,1537,1530,7,0,-174,86
1,1492,1610,-118,1,41,45
-1,1552,1670,-118,0,153,96
-1,1626,1776,-150,2,73,62
-1,1411,1544,-133,-7,-212,50
1,1401,1519,-118,1,100,91
-1,1489,1332,157,4,207,136
-1,1845,1732,113,-1,3,58
1,1683,1663,20,2,255,95
1,1420,1420,0,6,669,135
1,1595,1507,88,8,179,51
-1,1661,1500,161,-4,-179,68
1,1550,1410,140,2,-16,45
0,1321,1345,-24,-4,-15,84
-1,1508,1620,-112,0,-32,60
1,1782,1619,163,0,9,61
-1,1549,1665,-116,-9,-648,100
1,1760,1644,116,0,46,49
1,1832,1813,19,-1,-527,109
1,1638,1704,-66,1,236,93
-1,1177,1281,-104,-4,-200,72
1,1613,1788,-175,2,474,113
1,1501,1552,-51,9,240,64
-1,1421,1660,-239,0,-62,66
1,1542,1526,16,0,76,61
1,1967,1851,116,-1,-10,51
-1,1696,1500,196,-6,-107,50
-1,1498,1604,-106,-3,-424,118
-1,1678,1550,128,-2,-305,74
1,1385,1347,38,4,67,51
1,1763,1500,263,-1,-48,57
1,1534,1375,159,-1,92,76
1,1651,1576,75,-3,-5,63
-1,1676,1659,17,0,16,64
1,1540,1515,25,0,119,59
1,1842,1908,-66,-3,-250,109
1,1772,1629,143,0,-30,87
1,1500,1442,58,0,149,77
-1,1711,1813,-102,-2,-159,158
1,1781,1316,465,6,92,43
1,1363,1328,35,-4,-152,79
1,1504,1550,-46,0,46,63
1,1690,1462,228,2,442,113
1,1622,1779,-157,0,-21,63
1,1891,1855,36,-4,-77,67
0,1515,1553,-38,-6,-104,128
-1,1557,1653,-96,0,-126,70
1,1931,1490,441,9,248,53
1,1409,1344,65,2,400,131
1,1685,1801,-116,0,-11,59
-1,1362,1541,-179,-4,-701,111
1,1799,1488,311,3,224,72
1,1538,1517,21,-2,-10,67
-1,1593,1404,189,0,-14,41
1,1406,1348,58,1,5,41
0,1290,1556,-266,0,179,134
-1,1671,1561,110,-6,-321,88
1,1652,1239,413,5,90,47
-1,1764,1638,126,2,-8,74
-1,1786,1747,39,0,-41,64
1,1441,1323,118,8,72,48
1,1915,1836,79,1,62,49
1,1693,1670,23,-3,62,53
-1,1775,1974,-199,-3,-528,104
1,1935,1820,115,4,111,53
-1,1660,1652,8,1,69,68
-1,1537,1699,-162,0,-13,52
-1,1778,1811,-33,0,-6,56
1,1612,1490,122,-2,-13,63
1,1395,1374,21,0,-19,43
-1,1652,1749,-97,0,184,76
1,1847,1768,79,3,211,97
1,1636,1537,99,-2,59,55
1,1582,1657,-75,-1,172,115
-1,1531,1568,-37,0,-755,152
-1,1827,1926,-99,-3,-84,60
-1,1757,1644,113,0,-5,58
-1,1409,1642,-233,-1,-179,142
0,1626,1697,-71,0,15,122
-1,1664,1672,-8,-1,-97,58
1,1628,1340,288,1,12,53
-1,1339,1364,-25,-1,-18,52
-1,1812,1944,-132,-1,-73,88
-1,1488,1933,-445,-1,-410,128
1,1898,1313,585,-1,-50,49
1,1649,1661,-12,-3,-202,71
-1,1694,1789,-95,-4,-76,46
-1,1953,1805,148,0,-45,98
-1,1548,1365,183,-1,-7,74
1,1900,1500,400,0,-53,75
-1,1416,1500,-84,0,-39,70
-1,1895,1880,15,4,238,120
1,1483,1620,-137,-2,-23,58
1,1436,1344,92,2,151,121
-1,1617,1404,213,-7,8,40
1,1645,1523,122,5,203,55
-1,1556,1852,-296,-1,-73,50
1,1797,1686,111,-2,-125,94
1,1820,1546,274,0,1,65
-1,1604,1482,122,5,146,54
-1,1863,1548,315,-5,-24,42
-1,1908,1500,408,0,-232,92
-1,1359,1390,-31,-5,-159,50
-1,1433,1510,-77,1,86,80
1,1705,1530,175,0,25,57
1,1660,1650,10,1,58,71
1,1549,1504,45,0,192,69
1,1448,1307,141,2,544,109
-1,1743,2188,-445,-1,-42,70
-1,1794,1645,149,0,-7,56
1,1695,1297,398,2,126,53
1,1872,2180,-308,1,187,67
1,1604,1498,106,8,145,49
-1,1773,1831,-58,2,20,50
-1,1285,1856,-571,-6,-143,62
1,1509,1096,413,1,-14,49
0,1648,1584,64,-3,343,275
-1,1345,1405,-60,-4,-66,52
-1,1924,2190,-266,0,-253,128
-1,1329,1307,22,2,47,44
1,2053,1841,212,0,22,59
-1,1807,1503,304,-1,-56,48
1,1365,1112,253,10,281,51
1,1286,1614,-328,-4,-28,49
0,1486,1570,-84,-1,1,124
-1,1836,2059,-223,0,-383,120
-1,1429,1427,2,1,5,56
-1,1734,1551,183,-10,-74,42
1,1647,1394,253,1,155,67
1,1508,1532,-24,4,150,55
-1,1914,2195,-281,-2,-108,74
-1,1490,1612,-122,0,-6,80
-1,1678,1805,-127,0,-32,70
-1,1843,1588,255,-1,-72,72
-1,1683,1566,117,-2,-32,130
-1,1824,1831,-7,1,-71,110
-1,1850,1763,87,1,-70,52
1,1857,1606,251,-3,5,53
1,1946,1891,55,-1,-22,109
1,1675,1418,257,3,283,73
1,1293,1426,-133,-3,-137,115
1,1500,1703,-203,-1,-27,67
-1,1511,1379,132,0,-26,80
-1,1717,1660,57,0,-61,84
-1,1697,1568,129,0,-146,94
1,1661,1532,129,-6,-145,67
-1,1497,1786,-289,-1,-222,78
-1,1670,1500,170,-1,-39,44
-1,1757,1781,-24,-1,-105,102
-1,1516,1507,9,0,64,92
1,1126,1361,-235,4,230,57
-1,1513,1935,-422,-2,-37,56
-1,1380,1652,-272,-4,-123,57
1,1552,1601,-49,4,48,45
-1,1842,1813,29,0,-218,150
1,1777,1824,-47,-1,-136,89
-1,1286,1404,-118,-9,-212,42
1,1495,1324,171,-2,313,61
-1,1693,1806,-113,1,14,48
-1,1813,1671,142,2,120,102
-1,1475,1627,-152,3,-153,100
1,1710,1589,121,0,157,81
-1,1704,1672,32,0,-145,84
1,1605,1554,51,5,114,49
0,1520,1711,-191,-3,-5,76
-1,1524,1711,-187,-4,-20,50
-1,1339,1714,-375,-2,9,45
-1,1668,1927,-259,-2,-15,44
1,1346,1260,86,0,9,43
-1,1114,1519,-405,-5,-193,58
-1,1293,1456,-163,-1,-65,122
-1,1549,1677,-128,-3,-44,46
1,1933,1874,59,-3,67,73
1,1819,1836,-17,0,108,137
1,1337,1413,-76,0,171,72
-1,1741,1732,9,-4,-110,56
-1,1898,1686,212,0,-88,66
-1,1375,1514,-139,3,3,58
1,1644,1500,144,-9,-185,51
1,1941,1492,449,5,99,51
1,1564,1511,53,1,4,51
1,1634,1469,165,2,264,83
-1,1819,1836,-17,0,-371,90
-1,1744,1730,14,-5,-76,54
1,1650,1514,136,2,74,57
0,1500,1776,-276,1,337,125
-1,1696,1691,5,0,-32,86
1,1506,1657,-151,-3,-83,53
1,1677,1684,-7,0,-8,51
0,1846,1809,37,1,463,189
1,1957,1716,241,-7,-90,49
1,1641,1523,118,-2,204,83
-1,1500,1542,-42,1,50,56
-1,1417,1716,-299,0,-34,86
-1,1416,1493,-77,-2,-578,102
-1,1462,1640,-178,-1,-85,76
-1,1810,1845,-35,0,-335,126
-1,1614,1759,-145,5,84,96
0,1369,1481,-112,2,-45,69
1,1756,1625,131,-1,238,123
-1,1700,1767,-67,0,-181,112
-1,1689,1748,-59,1,34,90
-1,1686,1921,-235,0,5,56
-1,1656,1709,-53,0,9,82
1,1583,1702,-119,-1,10,49
1,1480,1523,-43,2,178,89
-1,1131,1521,-390,-2,-524,132
1,1456,1304,152,-7,-204,63
1,1717,1519,198,-2,-29,53
1,1737,1703,34,0,65,91
-1,1501,1560,-59,-6,-207,60
1,1500,1270,230,-5,-94,81
1,1953,1856,97,-1,77,57
1,1337,1500,-163,-1,56,51
-1,1265,1689,-424,0,-4,42
-1,1843,2065,-222,0,-201,72
1,1655,1719,-64,-2,115,114
-1,1854,1532,322,-4,-112,72
1,1439,1077,362,3,192,55
1,2203,1835,368,0,24,99
-1,1164,1653,-489,-12,-991,88
-1,1755,1979,-224,2,29,58
1,1357,1443,-86,1,7,41
-1,1795,1640,155,-1,-201,91
-1,1836,2174,-338,-2,-389,76
0,1501,1525,-24,-4,-16,92
1,1263,1354,-91,13,292,49
-1,1776,1691,85,-1,0,54
1,1943,1682,261,5,83,45
-1,1392,1639,-247,-6,-593,90
1,1463,1417,46,2,398,99
1,1568,1491,77,-7,-151,51
-1,1916,1984,-68,-4,-6,84
1,1810,1297,513,0,30,61
1,1627,1549,78,-2,-63,63
1,1680,1642,38,0,-54,95
-1,1226,1351,-125,2,99,119
1,1830,1653,177,0,275,75
1,2070,1551,519,4,178,51
-1,1677,1961,-284,-6,5,42
1,1477,1373,104,2,375,93
1,1741,1635,106,0,10,55
-1,1403,1413,-10,-1,-5,112
1,1709,1780,-71,0,97,107
-1,1627,1749,-122,-5,-444,74
-1,1647,1836,-189,1,80,90
1,1468,1587,-119,-1,197,94
-1,1340,1646,-306,0,4,58
-1,1945,1718,227,-1,-26,64
-1,1513,1723,-210,1,23,46
-1,1502,1490,12,-1,-76,68
-1,1636,1847,-211,-2,-571,96
1,1705,1763,-58,1,27,56
1,1398,1524,-126,-4,192,79
1,1756,1620,136,4,172,61
1,1690,1633,57,0,49,67
-1,1251,1383,-132,-2,-36,114
1,1608,1720,-112,-2,-22,51
-1,1604,1395,209,-9,-370,70
-1,1482,1577,-95,3,-125,122
-1,1613,1763,-150,-5,-282,76
-1,1408,1473,-65,5,78,60
1,1200,0,1200,12,262,53
1,1993,1750,243,0,29,61
-1,1517,1852,-335,-11,-72,42
-1,1601,1719,-118,-1,-45,64
-1,1670,1965,-295,0,-6,52
1,1770,1514,256,0,-3,47
1,1630,1675,-45,0,-7,51
1,1488,1524,-36,0,-9,51
-1,1489,1500,-11,1,-44,66
-1,1593,1843,-250,-2,30,53
1,1639,1586,53,0,307,93
-1,2071,2151,-80,0,57,46
0,1520,1500,20,9,200,44
1,1775,1414,361,12,971,89
0,1754,1399,355,-2,167,116
-1,1491,1477,14,-9,-512,90
-1,1567,1624,-57,-2,-32,66
-1,1791,1781,10,-2,-59,94
-1,1371,1085,286,-3,-97,56
-1,1220,1485,-265,-14,-814,70
1,1483,1519,-36,0,115,105
1,1778,1550,228,3,27,45
1,1997,1747,250,-1,-1,83
-1,1585,1473,112,0,-37,52
1,1500,1623,-123,3,183,107
1,1598,1517,81,0,5,59
-1,1720,1500,220,5,124,40
1,1783,1631,152,-1,13,95
-1,1590,1509,81,-8,-106,52
1,1511,1704,-193,-1,-70,73
-1,1736,1906,-170,-2,-26,43
-1,1674,1712,-38,-1,-121,63
-1,1500,1586,-86,-3,141,80
-1,1471,1514,-43,0,-70,88
1,1634,1544,90,-4,-20,49
1,2062,1607,455,1,247,81
-1,1508,1502,6,-3,-381,94
1,1563,1764,-201,-1,-4,41
-1,1790,1641,149,2,73,110
1,1611,1443,168,-3,-82,63
1,1629,1646,-17,-8,-182,59
-1,1588,1700,-112,-5,-89,64
1,1969,1666,303,1,25,49
1,1252,1305,-53,-1,31,77
1,1479,1488,-9,-3,-59,57
1,1778,1655,123,9,386,59
-1,1649,1512,137,-4,-262,78
-1,1489,1571,-82,8,197,50
1,1521,1703,-182,1,69,65
-1,1774,1855,-81,-1,-7,90
1,1744,1593,151,0,410,116
-1,1612,1582,30,0,-486,136
-1,1357,1920,-563,-3,-395,106
1,1718,1228,490,5,375,67
-1,1511,1516,-5,1,-103,112
-1,1580,1375,205,0,-12,86
-1,1732,1741,-9,-2,-362,106
1,1260,1202,58,3,65,82
-1,1462,1419,43,-4,-570,96
1,1589,1766,-177,-2,17,45
-1,1717,1500,217,0,-22,42
-1,1462,1649,-187,-1,-62,92
1,1629,1593,36,5,128,59
-1,1505,1864,-359,-1,13,44
-1,1818,1707,111,-1,68,70
-1,1157,1976,-819,0,-178,72
-1,1659,1599,60,-2,-96,60
-1,1502,1549,-47,1,171,68
1,1579,1480,99,-1,355,101
-1,1922,2002,-80,0,-5,118
1,1550,1585,-35,-2,-18,41
1,1655,1456,199,2,136,73
1,1962,1355,607,0,-4,55
1,1782,1765,17,0,98,75
-1,1647,1475,172,-5,-43,42
1,1708,1580,128,1,12,51
1,1529,1317,212,11,311,51
-1,1686,1665,21,3,6,40
-1,1392,1294,98,-2,-93,72
0,1756,1720,36,1,98,128
-1,1755,1793,-38,-3,-438,98
1,1451,1661,-210,-1,-13,51
1,1647,1786,-139,13,229,41
-1,1622,1595,27,1,18,94
-1,1524,1586,-62,3,80,102
-1,1605,1977,-372,0,11,54
-1,1726,1645,81,-3,-169,96
-1,2010,1904,106,-1,-140,78
-1,1448,1500,-52,-10,-396,92
-1,1769,1662,107,-12,-390,100
-1,1803,1745,58,-3,-151,80
1,1715,1524,191,-2,-122,93
-1,1500,1442,58,-4,-143,42
1,1752,1152,600,3,171,61
-1,1432,1277,155,-5,-181,58
1,1676,1673,3,0,-8,60
-1,1497,1500,-3,-5,-111,64
1,1605,1583,22,2,-3,41
1,1612,1639,-27,-3,-147,69
1,1595,1535,60,-3,-128,73
1,1642,1491,151,-2,380,97
1,1274,1326,-52,3,259,71
-1,1471,1587,-116,2,113,56
1,1758,1790,-32,0,-5,51
1,1333,1567,-234,-1,320,75
1,1312,1449,-137,1,87,69
1,1650,1462,188,2,163,99
-1,1745,1500,245,0,-210,96
1,1657,1515,142,6,426,89
-1,1548,1532,16,-3,-194,64
1,1931,2133,-202,0,32,101
-1,1435,1527,-92,-4,-31,42
1,1338,1198,140,0,61,43
-1,1952,2065,-113,-3,-48,78
-1,1574,1668,-94,4,99,66
-1,1865,1736,129,0,-119,176
1,1388,1368,20,2,258,83
1,1686,1722,-36,1,13,43
1,1839,1956,-117,1,-91,83
-1,1535,1426,109,0,16,42
1,1611,1742,-131,1,69,86
-1,1428,1377,51,-2,87,58
-1,1633,1771,-138,0,-442,124
1,1524,1425,99,3,288,87
-1,1524,1578,-54,-1,174,62
1,1804,1848,-44,0,-46,81
1,1286,1577,-291,2,148,68
1,1442,1521,-79,0,30,65
1,1707,1389,318,0,517,83
-1,1582,1576,6,-11,-294,55
-1,1436,1424,12,-2,-3,44
1,1500,1570,-70,-2,-60,55
1,1738,1789,-51,-3,-20,51
1,1573,1834,-261,0,291,103
1,1656,1624,32,5,233,71
-1,1737,1822,-85,-1,-71,64
0,1776,1752,24,2,-121,118
0,2013,1913,100,0,-1,119
-1,2073,2116,-43,0,-13,88
1,1756,1414,342,-4,0,107
1,1738,1671,67,5,231,77
1,1479,1425,54,7,51,41
1,1532,1559,-27,0,19,97
1,1443,1279,164,-3,-90,52
1,1592,1396,196,0,107,79
1,1948,1973,-25,0,17,47
-1,1447,1451,-4,-12,-59,40
1,1613,1806,-193,-1,-51,111
-1,1941,1868,73,3,132,98
-1,1684,1914,-230,-4,-65,40
-1,1532,1542,-10,-8,11,40
-1,1515,1375,140,0,-466,112
-1,1650,1647,3,-2,-25,49
-1,1328,1560,-232,2,-16,48
1,1597,1344,253,-3,139,71
1,1767,1657,110,2,3,51
-1,1752,1775,-23,-4,-161,80
1,1832,1729,103,5,74,47
1,1572,1504,68,-8,-353,67
1,1390,1304,86,-1,-7,47
1,1306,1169,137,15,731,67
-1,1679,1779,-100,-4,-58,66
-1,1962,1920,42,-1,-99,72
-1,1960,1960,0,0,-412,110
-1,1564,1658,-94,-3,-131,75
1,1353,1428,-75,3,153,83
-1,1430,1518,-88,-4,-309,98
-1,1337,1602,-265,-9,-290,62
-1,1522,1528,-6,-4,-97,48
1,1707,1699,8,0,-3,61
-1,1357,1823,-466,-11,-187,50
1,1733,1491,242,1,303,101
-1,1841,1697,144,-3,70,122
1,1557,1618,-61,-1,32,63
1,1786,1742,44,3,223,89
1,1833,1510,323,0,-1,49
-1,1425,1442,-17,1,62,40
1,2126,2063,63,0,44,77
-1,1330,1606,-276,-5,-372,68
1,1710,1584,126,0,-26,95
1,1848,1485,363,4,183,77
-1,1400,1574,-174,0,-123,82
-1,1721,1752,-31,-3,-69,48
-1,1893,1928,-35,0,-61,72
-1,1475,1588,-113,0,-375,104
-1,1374,1553,-179,-1,-83,98
-1,1638,1666,-28,-4,-76,75
1,1542,1459,83,0,810,125
-1,1926,1681,245,-18,-311,52
1,1839,1507,332,0,-9,41
1,1731,1796,-65,-4,-146,51
0,1935,1950,-15,0,46,148
-1,1506,1295,211,-8,-65,43
1,1949,1976,-27,3,100,61
1,1581,1494,87,0,136,117
-1,1318,1614,-296,-5,-173,66
-1,1747,1646,101,0,30,96
-1,1699,1906,-207,-3,-64,50
1,1580,1393,187,8,221,57
-1,1764,1711,53,-2,-197,112
1,1462,1417,45,6,122,49
1,1649,1775,-126,0,290,191
1,1825,1669,156,1,63,45
-1,1912,1694,218,-9,-10,88
1,1499,1571,-72,9,437,127
1,1783,1745,38,0,-7,41
-1,1627,1680,-53,0,38,80
1,1537,1273,264,0,2,49
1,1845,1552,293,7,214,55
-1,1201,1335,-134,8,144,52
-1,1580,1519,61,-9,-237,50
1,1709,1532,177,1,250,115
-1,1724,1749,-25,10,285,66
-1,1510,1662,-152,0,-58,60
-1,1712,1892,-180,0,-96,74
1,1793,1672,121,0,31,67
1,1519,1326,193,0,182,105
1,1735,1750,-15,2,115,73
-1,1359,1679,-320,-1,-224,96
-1,1329,1499,-170,-1,-16,52
-1,1482,1784,-302,-2,-46,45
1,1899,1496,403,1,35,53
1,1449,1367,82,7,295,63
-1,1961,1869,92,0,60,74
1,1857,1301,556,16,238,45
1,1521,1500,21,3,263,65
-1,1486,1738,-252,-6,-143,70
1,1541,1524,17,-1,-17,63
1,1746,1694,52,11,161,55
-1,1506,1666,-160,0,-187,104
1,1938,1875,63,0,2,43
0,2046,2009,37,3,594,120
1,1494,1901,-407,0,23,53
1,1408,1481,-73,3,236,89
-1,1657,1796,-139,0,-50,82
1,1555,1465,90,3,616,99
1,1436,1467,-31,-3,-89,97
1,1683,1626,57,-2,-32,93
1,1878,1515,363,-3,-8,53
-1,1723,1757,-34,0,-11,44
1,1755,1618,137,-2,-100,93
-1,1574,1718,-144,0,-52,88
0,1461,1349,112,-3,-13,67
-1,1859,1932,-73,1,66,70
1,1555,1638,-83,2,126,67
-1,1512,1881,-369,0,-270,122
-1,1711,1687,24,-1,-62,76
1,1595,1504,91,0,155,101
-1,1641,1646,-5,3,50,74
1,1319,1525,-206,2,445,71
1,1292,1366,-74,0,270,91
-1,1762,1611,151,0,-481,118
-1,1669,1504,165,-2,-38,60
-1,1714,1940,-226,0,137,124
1,1859,1947,-88,0,655,153
1,1513,1444,69,-1,-89,87
-1,1660,1660,0,0,20,82
-1,1738,1618,120,-5,-219,108
-1,1851,1800,51,0,-67,72
1,1843,1708,135,-2,-118,69
1,1666,1148,518,8,231,43
0,1507,1339,168,-2,-265,136
1,1628,1382,246,4,169,71
1,1313,1431,-118,-1,112,69
-1,1800,1627,173,1,243,82
1,1746,1699,47,-2,-192,93
1,1640,1046,594,2,28,45
1,1693,1539,154,2,38,47
1,1454,1522,-68,1,51,49
1,1620,1683,-63,0,-15,99
-1,1709,1693,16,0,28,58
1,1414,1386,28,5,236,61
1,1495,1604,-109,4,107,51
-1,1855,1945,-90,0,-829,134
1,1767,1713,54,1,140,119
1,1529,1106,423,-1,16,45
1,1459,1332,127,9,87,43
-1,1721,1882,-161,-9,-157,50
1,1784,1761,23,0,156,65
1,1756,1645,111,0,102,69
1,1439,1242,197,-2,74,59
-1,1824,1670,154,0,-1,108
1,1771,1482,289,2,71,51
-1,1698,1717,-19,2,30,46
-1,1749,1794,-45,-5,-281,110
1,1811,1743,68,0,71,95
1,1568,1596,-28,-1,-52,57
-1,1637,1764,-127,-1,-31,62
1,1810,1500,310,3,264,103
-1,1630,1556,74,0,105,74
1,1466,1565,-99,-2,-9,65
-1,1520,1658,-138,-1,-55,82
1,1552,1510,42,-1,-53,41
-1,1737,1709,28,-1,-263,84
1,1668,1355,313,2,21,43
1,1725,1557,168,0,-20,77
1,1508,1510,-2,-3,-9,53
1,1804,1738,66,-1,30,51
0,1474,1500,-26,-8,-879,114
-1,1423,1500,-77,0,-110,110
-1,1771,1629,142,0,165,98
-1,1638,1551,87,-1,-16,68
-1,1759,1701,58,0,-9,56
1,1933,1888,45,-3,-2,53
-1,1275,1310,-35,-3,46,84
1,1466,1673,-207,-1,34,113
1,1524,1356,168,0,831,123
0,1664,1882,-218,0,-20,106
1,1721,1715,6,0,7,49
-1,1402,1589,-187,0,-212,88
-1,1812,1634,178,0,-34,64
1,1645,1756,-111,0,-90,65
1,1813,1953,-140,0,-8,51
1,1887,1804,83,-1,115,95
1,1408,1516,-108,4,173,87
0,1632,1801,-169,0,-61,121
-1,1500,1517,-17,-1,6,46
1,1938,1828,110,-1,11,81
1,1788,1612,176,0,17,61
1,1576,1414,162,6,93,45
1,1730,1209,521,6,169,51
0,1741,1660,81,0,-36,116
1,1879,1943,-64,0,-52,99
-1,1521,1487,34,-2,-40,62
-1,1210,1728,-518,-4,-92,54
1,1632,1292,340,3,158,79
-1,1579,1569,10,0,-257,86
1,1500,1438,62,-1,192,91
-1,1820,1946,-126,2,-50,84
-1,1207,1731,-524,0,-10,52
1,1805,1533,272,0,32,79
1,1735,1709,26,-1,-11,61
1,1500,1794,-294,2,64,61
-1,1742,1671,71,-4,-236,85
1,1663,1738,-75,0,15,133
-1,1399,1477,-78,-12,-60,42
1,1350,1549,-199,0,-42,81
1,1552,1594,-42,11,524,61
-1,1715,1794,-79,-2,-455,148
-1,1447,1542,-95,-7,-200,60
1,1467,1473,-6,-1,98,83
1,1813,1953,-140,-1,-57,69
1,1329,1243,86,4,101,41
1,1606,1489,117,0,36,79
-1,1714,2066,-352,-2,-69,54
1,1889,1802,87,1,62,65
1,1725,1677,48,0,41,79
-1,1728,1644,84,0,-88,78
1,1688,1699,-11,5,239,71
1,1733,1822,-89,0,4,99
1,1938,1828,110,-1,22,73
1,1652,1616,36,9,236,63
1,1607,1643,-36,0,4,63
-1,1511,1350,161,-4,-194,90
-1,1585,1796,-211,3,46,90
1,1491,1366,125,7,679,110
1,1752,1896,-144,-1,-14,77
0,1796,1637,159,-4,63,135
-1,1562,1824,-262,-2,-95,52
1,1657,1536,121,3,71,81
1,1930,1892,38,5,241,61
-1,1568,1650,-82,-1,-6,40
-1,1561,1435,126,1,-148,142
-1,1827,1939,-112,0,27,66
1,1661,1529,132,-1,28,63
1,2069,1711,358,-1,2,55
-1,1688,1832,-144,0,10,58
-1,1810,1768,42,-1,-127,104
1,1583,1533,50,0,87,111
-1,1704,1777,-73,1,13,58
-1,1872,1670,202,-4,-346,85
1,1617,1804,-187,-3,-143,77
-1,1820,1840,-20,-3,-52,46
-1,1382,1635,-253,0,-128,140
1,1303,1677,-374,8,286,52
1,1839,1681,158,0,-5,55
1,1687,1523,164,3,67,46
1,1731,1563,168,0,70,97
1,1938,1667,271,0,125,79
-1,1457,1958,-501,0,-21,70
1,1656,1484,172,1,112,61
-1,1809,1850,-41,0,63,84
1,1675,1846,-171,1,118,85
-1,1487,1665,-178,1,-162,120
1,1882,1940,-58,1,56,67
-1,1337,1408,-71,-4,-46,56
1,1619,1515,104,0,20,57
1,1736,1212,524,4,96,46
1,1796,1916,-120,0,2,71
1,1805,1748,57,-1,-89,85
-1,1580,1801,-221,-2,-75,80
-1,1641,1403,238,-24,-397,42
1,1414,1509,-95,-4,196,77
1,1526,1679,-153,-2,-4,67
-1,1622,1782,-160,5,98,146
1,1800,1860,-60,-3,-13,55
1,1786,1695,91,0,-69,67
-1,1658,1714,-56,0,-21,80
-1,1860,1952,-92,0,-57,118
1,1403,1353,50,0,190,111
-1,1353,1746,-393,-6,-332,108
1,1641,1509,132,0,71,64
1,1586,1469,117,0,-17,77
1,1847,1812,35,0,-16,53
1,1927,1895,32,1,121,91
1,1633,1522,111,-1,-23,57
-1,1707,1778,-71,0,-1,50
-1,1495,1148,347,0,15,42
-1,1357,1320,37,-4,-27,50
-1,1448,1425,23,0,0,84
-1,1627,1462,165,1,-19,48
-1,2011,1670,341,1,0,50
1,1649,1812,-163,1,42,65
1,1531,1179,352,0,47,55
1,1695,1445,250,-1,6,57
1,1737,1432,305,8,572,71
-1,1617,1987,-370,0,66,76
1,1853,1786,67,0,4,67
1,1594,1542,52,2,165,81
-1,1477,1662,-185,2,25,46
-1,1456,1339,117,0,30,58
-1,1321,1664,-343,-11,-522,68
-1,1514,1725,-211,5,127,48
1,1857,1802,55,0,9,47
-1,1327,1391,-64,-2,-465,94
1,1687,1583,104,-1,11,55
1,1786,1753,33,0,18,53
1,1560,1428,132,11,305,57
-1,1580,1708,-128,0,-46,78
1,1470,1529,-59,5,-5,46
1,1739,1560,179,3,197,73
0,1442,1430,12,2,31,134
-1,1258,1634,-376,0,61,78
1,2092,1943,149,-1,5,131
1,1690,1733,-43,-2,-29,65
-1,1793,1991,-198,0,46,76
1,1611,1414,197,-1,47,61
-1,1500,1421,79,2,44,54
-1,1321,1306,15,2,-310,124
-1,1598,1753,-155,-1,-27,94
1,1861,1885,-24,-1,49,121
1,1731,1509,222,0,3,51
-1,1408,1640,-232,-6,-40,44
-1,1378,1661,-283,-2,-163,66
1,1703,1484,219,-3,-16,43
1,1665,1990,-325,0,2,56
-1,1742,1430,312,-2,-98,72
-1,1205,1652,-447,-3,-106,68
1,1676,1573,103,3,119,59
-1,1262,1551,-289,0,-92,102
-1,1767,1806,-39,-1,-27,68
-1,1701,1906,-205,-5,-35,50
-1,1666,1648,18,-2,-61,46
1,1500,1647,-147,0,136,87
1,1700,1653,47,9,396,73
1,1797,1471,326,3,176,63
-1,1604,1557,47,-1,18,70
1,1504,1736,-232,3,384,81
-1,1438,1575,-137,-1,-233,125
1,1540,1684,-144,0,172,83
-1,1681,1718,-37,-1,-22,58
1,1486,1500,-14,-3,-60,61
1,1488,1417,71,2,43,79
-1,1206,1998,-792,-2,-109,62
1,1328,1653,-325,4,85,123
1,1873,1959,-86,7,217,57
1,1802,1679,123,10,240,52
1,1700,1937,-237,0,-79,89
-1,1327,1645,-318,0,9,80
-1,1500,1217,283,-2,-710,102
-1,1438,1435,3,-4,-82,50
-1,1575,1721,-146,-3,-123,94
1,1788,2100,-312,2,483,97
1,1751,1505,246,-5,22,95
1,1258,1198,60,-6,59,79
1,1334,1318,16,6,253,55
0,1712,1545,167,0,-588,157
1,1534,1020,514,0,757,85
-1,1555,1726,-171,0,216,88
-1,1554,1745,-191,0,-98,114
1,1760,1881,-121,0,-10,101
1,1658,1528,130,2,96,65
1,1877,1953,-76,1,197,71
-1,1374,1359,15,-1,-201,120
-1,1817,1800,17,0,-68,102
-1,2080,1807,273,-1,-72,54
-1,1709,1685,24,-1,-687,134
-1,1230,1211,19,-11,-561,118
1,1520,1663,-143,-2,-34,41
1,1531,1769,-238,2,97,69
1,1660,1679,-19,3,83,47
1,1336,1421,-85,1,-8,49
1,1793,1825,-32,0,7,67
-1,1342,1647,-305,-6,-419,70
1,1920,1833,87,1,70,163
1,1426,1268,158,0,182,77
-1,1813,1806,7,-4,-63,74
1,1890,1935,-45,-2,-141,85
-1,1397,1552,-155,-1,-203,80
-1,1185,1732,-547,-1,-211,70
-1,1497,1433,64,-1,127,108
1,1599,1355,244,0,34,55
1,1697,1697,0,12,130,41
1,1707,1568,139,1,129,105
0,1432,1200,232,-3,28,164
1,1481,1367,114,0,-16,65
-1,1566,1429,137,0,2,62
-1,1746,1441,305,-3,-30,68
-1,1685,1708,-23,-9,-103,49
1,1422,1474,-52,5,491,73
-1,1354,1998,-644,-4,-101,50
-1,1775,1758,17,-9,-1119,114
-1,1307,1570,-263,0,17,72
1,1703,1727,-24,0,-10,61
1,1718,1674,44,0,249,77
-1,1448,1648,-200,-7,-373,74
1,1751,1549,202,2,78,77
-1,1353,1999,-646,-1,-40,50
-1,1184,1433,-249,-5,-80,52
1,1789,1615,174,9,160,41
1,1813,1509,304,0,4,47
1,1805,1468,337,-1,36,53
1,1538,1330,208,1,349,105
-1,1902,1919,-17,0,-145,80
-1,1925,2133,-208,-1,-138,66
1,1722,1500,222,0,47,51
1,2000,1802,198,0,52,79
1,1356,1435,-79,3,388,89
-1,1316,1426,-110,-6,-32,46
1,1551,1482,69,-2,-9,89
1,1737,1595,142,0,-12,53
1,1666,1550,116,0,6,51
-1,1664,1796,-132,-2,-123,60
1,1756,1500,256,4,187,51
1,1351,1250,101,3,-79,81
1,1817,1505,312,7,144,53
-1,1604,1288,316,-5,-156,80
1,1769,1763,6,1,231,93
-1,1892,1933,-41,-1,-81,92
-1,1356,1220,136,-3,-32,64
-1,1334,1479,-145,0,-357,148
1,1465,1336,129,2,116,65
1,1808,1178,630,6,375,59
-1,1728,1539,189,0,3,44
1,1936,1949,-13,0,27,57
1,1656,1492,164,0,-12,71
1,1746,1336,410,1,158,119
-1,1500,1486,14,4,73,66
1,1325,1481,-156,-1,-24,59
-1,1561,1479,82,0,45,50
-1,1377,1478,-101,-1,-25,45
-1,1407,1434,-27,-5,-93,62
1,1447,1544,-97,10,582,75
1,1677,1508,169,5,119,47
-1,1556,1707,-151,-6,-175,56
1,1641,1780,-139,0,-5,69
-1,2138,1744,394,0,-15,114
-1,1479,1574,-95,0,-156,104
-1,1656,1657,-1,-1,-174,126
-1,1308,1491,-183,-7,-488,78
0,1756,1980,-224,0,52,143
-1,1549,1821,-272,0,-61,107
0,1753,1780,-27,1,5,99
1,1415,1502,-87,3,190,83
1,1316,1357,-41,0,473,89
1,1249,1140,109,7,355,55
1,1316,1381,-65,5,285,71
-1,1706,1457,249,0,-87,118
-1,1483,1612,-129,11,364,68
-1,1177,1628,-451,-7,-463,138
1,1529,1461,68,1,-8,45
-1,1552,1818,-266,-2,-154,76
1,1341,1245,96,0,10,59
-1,1936,1947,-11,4,56,44
1,1657,1737,-80,-1,-61,69
-1,1545,1808,-263,-3,-449,138
-1,1606,1461,145,-6,-94,42
1,1339,1103,236,1,120,57
1,1795,1683,112,-2,-55,107
1,1754,1779,-25,-1,-67,69
1,1526,1515,11,8,693,93
1,1969,1763,206,5,102,53
-1,1765,1958,-193,-1,-118,78
-1,1547,1462,85,-1,-391,128
-1,1344,1884,-540,-1,-21,46
1,1200,0,1200,-4,-262,87
1,1825,1540,285,1,239,96
-1,1452,1716,-264,-5,-173,50
1,1694,1500,194,-1,-139,41
-1,1663,1728,-65,-6,-275,64
-1,1485,1536,-51,0,-6,48
-1,1329,1500,-171,-8,-148,48
1,1334,1538,-204,-1,-7,83
-1,1488,1757,-269,0,-273,158
1,1370,1083,287,-2,-25,45
1,1301,1357,-56,-3,52,99
1,1721,1448,273,-1,298,101
-1,1523,1830,-307,-1,-10,64
-1,1546,1532,14,1,-5,54
-1,1002,1507,-505,-25,-681,49
1,1582,1310,272,6,419,67
-1,1325,1434,-109,0,-258,96
-1,1837,1963,-126,-9,-203,114
-1,1365,1471,-106,-7,-823,74
1,1545,1534,11,5,214,63
1,1654,1519,135,-2,24,53
1,1279,1140,139,3,430,79
-1,1415,1748,-333,0,-193,87
1,1607,1324,283,0,29,51
1,1488,1636,-148,-1,542,113
1,1523,1557,-34,0,-57,65
1,1368,1445,-77,6,396,77
1,1767,1809,-42,0,17,59
-1,1340,1520,-180,0,-66,66
0,1679,1565,114,-1,1,85
1,1486,1630,-144,6,230,57
-1,1500,1813,-313,0,17,58
1,1513,1548,-35,-6,35,53
-1,1472,1570,-98,3,-20,68
1,1726,1443,283,1,155,107
1,1479,1320,159,9,263,57
-1,1700,1660,40,0,-7,50
1,1730,1518,212,-4,-43,71
-1,1299,1210,89,-13,-54,47
1,1620,1474,146,0,50,61
-1,1869,1870,-1,-3,-7,78
-1,1725,1927,-202,2,-279,84
-1,1769,1942,-173,5,81,46
-1,1472,1496,-24,3,323,140
1,1426,1363,63,1,126,65
1,1949,1762,187,5,228,61
-1,1273,1358,-85,-15,-381,72
1,1417,1485,-68,2,567,125
-1,1933,1720,213,0,-48,72
1,1737,1738,-1,-1,-69,79
-1,1418,1294,124,-2,-167,60
-1,2094,1821,273,0,-23,70
-1,1756,1955,-199,0,-3,70
1,1655,1500,155,1,18,53
1,1718,1696,22,-1,-62,137
-1,1915,1956,-41,2,38,52
-1,1943,1917,26,-1,-3,54
-1,1465,1391,74,1,5,68
1,1727,1726,1,1,84,53
-1,1363,1246,117,-2,-235,64
-1,1523,1269,254,3,118,68
-1,1737,1905,-168,1,-13,84
-1,1751,1676,75,-1,-358,108
1,1960,1751,209,0,76,53
1,1342,1500,-158,18,908,71
1,1666,1723,-57,0,-776,101
-1,1745,1966,-221,0,15,80
1,1731,1851,-120,-4,-76,99
-1,1512,1621,-109,-3,-15,74
1,1911,1967,-56,0,-103,81
-1,1685,1786,-101,0,-57,54
1,1939,1930,9,0,10,55
-1,1710,1706,4,-3,-87,103
1,1353,1271,82,1,-26,86
1,1449,1643,-194,0,123,67
-1,1971,1740,231,-1,43,44
-1,1837,1924,-87,0,-1,102
-1,1264,1405,-141,-3,-247,92
-1,1758,1953,-195,-10,-605,84
1,1699,1737,-38,1,248,81
-1,1806,1536,270,1,20,68
-1,1735,1640,95,-10,-311,132
-1,1599,1714,-115,1,-38,90
-1,1461,1582,-121,-5,-151,54
-1,1260,1429,-169,-2,-64,60
-1,1918,1958,-40,0,23,72
1,1829,1933,-104,0,42,87
1,1500,1521,-21,-2,-33,61
-1,1881,1858,23,-1,-333,130
1,1959,1753,206,0,152,69
1,1903,1677,226,1,28,99
0,1840,2071,-231,1,65,94
-1,1705,1711,-6,-1,-126,80
-1,1794,1573,221,0,-7,48
1,1472,1430,42,-2,-162,81
0,1918,1842,76,1,582,136
-1,1350,1743,-393,-5,-96,44
-1,1946,1765,181,2,225,90
1,1722,1679,43,-3,-139,53
1,1765,1946,-181,-2,-97,65
-1,1916,1845,71,0,38,98
1,1625,1625,0,0,74,73
1,1776,1869,-93,0,28,63
1,1928,1782,146,1,386,77
-1,1400,1746,-346,-5,-75,50
-1,1921,1953,-32,0,24,82
1,1903,1915,-12,2,221,131
1,1775,1936,-161,-2,112,65
-1,1513,1686,-173,-2,-62,58
1,2063,1847,216,3,108,63
-1,1672,1671,1,-1,-83,72
1,1500,1481,19,-1,-6,51
0,1857,1959,-102,-9,-601,93
-1,1919,1792,127,0,-40,90
-1,1257,1267,-10,-2,28,101
-1,1905,1914,-9,0,-143,76
-1,1613,1637,-24,2,54,48
-1,1348,1543,-195,-2,-132,59
1,1715,1908,-193,0,108,133
-1,1808,1903,-95,-11,-315,60
1,1529,1563,-34,1,36,56
1,1969,1911,58,-1,-41,47
-1,1853,1964,-111,-2,-70,68
1,1925,1732,193,10,160,53
-1,1501,1295,206,-1,-30,48
1,1677,1749,-72,0,-37,53
1,1912,1799,113,5,128,69
1,1585,1763,-178,2,41,55
1,1972,1845,127,3,537,113
1,1615,1726,-111,0,-46,73
1,1590,1452,138,0,324,77
1,1791,1920,-129,5,708,123
-1,1598,1656,-58,-3,-436,120
0,1755,1508,247,0,45,123
1,1469,1434,35,3,113,55
-1,1838,1980,-142,-1,-54,56
1,1852,1506,346,-1,509,109
-1,1901,1984,-83,1,64,96
1,1841,2069,-228,-3,2,85
-1,1670,1661,9,1,34,84
1,1517,1352,165,5,243,63
1,1676,1588,88,0,30,47
-1,1987,1832,155,2,188,90
-1,1904,1807,97,-11,-528,100
-1,1580,1694,-114,-1,-24,48
1,1902,1856,46,0,48,63
-1,1821,1889,-68,-13,-470,76
-1,1847,1971,-124,-1,-498,90
1,1595,1709,-114,0,14,51
-1,1681,1609,72,4,30,56
1,1899,1812,87,1,403,129
1,1978,1840,138,0,215,83
1,1383,1351,32,2,-2,47
1,1342,1216,126,1,136,91
1,1622,1657,-35,1,89,49
1,1997,1892,105,1,-27,43
1,1489,1551,-62,2,327,121
1,1636,1635,1,10,216,45
-1,1833,1986,-153,-11,-325,82
-1,1803,1907,-104,-2,-11,72
1,1624,1654,-30,4,104,47
-1,1658,1434,224,4,87,88
-1,1345,1618,-273,-3,-189,58
1,1423,1478,-55,1,169,93
1,1635,1636,-1,-6,105,121
-1,1992,1827,165,2,315,98
1,1403,1603,-200,4,22,43
1,1883,2008,-125,0,15,59
1,1916,1795,121,-2,-60,57
1,1852,1592,260,0,2,59
-1,1624,1652,-28,-1,-28,42
-1,1842,1976,-134,-5,-155,55
1,1513,1693,-180,0,35,97
1,2048,1860,188,0,23,53
-1,1787,1923,-136,-4,-146,64
-1,1328,1410,-82,1,2,44
-1,1367,1666,-299,-7,-198,50
1,1379,1228,151,1,2,69
1,1835,1983,-148,-1,-91,89
-1,1605,1682,-77,-6,-267,62
1,1930,1780,150,7,228,67
1,1802,1731,71,0,43,79
-1,1682,1605,77,0,-19,70
1,1899,1746,153,0,20,60
-1,1795,1892,-97,0,-26,62
-1,1588,1858,-270,0,-86,86
1,1850,1726,124,0,-105,79
-1,1774,1937,-163,-3,-228,96
1,1739,1912,-173,-1,-238,113
-1,1455,1528,-73,-1,-14,40
1,1675,1631,44,0,14,49
-1,1413,1584,-171,-2,-53,44
1,1719,1857,-138,1,238,79
1,1770,1852,-82,-1,-4,47
-1,1503,1855,-352,0,-108,94
1,1600,1668,-68,4,127,53
-1,1559,1418,141,-2,-17,98
1,1671,1635,36,-2,-39,51
-1,1510,1711,-201,-5,-471,130
1,1882,1755,127,2,43,49
-1,1625,1684,-59,1,23,54
1,1842,1734,108,4,42,51
1,1944,1767,177,3,71,41
-1,1854,2055,-201,0,-41,112
1,1537,1445,92,-3,-146,81
1,1569,1527,42,1,7,89
1,1761,1950,-189,0,-5,47
-1,1930,1895,35,-6,-372,72
1,1696,1616,80,1,32,71
-1,1726,1850,-124,0,4,48
1,1779,1799,-20,-1,18,61
-1,1717,1748,-31,-1,-16,54
1,1933,1778,155,-5,-42,113
1,1758,1706,52,-3,182,69
-1,1916,1918,-2,1,-16,56
1,1857,1719,138,-2,-133,77
1,1426,1440,-14,9,539,69
-1,1697,1768,-71,0,-351,72
-1,1771,1940,-169,-2,-279,132
1,1707,1667,40,6,135,61
-1,1929,1898,31,0,-160,84
1,1719,1657,62,-1,-37,45
-1,1503,1595,-92,-5,-187,102
1,1777,1688,89,0,127,79
-1,1192,1711,-519,-1,-408,110
1,1926,1912,14,0,-41,103
-1,1574,1701,-127,0,5,64
1,1731,1917,-186,3,271,81
-1,1260,1734,-474,-1,-264,74
-1,1594,1545,49,0,5,52
1,1785,1680,105,-2,-16,41
1,1946,1648,298,0,-57,81
-1,1385,1482,-97,-3,-113,74
1,1901,1672,229,0,449,99
1,1811,1786,25,3,201,59
-1,1344,1309,35,-5,-350,70
-1,1444,1792,-348,-1,-215,74
-1,1444,1414,30,1,49,58
0,1751,1645,106,-4,-1149,207
-1,2062,1848,214,1,-77,146
-1,1793,1949,-156,-5,-230,122
0,1470,1581,-111,1,-259,87
-1,1667,1906,-239,0,2,44
-1,1708,1566,142,0,-385,132
-1,1901,1937,-36,0,-9,52
-1,1911,1662,249,0,48,52
-1,1680,1893,-213,-11,-569,118
1,1370,1412,-42,-2,129,157
-1,1640,1756,-116,-5,-84,42
-1,1693,1880,-187,5,151,60
-1,1448,1653,-205,-2,-64,62
1,1946,1890,56,0,15,89
1,1796,1558,238,3,-85,51
1,1886,1765,121,-3,-468,99
1,1701,1533,168,-2,116,111
1,1632,1765,-133,0,1,53
-1,1574,1476,98,-2,-40,54
-1,1541,1259,282,0,-12,80
1,1757,1894,-137,2,262,81
-1,1691,1583,108,1,57,62
-1,1879,1774,105,0,-66,70
-1,1377,1731,-354,0,-203,126
-1,1881,1956,-75,-2,80,98
-1,1764,1850,-86,1,-50,94
-1,1617,1421,196,0,-103,73
1,1418,1500,-82,-3,89,97
-1,1866,2041,-175,-1,40,92
-1,1790,1864,-74,0,-133,116
1,1424,1318,106,0,-8,41
1,1858,1756,102,13,265,45
1,1599,1676,-77,-2,-54,59
-1,1518,1801,-283,0,-67,115
1,1873,1780,93,2,247,89
-1,1748,1866,-118,-1,-68,60
-1,1677,1443,234,-10,-87,40
1,1466,1548,-82,0,4,69
1,1873,1740,133,2,333,115
-1,1964,1872,92,0,-27,110
1,1889,1763,126,8,321,71
1,1540,1478,62,1,248,89
-1,1733,1880,-147,-1,-130,92
-1,1526,1708,-182,0,-83,98
-1,1763,1889,-126,-3,-304,70
1,1459,1605,-146,3,133,63
1,1886,1726,160,11,379,53
-1,1614,1648,-34,0,-112,94
0,1896,1892,4,0,517,115
1,1279,1385,-106,-1,14,69
1,1886,1951,-65,-1,216,117
-1,1764,1507,257,-13,-265,64
1,1917,1720,197,0,0,47
1,1764,1507,257,-4,-6,97
-1,2048,1860,188,0,3,96
-1,1714,1926,-212,-2,-55,50
1,1575,1736,-161,-3,293,75
1,1783,1775,8,1,67,53
1,1892,1896,-4,0,386,139
1,1780,1709,71,0,10,51
-1,1526,1744,-218,0,-38,54
1,1658,1603,55,0,49,89
1,1885,1903,-18,-1,13,54
-1,1700,1789,-89,-5,-376,80
-1,1750,1521,229,1,-137,56
1,1938,1899,39,0,-7,45
-1,1676,1736,-60,-2,-238,70
-1,1548,1474,74,-5,-137,59
-1,1731,1539,192,0,-201,82
1,1896,1892,4,-1,179,59
0,1535,1323,212,0,-133,182
1,1764,1793,-29,0,68,115
1,1557,1712,-155,1,412,87
1,1889,1648,241,3,18,43
1,1882,1855,27,-4,-162,101
-1,1352,1516,-164,-9,-409,64
-1,1695,1573,122,-11,-48,40
-1,1539,1668,-129,-5,-162,58
-1,1487,1503,-16,-3,-81,58
1,1589,1679,-90,1,81,61
-1,1907,1783,124,-4,-251,74
1,1492,1500,-8,5,409,105
1,1879,1857,22,0,228,125
1,1664,1603,61,0,129,81
-1,1370,1591,-221,-1,-11,51
-1,1532,1550,-18,1,-696,92
1,1295,1312,-17,5,64,50
-1,1480,1615,-135,-6,-52,41
-1,1839,1893,-54,5,626,98
-1,1846,1889,-43,0,-1107,220
-1,1110,1675,-565,-1,-27,44
1,1569,1644,-75,0,-34,75
-1,1894,1593,301,0,21,84
-1,1830,1902,-72,1,44,82
-1,1898,1836,62,0,55,80
1,1560,1522,38,4,114,63
1,1676,1104,572,7,97,47
1,1501,1448,53,2,121,61
1,1683,1910,-227,6,1590,109
1,1667,1596,71,0,122,61
0,1398,1326,72,0,344,188
-1,1798,1822,-24,-1,0,40
-1,1373,1306,67,-6,-817,118
-1,1319,1171,148,8,105,40
-1,1076,1326,-250,0,-77,64
-1,1306,1608,-302,-4,-120,50
1,1675,1585,90,1,537,129
-1,1721,1524,197,0,-35,74
1,1885,1795,90,0,4,53
1,1896,1464,432,1,14,73
1,1261,1500,-239,13,674,63
1,1583,1692,-109,-9,-201,55
-1,1683,1577,106,4,-42,57
0,1580,1500,80,-2,103,100
1,1590,1784,-194,1,27,101
-1,1448,1562,-114,-2,-19,86
1,1608,1446,162,-2,-44,49
1,1703,1802,-99,0,258,94
-1,1716,1770,-54,1,4,74
-1,1718,1710,8,0,6,60
-1,1698,1536,162,-6,-232,56
-1,1462,1898,-436,0,1,60
1,1827,1601,226,6,200,61
-1,1614,1893,-279,1,41,48
1,1612,1302,310,-1,-47,81
-1,1707,1779,-72,-1,-327,116
1,1706,1606,100,0,-106,87
-1,1537,1787,-250,1,45,80
1,1381,1678,-297,0,7,47
-1,1437,1595,-158,-13,-173,48
-1,1278,1462,-184,-1,-100,72
-1,1759,1754,5,1,37,62
1,1833,1590,243,-4,136,77
-1,1714,1598,116,-2,-397,86
1,1648,1708,-60,2,449,103
1,1697,1788,-91,0,88,81
1,1852,1659,193,3,66,45
1,1766,1641,125,-2,-1,41
-1,1620,1725,-105,-7,-306,72
1,1602,1430,172,-1,1007,117
1,1699,1549,150,-1,-43,115
-1,1558,1371,187,1,-432,136
-1,1550,1306,244,-5,-142,58
1,1864,1648,216,0,-2,59
1,1610,1522,88,-1,-13,47
-1,1949,1852,97,0,-119,124
1,1768,1748,20,2,87,61
-1,1272,1612,-340,-4,-127,62
0,1701,1774,-73,1,42,83
0,1562,1761,-199,0,-363,111
1,1643,1869,-226,0,288,123
1,1712,1854,-142,-1,-80,97
1,2071,1467,604,3,369,61
-1,1670,1732,-62,0,60,110
1,1694,1650,44,0,4,77
-1,1596,1752,-156,-2,-136,74
1,1706,1494,212,0,18,63
-1,1269,1733,-464,-1,-79,56
1,1738,1781,-43,-1,7,57
1,1677,1641,36,0,-18,67
-1,1655,1704,-49,-1,-28,48
-1,1564,1857,-293,-2,-90,86
-1,1741,1661,80,0,-18,46
-1,1791,1868,-77,-3,-170,116
-1,1684,1587,97,-1,28,60
-1,1897,1970,-73,0,103,94
1,1251,1375,-124,-1,-1,53
-1,1445,1507,-62,1,19,104
-1,1742,1764,-22,1,-29,72
-1,1716,1728,-12,0,-32,72
-1,1365,1466,-101,-3,-76,78
-1,1766,1750,16,1,-13,72
1,1933,1979,-46,0,111,84
1,1641,1212,429,-1,239,81
1,1735,1888,-153,0,45,141
-1,1533,1572,-39,4,78,94
1,1216,1386,-170,-4,-143,89
-1,1411,1517,-106,0,0,52
1,1781,1615,166,0,3,51
-1,1705,1738,-33,-5,-862,146
1,1878,1322,556,2,18,43
-1,1675,1592,83,-10,-377,68
1,1879,1487,392,1,25,51
-1,1761,1752,9,-3,-73,96
-1,1440,1312,128,-7,-63,47
1,1873,1750,123,-7,41,67
-1,1210,1643,-433,-12,-326,54
-1,1947,1952,-5,1,20,158
-1,1716,2072,-356,2,69,72
1,1748,1694,54,0,161,135
1,1559,1500,59,2,101,57
0,1402,1546,-144,6,621,73
-1,1743,1880,-137,0,-25,110
1,1689,1612,77,-1,-14,59
1,1355,1441,-86,-1,-38,65
1,1507,1587,-80,5,520,115
1,1606,1653,-47,-1,-24,43
-1,1512,1645,-133,0,-143,82
1,1518,1266,252,6,494,89
-1,1765,1750,15,-8,-31,106
-1,1685,1882,-197,-1,-120,84
1,1887,1736,151,0,6,57
0,1661,1625,36,0,-23,147
1,1526,1535,-9,-9,-585,83
-1,1505,1681,-176,3,47,58
0,1730,1894,-164,1,-41,70
1,1679,1751,-72,0,9,117
1,1653,1630,23,3,45,49
-1,1364,1591,-227,1,-5,42
1,1393,1542,-149,12,152,45
-1,1944,2075,-131,0,-54,58
1,1633,1407,226,0,56,79
0,1499,1431,68,-5,-139,91
-1,2084,1937,147,-3,-218,100
-1,1251,1523,-272,-7,-381,64
-1,1761,1752,9,-1,-86,74
1,1953,2066,-113,-2,158,93
1,1523,1500,23,3,168,52
1,1518,1500,18,-1,75,113
1,1523,1552,-29,0,127,91
1,1728,1642,86,-13,-55,101
1,1558,1687,-129,5,73,43
-1,1968,2049,-81,0,-1,42
1,2059,1959,100,-2,-139,89
-1,1496,1433,63,-12,-141,48
-1,1574,1587,-13,-7,-296,67
-1,2068,1951,117,0,32,84
-1,1860,1943,-83,0,-17,58
1,1429,1446,-17,0,164,123
-1,1672,1576,96,-1,-132,94
1,1951,1851,100,0,237,127
-1,1483,1281,202,-6,-306,68
1,2037,1980,57,-1,-24,45
1,1935,1735,200,0,71,103
1,1687,1528,159,0,2,69
1,1597,1350,247,14,546,72
1,1970,2047,-77,3,377,107
-1,1652,1765,-113,-2,-81,66
1,1539,1238,301,6,284,57
-1,1353,1503,-150,-1,-55,56
-1,1275,1312,-37,-4,-243,70
-1,1524,1538,-14,-2,-86,52
1,2032,1984,48,0,55,111
1,1634,1793,-159,3,805,151
1,1515,1535,-20,3,40,47
0,1974,2043,-69,-7,148,90
1,1526,1531,-5,-2,319,147
-1,1729,1941,-212,-1,-82,80
1,2040,1977,63,0,33,81
1,1465,1459,6,2,473,119
-1,1722,2042,-320,-2,-67,56
1,1325,1202,123,7,297,69
1,1278,1762,-484,7,68,40
-1,1308,1267,41,4,46,44
1,1520,1386,134,6,264,61
-1,1346,1616,-270,-1,49,110
1,1500,1520,-20,3,102,55
-1,1751,1774,-23,-1,9,76
1,1548,1513,35,6,542,99
-1,1510,1681,-171,3,127,56
-1,1188,1755,-567,-1,-20,70
1,1599,1356,243,3,222,61
1,1685,1511,174,2,13,43
1,2141,1923,218,-2,-287,85
1,1947,1792,155,0,269,171
0,1703,1504,199,0,25,114
-1,1299,1227,72,-3,-141,60
-1,1604,1724,-120,0,-114,136
1,1504,1754,-250,-2,-20,57
1,1442,1392,50,2,107,73
1,1523,1181,342,10,219,47
-1,1332,1289,43,-1,-584,102
-1,1735,1879,-144,-1,-91,122
1,1378,1537,-159,-1,-52,65
1,1241,1285,-44,2,240,89
-1,1719,2046,-327,-1,-29,78
1,1886,1727,159,0,4,41
1,1732,1596,136,9,216,49
1,1776,1648,128,1,41,52
1,1509,1684,-175,-1,191,59
-1,1589,1738,-149,-3,7,48
1,1892,1643,249,3,265,95
1,1700,1620,80,-2,-6,61
1,1395,1293,102,1,88,71
1,1954,1715,239,3,566,97
1,1745,1582,163,3,463,105
-1,1638,1896,-258,0,4,40
1,1475,1394,81,1,55,48
1,1402,1435,-33,0,37,57
1,1901,1634,267,0,-12,57
-1,1452,1519,-67,-1,9,86
1,2059,1916,143,1,71,63
1,1658,1612,46,1,466,115
1,1503,1559,-56,3,66,57
-1,1576,1751,-175,-7,-206,64
-1,1271,1254,17,1,6,46
1,1600,1500,100,0,134,103
1,1421,1174,247,16,529,57
-1,1319,1785,-466,-1,-49,66
1,1634,1481,153,5,222,59
-1,1522,1489,33,0,-109,70
1,1652,1403,249,5,268,59
1,1607,1716,-109,1,81,55
1,1267,1259,8,3,294,73
1,1421,1451,-30,0,10,87
1,1958,1907,51,0,-42,73
1,1385,1484,-99,-3,94,101
-1,1399,1664,-265,0,-133,100
-1,1507,1502,5,-4,28,68
1,1593,1673,-80,1,131,109
-1,1434,1494,-60,-3,-68,48
-1,1702,1622,80,-1,-67,70
-1,1344,1538,-194,2,40,42
-1,1513,1630,-117,0,-258,112
-1,1609,1658,-49,-7,-543,88
-1,1602,1667,-65,4,105,54
0,1690,1711,-21,1,437,215
-1,1500,1543,-43,3,219,158
1,1637,1689,-52,0,-4,81
1,1505,1220,285,0,-31,51
1,1571,1469,102,3,74,50
1,1442,1536,-94,1,58,77
1,1641,1384,257,3,23,75
0,1675,1570,105,4,631,115
1,1578,1481,97,0,-19,73
-1,1516,1477,39,-3,21,44
1,1720,1279,441,2,36,51
-1,1573,1667,-94,-9,-460,70
1,1666,1664,2,-1,8,45
-1,1482,1572,-90,-2,-68,78
1,1415,1500,-85,10,279,49
1,1503,1528,-25,2,130,61
1,1487,1687,-200,1,149,76
-1,1647,1526,121,3,-403,138
-1,1326,1393,-67,0,2,44
1,1620,1500,120,18,492,51
1,1637,1579,58,-3,-47,79
1,1626,1375,251,12,467,71
1,1563,1554,9,1,682,129
-1,1345,1750,-405,-9,-311,51
-1,1638,1478,160,-3,-231,68
1,1631,1532,99,-2,-196,71
-1,1569,1647,-78,-1,-4,42
-1,1394,1554,-160,-1,-463,140
1,1649,1503,146,2,151,81
1,1639,1321,318,9,293,55
1,1656,1561,95,-1,210,75
0,1710,1691,19,-4,-309,167
1,1642,1287,355,25,405,45
-1,1668,2066,-398,-6,-80,42
1,1472,1162,310,11,352,62
1,2066,1668,398,1,31,51
1,1516,1327,189,0,0,59
-1,1553,1665,-112,-8,-118,48
-1,1496,1663,-167,-2,-72,84
1,1457,1548,-91,8,580,119
-1,1500,1812,-312,2,89,89
-1,1348,1645,-297,-3,-57,40
1,1469,1411,58,2,93,63
1,1673,1545,128,2,301,93
1,1522,1207,315,0,-56,93
1,1477,1500,-23,3,182,71
-1,1154,1574,-420,1,-67,68
1,1453,1476,-23,0,47,99
-1,1538,1680,-142,-4,-250,76
-1,1317,1379,-62,-3,-602,126
-1,2147,2070,77,-2,-84,60
-1,1178,1075,103,-1,-333,136
-1,1525,1344,181,-4,-267,124
-1,1542,1625,-83,-3,-171,82
-1,1687,1531,156,1,-216,96
-1,1798,2085,-287,-3,-163,68
-1,1369,1709,-340,1,19,42
1,1508,1404,104,-2,145,95
1,2085,1672,413,3,289,65
-1,1669,2089,-420,-9,-278,56
-1,1869,2002,-133,1,-193,96
1,1463,1465,-2,-4,-3,78
-1,1510,1758,-248,0,24,52
-1,1488,1567,-79,-7,-1167,124
-1,1309,1324,-15,8,258,72
-1,1516,1394,122,-2,-159,98
-1,1494,1619,-125,0,-28,102
-1,1490,1462,28,1,-127,92
1,2009,1861,148,0,262,121
1,1454,1475,-21,0,82,71
1,1471,1505,-34,0,591,157
-1,1524,1547,-23,-2,-135,86
1,1500,1490,10,-4,88,83
1,1509,1450,59,1,219,84
1,1501,1630,-129,0,24,65
-1,1209,1324,-115,-6,-408,70
-1,1631,1461,170,-1,-40,88
-1,1457,1547,-90,0,-6,92
1,1326,1513,-187,-1,64,51
-1,1517,1376,141,3,-208,114
1,1674,1500,174,3,52,43
1,1763,1594,169,-4,-223,81
1,1462,1466,-4,6,233,89
1,1496,1343,153,9,269,63
1,1754,1452,302,6,496,85
-1,1332,1199,133,-1,-109,108
1,1467,1471,-4,-1,99,105
1,1500,1500,0,10,421,55
-1,1524,1397,127,4,277,143
-1,1346,1502,-156,1,-35,52
1,1748,1524,224,1,69,96
-1,1894,1702,192,3,-94,94
1,1712,1832,-120,6,375,69
1,1782,1776,6,-1,-1,43
1,1465,1521,-56,0,103,95
-1,1877,1719,158,7,515,88
1,1307,1500,-193,-1,459,109
-1,1471,1512,-41,-5,-370,90
-1,1818,1726,92,-2,-347,86
1,1862,1736,126,-6,-108,59
1,1726,1818,-92,7,406,91
1,1765,1792,-27,0,64,55
-1,1468,1562,-94,2,50,48
1,1729,1396,333,8,209,57
1,1895,1869,26,0,48,79
-1,1804,1740,64,1,31,48
1,1859,1904,-45,0,40,67
-1,1570,1654,-84,-1,-32,64
1,1893,1871,22,-2,105,115
1,1561,1461,100,8,429,77
-1,1861,1902,-41,-2,-95,52
1,1732,1647,85,1,99,61
1,1437,1510,-73,2,210,61
-1,1502,1508,-6,-1,-47,58
-1,1776,1639,137,0,-840,104
1,1911,1852,59,0,-66,97
1,1453,1377,76,0,62,81
-1,1673,1789,-116,-5,-239,74
-1,1582,1878,-296,-5,-283,84
1,1364,1500,-136,13,746,73
-1,1381,1515,-134,-2,-145,82
1,1761,1654,107,10,419,53
-1,1843,1920,-77,-1,-74,94
-1,1453,1569,-116,-4,46,52
1,1768,1741,27,7,672,107
1,1928,1835,93,0,783,115
-1,1768,1784,-16,0,2,48
1,1741,1646,95,-3,-116,85
-1,1339,1333,6,-2,-198,94
-1,1827,1936,-109,1,-78,104
-1,1281,1481,-200,-3,-31,50
-1,1468,1460,8,2,20,40
-1,1638,1750,-112,-12,-613,186
1,1819,1753,66,1,-297,87
1,1578,1518,60,1,223,67
-1,1319,1508,-189,-5,-446,137
-1,1744,1828,-84,4,319,80
-1,1414,1369,45,1,-183,66
-1,1140,1436,-296,1,38,66
1,1836,1736,100,0,-15,71
-1,1274,1099,175,-2,-27,46
-1,1728,1844,-116,1,218,92
-1,1459,1489,-30,3,67,74
-1,1851,1720,131,-1,-399,90
1,1518,1522,-4,5,9,43
1,1509,1450,59,0,-296,115
1,1662,1462,200,0,-8,69
-1,1657,1804,-147,0,-237,140
-1,1500,1500,0,-1,-4,56
1,1837,1735,102,-3,-70,61
-1,1796,1657,139,1,86,80
1,1449,1367,82,-2,344,115
-1,1727,1823,-96,1,284,104
1,1446,1256,190,2,235,67
-1,1456,1668,-212,-1,-83,78
-1,1595,1691,-96,-5,-364,82
1,1320,1496,-176,4,125,57
-1,1831,1719,112,-3,-234,74
-1,1327,1532,-205,-4,-385,76
1,1758,1414,344,-1,-1,59
-1,1733,1817,-84,1,9,64
1,1761,1411,350,4,340,83
0,1900,1882,18,-1,-104,119
-1,1673,1451,222,-6,-301,132
1,1313,1378,-65,3,210,61
-1,1518,1461,57,-2,-232,146
1,1408,1764,-356,6,308,55
0,1439,1500,-61,-1,-226,92
-1,1764,1408,356,-1,-128,62
-1,0,1178,-1178,-4,-258,62
1,1178,0,1178,-3,67,97
-1,1565,1811,-246,-1,-27,56
1,1429,1742,-313,-4,377,99
-1,1498,1441,57,-7,-965,108
-1,1574,1631,-57,-5,-384,72
-1,1815,1926,-111,0,-47,74
-1,1565,1640,-75,-1,-7,46
1,1442,1369,73,-3,28,91
1,1322,1373,-51,-1,-14,67
1,1789,1655,134,-1,220,77
1,1648,1556,92,-3,113,65
-1,1721,1426,295,0,-36,62
1,1886,1725,161,-2,-129,63
1,1504,1316,188,1,74,65
1,1536,1327,209,-1,34,93
1,1656,1548,108,0,19,51
-1,1808,1883,-75,-1,-114,58
-1,1447,1701,-254,7,34,62
1,1562,1642,-80,1,4,43
1,1492,1506,-14,-1,11,71
1,1302,1466,-164,10,108,43
1,1478,1283,195,1,391,77
1,1629,1575,54,3,115,45
-1,1706,1442,264,-2,-364,84
-1,1210,1592,-382,-4,-363,68
-1,1510,1310,200,-2,-206,66
-1,1638,1566,72,-2,-85,52
0,1688,1814,-126,0,-28,97
-1,1899,1809,90,0,-14,68
-1,1462,1685,-223,-2,-231,108
1,1936,1807,129,-3,-7,97
1,1482,1592,-110,3,64,49
-1,1617,1327,290,0,-404,116
1,1495,1519,-24,0,-4,57
1,1810,1693,117,1,224,71
1,1321,1543,-222,-1,120,59
1,1622,1500,122,2,256,93
1,1631,1450,181,0,19,51
1,1696,1699,-3,-2,94,85
-1,1443,1637,-194,0,5,40
1,1443,1262,181,-6,-133,51
1,1562,1547,15,0,7,51
-1,1673,1797,-124,0,0,76
-1,1342,1719,-377,-4,-211,64
1,1688,1708,-20,0,216,109
-1,1493,1506,-13,-1,-33,52
1,1521,1340,181,-2,67,107
-1,1427,1642,-215,-6,-106,56
1,1706,1892,-186,1,123,127
-1,1696,1700,-4,2,122,80
1,1754,1564,190,0,25,53
1,1563,1581,-18,-3,8,41
-1,1390,1647,-257,0,-357,76
-1,1628,1875,-247,-1,-48,68
-1,1711,1684,27,-5,-362,104
-1,1606,1426,180,1,19,68
-1,1800,1945,-145,2,61,146
1,1516,1471,45,0,-14,47
-1,1697,1699,-2,0,35,72
1,1807,1466,341,-1,195,85
-1,1710,1685,25,-1,31,68
-1,1694,1721,-27,-3,-138,64
1,1697,1698,-1,1,224,77
-1,1665,1533,132,-2,-141,92
1,1832,1624,208,3,99,59
-1,1892,1652,240,0,-791,136
0,1463,1810,-347,-1,150,136
1,1575,1613,-38,3,250,75
1,1687,1709,-22,11,221,43
1,1709,1687,22,-1,-730,111
-1,1666,1476,190,-1,-272,100
-1,1684,1731,-47,-1,-41,42
1,1452,1300,152,6,265,59
0,1677,1697,-20,-3,-495,102
-1,1619,1655,-36,0,-8,44
-1,1633,1841,-208,-2,-70,56
-1,1674,1741,-67,-3,-2,100
-1,1696,1678,18,-3,-79,76
1,1801,1472,329,-2,-53,101
-1,1528,1474,54,-1,-49,58
1,1665,1609,56,-1,-10,47
-1,1541,1660,-119,-1,-6,40
1,1689,1684,5,1,103,75
1,1740,1576,164,4,12,43
-1,1665,1750,-85,-2,-138,100
-1,1673,1700,-27,-3,-167,96
1,1849,1725,124,0,22,95
-1,1468,1804,-336,-5,-162,60
-1,1290,1465,-175,-6,-186,62
1,1670,1533,137,0,42,89
1,1710,1662,48,-2,39,63
-1,1357,1540,-183,1,-233,66
1,1662,1714,-52,2,-5,41
1,1657,1758,-101,-2,-94,55
-1,1662,1710,-48,-2,-51,72
1,1778,1669,109,4,110,55
1,1389,1309,80,10,114,47
-1,1372,1339,33,0,1,62
1,1719,1653,66,1,-21,66
1,1748,1513,235,3,99,60
-1,1671,1744,-73,-2,-177,74
1,1569,1342,227,8,142,43
1,1644,1728,-84,0,92,85
-1,1606,1619,-13,-1,-39,88
1,1714,1657,57,0,474,111
1,1875,1753,122,1,38,55
1,1753,1875,-122,-1,138,75
1,1641,1497,144,0,-49,57
1,1648,1723,-75,0,-32,71
-1,1476,1675,-199,3,90,68
-1,1562,1516,46,-9,-120,46
0,1798,1850,-52,0,-21,125
1,1710,1661,49,2,93,50
0,1626,1351,275,0,143,125
1,1786,1767,19,6,91,43
1,1652,1720,-68,-1,38,61
-1,1511,1766,-255,1,-62,70
-1,1488,1648,-160,-4,-87,54
1,1629,1551,78,0,-53,83
1,1707,1665,42,9,234,61
1,1397,1500,-103,-4,349,95
-1,1536,1585,-49,0,65,60
1,1655,1716,-61,-1,-19,71
-1,1656,1866,-210,-6,-162,130
1,1818,1821,-3,-2,-23,53
-1,1431,1330,101,-3,-70,51
-1,1796,1757,39,-12,-160,54
-1,1704,1668,36,-1,243,84
-1,1466,1465,1,1,183,112
1,1490,1500,-10,7,181,47
1,1860,1650,210,2,50,47
-1,1784,1769,15,2,-25,62
1,1828,1679,149,0,267,75
1,1680,1692,-12,-2,-58,57
-1,1773,1646,127,4,-402,108
-1,1663,1709,-46,0,-37,50
1,1681,1691,-10,1,2,41
1,1512,1638,-126,2,497,107
1,1680,1692,-12,0,-81,77
1,1942,1961,-19,-2,-24,41
-1,1344,1505,-161,-8,-48,42
1,1810,1770,40,1,132,113
1,1681,1691,-10,3,63,51
-1,1759,1661,98,0,0,40
1,1608,1579,29,-4,-140,53
-1,1655,1866,-211,0,-54,67
1,1366,1409,-43,1,462,93
1,1680,1692,-12,-2,17,71
1,1618,1666,-48,0,-10,47
-1,1666,1618,48,0,20,42
-1,1371,1292,79,-2,-23,58
-1,1526,1592,-66,0,-59,58
1,1477,1447,30,-3,-222,95
-1,1691,1654,37,-7,-723,101
0,1671,1793,-122,0,43,108
1,1850,1630,220,-1,-14,85
1,1681,1569,112,1,-33,59
-1,1636,1474,162,0,229,68
1,1537,1611,-74,-1,56,69
-1,1624,1572,52,1,10,68
1,1855,1625,230,4,157,57
1,1359,1457,-98,3,124,67
-1,1266,1406,-140,-9,-68,44
1,1562,1689,-127,-4,-42,55
-1,1861,1680,181,-1,-308,110
1,1674,1576,98,2,83,57
-1,1569,1682,-113,-4,-160,56
1,1789,1675,114,0,-5,85
1,1842,1695,147,2,9,53
-1,1644,1768,-124,1,-36,54
-1,1689,1561,128,-14,-360,54
1,1617,1611,6,0,163,73
-1,1358,1747,-389,-5,-173,64
1,1379,1430,-51,-3,-3,59
1,1850,1689,161,7,10,41
0,1490,1337,153,1,13,132
-1,1754,1780,-26,-13,-523,64
1,1857,1683,174,-1,363,83
1,1675,1576,99,3,88,81
-1,1780,1876,-96,-6,-218,76
-1,1568,1683,-115,3,122,86
1,1954,1760,194,0,111,113
1,1572,1474,98,5,586,91
1,1884,1790,94,-4,-224,99
-1,1413,1187,226,0,-36,70
-1,1485,1517,-32,0,-91,76
-1,1307,1687,-380,1,5,42
-1,1690,1560,130,-14,-227,50
-1,1601,1653,-52,-4,-619,140
0,1864,2044,-180,0,145,77
1,1575,1676,-101,0,125,71
-1,1618,1876,-258,-2,-126,74
-1,1666,1797,-131,-2,-167,108
-1,1692,1870,-178,-9,-240,58
1,1247,1500,-253,17,1231,83
1,1460,1410,50,1,232,69
1,1662,1589,73,2,79,95
-1,1485,1780,-295,-3,-95,56
1,1876,1686,190,0,324,99
1,1342,1741,-399,-2,-45,97
1,1883,1671,212,7,201,45
1,1680,1580,100,-4,-72,45
1,1888,1782,106,-6,-354,69
-1,1410,1600,-190,-1,-21,42
-1,1688,1666,22,-2,-4,48
1,1666,1688,-22,-4,52,61
-1,1623,1478,145,0,-209,115
1,1565,1480,85,14,945,87
1,1681,1601,80,3,102,59
1,1719,1363,356,-4,27,51
1,1804,1500,304,0,25,67
1,1874,1470,404,-3,177,125
-1,1591,1481,110,-1,-111,106
1,1290,1426,-136,5,135,43
1,1733,1685,48,0,42,71
-1,1180,1266,-86,0,-285,80
1,1500,1214,286,1,216,79
-1,1741,1885,-144,-1,-40,54
1,1686,1392,294,6,415,85
1,1472,1574,-102,3,120,91
-1,1517,1575,-58,-4,-95,54
1,1892,1677,215,-1,292,85
-1,1690,1704,-14,0,-4,90
-1,1590,1498,92,-1,-28,40
1,1502,1386,116,0,453,121
-1,1672,1897,-225,-5,-1081,148
1,1329,1168,161,8,135,41
1,1618,1574,44,0,16,42
0,1902,1667,235,3,155,72
-1,1686,1631,55,-1,-468,94
-1,1601,1496,105,-1,184,66
-1,1349,1387,-38,-12,-277,70
-1,1352,1430,-78,0,-82,102
-1,1674,1895,-221,-1,-122,80
-1,1667,1899,-232,0,14,48
1,1645,1674,-29,2,80,59
-1,1830,1759,71,1,107,106
1,1900,1669,231,5,965,135
1,1315,1510,-195,0,22,57
1,1732,1511,221,3,246,79
-1,1581,1591,-10,2,-156,100
-1,1664,1905,-241,-5,-121,76
-1,1303,1418,-115,-8,-116,48
-1,1493,1659,-166,-1,-671,170
-1,1718,1432,286,0,-46,52
1,1724,1658,66,0,-9,59
1,1493,1333,160,3,86,53
1,1909,1660,249,9,370,51
1,1576,1344,232,3,264,81
1,1964,1808,156,0,18,49
-1,1395,1577,-182,7,364,66
-1,1651,1961,-310,-6,-110,64
1,1642,1677,-35,0,6,73
1,1521,1389,132,9,713,81
1,1487,1507,-20,6,171,55
1,1733,1648,85,0,66,49
-1,1506,1744,-238,-3,-250,74
1,1673,1918,-245,-4,-57,53
1,1752,1388,364,8,766,83
1,1570,1325,245,2,105,62
1,1961,1801,160,-1,-26,41
1,1742,1662,80,1,132,61
-1,1360,1229,131,-3,-252,77
-1,1390,1566,-176,-3,-70,43
1,1665,1487,178,3,417,89
-1,1751,1654,97,1,-55,50
1,1411,1566,-155,-1,-22,45
-1,1370,1651,-281,-5,-376,72
1,1339,1397,-58,0,20,59
-1,1382,1913,-531,1,2,44
1,1888,1581,307,0,243,111
-1,1795,1968,-173,0,0,64
1,1668,1614,54,-4,-295,125
-1,1245,1344,-99,-2,-16,62
-1,1904,1984,-80,-2,-17,46
-1,1352,1464,-112,-2,-158,78
0,1486,1483,3,0,-266,127
1,1481,1671,-190,-5,-169,63
-1,1581,1500,81,-2,-185,96
1,1580,1535,45,5,440,95
-1,1485,1426,59,-3,-82,42
1,1836,1974,-138,0,5,53
1,1339,1340,-1,2,305,76
1,1579,1789,-210,-5,17,45
-1,1540,1859,-319,-3,-64,64
1,1526,1264,262,2,209,72
1,1644,1559,85,2,63,59
-1,1915,1541,374,0,-26,108
1,1209,1353,-144,-1,-69,87
1,1644,1552,92,0,-6,77
-1,1530,1497,33,3,884,138
1,1345,1260,85,11,580,65
1,1444,1501,-57,-1,585,225
-1,1323,1351,-28,-6,-200,106
1,1204,1322,-118,-1,11,41
-1,1337,1402,-65,-1,-295,160
-1,1353,1594,-241,1,14,58
1,1568,1519,49,-2,-271,117
-1,1382,1541,-159,-9,-486,72
1,1362,1583,-221,0,0,45
-1,1599,1395,204,-6,-405,98
-1,1452,1439,13,1,46,56
0,1548,1375,173,0,191,71
-1,1607,1553,54,-6,-255,72
1,1451,1075,376,1,90,65
1,1979,2114,-135,0,11,57
1,1920,1886,34,0,56,85
-1,1380,1543,-163,0,5,66
1,1510,1616,-106,1,127,131
-1,1311,1575,-264,-7,-387,66
-1,1559,1667,-108,-2,-97,78
-1,1348,1598,-250,1,-310,134
-1,1486,1600,-114,-3,-251,64
1,1374,1250,124,0,-20,67
-1,1741,1778,-37,0,-40,62
1,1904,1992,-88,0,-2,53
-1,1328,1236,92,0,-22,68
1,1778,1741,37,2,154,75
-1,1443,1332,111,-3,-281,122
-1,1875,1728,147,-4,-311,82
-1,1568,1657,-89,-2,-89,56
1,1453,1213,240,7,291,57
-1,1545,1550,-5,-8,-173,62
1,1528,1480,48,1,218,145
1,1792,1408,384,0,8,59
1,1286,1309,-23,-8,-265,59
1,1461,1295,166,1,103,73
1,1452,1553,-101,0,21,57
1,1500,1958,-458,-1,62,75
-1,1208,1442,-234,-4,-90,54
-1,1687,1483,204,2,-8,56
1,1720,1551,169,1,23,81
1,1288,1605,-317,-1,-36,60
1,1679,1602,77,-1,-71,63
1,1896,1586,310,-6,108,65
-1,1449,1768,-319,1,-87,67
1,1533,1334,199,1,237,72
-1,1450,1627,-177,2,-51,49
0,1746,1900,-154,0,78,115
-1,1470,1676,-206,-1,-425,120
-1,1497,1552,-55,1,43,64
-1,1603,1944,-341,-1,-217,102
-1,1968,1895,73,-3,-717,114
-1,1683,1670,13,0,-52,124
1,1593,1639,-46,3,110,63
1,1276,1368,-92,-5,-40,43
1,1538,1357,181,3,102,49
-1,1498,1479,19,-1,-94,80
1,1653,1362,291,4,278,57
1,1309,1466,-157,0,53,53
-1,1683,1464,219,3,-38,50
-1,1572,1754,-182,0,-8,52
1,1544,1573,-29,-1,99,81
-1,1762,1564,198,-2,-227,120
1,1500,1381,119,-2,-82,115
-1,1654,1723,-69,0,66,52
1,1327,1269,58,4,249,77
1,1947,1600,347,5,137,43
-1,1482,1662,-180,-5,-147,44
1,1872,1994,-122,-2,20,83
-1,1723,1581,142,-3,-104,78
-1,1375,1625,-250,0,-210,92
1,1586,1741,-155,0,148,69
-1,1487,1500,-13,0,11,64
-1,1628,1688,-60,1,78,114
1,1979,1887,92,-3,-18,63
1,1721,1605,116,-1,-38,77
1,1505,1497,8,2,141,83
-1,1302,1576,-274,-6,-535,110
-1,1493,1777,-284,0,-88,78
-1,1382,1359,23,-3,-93,62
-1,1698,1732,-34,-6,-232,60
-1,1307,1583,-276,-8,-355,62
1,1354,1288,66,9,190,53
1,1950,1900,50,0,40,63
1,1646,1500,146,1,15,41
1,1680,1516,164,2,46,61
-1,1337,1611,-274,-3,-177,73
-1,1500,1480,20,-10,-308,62
-1,1132,1298,-166,0,-153,110
-1,1297,1580,-283,1,-182,58
1,1366,1278,88,1,36,51
1,1813,1539,274,-1,-44,63
-1,1586,1955,-369,1,3,46
-1,1527,1669,-142,-6,-370,72
1,1742,1643,99,1,26,45
1,1626,1464,162,0,325,99
0,1584,1535,49,-1,-502,94
1,1772,1500,272,2,289,95
-1,1537,1583,-46,1,2,42
1,2076,1597,479,0,462,123
-1,1879,1987,-108,1,-198,94
-1,1404,1769,-365,-3,-52,66
1,1527,1593,-66,6,200,71
-1,1520,1677,-157,1,3,58
-1,1579,1540,39,-13,-1847,146
-1,1293,1733,-440,-7,-259,52
1,1553,1567,-14,2,105,55
-1,1823,2155,-332,-1,-584,114
1,1565,1555,10,2,111,65
1,1381,1478,-97,10,556,79
-1,1736,1679,57,1,-26,84
1,1500,1573,-73,0,-2,45
1,1444,1632,-188,0,192,99
-1,1463,1514,-51,-1,-168,88
1,1449,1149,300,6,205,81
1,2163,1820,343,1,95,71
-1,1556,1563,-7,-9,-312,72
-1,1552,1568,-16,1,51,60
1,1817,2167,-350,0,-33,65
1,1578,1541,37,-5,-124,55
1,1487,1396,91,5,925,121
1,1487,1662,-175,-10,-261,49
1,1588,1531,57,-2,-20,81
-1,1511,1681,-170,-5,-27,48
-1,1764,1960,-196,-3,-150,72
1,1522,1597,-75,1,81,57
-1,1837,2152,-315,-10,-199,48
-1,1597,1522,75,-2,-455,102
-1,1707,1897,-190,-1,-99,90
1,2128,1995,133,0,14,59
1,1673,1786,-113,0,51,85
-1,2158,1834,324,1,-52,76
1,1584,1535,49,0,2,55
-1,1855,2135,-280,-3,-135,66
-1,1593,1526,67,0,-321,102
-1,1355,1443,-88,-9,-79,104
1,1687,1505,182,-5,-220,103
-1,1871,2118,-247,-4,-389,100
-1,1539,1581,-42,3,39,42
1,2123,1866,257,1,197,129
-1,1496,1688,-192,-3,-126,61
1,1419,1401,18,0,77,59
-1,1551,1590,-39,-4,-241,62
1,1600,1541,59,0,-27,63
-1,1583,1699,-116,-1,-83,64
1,1694,1490,204,3,153,96
1,1757,1796,-39,0,56,55
1,1689,1719,-30,-1,-21,53
1,1499,1387,112,-3,9,49
1,1763,1595,168,5,175,62
-1,1195,1321,-126,-2,-41,50
1,1710,1566,144,4,224,77
-1,1612,1579,33,2,31,48
1,1466,1366,100,0,0,47
1,2098,1667,431,1,24,57
0,1793,1716,77,1,-65,140
-1,1306,1430,-124,-5,-891,122
1,1719,1791,-72,0,426,171
-1,1647,1861,-214,2,178,88
1,1487,1484,3,0,-49,71
1,1778,1732,46,0,-57,67
-1,1269,1662,-393,-2,-6,46
-1,1732,1787,-55,-2,-56,46
-1,1299,1487,-188,0,3,70
-1,0,1210,-1210,-5,-129,60
1,1797,1723,74,1,38,109
1,1536,1521,15,-2,-13,41
1,1714,1805,-91,-1,-1,53
-1,1493,1293,200,-6,59,40
1,1792,1728,64,5,92,43
-1,1255,1281,-26,1,-44,54
-1,1719,1801,-82,-14,-397,62
-1,1806,1852,-46,0,-28,68
-1,1473,1267,206,0,69,50
1,1801,1719,82,8,225,63
-1,1547,1500,47,-6,-75,42
1,1503,1609,-106,-1,337,116
-1,1710,1809,-99,0,3,42
1,1817,1702,115,1,49,59
-1,1310,1585,-275,-1,-368,126
1,1426,1445,-19,-5,-57,45
-1,1547,1500,47,-2,-89,56
1,1695,1504,191,-4,-78,43
1,1292,1235,57,4,634,111
-1,1577,1517,60,-1,-536,146
-1,1679,1498,181,-7,-382,75
1,1992,2100,-108,1,194,119
-1,1395,1607,-212,0,-1,58
-1,1457,1589,-132,-4,-66,48
1,1648,1531,117,-10,-340,59
-1,1531,1648,-117,-3,-516,92
-1,2085,1631,454,0,-132,92
1,1700,1538,162,3,37,43
-1,1824,2006,-182,-4,-311,76
1,1541,1461,80,4,56,51
1,1504,1350,154,0,73,53
0,1419,1434,-15,2,187,206
1,1652,2062,-410,0,-10,87
0,1559,1471,88,-2,-261,108
1,2039,1673,366,0,57,85
1,1655,1804,-149,7,257,43
-1,1438,1597,-159,-1,-55,62
-1,1670,1676,-6,0,-69,80
-1,1560,1510,50,-5,-408,118
-1,1687,2012,-325,0,-9,46
1,1610,1361,249,0,-112,69
1,1621,1500,121,0,-17,53
1,1659,1666,-7,6,98,40
0,1433,1419,14,1,1135,218
1,1671,1655,16,5,266,65
1,1638,1432,206,7,117,47
1,1724,1743,-19,11,336,61
1,2016,2042,-26,1,64,63
1,1522,1296,226,3,158,131
1,2028,2028,0,0,145,137
1,1420,1433,-13,2,96,65
1,2028,2028,0,-1,179,119
1,1612,1855,-243,-2,-29,87
-1,1713,1641,72,2,181,78
-1,1255,1274,-19,-3,-625,90
1,1789,1356,433,17,536,57
1,2016,2016,0,0,-6,45
-1,2005,2028,-23,1,-7,58
-1,1514,1835,-321,-2,-223,84
1,2105,1945,160,0,18,45
-1,1500,1248,252,-1,5,52
1,1609,1385,224,-1,-122,119
0,1599,1625,-26,-1,112,71
-1,1301,1313,-12,-2,-24,40
1,1711,1777,-66,2,250,73
1,1527,1296,231,0,32,165
-1,1612,1709,-97,-1,-4,60
-1,1534,1500,34,2,184,102
1,1548,1205,343,0,-253,87
-1,1115,1652,-537,-4,-119,62
1,1861,1855,6,-1,96,73
1,1644,1560,84,-1,113,59
-1,1377,1256,121,3,37,46
-1,1721,1834,-113,2,107,86
1,1550,1512,38,0,-10,61
-1,1334,1500,-166,5,57,86
-1,1764,1729,35,3,104,50
-1,1457,1380,77,-1,-179,64
-1,1844,1872,-28,-2,-88,68
1,1632,1321,311,3,279,76
0,1502,1561,-59,2,447,86
-1,1251,1447,-196,-4,-449,88
-1,1337,1262,75,0,-191,68
-1,1635,1949,-314,-3,-217,84
-1,1366,1238,128,-1,-52,54
1,1600,1625,-25,3,325,105
1,1394,1509,-115,12,196,49
-1,1255,1301,-46,-2,-99,48
1,1412,1354,58,0,418,95
-1,1330,1336,-6,-2,27,42
-1,1427,1410,17,-3,182,131
1,1492,1502,-10,-3,-24,49
-1,1320,1617,-297,-8,-254,56
-1,1352,1453,-101,-1,-516,110
-1,1388,1318,70,-2,-175,66
1,1244,1021,223,0,25,53
1,1491,1604,-113,-1,-31,57
1,1363,1631,-268,0,-3,45
-1,1841,1882,-41,-5,-227,86
1,1564,1559,5,7,485,67
-1,1759,1710,49,0,-7,66
1,1617,1112,505,1,153,57
1,1549,1421,128,2,139,63
1,1532,1326,206,4,212,83
1,1576,1308,268,0,-4,41
-1,1250,1343,-93,-11,-483,64
-1,1540,1613,-73,0,-38,56
1,1505,1590,-85,-3,-128,67
-1,1422,1708,-286,-1,71,90
1,1728,1747,-19,-1,-28,51
-1,1245,1405,-160,-8,-1102,116
1,1556,1798,-242,3,201,61
1,1628,1414,214,1,53,57
-1,1462,1533,-71,-2,-334,98
0,1540,1574,-34,5,381,128
-1,1519,1576,-57,-5,-150,62
-1,1654,1402,252,-8,-108,55
1,1462,1473,-11,-1,4,48
-1,1892,1832,60,0,-78,110
-1,1744,1615,129,-2,-305,104
-1,1421,1791,-370,-7,-248,54
-1,1531,1565,-34,-2,-147,62
1,1475,1558,-83,1,102,61
-1,1343,1383,-40,1,98,94
-1,1110,1392,-282,-15,-294,46
1,1680,1751,-71,2,116,95
1,1500,1324,176,4,125,61
-1,1428,1677,-249,0,60,66
-1,1238,1481,-243,-2,61,72
1,1332,1393,-61,4,32,43
1,1464,1537,-73,-6,2,130
-1,1383,1346,37,-11,-652,74
-1,1544,1490,54,0,-6,48
-1,1265,1287,-22,-1,-132,88
-1,1444,1583,-139,-2,-48,63
1,1879,1590,289,0,68,96
1,1608,1301,307,2,191,61
1,1485,1524,-39,5,83,47
1,1909,1801,108,1,177,115
-1,1515,1499,16,-2,-30,102
1,1470,1513,-43,1,36,49
1,1795,1541,254,4,105,47
-1,1315,1396,-81,0,33,48
1,1233,1101,132,5,119,57
1,1736,1676,60,1,16,49
1,1478,1431,47,2,335,111
1,1612,1544,68,3,71,48
1,1651,1493,158,-5,-97,63
-1,1211,1411,-200,-3,-671,118
1,1642,1724,-82,0,-29,63
-1,1485,1492,-7,-2,-490,94
-1,1790,1936,-146,-1,-383,160
1,1533,1621,-88,-1,207,73
-1,1315,1486,-171,-3,-179,99
-1,1393,1325,68,-11,-615,66
-1,1504,2003,-499,0,-137,78
1,1510,1558,-48,4,222,63
-1,1241,1337,-96,-2,-433,114
1,1707,1504,203,6,212,63
1,1483,1002,481,-7,-118,77
0,1087,1238,-151,0,175,80
-1,1359,1823,-464,-2,-431,108
-1,1700,1456,244,0,-40,64
1,1553,1099,454,8,218,49
-1,1290,1404,-114,0,-17,66
-1,1511,1839,-328,0,-31,48
-1,1777,1883,-106,0,-219,100
1,1520,1473,47,4,110,51
1,1500,1407,93,0,79,101
-1,1499,1714,-215,0,-162,88
-1,1682,1825,-143,0,1,50
1,1357,1314,43,-2,0,123
1,1864,1766,98,-4,-18,68
1,1608,1724,-116,0,142,117
-1,1530,1624,-94,-1,-17,58
-1,1613,1656,-43,0,-34,100
1,1482,1226,256,0,11,57
1,1421,1204,217,0,124,101
1,1616,1618,-2,0,220,101
1,1229,1339,-110,7,557,65
1,2178,1831,347,0,7,91
-1,1487,1573,-86,0,454,176
1,1642,1591,51,0,152,59
1,1770,1189,581,2,71,67
-1,1745,1957,-212,0,-7,64
-1,1556,1298,258,-1,-23,48
1,1532,1511,21,0,-21,63
-1,1916,1679,237,-2,-455,92
-1,1771,1503,268,2,47,48
-1,1185,1510,-325,-2,-61,62
1,1602,1580,22,1,42,55
1,1575,1391,184,0,0,135
1,1543,1542,1,0,54,107
-1,1245,1503,-258,0,-250,90
1,1543,1287,256,2,137,63
-1,1606,1631,-25,0,-54,64
-1,1200,1332,-132,2,124,84
1,1305,1469,-164,1,22,59
1,1758,1654,104,0,69,105
-1,1817,1713,104,-5,-268,74
1,1302,998,304,5,555,71
1,1547,1560,-13,0,9,107
1,1599,1417,182,2,124,63
1,1392,1432,-40,4,551,103
1,1240,1121,119,4,315,87
1,1712,1325,387,-1,-51,43
-1,1606,1590,16,0,-210,116
1,1850,1720,130,2,126,77
1,1747,1726,21,0,24,113
-1,1324,1530,-206,-2,-85,70
-1,1477,1745,-268,-10,-69,64
1,1501,1512,-11,-1,226,95
1,1344,1417,-73,-1,-1,87
0,1620,1570,50,0,7,82
-1,1688,1681,7,-1,-106,90
-1,1713,1859,-146,-4,-50,50
-1,1433,1351,82,-1,10,50
-1,1473,1751,-278,2,76,68
1,1249,1027,222,1,201,73
1,1419,1414,5,6,414,93
1,1500,1512,-12,-3,-87,41
1,1428,1412,16,9,694,81
1,1702,1755,-53,1,66,66
-1,1472,1476,-4,-10,-762,98
1,1469,1546,-77,3,161,74
1,1792,1569,223,0,-8,63
-1,1706,1853,-147,0,30,66
1,1491,1514,-23,0,-9,67
1,2175,1789,386,1,50,65
1,1714,1585,129,5,47,55
-1,1787,2178,-391,0,-117,82
1,1860,1699,161,0,22,49
-1,1179,1403,-224,-19,-2213,214
1,1938,1788,150,2,75,44
1,2181,1784,397,0,146,123
1,1714,1525,189,5,157,45
-1,1336,1765,-429,-4,-131,60
-1,1781,1945,-164,-2,-89,72
-1,1182,1741,-559,-3,-517,112
1,1609,1357,252,1,105,53
-1,1782,2184,-402,6,159,70
-1,1693,1867,-174,0,-135,108
1,2184,1782,402,0,47,101
-1,1578,1721,-143,0,19,114
1,1483,1427,56,-2,310,137
-1,1485,1387,98,-3,-79,64
-1,1780,2186,-406,-1,-47,42
1,1732,1695,37,3,293,127
1,1811,1520,291,-1,-3,91
1,1643,1525,118,-7,-307,69
1,2141,1778,363,1,97,71
-1,1267,1704,-437,0,-373,130
1,1643,1525,118,3,285,107
1,1775,2144,-369,0,-7,65
1,2044,1951,93,-1,-40,97
-1,1502,1574,-72,-8,-101,44
1,1469,1485,-16,0,95,71
-1,2120,1797,323,-1,12,64
-1,1797,2120,-323,0,-5,44
1,1568,1319,249,-1,12,43
1,1728,1571,157,1,48,80
1,2124,1818,306,-2,-18,49
1,1742,1363,379,0,99,55
-1,1815,2128,-313,-1,-21,62
-1,2132,1811,321,-9,-6,82
1,1301,1023,278,0,107,71
-1,1351,1745,-394,-7,-84,56
1,1493,1417,76,0,459,95
-1,1873,1972,-99,0,-22,114
1,1500,1358,142,1,134,91
-1,1833,2109,-276,-1,-60,92
-1,1470,1352,118,-1,-125,78
-1,1597,1662,-65,0,-19,56
1,1685,1742,-57,0,35,77
-1,1735,1706,29,-1,-59,66
1,1943,1916,27,0,7,105
1,2113,1828,285,1,-54,119
1,1548,1596,-48,6,224,65
1,1502,1172,330,8,108,46
1,1354,1367,-13,11,179,41
1,1558,1747,-189,0,2,63
-1,1824,2118,-294,-1,-112,90
1,1995,1734,261,-1,38,59
1,2122,1820,302,-4,76,101
-1,1260,1160,100,-1,65,60
-1,1160,1505,-345,-1,-55,51
1,1502,1307,195,6,218,57
-1,1625,1595,30,5,117,90
1,1587,1651,-64,6,242,53
1,1638,1599,39,0,-7,51
1,1619,1713,-94,-3,-190,103
1,1647,1590,57,4,713,147
1,1500,1342,158,0,-8,51
1,1500,2005,-505,-4,15,109
1,1500,1278,222,7,566,83
1,1565,1535,30,-1,16,59
1,1537,1443,94,-2,7,61
1,1581,1656,-75,-1,-37,43
1,1883,1812,71,-5,34,57
-1,1644,1594,50,-3,-88,54
-1,1330,1449,-119,3,-13,82
-1,1571,1381,190,0,-177,122
1,1592,1507,85,0,50,101
-1,1594,1644,-50,-1,-120,112
-1,1611,1657,-46,-1,-66,98
-1,1653,1606,47,3,90,56
-1,1497,1575,-78,0,-112,80
0,1800,1627,173,2,138,86
1,1641,1618,23,0,41,53
-1,1618,1641,-23,-2,-257,62
-1,1608,1880,-272,-2,-108,76
1,1608,1651,-43,1,237,67
1,1639,1599,40,-3,-33,49
-1,1545,1317,228,0,-5,46
-1,1567,1506,61,-6,-636,92
1,1610,1627,-17,-3,-183,69
1,1729,1892,-163,1,-14,45
1,1418,1348,70,-2,9,64
-1,1632,1621,11,0,-110,126
1,1616,1621,-5,2,1,41
1,1683,1698,-15,0,155,79
1,1398,1224,174,-2,-51,79
1,1621,1616,5,-1,-21,53
-1,1632,1606,26,-2,-276,66
-1,1746,2031,-285,0,-120,86
1,1881,1698,183,2,89,51
1,1617,1641,-24,3,330,65
-1,1641,1617,24,-6,-465,94
-1,1287,1452,-165,-11,-403,60
-1,1604,1546,58,1,-2,45
-1,1604,1951,-347,-2,-51,96
-1,1628,1630,-2,0,11,118
-1,1434,1541,-107,3,337,98
-1,1848,2081,-233,-2,-13,92
1,1547,1527,20,-5,-126,55
-1,1618,1641,-23,0,-124,66
1,1559,2013,-454,2,58,58
-1,1500,1989,-489,-6,-239,76
-1,1660,1620,40,0,-41,72
-1,1298,1414,-116,0,56,102
1,1468,1587,-119,0,19,55
-1,1631,1648,-17,-1,-445,136
-1,1405,1736,-331,0,-344,94
-1,1648,1631,17,1,-377,98
1,1546,1455,91,10,321,58
1,1634,1279,355,-1,-74,53
-1,1642,1658,-16,6,-49,64
1,1167,1517,-350,-10,-204,50
-1,1375,1433,-58,-6,-561,92
-1,1668,1632,36,-3,-96,56
1,1644,1656,-12,0,-2,41
-1,1647,1661,-14,-3,-19,56
-1,1784,2035,-251,-2,-105,124
1,1651,1769,-118,0,-12,103
-1,1458,1477,-19,-2,-93,57
-1,1646,1654,-8,-2,-99,64
-1,1530,1645,-115,-2,-53,54
1,1635,1665,-30,-5,-170,51
1,1655,1736,-81,0,-34,77
1,1497,1395,102,4,267,83
-1,1626,1653,-27,-8,-376,72
-1,1653,1626,27,3,27,44
-1,1637,1642,-5,-5,-147,44
1,1637,1642,-5,-2,-39,77
1,1601,1772,-171,-5,-172,105
1,1272,1423,-151,4,924,135
-1,1493,1220,273,1,-361,104
-1,1529,1401,128,-6,-294,66
1,1920,2040,-120,-1,58,85
-1,1637,1642,-5,1,-230,84
1,1432,1387,45,11,434,61
-1,1653,1627,26,6,133,50
-1,2024,1934,90,0,201,108
1,1636,1519,117,1,36,69
-1,1638,1642,-4,0,4,58
1,1189,1156,33,-3,-172,79
-1,1947,2009,-62,0,8,64
1,1648,1652,-4,1,36,55
1,1515,1467,48,0,41,59
0,1376,1434,-58,2,-150,115
-1,1466,1621,-155,-3,-47,74
-1,1739,1954,-215,0,-172,88
1,1641,1659,-18,1,201,85
1,1625,1104,521,4,318,77
1,1644,1643,1,5,116,53
1,1648,1652,-4,0,-2,43
-1,1390,1560,-170,-2,-24,72
-1,1369,1710,-341,-3,-466,120
-1,1836,1928,-92,-2,-77,58
-1,1300,1471,-171,1,9,44
-1,1645,1641,4,-7,-352,90
1,1663,1566,97,-5,-82,71
1,1377,1182,195,0,-5,55
1,1161,1413,-252,-1,-65,53
1,1936,1828,108,1,23,53
1,1695,1635,60,13,535,71
1,1558,1671,-113,5,656,95
1,1733,1500,233,0,47,81
-1,1572,1657,-85,1,29,60
1,1821,1944,-123,0,-11,43
-1,1665,1564,101,0,-228,76
-1,1627,1734,-107,0,-53,117
1,1479,1378,101,9,706,75
-1,1960,1811,149,-4,-273,84
-1,1391,1281,110,-1,-106,76
-1,1577,1652,-75,-1,0,100
-1,1644,1618,26,-1,-3,50
1,1930,1875,55,-11,-32,85
0,1305,1665,-360,12,716,89
1,1546,1437,109,-3,-365,133
1,1660,1569,91,6,484,107
1,2066,1971,95,1,46,67
-1,1366,1500,-134,-7,-265,58
-1,1764,1619,145,0,-44,66
-1,1500,1578,-78,-2,-136,126
1,1630,1629,1,0,29,57
1,1561,1668,-107,3,228,83
1,1370,1489,-119,0,2,45
-1,1427,1433,-6,-3,-105,68
-1,1626,1500,126,-4,-135,58
-1,1348,1537,-189,-3,-91,54
-1,1511,1655,-144,-2,15,44
-1,1634,1711,-77,-1,-132,94
-1,1654,1575,79,-21,-285,46
1,1629,1352,277,8,131,41
-1,1373,1687,-314,-11,-383,56
1,1471,1385,86,7,240,63
1,1616,1591,25,3,73,55
1,1600,1629,-29,6,294,61
-1,1631,1632,-1,-1,-431,105
-1,1657,2019,-362,0,48,102
-1,1612,1618,-6,2,212,62
-1,1627,1575,52,-2,-59,66
-1,1376,1481,-105,0,29,46
1,1738,1625,113,3,126,65
1,1559,1282,277,7,260,53
-1,1628,1601,27,-9,-484,72
-1,1315,1404,-89,-8,-960,100
1,1617,1613,4,1,-41,47
-1,1500,1389,111,-12,-723,86
-1,1618,1761,-143,1,-41,98
-1,1835,1937,-102,-4,-141,126
-1,1627,1602,25,-1,175,44
-1,1554,1347,207,-3,-95,76
1,1602,1627,-25,10,528,101
-1,1738,1690,48,-11,-376,70
-1,1838,1942,-104,-2,-57,52
1,1419,1370,49,3,116,59
1,1599,1775,-176,0,8,41
-1,1500,1415,85,-1,-105,106
-1,1619,1763,-144,-7,-213,68
-1,1243,1575,-332,-12,-579,70
-1,1633,1370,263,-8,-144,58
-1,1614,1400,214,-1,-256,158
-1,1360,1428,-68,-15,-312,44
-1,1629,1767,-138,1,41,42
-1,1369,1619,-250,-2,-293,89
1,1767,1629,138,5,272,71
-1,1539,1658,-119,-2,-174,64
1,1769,1705,64,1,134,109
1,1437,1351,86,3,107,49
1,1536,1439,97,3,59,49
1,1597,1616,-19,9,597,77
1,1742,1775,-33,-2,-288,103
-1,1616,1597,19,-4,-16,88
1,2139,1274,865,0,-7,63
1,1762,1754,8,-2,243,97
1,1605,1609,-4,-6,-335,85
1,1532,1699,-167,1,107,107
1,1342,1445,-103,-2,307,123
-1,1951,1825,126,-1,-88,100
1,1743,1773,-30,-1,118,91
1,1664,1418,246,2,226,111
1,1842,1519,323,0,-100,79
1,1616,1598,18,0,237,105
1,1584,1663,-79,1,46,69
-1,1317,1605,-288,-2,-852,106
-1,1272,2139,-867,-3,-64,48
-1,1761,1755,6,0,-71,98
-1,1939,1796,143,-3,-55,52
1,1626,1588,38,6,969,171
1,1627,1624,3,3,264,77
-1,1750,1754,-4,-4,-87,56
-1,1445,1365,80,-6,-376,86
0,1635,1739,-104,-5,85,118
-1,1764,1939,-175,0,-95,98
-1,1431,1357,74,-9,-585,82
1,1407,1183,224,6,54,42
0,1261,1100,161,1,476,133
-1,1812,2089,-277,-2,-104,66
-1,1630,1578,52,-7,-353,56
-1,1618,1590,28,-6,-214,50
-1,1547,1772,-225,-11,-618,80
-1,1779,1822,-43,-7,-233,68
-1,1160,1416,-256,-2,-39,48
-1,1744,1758,-14,-5,-535,84
-1,1845,1777,68,-3,-44,44
1,1411,1669,-258,0,97,53
-1,1607,1602,5,3,89,126
-1,1733,2041,-308,-1,-69,56
1,1612,1638,-26,1,447,113
-1,1808,2093,-285,4,-30,138
-1,1596,1613,-17,-7,-217,58
1,1469,1475,-6,-1,122,73
-1,1313,1493,-180,-1,-352,97
-1,1932,2061,-129,0,-3,48
1,2045,1723,322,1,16,47
-1,1454,1769,-315,-1,-95,68
1,1722,1702,20,3,100,56
1,2049,1603,446,1,132,73
1,1505,1831,-326,0,47,81
1,1749,1767,-18,2,44,51
1,1461,1382,79,0,-46,73
1,1586,1623,-37,-3,-125,53
-1,1602,2051,-449,-1,-32,122
0,1463,1481,-18,-11,8,119
-1,1934,1849,85,0,-15,68
-1,1611,1598,13,-4,-94,100
1,1791,1925,-134,0,-6,65
-1,1542,1478,64,-3,-103,64
1,1692,1733,-41,1,6,61
1,1425,1656,-231,2,36,43
-1,1600,1609,-9,6,577,110
1,1418,1330,88,-1,259,123
1,2097,1627,470,2,104,67
1,1590,1619,-29,4,108,73
-1,1756,1755,1,-8,-169,52
-1,1451,1519,-68,1,72,54
1,1626,1625,1,1,54,77
-1,1638,1443,195,-1,-59,70
-1,1648,2026,-378,0,-134,116
0,1608,1765,-157,-4,-228,131
-1,1500,1833,-333,5,31,50
1,1721,1704,17,2,88,57
-1,1528,1649,-121,-10,-148,117
1,1601,1646,-45,0,381,95
1,2033,1777,256,-1,50,63
-1,1702,1759,-57,0,14,64
-1,1693,1717,-24,-1,-185,74
1,1874,1941,-67,0,44,79
-1,1644,1616,28,8,460,74
-1,1455,1532,-77,1,34,40
-1,1455,1306,149,-2,-75,110
0,1772,1642,130,0,146,133
-1,1951,1780,171,-9,-413,70
1,1597,1442,155,2,38,43
1,2038,1784,254,1,171,83
1,1628,1631,-3,3,610,103
1,1631,1628,3,2,334,83
-1,1779,2042,-263,-1,-35,66
1,1617,1620,-3,2,715,97
1,2042,1779,263,0,104,77
1,1674,1626,48,0,170,79
1,1647,1369,278,5,135,59
1,1871,1918,-47,0,21,105
1,1609,1628,-19,13,643,93
-1,1796,1935,-139,-2,-117,68
1,1736,1775,-39,-1,81,81
0,1620,1568,52,0,-855,114
-1,1617,1620,-3,-11,-805,116
-1,1762,1748,14,3,74,56
1,1483,1215,268,0,737,155
-1,1631,1606,25,-7,-145,44
1,1618,1620,-2,-6,-156,47
-1,1620,1618,2,-6,-194,50
1,2047,1750,297,2,216,69
1,1661,1623,38,0,130,93
1,1628,1608,20,-3,124,95
1,1759,1747,12,3,165,97
1,2051,1725,326,0,16,63
-1,1598,1638,-40,-8,-266,80
1,1500,1500,0,6,109,49
1,1844,1807,37,-1,191,99
1,1780,1667,113,1,95,75
-1,1707,1850,-143,0,3,46
0,1604,1324,280,0,241,147
1,1259,1113,146,3,177,63
1,1703,1078,625,3,84,47
1,1647,1588,59,-6,-199,61
-1,1588,1647,-59,4,71,76
1,1672,1589,83,0,89,75
-1,1520,1311,209,0,-87,94
1,1656,1579,77,-1,-27,45
-1,1701,1837,-136,-1,-79,79
1,1571,1664,-93,0,-8,61
1,1910,1797,113,1,108,81
1,1651,1584,67,0,26,69
1,2054,1778,276,0,897,143
1,1365,1248,117,0,1,61
-1,1613,1571,42,-6,-304,141
-1,1486,1707,-221,3,127,64
-1,1336,1541,-205,-2,-569,84
-1,1213,1419,-206,0,21,48
-1,1430,1575,-145,-2,-155,66
1,1793,1636,157,-5,122,107
1,1501,1637,-136,0,68,73
-1,1335,1453,-118,-1,-86,82
-1,1797,1706,91,-3,-303,88
-1,1749,1662,87,-2,-137,84
1,1753,1440,313,1,63,53
-1,1678,1705,-27,3,-181,106
1,1685,1623,62,-1,441,133
-1,1749,1719,30,3,70,98
-1,1799,1789,10,-3,-41,42
1,1650,1402,248,9,153,41
1,1348,1323,25,5,194,57
-1,1431,1490,-59,0,21,42
-1,1786,1718,68,-3,-8,40
-1,1590,1687,-97,0,30,64
1,1787,1728,59,0,28,63
-1,1600,1767,-167,0,-20,72
-1,1500,1500,0,-10,-81,46
1,1423,1424,-1,5,218,59
-1,1727,1731,-4,-2,-206,88
1,1799,1735,64,0,58,61
-1,1249,1326,-77,1,-118,110
-1,1266,1713,-447,0,-17,62
-1,1622,1543,79,-1,-117,72
1,1335,1222,113,2,32,43
-1,1612,1694,-82,1,-75,118
1,1500,1731,-231,-1,41,67
-1,1471,1629,-158,1,125,118
1,1516,1582,-66,0,309,127
-1,1320,1398,-78,-5,-156,74
-1,1770,1994,-224,-2,-115,70
-1,1435,1756,-321,-1,-13,44
-1,1805,1719,86,-3,-75,64
1,1715,1668,47,0,-6,51
-1,1676,1736,-60,-1,25,85
1,1691,1603,88,5,449,101
1,1524,1725,-201,-2,1,53
1,1714,1343,371,4,12,43
-1,1964,1999,-35,0,-31,90
1,1559,1538,21,-1,-15,57
1,1732,1695,37,5,519,141
-1,1327,1378,-51,-5,-200,58
-1,1614,1500,114,0,-108,61
-1,1426,1429,-3,-2,-792,112
1,1716,1472,244,0,11,47
1,1780,1732,48,-9,-15,55
-1,1534,1774,-240,1,-71,68
-1,1535,1970,-435,0,-215,94
-1,1260,1540,-280,2,325,114
1,1523,1437,86,0,94,58
1,1265,1317,-52,8,245,49
-1,1467,1721,-254,0,-284,98
-1,1500,1446,54,0,8,40
1,1717,1565,152,0,-22,59
-1,1727,1943,-216,-4,-44,44
1,1927,1724,203,5,185,61
-1,1564,1685,-121,-1,-21,80
1,1737,1511,226,0,2,43
-1,1642,1723,-81,-4,-70,44
-1,1722,1972,-250,-8,-513,78
-1,1529,1528,1,-1,-100,70
-1,1932,1771,161,0,-315,152
1,1289,1434,-145,-1,30,67
-1,1610,1496,114,-3,-119,124
1,1304,1279,25,-2,-38,79
1,1742,1506,236,1,109,59
-1,1742,1717,25,-7,-531,92
1,1953,1731,222,-4,293,97
1,1522,1355,167,2,67,99
1,1725,1463,262,1,37,57
-1,1419,1455,-36,-8,-11,42
-1,1501,1746,-245,-3,-84,60
0,1550,1489,61,-1,-517,110
-1,1746,1501,245,2,68,56
1,1522,1284,238,-3,70,107
0,1388,1693,-305,-10,-144,110
1,1680,1622,58,1,90,83
1,1729,1654,75,1,251,125
-1,1730,1701,29,0,-48,78
1,1778,1529,249,2,72,87
1,1436,1460,-24,-2,14,65
1,1518,1539,-21,-3,64,89
-1,1264,1469,-205,-1,-22,54
1,1465,1500,-35,0,133,71
1,1521,1751,-230,3,-30,63
-1,1540,1621,-81,-2,40,50
1,1741,1605,136,4,332,87
1,1718,1854,-136,0,69,85
1,1916,1789,127,0,63,71
-1,1591,1512,79,1,23,96
1,1733,1540,193,2,2,47
-1,1506,1683,-177,0,-141,68
1,1500,1763,-263,0,12,115
-1,1525,1980,-455,-3,-544,92
1,1339,1439,-100,9,144,42
-1,1534,1739,-205,-1,-54,58
-1,1396,1314,82,-1,-36,44
1,1803,1448,355,0,-12,57
1,1646,1738,-92,2,251,93
1,1709,1952,-243,3,483,105
-1,1569,1461,108,1,1,50
1,1302,1415,-113,5,215,65
1,1744,1528,216,1,88,53
1,1840,1789,51,0,76,65
1,1386,1500,-114,0,-70,123
-1,1636,1629,7,-2,-122,76
-1,1592,1475,117,2,60,46
-1,913,0,913,-1,-310,94
-1,1174,1984,-810,-1,-56,50
1,1934,1727,207,3,116,87
-1,1522,1749,-227,0,17,64
1,1924,2131,-207,1,17,45
1,1453,1126,327,3,271,73
1,1807,1554,253,2,535,129
-1,1237,1329,-92,-2,-252,85
-1,1783,1848,-65,0,-33,76
1,1648,1491,157,4,95,45
1,1724,1659,65,0,279,113
-1,1332,1476,-144,-2,-87,76
1,1258,1382,-124,0,342,93
-1,1173,1984,-811,-1,-77,76
1,1822,1307,515,3,97,55
1,1280,1529,-249,0,7,51
1,1500,1654,-154,-1,8,53
-1,1959,1726,233,2,37,52
1,1857,1940,-83,0,-22,85
1,1984,1173,811,0,97,61
1,1465,1432,33,-3,220,65
1,1991,1517,474,1,-9,69
1,1938,2009,-71,-1,8,44
-1,1359,1501,-142,0,-237,94
1,1926,1869,57,4,131,75
1,1390,1243,147,2,41,51
-1,1538,1458,80,1,36,64
-1,1173,1985,-812,-2,-84,70
-1,1267,1384,-117,-9,-333,54
1,1644,1722,-78,-2,-43,65
1,1869,2024,-155,7,118,47
1,1861,1935,-74,2,256,84
-1,1515,1993,-478,1,29,68
1,1532,1549,-17,0,58,59
1,1439,1337,102,12,258,53
1,1814,1996,-182,0,35,53
-1,1172,1985,-813,0,-109,68
1,1939,1500,439,0,95,81
-1,1952,1832,120,-10,-248,42
1,1168,1337,-169,13,184,43
0,1922,1873,49,-2,-115,108
-1,1624,1979,-355,-2,-182,74
-1,1223,1397,-174,-4,-130,54
1,1875,1920,-45,0,59,103
-1,1275,1389,-114,1,-39,102
1,1680,1548,132,2,155,57
-1,1743,1504,239,-6,-371,56
-1,1518,1549,-31,-1,-15,62
1,1525,1577,-52,-10,-34,75
0,1716,1658,58,4,-77,86
1,1328,1287,41,3,131,47
1,1285,1839,-554,-1,24,87
-1,1908,1886,22,1,-24,80
1,1517,1354,163,5,243,73
-1,1621,1538,83,1,-43,112
-1,1260,1483,-223,0,52,112
1,1750,1999,-249,0,-20,59
-1,1685,1726,-41,-7,-298,78
1,1405,1457,-52,1,114,54
-1,1598,1801,-203,-2,-113,77
1,1403,1673,-270,0,299,127
1,1514,1305,209,2,135,69
1,1714,1660,54,0,511,121
0,1854,1982,-128,-5,-123,113
-1,1594,1985,-391,-7,-48,40
-1,1332,1452,-120,-8,-161,48
-1,1277,1315,-38,-1,-15,60
1,1941,1719,222,-3,254,75
1,1841,1742,99,-7,-274,55
-1,1500,1989,-489,-1,-65,68
0,1607,1559,48,1,147,71
-1,1410,1675,-265,0,7,64
-1,1708,1992,-284,6,411,82
1,1650,1768,-118,5,200,63
-1,1399,1459,-60,-1,-181,90
1,1376,1422,-46,3,51,55
-1,1619,1447,172,1,-427,110
1,1860,1567,293,0,78,71
-1,1476,1545,-69,-3,-133,60
1,1694,1735,-41,-3,-7,59
1,1605,1560,45,-8,495,129
-1,1679,1406,273,-2,-1005,164
-1,1486,1781,-295,-1,-82,77
1,1655,1423,232,1,53,65
-1,1753,1665,88,1,28,66
-1,1353,1766,-413,-12,-375,54
1,1254,1267,-13,0,0,49
-1,1462,1450,12,3,139,86
1,1564,1865,-301,0,44,77
-1,1757,1997,-240,-1,-267,134
1,1669,1522,147,2,-39,86
-1,1679,1739,-60,7,39,40
1,1585,1481,104,1,295,79
1,1800,1488,312,1,191,67
-1,1541,1450,91,-5,-433,66
0,1753,1713,40,-1,105,141
1,1748,1669,79,2,86,59
0,1752,1618,134,-3,-362,92
-1,1562,1423,139,2,-73,72
-1,1660,1706,-46,0,-58,66
1,1906,1893,13,0,-111,87
-1,1661,1757,-96,-1,-137,96
1,1947,1458,489,1,26,43
-1,1622,1748,-126,-1,-87,80
1,1464,1451,13,-1,-3,65
-1,1286,1271,15,-2,50,66
1,1254,1285,-31,-4,6,51
-1,1615,1473,142,1,75,70
-1,1504,1504,0,-8,-117,54
-1,1266,1353,-87,-2,-254,88
1,1755,1615,140,13,353,51
-1,1533,1979,-446,0,-40,70
1,1714,1751,-37,2,32,51
1,1708,1428,280,0,60,53
-1,1608,1519,89,-1,-196,85
1,1394,1475,-81,1,279,81
1,1838,1474,364,0,110,53
1,1915,1765,150,-1,-203,73
-1,1445,1660,-215,-1,-34,56
-1,1751,1922,-171,0,89,102
1,1739,1726,13,0,212,155
-1,1716,1650,66,-1,-17,64
1,1771,1667,104,0,-14,51
-1,1599,1935,-336,-1,-31,46
-1,1729,1882,-153,-2,-116,120
-1,1054,1489,-435,-8,-168,48
1,1461,1457,4,0,651,141
-1,1266,1239,27,0,22,74
1,1928,1744,184,-1,-406,101
1,1666,1439,227,-1,-49,61
-1,1934,1739,195,-2,-333,118
-1,1237,1439,-202,-1,-7,44
1,1463,1593,-130,-3,-51,78
1,1596,1500,96,0,-3,63
1,1949,1553,396,1,149,81
1,1588,1537,51,-1,-205,91
1,1652,1786,-134,1,68,52
-1,1412,1473,-61,-8,-731,102
-1,1425,1491,-66,-10,-920,114
1,1667,1771,-104,-3,-5,120
1,1456,1721,-265,0,7,67
-1,1493,1424,69,0,-42,78
1,1842,1721,121,1,153,103
-1,1366,1603,-237,-3,-86,52
-1,1397,1439,-42,-2,-37,104
1,1547,1477,70,-1,-46,55
1,1578,1479,99,11,529,63
-1,1409,1670,-261,-2,-44,60
-1,1346,1381,-35,-2,-246,60
-1,1757,1755,2,1,82,82
-1,1500,1671,-171,-1,43,66
1,1482,1378,104,-1,1,73
-1,1607,1310,297,0,-20,92
-1,1853,1978,-125,-5,-100,50
1,1583,1353,230,1,74,66
1,1500,1415,85,1,64,95
-1,1641,1716,-75,1,-144,88
-1,1641,1586,55,1,11,78
1,1352,1491,-139,12,342,53
1,1443,1386,57,0,-268,101
-1,1392,1434,-42,-2,-195,150
-1,1767,1755,12,-9,-198,42
1,1691,1676,15,-1,168,101
-1,1676,1960,-284,-2,-152,60
1,1475,1399,76,20,194,40
0,1755,1745,10,1,148,113
1,1376,1468,-92,0,-2,45
1,1433,1391,42,3,34,81
-1,1254,1500,-246,-1,-191,138
1,1952,1439,513,1,81,59
1,1360,1161,199,3,261,91
1,1424,1468,-44,-5,-34,45
1,1745,1755,-10,0,11,49
-1,1407,1509,-102,-3,-231,80
1,1380,1456,-76,2,37,47
1,1480,1367,113,-3,-210,115
-1,1665,1987,-322,-1,-22,42
1,1756,1744,12,9,210,51
-1,1396,1379,17,-5,-354,66
1,1426,1394,32,0,206,83
-1,1560,1733,-173,-4,-18,42
1,1672,1733,-61,-3,-45,55
1,1672,1568,104,1,-27,106
-1,1554,1981,-427,-4,-344,92
1,1337,1662,-325,12,318,59
1,1447,1384,63,0,8,61
1,1767,1685,82,1,163,108
1,1500,1500,0,7,340,42
1,1622,1843,-221,-1,-66,87
1,1953,1662,291,1,436,97
1,1534,1599,-65,-2,47,63
1,1983,1552,431,7,102,61
1,1905,1677,228,0,257,93
-1,1575,1533,42,-3,-727,108
-1,1414,1822,-408,-3,-261,98
-1,1856,1940,-84,0,-63,54
-1,1798,1768,30,1,-91,72
1,1327,1285,42,-5,58,83
-1,1940,1856,84,-5,-198,92
-1,1845,1645,200,-3,-587,116
1,1524,1336,188,8,117,41
-1,1948,1870,78,-3,-268,72
-1,1642,1928,-286,-6,-146,50
1,1507,1584,-77,0,-7,59
1,1861,1935,-74,0,120,75
1,1855,1767,88,-3,34,65
-1,1400,1390,10,-2,-355,100
-1,1773,1500,273,0,-4,88
-1,1829,1661,168,3,-346,90
-1,1837,1923,-86,-9,-533,70
1,1627,1243,384,9,112,45
1,1780,1787,-7,-5,-128,61
-1,1783,2049,-266,-4,-187,62
-1,1453,1420,33,-3,-263,115
1,1812,1858,-46,1,74,75
1,1555,1671,-116,3,128,75
-1,1828,1931,-103,-9,-13,40
1,1759,1863,-104,-1,-24,59
-1,1672,1909,-237,2,132,58
-1,1670,1819,-149,-1,-93,66
1,1491,1545,-54,6,227,99
-1,1395,1504,-109,-7,-316,70
-1,1938,1932,6,1,-32,96
1,1296,1416,-120,-1,-1,51
-1,1234,1356,-122,2,156,110
1,1776,1790,-14,0,-44,63
1,1604,1433,171,2,1,41
-1,1826,1663,163,-2,-490,140
1,1969,1613,356,1,-1,41
-1,1500,1255,245,-17,-229,43
1,1610,1523,87,2,59,51
1,1846,1849,-3,0,67,148
-1,1561,1662,-101,-1,-268,108
0,1881,1928,-47,-2,-297,141
1,1864,1557,307,2,141,59
-1,1679,1810,-131,-2,-255,84
0,1605,1530,75,-3,-664,122
1,1914,1667,247,-3,11,47
1,1630,1500,130,2,194,61
1,1718,1428,290,6,102,43
1,1926,1883,43,2,-9,43
1,1602,1532,70,-6,-121,63
1,1779,1787,-8,0,13,55
-1,1873,1935,-62,-4,-243,104
-1,1433,1441,-8,0,-676,106
1,1817,1672,145,1,39,49
1,1972,1773,199,3,68,42
1,1611,1522,89,7,547,79
-1,1944,1863,81,1,111,78
-1,1665,1824,-159,-1,-171,114
1,1546,1683,-137,0,-15,59
-1,1776,1790,-14,-1,-388,154
-1,1877,1931,-54,2,126,62
-1,1402,1513,-111,0,18,64
1,1838,1767,71,8,179,57
-1,1493,1824,-331,-6,-21,42
1,1931,1877,54,0,86,51
-1,1636,1385,251,1,70,86
-1,1619,1636,-17,0,-152,64
1,1831,1659,172,5,236,85
0,1868,1940,-72,0,-73,141
-1,1313,1472,-159,1,-167,110
-1,1689,1863,-174,0,-168,90
1,2004,1765,239,0,225,145
1,1452,1421,31,3,927,117
-1,1778,1779,-1,0,8,54
-1,1663,1561,102,-1,-44,80
-1,1615,1914,-299,-5,-38,40
1,1938,1870,68,1,391,95
-1,1653,1837,-184,1,205,100
-1,1582,1945,-363,-2,-138,74
0,1933,1875,58,-1,-125,126
1,1525,1379,146,4,420,87
-1,1337,1468,-131,-17,-98,40
1,1843,1647,196,2,87,71
-1,1575,1645,-70,-6,-657,92
1,1616,1687,-71,-1,-12,85
1,1979,1763,216,1,49,65
1,1948,1513,435,-6,-253,73
1,1783,1647,136,-1,-70,87
0,2008,1866,142,0,58,102
1,1876,1932,-56,2,64,63
-1,1869,1683,186,1,54,76
-1,1653,1956,-303,-3,-58,48
1,1932,1876,56,-2,-35,49
1,1867,1920,-53,2,94,59
1,1641,1848,-207,-1,-35,75
1,1800,1766,34,-1,323,113
1,1656,1566,90,0,164,105
-1,1908,1880,28,1,-228,116
-1,1892,1897,-5,-5,-15,40
-1,1831,1659,172,0,327,108
-1,1649,1340,309,1,-533,130
1,1907,1881,26,0,158,79
-1,1500,1500,0,-11,-302,56
-1,1410,1407,3,-6,-325,68
-1,1871,1917,-46,-5,-473,152
1,1631,1520,111,-3,-10,61
-1,1675,1815,-140,0,7,58
1,1558,1667,-109,-4,25,63
-1,1412,1329,83,-11,-944,90
1,1926,1861,65,5,97,47
-1,1790,1640,150,2,-24,60
-1,1520,1500,20,0,-27,72
1,1852,1934,-82,0,248,113
-1,1757,1809,-52,1,199,88
-1,1655,1774,-119,3,95,90
1,1709,1479,230,1,15,41
-1,1649,1572,77,1,10,66
-1,1921,1866,55,-2,-73,62
1,1531,1549,-18,2,85,61
1,1822,1526,296,1,86,69
-1,1782,1648,134,-1,-150,78
1,1446,1652,-206,-4,-154,69
-1,1878,1909,-31,-5,-423,122
1,1714,1531,183,0,16,69
1,2004,1870,134,0,-7,45
-1,1387,1521,-134,-9,-106,44
-1,1919,1868,51,-2,-276,148
-1,1522,1825,-303,0,-326,94
-1,1766,1863,-97,-3,-259,68
-1,1500,1509,-9,-4,-213,55
-1,1760,2011,-251,-5,-62,92
1,1585,1633,-48,0,24,103
1,1754,1767,-13,0,24,51
0,1818,1748,70,0,26,98
-1,1881,1907,-26,-1,-478,94
1,1829,1777,52,-5,-82,103
1,1917,1871,46,3,119,67
1,1642,1350,292,1,144,83
1,1861,1926,-65,-3,-24,47
1,1619,1597,22,16,502,63
-1,1543,1894,-351,0,-64,96
-1,1913,1874,39,-3,34,118
1,1603,1522,81,0,266,77
1,1549,1397,152,5,467,99
-1,1838,1724,114,0,6,60
1,1525,1720,-195,0,405,147
1,1886,1902,-16,0,129,79
-1,1316,1333,-17,-5,-178,56
-1,1750,1816,-66,-1,-112,74
-1,1846,2118,-272,-4,-3,54
1,1540,1379,161,3,190,67
1,1757,1755,2,1,74,69
-1,1891,1897,-6,-7,-315,68
-1,1401,1347,54,1,226,78
1,1587,1631,-44,-2,-127,91
1,1907,1881,26,0,2,61
1,1646,1278,368,-1,-252,75
1,1569,1425,144,3,164,77
-1,1896,1892,4,-7,-305,78
-1,1883,1897,-14,0,-43,53
-1,1896,1902,-6,-1,-99,148
1,1773,1468,305,2,93,87
-1,1388,1360,28,2,36,44
-1,1902,1896,6,-6,-173,60
1,1474,1639,-165,1,428,107
0,1892,1896,-4,0,213,129
1,1769,1689,80,-1,-123,81
-1,1913,1907,6,-2,-255,74
-1,1649,1718,-69,-1,-423,154
1,1917,1902,15,-2,-84,99
0,1565,1390,175,2,92,112
-1,1702,2123,-421,-2,-89,70
1,1892,1927,-35,0,67,129
1,1927,1892,35,-1,-83,95
1,1490,1349,141,0,30,61
1,1626,1842,-216,0,-14,43
-1,1904,1916,-12,0,23,76
1,1478,1410,68,1,50,41
-1,1520,1520,0,5,151,60
-1,1926,1894,32,-1,-310,118
-1,1700,1639,61,1,-91,74
0,1210,1435,-225,2,142,114
-1,1530,1433,97,0,-304,74
-1,2020,1739,281,-1,-3,42
1,1517,1329,188,15,421,55
-1,1905,1915,-10,-1,-110,94
1,1343,1372,-29,11,200,45
-1,1639,1373,266,-5,-396,100
1,1778,1824,-46,0,-186,83
-1,1895,1811,84,0,-61,76
1,1754,1835,-81,-1,35,87
-1,1791,1686,105,-2,-32,60
1,1490,1397,93,4,136,54
1,1882,1825,57,0,146,97
-1,1443,1683,-240,0,13,68
1,1653,1687,-34,4,299,89
-1,1554,1460,94,-2,-63,46
1,1367,1392,-25,1,62,53
-1,1776,1816,-40,1,89,84
1,1599,1595,4,0,14,63
-1,1528,1619,-91,0,-239,136
-1,1891,1826,65,-4,-136,72
1,1379,1380,-1,-4,-10,55
1,1674,1666,8,0,23,87
1,1507,1500,7,4,72,47
-1,1523,1825,-302,-5,-293,70
1,1839,1879,-40,2,14,63
-1,1515,1328,187,2,39,76
1,1474,1525,-51,1,31,56
1,1867,1852,15,-6,-195,81
1,1648,1351,297,4,125,51
1,1701,1794,-93,0,16,57
1,1517,1494,23,0,92,57
-1,1390,1368,22,-3,-239,80
1,1841,1877,-36,0,-13,85
-1,1766,1603,163,-1,-224,60
1,1540,1418,122,-4,-578,109
1,1715,1735,-20,4,102,49
-1,1688,1430,258,-3,122,120
1,1866,1853,13,7,234,69
-1,1600,1613,-13,-1,-38,72
1,2126,1643,483,1,7,87
1,1752,1716,36,3,104,105
1,1654,1685,-31,5,354,89
1,1843,1876,-33,2,219,79
-1,1441,1490,-49,-5,-356,71
-1,1361,1873,-512,2,40,60
1,1610,1500,110,2,43,71
1,1380,1378,2,6,176,59
1,1874,1360,514,3,132,63
-1,1761,1862,-101,-4,-235,96
-1,1602,1409,193,-1,-99,66
1,1380,1633,-253,-5,71,57
-1,1359,1876,-517,-3,-109,66
1,1616,1640,-24,-2,-46,49
1,1389,1342,47,-2,85,65
1,1753,1657,96,1,185,81
-1,1673,1667,6,1,-28,58
1,1641,1590,51,22,360,43
-1,1215,1218,-3,-3,-320,76
1,1501,1431,70,0,285,101
1,1870,1820,50,0,109,121
1,1582,1473,109,0,65,61
1,1753,1799,-46,2,471,97
1,1616,1295,321,-1,46,41
1,1613,1404,209,0,-8,69
-1,1552,1497,55,-2,-56,44
1,2128,1627,501,1,923,141
-1,1395,1500,-105,-5,-189,62
-1,1485,1760,-275,-2,-249,68
-1,1730,1661,69,0,-76,72
-1,1753,1887,-134,-2,-47,50
0,1232,1592,-360,1,-250,129
1,1498,1389,109,-2,-42,205
1,1500,1388,112,5,468,79
-1,1422,1511,-89,4,243,62
1,1537,1466,71,1,47,51
-1,1658,1652,6,0,-8,50
-1,1664,1746,-82,-5,-188,74
1,1234,1132,102,-2,225,103
1,1653,2024,-371,2,150,59
1,1787,1765,22,-1,-131,85
1,2132,1136,996,4,118,51
0,1755,1655,100,-3,479,127
-1,1558,1580,-22,0,-50,78
1,1521,1413,108,4,357,85
1,1769,1481,288,5,187,57
1,1600,1420,180,2,38,40
1,1547,1457,90,3,239,75
1,1984,1581,403,0,10,61
-1,1658,1877,-219,1,-21,104
1,1883,1653,230,9,228,47
1,1412,1606,-194,-3,9,75
1,1752,1648,104,-6,-181,83
1,1448,1628,-180,-1,-78,53
-1,1550,1404,146,0,-13,58
-1,1760,1640,120,1,93,84
1,1987,1681,306,3,34,43
1,2132,1687,445,0,336,95
1,1655,1368,287,0,152,57
1,1535,1419,116,1,321,119
-1,1363,1659,-296,-14,-477,68
-1,1643,1629,14,-1,-61,76
-1,1745,1648,97,0,43,88
1,1588,1434,154,0,8,51
-1,1731,1661,70,-4,-97,60
0,1579,1542,37,0,-120,165
-1,1655,1579,76,-2,-159,82
1,1394,1242,152,1,201,149
1,1731,1369,362,0,34,55
1,1426,1595,-169,1,10,57
-1,1924,2137,-213,0,-80,90
-1,1406,1203,203,0,-45,62
-1,1625,1578,47,2,-89,76
-1,1717,1673,44,1,328,116
1,1692,1697,-5,-1,242,77
1,1464,1651,-187,3,165,67
1,1663,1705,-42,-1,-21,63
1,1500,1612,-112,5,94,55
1,1592,1642,-50,-1,-10,51
1,1699,1634,65,-1,-125,79
-1,1578,1446,132,-1,-31,74
-1,1428,1511,-83,-5,-264,70
1,1576,1418,158,-1,-2,51
0,1420,1298,122,4,189,134
1,1952,1734,218,6,215,59
1,1812,1773,39,1,-14,63
1,2005,1927,78,-4,-19,91
-1,1202,1383,-181,4,208,58
-1,1527,1564,-37,0,44,80
0,1380,1520,-140,-1,48,113
-1,1410,1441,-31,2,98,98
-1,1380,1577,-197,-7,-168,52
1,1769,1845,-76,0,-43,81
1,1797,1669,128,0,159,63
-1,1682,1802,-120,-3,-294,124
0,1657,1744,-87,1,396,136
-1,1351,1544,-193,-10,-615,66
1,1462,1401,61,6,491,83
1,1682,1613,69,-1,-22,43
1,1471,1195,276,0,152,77
-1,1604,1611,-7,-2,-44,58
-1,1722,1677,45,-2,-69,54
-1,1462,1346,116,1,-429,126
1,1722,1677,45,-1,202,85
1,1725,1602,123,4,88,49
-1,1375,1415,-40,-2,-169,82
1,1667,1710,-43,2,351,79
-1,1385,1709,-324,-3,-134,74
1,1596,1500,96,16,453,51
-1,1698,1680,18,0,-215,72
1,1500,1301,199,7,154,44
-1,1550,1584,-34,-1,14,70
1,1507,1444,63,0,156,82
-1,1692,1789,-97,-1,-447,94
1,1552,1317,235,1,433,133
1,1687,1500,187,5,149,51
-1,1257,1589,-332,-6,-16,40
1,1797,1840,-43,-2,-16,43
1,1713,1381,332,3,120,63
1,1595,1538,57,1,-100,85
1,1797,1840,-43,0,55,121
1,1592,1523,69,-1,-13,53
-1,1734,1983,-249,0,-85,116
1,1892,1675,217,0,52,57
1,1828,1732,96,-2,345,113
-1,1363,1447,-84,-3,-46,55
-1,1435,1500,-65,-2,-122,45
1,1605,1681,-76,0,-225,107
1,2014,1818,196,1,173,97
-1,1691,1603,88,-6,-191,48
1,1753,1507,246,2,105,57
-1,1705,1738,-33,-1,-154,66
-1,1363,1428,-65,-1,102,50
1,1668,1620,48,2,254,65
-1,1692,1500,192,-4,-38,50
-1,1249,1284,-35,0,-49,70
-1,1682,1813,-131,0,-6,52
1,1836,1724,112,5,313,97
1,1365,1350,15,-4,-45,41
0,1625,1758,-133,5,735,161
-1,1610,1677,-67,3,100,50
-1,1677,1695,-18,0,-179,78
1,1668,1571,97,0,43,65
1,1886,1374,512,1,37,65
-1,1487,1455,32,-1,-12,46
1,1487,1467,20,-10,-147,59
-1,1190,1238,-48,2,55,66
-1,1692,1527,165,-4,-421,60
1,1670,1940,-270,-1,-8,57
-1,1778,1612,166,-4,-152,64
-1,1716,1843,-127,1,-1,42
-1,1677,1686,-9,0,-544,168
1,1620,1163,457,2,592,93
-1,1292,1559,-267,-13,-194,40
-1,1242,1557,-315,4,-213,84
-1,1295,1238,57,-2,-31,73
1,1628,1717,-89,3,-37,63
0,1697,1666,31,2,183,118
-1,1577,1763,-186,3,31,56
-1,1376,1330,46,-3,-106,60
-1,1630,1753,-123,-2,-123,84
1,1850,1783,67,3,75,55
1,1506,1456,50,-1,315,155
-1,1699,1643,56,1,-1,48
1,1686,1930,-244,0,63,57
1,1657,1810,-153,-3,611,175
1,1252,1281,-29,2,196,69
1,1713,1553,160,0,-10,79
1,1770,1571,199,-1,4,51
-1,1344,1719,-375,-5,-16,42
1,1346,1339,7,-4,-142,51
1,1761,1297,464,20,346,41
1,1546,1607,-61,5,263,73
-1,1912,1704,208,-1,63,76
-1,1859,1645,214,0,-27,60
-1,1263,1462,-199,-2,-134,54
1,1346,1322,24,-1,-48,51
1,1363,1436,-73,-2,80,81
1,1775,1622,153,3,304,91
1,1594,1596,-2,0,-144,97
-1,1497,1298,199,-4,8,44
1,1614,1781,-167,-4,-80,93
-1,1516,1667,-151,0,-115,82
1,1680,1555,125,0,12,55
1,1587,1618,-31,1,49,57
-1,1468,1503,-35,-1,-486,104
-1,1519,1653,-134,0,-546,84
-1,1189,1272,-83,5,421,80
0,1687,1467,220,-3,175,173
-1,1557,1605,-48,-4,-47,44
1,1384,1552,-168,-2,-23,45
1,1735,1607,128,0,199,77
1,1516,1341,175,-9,-147,56
-1,1366,1730,-364,-1,-36,53
-1,1615,1527,88,-3,-662,86
-1,1599,1565,34,-9,-403,66
-1,1473,1681,-208,-7,-1819,128
-1,1341,1633,-292,-9,-384,77
1,1180,1223,-43,0,-18,63
1,1567,1601,-34,0,146,107
1,1686,1548,138,-1,84,51
-1,1450,1451,-1,-6,-410,94
1,1571,1343,228,-1,460,93
-1,1598,1567,31,0,8,74
-1,1394,1377,17,0,-15,46
1,1849,2090,-241,0,-33,77
1,1447,1324,123,-4,-92,59
1,1676,1416,260,1,548,119
-1,2090,1849,241,-4,77,104
1,1194,1582,-388,5,129,45
-1,1352,1500,-148,-3,-50,51
1,1277,1429,-152,2,405,119
1,1904,1820,84,-1,185,133
-1,1513,1457,56,1,-124,82
1,1509,1547,-38,-1,-87,63
0,1521,1472,49,0,186,103
1,1887,2073,-186,0,-22,97
-1,1651,1346,305,3,163,64
1,1585,1579,6,0,-35,77
-1,1634,1904,-270,-1,-10,48
-1,1682,1369,313,-9,-84,42
-1,1422,1454,-32,0,-126,75
1,1151,1223,-72,-4,-250,61
-1,927,1629,-702,-4,-42,42
-1,1582,1342,240,-1,-43,60
1,1909,1630,279,-1,-14,47
-1,1754,2056,-302,-4,-188,64
1,1470,1500,-30,-1,-6,97
-1,1520,1584,-64,-3,-54,54
-1,1014,1501,-487,-2,-39,50
1,1563,1304,259,0,25,49
-1,1412,1743,-331,1,-162,70
-1,1380,1522,-142,0,-31,50
-1,1479,1732,-253,0,-61,60
-1,1555,1251,304,-1,-44,42
-1,1626,1913,-287,0,-26,56
1,1482,1514,-32,7,549,79
1,1745,955,790,9,473,61
1,1294,1363,-69,4,87,41
1,1210,1255,-45,1,116,52
-1,1426,1663,-237,-1,-168,76
-1,1750,1745,5,0,-76,80
1,1738,1820,-82,0,9,61
1,1250,1173,77,-6,7,45
1,1479,1269,210,5,188,55
-1,1511,1421,90,-5,-102,66
1,1253,1500,-247,5,501,75
1,1807,1753,54,0,-11,63
-1,1568,1894,-326,0,-204,80
-1,1344,1349,-5,-13,-807,100
-1,1483,1309,174,-11,-933,92
-1,1917,1500,417,0,-146,108
-1,1743,1816,-73,3,42,60
-1,1338,1264,74,-12,-257,50
-1,1509,1548,-39,-15,-528,80
1,1497,1405,92,7,154,55
1,1572,1357,215,6,162,55
-1,1824,1734,90,-1,-109,102
1,1629,1436,193,2,89,51
1,1223,1031,192,10,371,53
-1,1265,1529,-264,-11,-1659,144
-1,1351,1578,-227,0,-134,84
1,1505,1472,33,0,-9,60
1,1981,1903,78,-1,-21,121
-1,1748,1811,-63,0,-6,50
1,1499,1562,-63,12,505,71
1,1478,1348,130,3,243,141
1,1229,1142,87,10,905,73
0,1584,1298,286,0,-35,118
1,1706,1822,-116,6,242,79
-1,1739,1820,-81,-6,-74,58
1,1897,1565,332,5,58,47
1,1455,1214,241,3,590,81
-1,1537,1646,-109,2,23,46
-1,1693,1754,-61,-9,-256,56
-1,1428,1512,-84,-3,-83,52
-1,1285,1503,-218,-5,-124,53
1,1693,1754,-61,0,238,135
1,1575,1418,157,0,323,141
-1,1326,1466,-140,0,-84,62
1,1556,1265,291,-1,97,71
1,1515,1500,15,-3,-164,85
1,2102,1655,447,6,354,63
-1,1828,1975,-147,-8,-284,68
1,1680,1484,196,0,-2,67
1,1472,1261,211,0,-141,69
1,1403,1340,63,7,137,42
1,1822,1741,81,2,27,45
-1,1280,1494,-214,-3,-15,58
1,1521,1420,101,0,63,89
-1,2060,2022,38,-3,2,64
1,1668,1099,569,6,373,63
1,1512,1386,126,5,279,55
1,1492,1593,-101,0,274,69
-1,1444,1409,35,1,-375,100
-1,1504,1544,-40,-11,-443,66
-1,1279,1441,-162,-8,-471,90
1,1550,1449,101,3,-7,83
0,1583,1518,65,5,491,222
1,1533,1258,275,13,207,44
-1,1590,1594,-4,-1,-121,72
-1,1208,1275,-67,-3,-448,100
1,1437,1260,177,0,69,75
1,1332,1284,48,6,142,49
1,1580,1520,60,2,77,55
-1,1747,1470,277,-1,-45,64
-1,1511,1591,-80,-9,-304,62
-1,1478,1605,-127,-12,-408,64
-1,1324,1544,-220,2,69,56
1,1601,1502,99,0,262,91
1,1276,1377,-101,-1,45,165
-1,1416,1562,-146,1,16,44
-1,1270,1317,-47,-4,-370,64
1,1672,1537,135,0,-104,109
1,1730,1541,189,0,-30,45
1,1494,1610,-116,4,208,59
1,1684,1813,-129,9,265,43
-1,1828,1813,15,-1,-12,42
1,1799,1817,-18,-1,-28,49
1,1236,1551,-315,5,254,51
-1,1490,1729,-239,0,20,116
1,1642,1486,156,1,15,43
-1,1699,1810,-111,-5,-117,58
-1,1699,1810,-111,-4,-306,70
-1,1596,1337,259,0,-56,58
1,1327,1260,67,13,777,77
1,1544,1500,44,0,123,107
-1,1657,1612,45,0,-218,136
-1,1535,1691,-156,-4,-202,94
1,0,1200,-1200,-1,945,101
-1,1393,1301,92,-2,9,66
-1,1817,1830,-13,0,246,110
1,1582,1529,53,-1,59,65
-1,1332,1287,45,-11,-172,40
1,1366,1634,-268,0,47,65
-1,1656,1357,299,-2,-100,82
-1,1470,1545,-75,-3,-92,42
1,1840,1807,33,-2,-85,67
1,1479,1430,49,3,159,59
-1,1732,1704,28,-8,-166,54
-1,1569,1473,96,1,-53,61
-1,1797,1849,-52,-6,-144,72
-1,1291,1240,51,6,55,65
-1,1620,1676,-56,0,7,60
-1,1506,1669,-163,3,-30,80
1,1858,1789,69,0,546,115
-1,1708,1933,-225,1,-19,90
-1,1381,1617,-236,-5,-504,96
1,1933,1708,225,-1,87,61
1,1780,1867,-87,-1,-8,61
-1,1703,1956,-253,-2,-51,58
1,1793,1854,-61,0,-6,53
-1,1841,1805,36,0,-192,142
1,1471,1447,24,5,91,53
1,1563,1683,-120,19,1333,86
1,1634,1682,-48,0,11,59
-1,1251,1336,-85,-4,-430,64
1,1333,1493,-160,-8,-301,49
-1,1816,1830,-14,0,-28,80
-1,1668,1579,89,3,35,46
1,1466,1569,-103,0,12,53
-1,1646,1758,-112,-1,-20,50
-1,1500,1611,-111,-5,-45,44
1,1764,1686,78,6,133,47
-1,1379,1593,-214,-2,-354,143
1,1327,1487,-160,2,429,107
1,1840,1807,33,1,26,45
-1,1617,1666,-49,0,-2,54
-1,1807,1840,-33,0,46,100
1,1406,1443,-37,1,40,57
1,1438,1271,167,2,202,93
0,1627,1650,-23,0,-5,103
-1,1849,1797,52,-1,-42,46
-1,1797,1849,-52,0,-141,82
1,1644,1591,53,4,93,47
-1,1345,1586,-241,-7,-82,40
-1,1678,1598,80,-2,2,46
1,1582,1653,-71,0,-13,51
-1,1551,1622,-71,-2,-54,58
-1,1384,1264,120,1,20,46
-1,1545,1529,16,0,-78,84
0,1593,1500,93,22,1633,75
-1,1649,1773,-124,0,167,82
-1,1858,1789,69,-1,-101,66
-1,1595,1591,4,8,251,62
1,1588,1770,-182,1,92,67
1,1579,1622,-43,0,-23,43
1,1365,1336,29,7,191,47
1,1449,1761,-312,-2,67,89
1,1508,1417,91,3,511,125
-1,1563,1632,-69,1,5,42
1,1275,1370,-95,1,86,47
1,1513,1662,-149,-2,15,129
1,1379,1326,53,5,109,55
-1,1545,1650,-105,-6,-548,84
-1,1548,1484,64,0,-31,100
-1,1218,1316,-98,-10,-254,46
-1,1393,1316,77,-7,-37,40
-1,1302,1479,-177,-1,-137,64
-1,1456,1478,-22,-3,-87,66
1,1684,1437,247,-7,7,53
1,1503,1514,-11,9,368,67
-1,1437,1684,-247,0,-28,88
-1,1610,1592,18,-5,-439,84
-1,1433,1687,-254,0,11,44
-1,1613,1555,58,-6,-79,54
-1,1569,1629,-60,-1,-13,40
-1,1331,1299,32,-4,-541,150
1,1673,1689,-16,14,697,77
1,1959,1713,246,0,7,89
-1,1485,1525,-40,0,115,88
1,1524,1442,82,1,92,49
1,1552,1631,-79,0,56,69
1,1502,1449,53,8,191,45
1,1582,1729,-147,2,135,67
-1,1608,1431,177,-2,27,76
1,1479,1533,-54,7,252,53
1,1497,1562,-65,0,72,79
-1,1670,1535,135,-1,-45,50
-1,1684,1678,6,-7,-210,78
-1,1520,1492,28,0,-413,124
-1,1388,1497,-109,0,-209,114
1,1724,1655,69,0,47,57
1,1110,1440,-330,1,66,133
1,1714,1603,111,1,294,109
1,1452,1591,-139,-4,-313,123
-1,1325,1359,-34,0,-57,72
1,1422,1555,-133,-1,197,89
1,1504,1508,-4,0,480,117
1,1957,1606,351,-1,-2,53
-1,1489,1741,-252,0,-342,122
1,1496,1515,-19,0,301,115
-1,1379,1191,188,-4,-217,64
-1,1689,1756,-67,-3,-74,46
1,1756,1689,67,11,311,47
-1,1575,1471,104,0,70,114
1,1647,1562,85,1,328,113
-1,1510,1548,-38,-4,-35,44
1,1598,1608,-10,-1,65,56
-1,1680,1766,-86,-12,-148,44
1,1960,1757,203,0,5,53
-1,1775,1672,103,-1,57,76
0,1554,1655,-101,-2,-277,153
-1,1672,1775,-103,0,153,96
1,1502,1508,-6,6,45,101
1,1783,1664,119,-1,42,53
-1,1512,1769,-257,0,-55,68
1,1656,1791,-135,-7,-251,53
1,1505,1276,229,4,27,44
1,1775,1672,103,-4,-126,67
1,1635,1475,160,-1,-30,63
0,1652,1557,95,2,431,143
1,1966,1928,38,2,11,45
-1,1916,1658,258,0,-222,96
-1,1784,1664,120,-3,-3,54
-1,1497,1526,-29,-5,-38,40
-1,1046,1246,-200,0,105,78
-1,1676,1898,-222,2,877,126
-1,1560,1649,-89,-6,-172,56
1,1777,1670,107,-2,205,67
1,1749,1505,244,0,180,115
1,1546,1487,59,0,107,59
-1,1903,1671,232,-12,-403,66
-1,1662,1785,-123,0,-80,64
1,1657,1552,105,0,279,119
-1,1714,1886,-172,-5,-150,82
1,1317,1378,-61,1,124,57
-1,1655,1793,-138,0,39,66
-1,1752,1918,-166,-1,-32,54
-1,1800,1648,152,-2,174,60
1,1276,1013,263,5,128,49
0,1544,1665,-121,0,-347,96
-1,1478,1564,-86,-6,-813,94
-1,1663,1784,-121,-3,-153,84
-1,1707,1689,18,-1,-19,86
1,1784,1663,121,0,29,69
0,1372,1418,-46,0,221,138
1,1661,1547,114,0,297,113
-1,1721,1609,112,1,-201,90
-1,1977,1603,374,1,-73,56
-1,1642,1524,118,4,-863,130
-1,1656,1792,-136,-3,-14,54
1,1426,1444,-18,6,252,66
-1,1964,1924,40,-4,-86,108
1,1647,1746,-99,5,116,55
-1,1799,1649,150,4,-43,62
-1,1569,1585,-16,0,-33,51
-1,1892,1696,196,-2,-67,56
-1,1649,1799,-150,-3,-237,88
-1,1712,1875,-163,-2,-535,108
-1,1506,1470,36,9,530,85
-1,1806,1642,164,-16,-404,66
-1,1642,1806,-164,-1,-26,88
1,1367,1113,254,-2,725,145
1,1487,1270,217,6,440,91
-1,1172,1326,-154,-8,-203,57
-1,1812,1658,154,0,-25,64
-1,1916,1764,152,-1,-191,128
1,1796,1674,122,0,-49,63
-1,1706,1881,-175,3,31,70
-1,1666,1781,-115,-1,-56,66
1,1593,1492,101,-1,6,41
1,1482,1757,-275,0,193,107
0,1415,1373,42,0,155,123
1,1789,1659,130,-3,-22,99
1,1558,1478,80,0,210,70
-1,1204,1321,-117,-4,-118,56
-1,1652,1796,-144,0,39,58
-1,1701,1601,100,2,15,72
-1,1645,1803,-158,-14,-317,52
1,1955,1710,245,2,46,45
-1,1608,1627,-19,2,26,40
1,1810,1638,172,0,11,71
1,1960,1706,254,1,201,71
1,1599,1227,372,0,43,45
1,1700,1888,-188,0,735,157
1,1288,1680,-392,0,26,65
-1,1632,1816,-184,0,-64,82
-1,1664,1333,331,0,71,60
0,1328,1114,214,0,1797,125
1,1822,1626,196,0,64,67
-1,1696,1606,90,-10,-339,66
1,1717,1645,72,0,15,51
1,1621,1828,-207,-5,-48,73
-1,1606,1405,201,0,-106,114
1,1620,1681,-61,-4,-203,61
1,1828,1621,207,-1,66,67
-1,1638,1810,-172,-6,-265,64
1,1328,1277,51,0,192,111
1,1965,1701,264,1,218,85
1,1810,1638,172,0,-28,69
-1,1418,1936,-518,-6,-106,52
-1,1731,1451,280,1,2,92
1,1265,1171,94,15,220,49
1,1632,1816,-184,-9,-29,61
-1,1668,1633,35,-11,-4,40
-1,1800,1648,152,1,89,70
1,1645,1656,-11,17,904,79
-1,1443,1697,-254,-4,-101,62
1,1969,1791,178,-1,420,96
1,1726,1636,90,0,35,67
-1,1664,1783,-119,-2,-283,82
-1,1271,1619,-348,-2,-20,52
-1,1110,1273,-163,-9,-903,78
-1,1461,1250,211,1,19,44
-1,1783,1664,119,-8,-78,50
-1,1644,1656,-12,-1,-18,44
1,1679,1768,-89,0,-25,59
1,1938,1417,521,-2,-82,71
-1,1338,1423,-85,-14,-297,47
1,1268,1461,-193,-8,-291,75
1,1720,1642,78,-2,-82,111
1,1469,1423,46,6,173,48
1,1794,1426,368,0,34,59
1,1728,1633,95,0,1,43
1,1918,1633,285,0,-7,51
1,1564,1393,171,1,21,53
1,1737,1625,112,3,63,47
1,1387,1579,-192,4,-8,45
-1,1542,1749,-207,1,13,80
-1,1744,1618,126,0,4,90
1,1492,1598,-106,1,81,81
1,1653,1701,-48,-1,69,111
-1,1416,1939,-523,-6,-130,44
1,1431,1457,-26,-2,-187,79
1,1658,1568,90,1,77,71
-1,1967,1814,153,0,-165,81
-1,1729,1632,97,-1,-129,90
1,1682,1548,134,-1,-10,61
1,1830,1952,-122,6,111,43
-1,1371,1388,-17,-1,-50,88
1,1465,1336,129,-2,25,86
1,1615,1807,-192,-8,-102,51
1,1976,1681,295,0,58,103
-1,1715,1646,69,0,-12,52
1,1939,1845,94,4,531,105
-1,1323,1621,-298,-23,-176,42
1,1837,1946,-109,-1,65,133
1,1933,1851,82,14,165,45
1,1702,1660,42,-3,1,41
-1,1413,1942,-529,-1,-96,88
1,1842,1941,-99,-1,137,73
1,1446,1666,-220,2,155,75
-1,1712,1650,62,0,-5,100
-1,1789,1856,-67,0,-217,74
1,1677,1559,118,0,201,75
1,1805,1395,410,0,7,57
-1,1780,1865,-85,5,68,48
-1,1908,1861,47,-1,-1461,190
-1,1699,1754,-55,-4,-281,86
-1,1772,1658,114,-3,-127,63
1,1874,1873,1,-1,418,160
-1,1690,1658,32,0,-108,76
-1,1685,1552,133,-10,-92,50
1,1757,1764,-7,-1,-25,51
-1,1233,1211,22,-14,-436,62
-1,1525,1508,17,-2,-156,80
-1,1768,1752,16,-1,-677,160
-1,1862,1670,192,-2,-160,75
1,1710,1592,118,1,33,95
-1,1670,1862,-192,-1,-36,92
-1,1565,1567,-2,0,87,72
-1,1757,1764,-7,0,16,66
-1,1329,1638,-309,-1,-20,44
-1,1364,1481,-117,-12,-320,68
-1,1649,1714,-65,-1,-3,108
1,1226,1220,6,-5,163,111
1,1412,1368,44,2,303,65
-1,1775,1868,-93,-4,-195,62
1,1868,1775,93,3,869,123
-1,1876,1767,109,1,-15,78
1,1671,1623,48,-1,-30,59
1,1387,1356,31,-1,28,67
-1,1937,1889,48,-3,-50,40
-1,1513,1578,-65,-8,-31,42
1,1656,1289,367,1,532,115
-1,1721,1781,-60,1,129,84
-1,1614,1681,-67,0,-127,144
-1,1332,1330,2,-15,-96,42
1,1209,1239,-30,1,323,119
-1,1424,1577,-153,-6,-198,60
1,1913,1913,0,-3,-3,61
1,1983,1751,232,0,145,112
-1,1504,1345,159,1,-207,84
-1,1291,1316,-25,-3,-280,74
-1,1605,1587,18,-1,8,52
-1,1731,1409,322,0,-161,168
-1,1690,1666,24,-1,45,70
-1,1659,1729,-70,-6,-393,68
-1,1588,1599,-11,-1,-11,62
-1,1678,1678,0,-6,-283,74
1,1279,1327,-48,0,-21,53
1,1456,1432,24,2,270,105
-1,1490,1475,15,-7,-173,52
-1,1649,1753,-104,1,-59,74
-1,1469,1480,-11,0,-31,72
1,1738,1617,121,1,172,71
-1,1667,1592,75,0,-9,42
1,1200,1120,80,-1,190,71
1,1717,1500,217,-1,-20,48
-1,1210,1414,-204,-11,-464,76
1,1696,1478,218,-1,90,87
-1,1293,1314,-21,1,-583,116
-1,1641,1622,19,-5,-208,56
1,1488,1593,-105,0,1,109
-1,1260,1239,21,-4,-236,88
0,1475,1453,22,-4,-257,110
-1,1654,1629,25,-5,-227,72
1,1577,1336,241,0,349,189
-1,1082,1385,-303,-5,-316,90
-1,1722,1994,-272,0,-12,62
-1,1444,1649,-205,0,-24,70
-1,1501,1642,-141,4,194,98
1,1641,1794,-153,1,120,87
0,1540,1616,-76,-1,-58,147
1,1458,1454,4,2,221,123
-1,1636,1659,-23,0,13,44
-1,1565,1606,-41,0,-65,82
-1,1332,1500,-168,-6,-267,68
1,1765,2026,-261,-1,-37,81
1,1432,1110,322,-1,6,43
-1,1282,1755,-473,0,-8,58
1,1642,1130,512,1,385,101
-1,2007,1784,223,-2,-50,66
-1,1483,1761,-278,0,64,74
-1,1441,1296,145,0,35,81
-1,1590,1307,283,0,12,68
-1,1389,1573,-184,0,-289,204
-1,1803,1989,-186,0,-65,64
-1,1392,1429,-37,-3,-110,56
-1,1606,1502,104,-1,-54,74
-1,1280,1690,-410,-1,-90,76
1,1634,1579,55,-2,27,43
1,1791,2001,-210,0,-4,59
1,1643,1286,357,-3,-17,77
1,1582,1241,341,0,99,61
-1,1077,1341,-264,-10,-748,94
1,1983,1809,174,0,41,91
-1,1655,1720,-65,0,-256,96
-1,1717,1715,2,-4,-36,42
1,1724,1635,89,1,24,49
1,1395,1417,-22,5,112,54
-1,1487,1629,-142,1,75,44
-1,1313,1500,-187,-3,-192,94
-1,1995,1796,199,1,-119,70
-1,2061,1902,159,-3,-11,46
-1,1629,1539,90,-7,-644,96
-1,1460,1742,-282,-6,-247,67
-1,1581,1650,-69,0,-4,86
-1,1591,1885,-294,-2,-135,61
1,1466,1328,138,7,175,54
-1,1474,1509,-35,-2,-119,102
1,1984,1808,176,0,0,63
1,1726,1589,137,0,18,57
-1,1801,1991,-190,-1,-31,74
1,1914,1588,326,3,169,61
-1,1803,1989,-186,0,-56,100
-1,1500,1605,-105,0,17,54
1,1659,1572,87,-4,-34,69
1,1997,1795,202,5,61,61
-1,1545,1655,-110,0,-501,162
-1,1829,1700,129,0,-14,136
-1,1789,2002,-213,0,-24,68
1,2002,1789,213,0,-60,77
-1,1645,1733,-88,-5,-32,42
-1,1261,1572,-311,0,-6,58
-1,1277,1581,-304,1,67,58
1,1375,1242,133,3,115,49
1,1918,1746,172,-1,-28,119
0,1478,1486,-8,-2,-388,149
1,1963,1649,314,0,48,73
-1,1563,1618,-55,0,-4,48
-1,1784,2008,-224,0,10,62
1,2013,1779,234,-1,117,91
1,1830,1970,-140,-3,25,41
0,1472,1469,3,4,370,91
1,1628,1554,74,0,10,45
1,1740,1924,-184,0,78,99
-1,1741,2077,-336,-1,-8,48
-1,1272,1473,-201,-13,-227,52
1,1491,1380,111,11,123,43
1,1361,1500,-139,16,359,45
-1,1266,1742,-476,0,-72,66
1,1581,1637,-56,-4,-46,43
1,1479,1257,222,-1,70,51
-1,1658,1385,273,-1,-19,82
1,1546,1625,-79,0,3,44
1,1330,1071,259,10,252,49
1,1887,1843,44,1,39,47
1,1907,1756,151,0,229,161
-1,1663,1668,-5,4,161,52
-1,1624,1378,246,4,179,62
-1,1628,1965,-337,-1,-20,74
0,1579,1645,-66,-2,-55,120
1,1646,1537,109,-2,-58,83
-1,1701,1745,-44,-3,-356,226
-1,1834,1933,-99,0,-10,64
-1,1264,1289,-25,0,-396,114
-1,1498,1500,-2,1,87,56
1,1371,1469,-98,3,91,52
1,2042,1924,118,-1,-36,55
-1,1398,1701,-303,0,-25,54
0,1576,1794,-218,-4,-95,155
1,1916,2050,-134,1,-4,51
-1,1385,1586,-201,1,31,52
-1,1214,1251,-37,-1,58,68
1,1943,1596,347,3,137,67
-1,1966,1826,140,-1,-4,96
1,1289,1232,57,2,85,57
1,1485,1539,-54,0,-12,43
1,1529,1654,-125,2,172,91
1,1683,1735,-52,-1,15,56
-1,1329,1394,-65,-6,-374,95
-1,1252,1591,-339,3,95,70
-1,1500,1790,-290,0,-14,66
1,1592,1379,213,5,279,69
-1,1923,2042,-119,1,10,60
-1,1689,1581,108,-2,-70,62
1,1593,1603,-10,-5,-36,41
-1,1743,1794,-51,0,10,66
0,1752,1722,30,0,81,141
1,1597,1233,364,-2,-2,55
-1,1383,1586,-203,-1,-47,56
-1,1788,1598,190,0,-22,82
1,1484,1404,80,8,324,57
-1,1696,1867,-171,-2,-62,60
1,2050,1916,134,-2,-71,63
-1,1639,1544,95,3,147,70
1,2034,1931,103,0,7,59
-1,1478,1729,-251,0,-30,90
1,1319,1434,-115,-1,-26,53
1,1223,1298,-75,-4,-24,163
-1,1803,1733,70,0,-6,76
1,1467,1242,225,6,383,67
-1,1573,1603,-30,-1,-157,104
1,1472,1394,78,0,15,71
1,1493,1159,334,5,305,81
-1,1747,1790,-43,-1,0,62
-1,1382,1704,-322,-1,-88,64
1,2058,1909,149,-1,-19,59
1,1351,1366,-15,-14,-446,53
-1,1589,1606,-17,-1,-149,72
-1,1459,1675,-216,-5,-141,46
-1,1558,1624,-66,-5,-67,46
-1,1809,1728,81,-3,-136,70
1,1841,1795,46,0,37,89
1,1525,1480,45,6,126,61
1,1379,1481,-102,-1,286,73
-1,1924,2065,-141,-2,-76,58
0,1741,1795,-54,0,53,101
1,1680,1454,226,3,1232,111
-1,1500,1763,-263,-2,-387,122
0,1633,1549,84,0,-53,163
1,1268,1334,-66,0,424,73
-1,1472,1579,-107,-1,-33,54
1,1582,1521,61,-8,-155,63
1,2072,1917,155,1,-129,91
-1,1794,1743,51,0,0,86
-1,1478,1591,-113,0,-436,126
1,1751,1618,133,7,249,59
1,1543,1553,-10,0,-67,79
-1,1535,1521,14,-7,-20,94
-1,1602,1501,101,-2,50,74
1,1747,1850,-103,3,86,49
1,1512,1591,-79,1,3,49
-1,1756,1781,-25,-9,-82,92
0,1914,1870,44,0,-2,51
-1,1562,1705,-143,0,-149,106
-1,1370,1513,-143,-6,-62,79
-1,1577,1526,51,-1,-93,60
-1,1791,1745,46,0,54,102
-1,1623,1837,-214,-1,-154,72
1,1469,1412,57,-5,-94,47
1,1539,1564,-25,0,51,65
1,1456,1410,46,1,13,49
-1,1598,1601,-3,-1,-82,60
1,2054,1913,141,-5,-336,87
1,1470,1500,-30,3,281,105
-1,1758,1851,-93,-3,-84,54
0,1443,1790,-347,3,118,67
-1,1758,1779,-21,0,-15,104
1,1495,1335,160,-2,-205,141
1,1500,1302,198,0,2,86
-1,1551,1631,-80,0,-16,46
1,1711,1524,187,4,370,103
1,1574,1529,45,0,19,59
1,1523,1398,125,8,92,43
1,1789,1747,42,-3,-124,99
1,1973,1780,193,-3,-112,121
1,1842,1618,224,-1,-49,41
1,1906,2062,-156,0,59,59
-1,1590,1452,138,-2,-158,62
-1,1623,1946,-323,-1,-279,182
1,1344,1668,-324,-12,-192,69
-1,1788,1795,-7,-3,-130,50
-1,1479,1335,144,-1,14,136
1,1542,1615,-73,2,53,53
1,1613,1587,26,-1,171,105
1,1528,1543,-15,1,72,87
1,1496,1305,191,1,50,59
1,1529,1486,43,0,-2,55
0,1901,1750,151,0,-129,127
-1,1738,1799,-61,0,-12,72
1,1248,1375,-127,0,-14,41
1,1346,1525,-179,0,72,83
0,1750,1723,27,-3,-128,110
1,1520,1583,-63,0,32,45
-1,1817,1921,-104,-1,-15,92
-1,1550,1575,-25,0,-15,54
0,1509,1412,97,1,-32,139
0,1890,1729,161,0,-51,117
1,1531,1539,-8,0,79,106
1,1570,1533,37,1,6,43
-1,1365,1640,-275,0,5,100
-1,1500,1386,114,-8,-91,44
1,1688,1648,40,0,-21,77
-1,1629,1471,158,0,-12,52
1,1588,1585,3,-1,-1,61
-1,1266,1374,-108,-2,-281,104
-1,1734,1885,-151,3,261,100
1,1523,1580,-57,0,33,55
1,1343,1475,-132,-5,-42,41
-1,1641,1904,-263,-1,-44,56
1,1413,1328,85,8,78,45
-1,1798,1717,81,-4,-6,44
-1,1555,1455,100,3,-318,96
-1,1443,1491,-48,-7,-333,60
1,1576,1601,-25,-1,272,77
-1,1507,1422,85,4,138,112
-1,1539,1657,-118,2,56,60
1,1637,1357,280,2,57,61
-1,1585,1540,45,-1,5,44
0,1837,1625,212,0,6,89
-1,1533,1456,77,0,51,56
-1,1644,1360,284,4,350,78
-1,1567,1536,31,-9,-100,46
-1,1668,1528,140,-3,-53,48
1,1481,1489,-8,-1,-45,81
1,1426,1422,4,14,393,49
1,1308,1246,62,1,561,141
-1,1814,1818,-4,-2,-152,56
-1,1028,1356,-328,-18,-452,48
1,1912,1744,168,2,67,51
-1,1476,1363,113,-7,-399,74
1,1715,1804,-89,3,380,67
1,1344,1363,-19,6,62,47
-1,1616,1868,-252,-7,-383,72
0,1553,1623,-70,0,26,170
1,1616,1365,251,1,345,89
-1,1143,1258,-115,-11,-754,100
1,1828,1791,37,0,182,79
1,1782,1837,-55,5,376,113
1,1827,1468,359,-1,50,83
-1,1640,1671,-31,0,60,60
-1,1294,1419,-125,0,-29,52
-1,1874,1747,127,0,-233,154
-1,1345,1367,-22,1,28,56
1,1383,1460,-77,0,118,91
1,1551,1636,-85,-1,27,73
1,1754,1648,106,0,-3,41
1,1894,1759,135,0,5,43
-1,1286,1450,-164,-7,-521,86
1,1360,1681,-321,-1,63,85
1,1372,965,407,12,143,47
-1,1752,1902,-150,-1,-59,78
1,1637,1704,-67,-5,-96,57
0,1762,1761,1,0,-2,111
-1,1648,1876,-228,-1,-28,62
-1,1855,1742,113,0,-95,154
1,1586,1483,103,-3,-392,119
-1,2027,1795,232,1,28,54
-1,1440,1335,105,-5,-74,50
1,1636,1628,8,0,-6,67
-1,1812,2006,-194,-1,-235,82
1,1381,1728,-347,-2,-15,43
-1,1485,1567,-82,0,-12,60
1,1640,1881,-241,0,62,79
-1,2013,1828,185,-4,-208,76
-1,1807,1894,-87,0,15,58
1,1670,1223,447,-1,197,91
1,1993,1807,186,0,353,107
1,1862,1658,204,13,936,81
1,2006,1793,213,3,89,49
-1,1799,2000,-201,-3,-299,108
1,1566,1567,-1,0,3,73
1,1654,1607,47,1,43,49
1,1944,1790,154,0,42,63
-1,1692,1788,-96,-2,-548,102
1,1591,1246,345,-3,-40,43
-1,1653,1868,-215,0,-1,60
1,1813,1762,51,-2,-99,77
1,1378,1476,-98,1,-24,75
-1,1796,2131,-335,-3,3,84
-1,1533,1593,-60,0,19,56
1,1475,1580,-105,-1,-16,45
1,1793,1684,109,12,400,63
1,1873,1647,226,-4,-137,89
-1,1625,1664,-39,0,-8,58
-1,1399,1427,-28,0,-44,112
0,1325,1476,-151,0,84,106
1,1388,1456,-68,8,78,45
-1,1359,1594,-235,0,159,80
-1,1207,1672,-465,-1,11,46
0,1427,1472,-45,0,43,109
-1,1752,1823,-71,0,44,84
-1,1756,1879,-123,3,47,50
-1,1289,1566,-277,-3,-371,80
-1,1500,1801,-301,1,-49,78
1,1500,1496,4,1,103,57
1,1745,1674,71,0,127,87
-1,1598,1338,260,1,-208,78
1,1805,1429,376,-1,2,49
1,1470,1429,41,9,129,41
1,1931,1268,663,9,140,45
1,2012,1807,205,3,256,83
0,1887,1749,138,-6,-492,86
-1,1754,1910,-156,-3,-11,40
1,1903,1761,142,0,0,41
1,1609,1529,80,3,293,67
1,1607,1388,219,2,85,59
-1,1581,1525,56,-3,-92,86
-1,1541,1537,4,-1,-99,66
1,1753,1882,-129,0,-9,53
1,1916,1748,168,0,-9,49
1,1480,1934,-454,-3,-177,67
1,1926,1852,74,-3,-5,63
1,1821,1863,-42,0,45,79
-1,1567,1538,29,-1,3,80
1,1572,1612,-40,0,28,109
-1,1866,1768,98,-3,-268,74
-1,1692,1744,-52,-1,-261,130
1,2049,1555,494,-1,-20,55
1,1323,1383,-60,-1,6,69
-1,1759,1950,-191,-7,-231,62
-1,1414,1634,-220,-6,-177,54
-1,1844,1986,-142,1,-116,106
-1,1548,1682,-134,0,-45,112
-1,2019,2011,8,0,0,46
-1,2006,2022,-16,1,12,46
-1,1549,1555,-6,-5,-237,62
-1,1993,2032,-39,1,44,82
0,1782,1851,-69,0,513,127
-1,1922,1853,69,-1,-13,58
1,1323,1352,-29,15,340,45
1,2026,1837,189,2,44,43
1,1338,1426,-88,4,150,77
1,1809,1742,67,3,47,51
-1,1566,1539,27,-1,367,100
-1,1997,2029,-32,-2,-20,42
-1,1500,1351,149,-2,-407,70
-1,1335,1381,-46,3,-4,40
-1,1985,2039,-54,-1,-38,50
1,2078,1826,252,-2,-57,67
-1,1975,2048,-73,0,-22,108
-1,1325,1479,-154,-6,-62,42
-1,1965,2056,-91,-1,-202,124
-1,1734,1856,-122,0,-58,112
1,1662,1387,275,1,61,81
-1,1550,1554,-4,-4,-479,94
-1,1822,2096,-274,1,114,80
-1,1538,1537,1,0,-48,58
-1,1956,2064,-108,0,-11,46
1,2073,1606,467,0,14,58
1,1726,1642,84,0,55,59
1,2111,1817,294,4,116,65
-1,1354,1410,-56,-11,-865,82
1,1565,1540,25,0,503,89
-1,1500,1704,-204,-1,-492,112
1,1406,1445,-39,6,142,47
-1,1541,1514,27,-3,-74,46
1,1972,2091,-119,2,270,69
1,1607,1588,19,-5,1,57
1,1666,1605,61,0,186,81
1,1442,959,483,11,365,45
-1,1327,1580,-253,-14,-181,45
1,1854,1880,-26,0,140,79
1,1529,1566,-37,2,49,53
-1,1509,1575,-66,-2,-56,50
-1,1618,1735,-117,-1,-81,59
1,1677,1554,123,6,240,53
-1,1412,1584,-172,-1,-5,60
1,1419,1273,146,-1,-58,59
-1,1595,1676,-81,-1,-19,48
-1,1578,1622,-44,-4,-68,44
1,1344,1443,-99,1,151,63
-1,1868,1866,2,-2,-27,52
1,1761,1684,77,21,394,41
-1,1389,1591,-202,-6,-497,126
1,1690,1769,-79,4,309,83
1,1572,1606,-34,4,209,95
-1,1814,2125,-311,0,0,56
1,2136,1810,326,1,61,63
-1,1457,1530,-73,0,-92,108
1,1541,1686,-145,-2,-83,59
-1,1703,1540,163,-2,-50,44
1,1878,1858,20,-1,-19,49
1,1584,1498,86,-2,-66,59
1,1596,1371,225,1,81,89
1,1271,1421,-150,0,-8,47
-1,1402,1500,-98,-11,-120,46
1,1632,1395,237,6,117,47
1,1848,1889,-41,4,548,91
1,1701,1542,159,5,170,51
1,1669,1800,-131,0,9,99
1,1689,1567,122,2,-7,43
1,1876,1860,16,-3,-43,79
-1,1283,1412,-129,1,-219,94
1,1600,1507,93,0,62,53
-1,1988,1536,452,3,114,60
1,1414,1335,79,2,292,97
-1,1742,1599,143,-5,-26,84
-1,1556,1965,-409,-1,-54,62
1,1696,1785,-89,-4,-52,67
-1,1685,1426,259,0,-206,94
-1,1593,1488,105,-5,-1079,142
-1,1849,1887,-38,0,-73,90
-1,1317,1649,-332,0,0,56
1,1708,1554,154,4,180,49
-1,1618,1576,42,1,-19,42
1,1500,1964,-464,1,67,75
1,1967,1554,413,12,180,45
-1,1600,1730,-130,5,-99,96
-1,1263,2016,-753,-6,-147,52
1,1897,1840,57,3,109,61
-1,1402,1404,-2,-1,-580,96
-1,1593,1565,28,0,1,86
0,1623,1709,-86,2,126,120
1,1280,1272,8,1,327,133
1,1738,1590,148,-1,583,131
1,1420,1428,-8,2,116,77
1,2024,1805,219,0,243,111
-1,1714,1578,136,-3,-57,42
-1,1396,1733,-337,0,-84,64
-1,1304,1970,-666,-9,-187,50
-1,1581,1744,-163,0,-394,120
1,1606,1608,-2,1,8,63
1,1360,1594,-234,-4,-42,41
-1,1714,1668,46,0,-37,74
-1,1827,1909,-82,-3,-52,40
1,1617,1672,-55,3,527,79
-1,1800,2103,-303,0,-128,98
-1,1389,1681,-292,-5,-87,50
1,1730,1814,-84,1,59,65
1,1802,2093,-291,0,97,135
1,1629,1660,-31,-2,168,75
1,1385,1500,-115,7,266,71
-1,1641,1648,-7,0,0,82
1,1970,1590,380,0,-3,45
1,1973,1587,386,1,153,59
-1,1659,1596,63,-7,-252,58
1,1258,1396,-138,2,-48,57
-1,1329,1707,-378,-7,-38,40
1,2177,1815,362,0,-24,107
1,1627,1282,345,3,344,101
-1,1630,1585,45,-1,-64,52
-1,1382,1432,-50,1,-4,52
1,1975,1600,375,1,34,49
-1,1291,1509,-218,0,-410,92
0,1659,1540,119,-3,9,115
-1,1372,1539,-167,-11,-535,76
1,1688,1563,125,1,-26,43
-1,1513,1373,140,1,-117,76
1,1373,1513,-140,-2,-146,67
1,1488,1395,93,1,131,65
-1,1455,1526,-71,-1,-258,79
1,1786,1657,129,4,135,53
1,1984,1605,379,-1,-17,47
-1,1407,1388,19,-13,-373,50
-1,1545,1656,-111,4,110,66
1,1400,1340,60,1,238,67
1,1575,1715,-140,5,119,65
1,1967,1818,149,-1,180,73
-1,1518,1602,-84,0,-89,94
-1,1663,1535,128,0,-254,112
1,1807,1784,23,0,38,79
1,1410,1295,115,0,263,73
0,1545,1649,-104,1,99,76
-1,1691,1718,-27,-4,-150,51
-1,1388,1515,-127,-1,-250,86
-1,1975,1811,164,0,19,48
-1,1433,1446,-13,1,50,44
1,1632,1449,183,3,155,62
1,1956,1827,129,1,50,51
-1,1592,1514,78,-2,-49,50
1,1613,1418,195,0,-23,67
1,1553,1649,-96,8,65,41
-1,1412,1620,-208,1,130,84
1,1442,1440,2,5,380,77
-1,1635,1570,65,1,-145,80
1,1543,1740,-197,0,19,97
1,1627,1406,221,-1,65,53
-1,1918,1844,74,-2,-38,60
1,1327,1085,242,12,371,52
-1,1400,1634,-234,-2,254,98
1,1934,1646,288,1,66,61
1,1738,1694,44,3,196,95
1,1640,1552,88,2,135,91
-1,1628,1623,5,9,264,46
-1,1756,1972,-216,-2,-58,48
1,1738,1681,57,6,131,47
1,1640,1395,245,5,187,55
-1,1264,1381,-117,-7,-45,62
1,1709,1622,87,1,109,119
1,1655,1619,36,-9,-114,47
1,1390,1221,169,2,222,69
1,1524,1297,227,-1,-91,69
1,1619,1655,-36,0,10,43
-1,1905,2201,-296,-1,-78,68
1,1643,1609,34,0,35,65
-1,1514,1587,-73,-1,-8,54
-1,1213,1397,-184,-2,-14,64
1,1599,1652,-53,13,687,77
-1,1640,1612,28,-9,-440,62
1,1639,1613,26,-5,-14,43
1,1427,1079,348,9,364,67
1,1365,1183,182,-2,-176,77
-1,1403,1206,197,1,56,68
1,1429,1454,-25,0,-78,123
-1,1685,1748,-63,0,-55,104
-1,1504,1504,0,-11,-62,44
-1,1596,1594,2,3,50,66
-1,1642,1736,-94,-2,-62,95
1,1708,1255,453,0,107,101
0,1658,1593,65,0,-104,167
1,1367,1246,121,0,47,83
1,1653,1500,153,0,118,62
-1,1237,1376,-139,0,-7,62
1,1595,1656,-61,1,-43,61
-1,1656,1595,61,-8,-228,50
1,1383,1228,155,0,154,95
1,1710,1248,462,6,529,97
1,1443,1239,204,-6,-131,59
1,1608,1644,-36,-1,-22,47
1,1644,1608,36,8,263,61
-1,1466,1515,-49,0,88,78
0,1484,1593,-109,1,-90,111
-1,1221,1390,-169,-3,-192,82
1,2056,1900,156,0,296,89
-1,1392,1516,-124,-4,-125,48
-1,1643,1610,33,0,-268,100
1,1713,1237,476,3,102,77
1,1397,1213,184,2,169,69
1,1610,1643,-33,7,168,53
1,1820,1649,171,1,70,41
-1,1276,1374,-98,-13,-294,52
1,1994,1865,129,0,2,47
-1,1408,1467,-59,-11,-369,68
1,1712,1721,-9,0,9,81
-1,1816,2127,-311,-2,-39,55
-1,1906,1953,-47,-1,-13,52
1,1618,1729,-111,1,18,53
1,2131,1812,319,2,-29,89
1,1610,1659,-49,0,113,49
-1,1265,1645,-380,-4,-53,50
1,1366,1306,60,-2,165,87
1,1808,2135,-327,-1,85,93
1,1730,1500,230,1,31,53
1,1575,1729,-154,-1,134,80
1,1646,1624,22,1,198,107
-1,1586,1508,78,-1,-88,84
1,1667,1710,-43,-6,401,159
1,2111,1831,280,-3,-80,83
-1,1481,1508,-27,-3,-55,52
1,1487,1091,396,0,126,74
1,1682,1197,485,0,20,55
-1,1826,2115,-289,0,-205,94
1,1530,1714,-184,-1,-53,71
-1,1581,1498,83,-2,-307,114
1,1613,1604,9,0,21,59
1,2120,1822,298,1,79,81
1,1724,1393,331,4,272,71
-1,1399,1735,-336,-4,-113,52
-1,1656,1897,-241,-3,-190,92
1,1664,1452,212,-7,-96,69
-1,1818,2124,-306,0,-388,126
-1,1732,1683,49,-2,-151,66
1,1595,1510,85,6,248,58
1,1711,1594,117,1,197,117
1,1669,1516,153,3,297,63
-1,1814,2129,-315,-4,-131,60
-1,1590,1521,69,1,-120,94
0,1737,1577,160,0,41,96
1,1676,1508,168,-8,-116,41
-1,1658,1523,135,0,-19,76
-1,2133,1810,323,-4,-217,56
-1,1682,1434,248,5,71,44
1,1963,1841,122,3,273,69
-1,1833,2109,-276,-2,-92,52
1,1494,1228,266,0,12,113
-1,1665,1492,173,-2,-115,88
-1,1696,1720,-24,-4,-62,42
-1,2114,1828,286,1,-113,74
1,1727,1607,120,3,93,57
1,1471,1507,-36,-4,-23,77
-1,1080,1396,-316,-3,-73,78
-1,1833,1970,-137,-1,-29,48
-1,1850,2090,-240,-6,-135,82
1,1391,1376,15,1,181,76
1,1471,1538,-67,-1,89,91
1,1686,1446,240,0,36,43
-1,1857,1730,127,-1,-435,112
1,1452,1325,127,-1,94,45
-1,1297,1223,74,3,-33,48
-1,1584,1733,-149,3,-36,146
1,2096,1845,251,5,241,67
-1,1977,1826,151,0,-18,76
1,1577,1494,83,-2,73,77
1,1565,1552,13,0,-102,87
1,1612,1662,-50,0,-13,41
-1,1840,2102,-262,2,-40,70
-1,1282,1402,-120,0,-7,48
-1,1392,1489,-97,5,213,66
1,2107,1835,272,0,68,69
-1,1687,2061,-374,-5,-11,76
0,1542,1363,179,0,-171,140
-1,1353,1579,-226,0,-77,70
1,1497,1559,-62,0,-38,97
-1,1274,1531,-257,-3,-175,78
-1,1830,2112,-282,3,137,68
1,1498,1332,166,-4,-108,53
1,1735,1519,216,3,304,97
-1,1372,1353,19,-1,40,114
-1,2067,1684,383,0,-26,112
0,2116,1825,291,-1,14,112
1,1842,2000,-158,6,327,91
-1,1495,1476,19,-1,-188,102
1,1594,1477,117,1,552,133
1,1484,1535,-51,1,369,87
1,1891,1719,172,1,-1,47
-1,1690,1652,38,-1,-103,72
1,1834,2107,-273,-1,288,97
-1,1607,1678,-71,0,2,58
-1,1262,1234,28,-12,-557,62
-1,1498,1383,115,1,11,50
1,1740,1584,156,-3,51,79
1,1586,1651,-65,0,11,111
1,1578,1842,-264,-1,-27,47
-1,1612,1536,76,-4,-133,54
-1,2017,1750,267,-3,-8,58
1,1537,1487,50,2,12,43
-1,1261,1595,-334,-4,-40,52
-1,1726,1667,59,-4,-389,92
1,1496,1370,126,3,237,67
1,1559,1399,160,-2,-71,53
1,1488,1483,5,0,48,85
-1,1827,1968,-141,0,12,60
1,1962,1973,-11,0,-8,41
-1,1728,1619,109,-4,-171,62
-1,1498,1409,89,-1,-108,94
-1,1250,1734,-484,0,-99,66
1,1546,1578,-32,1,5,53
-1,1606,1631,-25,-11,-18,40
0,1747,1755,-8,-1,-248,185
1,1947,1973,-26,1,94,79
-1,1600,1597,3,-1,-114,92
1,1262,1384,-122,-1,-7,51
-1,1824,1634,190,-5,-119,56
1,1625,1580,45,-1,-48,47
-1,1472,1468,4,-2,-59,60
-1,1542,1334,208,-3,-266,52
-1,1249,1659,-410,1,23,50
0,1599,1452,147,0,-12,78
-1,1820,1866,-46,0,16,70
-1,1704,1973,-269,0,-6,80
1,1650,1353,297,5,198,57
1,1390,1788,-398,1,353,133
1,1642,1596,46,-2,24,89
-1,1360,1697,-337,-2,-161,68
-1,1480,1508,-28,-1,-122,122
1,1614,1575,39,-4,419,141
-1,1635,1569,66,-5,-228,64
1,1981,1700,281,4,45,49
-1,1365,1355,10,-5,-36,44
-1,1768,1717,51,0,-88,84
1,1574,1548,26,-4,-112,85
-1,1700,1357,343,0,20,144
-1,1696,1903,-207,0,-240,106
1,1347,1280,67,3,96,53
-1,1989,1769,220,-7,-339,62
-1,1391,1402,-11,-1,-2,46
-1,1291,1203,88,-7,-415,92
-1,1667,1604,63,0,92,52
1,1654,1595,59,0,-1,51
-1,1747,1704,43,-9,-472,90
1,1595,1291,304,0,50,65
1,1366,1353,13,6,571,99
-1,1531,1573,-42,-1,-232,96
1,1919,1961,-42,0,-51,65
1,1350,1438,-88,1,19,43
1,1649,1599,50,-3,-84,55
-1,1589,1538,51,2,-130,68
-1,1271,1408,-137,3,81,94
1,1646,1603,43,0,22,59
-1,1518,1690,-172,0,-5,48
1,1610,1604,6,7,107,43
-1,1778,2005,-227,0,-200,140
1,1354,1433,-79,0,94,65
1,1622,1583,39,0,343,131
-1,1713,1500,213,-9,-123,46
-1,1597,1697,-100,1,-438,134
-1,1521,1623,-102,-4,-237,94
-1,1576,1323,253,5,97,44
-1,1282,1359,-77,0,-124,68
-1,1257,1409,-152,-2,-256,100
-1,1587,1550,37,0,-33,52
1,1662,1458,204,-1,-14,43
1,1925,1452,473,-9,284,107
1,1654,1729,-75,0,85,75
1,1448,1368,80,2,67,58
-1,1767,1672,95,0,7,44
-1,1644,1512,132,0,-45,76
1,1667,1453,214,2,22,67
1,1412,1459,-47,2,104,61
-1,1705,1589,116,0,100,120
-1,1636,1816,-180,-1,-17,46
-1,1588,1621,-33,0,-140,114
-1,1573,1342,231,-1,-26,58
-1,1672,1617,55,0,-617,178
-1,1239,1629,-390,-12,-583,64
-1,1611,1657,-46,-8,-359,78
1,1636,1551,85,9,590,97
-1,1264,1627,-363,-3,-206,120
1,1604,1690,-86,0,147,75
-1,1196,1455,-259,-1,-482,116
1,1977,1813,164,3,429,127
1,1734,1671,63,-1,39,119
-1,1527,1648,-121,0,1,60
1,1550,1829,-279,0,-149,93
-1,1720,1632,88,1,-435,158
1,1266,1400,-134,8,235,56
1,1664,1431,233,0,92,77
1,1725,1681,44,0,-2,43
-1,1814,1563,251,-7,-149,48
-1,1632,1573,59,-1,-82,100
-1,1676,1617,59,-1,103,78
1,1428,1441,-13,3,238,87
1,1810,1575,235,0,29,63
-1,1680,1715,-35,0,-18,88
-1,1488,1318,170,2,107,98
1,1460,1242,218,6,192,48
1,1377,1478,-101,-5,-151,47
1,1509,1360,149,6,411,93
-1,1630,1662,-32,-3,-110,64
-1,1419,1532,-113,-11,-381,64
1,1796,1593,203,0,-4,79
1,1542,1653,-111,2,299,73
-1,1646,1703,-57,-1,-86,120
1,2010,1772,238,-1,58,109
0,1493,1648,-155,1,232,194
-1,1246,1460,-214,3,39,43
-1,1416,1671,-255,0,-473,114
1,1630,1261,369,10,386,59
1,1739,1902,-163,1,37,49
1,1673,1620,53,8,388,77
1,1586,1802,-216,0,-44,95
1,1602,1277,325,4,623,83
1,1660,1513,147,3,552,75
-1,1240,1465,-225,-6,-34,68
1,1755,1500,255,6,1293,105
-1,1611,1682,-71,0,-151,86
1,2127,1959,168,1,7,45
-1,1342,1459,-117,-4,-169,60
1,1927,1683,244,0,70,81
1,1391,1221,170,1,32,45
-1,1684,1784,-100,2,4,86
-1,1621,1683,-62,0,32,62
-1,1572,1575,-3,0,-127,85
1,1830,1856,-26,3,889,131
1,1671,1669,2,1,96,65
-1,1953,2134,-181,-1,-40,56
-1,1235,1412,-177,0,-95,88
-1,1792,1725,67,-4,-204,88
1,1725,1807,-82,0,183,81
-1,1691,1602,89,-3,-72,73
-1,1356,1149,207,-2,-142,63
1,1717,1515,202,2,193,69
-1,1842,1843,-1,0,-335,112
1,1759,1675,84,2,40,83
-1,1792,1676,116,-1,-10,72
1,1411,1347,64,10,170,41
-1,1713,1571,142,-2,-29,41
-1,1616,1677,-61,-2,-642,107
-1,1360,1630,-270,-6,-269,82
1,1612,1461,151,7,59,47
-1,1578,1567,11,0,-481,146
1,1744,1580,164,1,11,41
0,1380,1397,-17,-4,-449,96
-1,1601,1984,-383,-10,-283,66
-1,1690,1777,-87,0,-44,64
-1,1734,1897,-163,-2,-51,51
1,1421,1373,48,-2,11,45
1,1456,1466,-10,-2,591,139
1,1696,1592,104,0,7,55
1,1768,2015,-247,0,19,103
1,1687,1607,80,-2,112,77
-1,1355,1833,-478,-1,-47,48
1,1786,1682,104,1,266,79
-1,1941,1743,198,0,70,78
1,1228,1210,18,2,133,75
-1,1418,1644,-226,-1,-171,68
-1,1417,1288,129,2,65,60
-1,1750,1714,36,-1,-323,106
1,1772,1826,-54,1,42,59
-1,1598,1695,-97,-1,-58,70
-1,1556,1661,-105,-3,-55,48
-1,1581,1704,-123,-3,-270,110
-1,1420,1593,-173,-7,-566,86
1,1786,1903,-117,-1,-17,73
-1,1670,1583,87,0,-10,52
0,1239,1494,-255,-1,-50,67
-1,1619,1681,-62,-1,-56,56
0,1413,1646,-233,0,114,138
-1,1737,1771,-34,4,49,54
1,1396,1381,15,2,-62,79
1,1666,1588,78,-3,0,63
1,1932,1813,119,0,53,73
-1,1674,1579,95,0,-631,104
1,1549,1426,123,7,353,59
-1,1888,1801,87,0,-19,68
0,1467,1411,56,0,-12,77
1,1375,1574,-199,-2,-9,49
1,1402,1418,-16,0,62,55
-1,1728,1668,60,-2,40,58
-1,1766,1795,-29,-3,-181,78
1,1666,1542,124,7,129,59
1,1660,1593,67,0,27,45
1,1478,1506,-28,0,-49,61
1,1607,1310,297,0,9,49
-1,1575,1364,211,0,-40,68
-1,1500,1302,198,1,0,56
1,1669,1447,222,3,217,71
1,1941,1805,136,-4,-93,61
-1,1486,1450,36,-3,-161,62
0,1633,1705,-72,0,-101,167
-1,1947,1792,155,-9,-18,110
1,1674,1534,140,0,84,87
1,1754,1454,300,4,381,109
1,1814,1875,-61,1,23,93
1,1987,1599,388,1,85,73
1,1282,1121,161,9,276,51
1,1728,1802,-74,-1,-19,107
1,1644,1581,63,1,344,109
1,1441,1498,-57,3,123,49
-1,1500,1610,-110,-1,-84,60
-1,1679,1584,95,-3,-152,58
1,1407,1406,1,7,743,85
1,1712,1634,78,0,42,67
1,1413,1450,-37,0,45,65
1,1949,1727,222,1,54,63
1,1727,1680,47,8,344,65
-1,1431,1362,69,0,-67,74
1,1706,1600,106,-4,62,83
1,1545,1572,-27,0,-25,75
-1,1284,1385,-101,-2,-26,56
1,1592,1486,106,14,337,60
1,1684,1799,-115,0,-8,47
-1,1601,1176,425,1,-27,100
1,1420,1463,-43,4,303,73
1,1862,1827,35,0,9,49
-1,1720,1625,95,0,-21,70
1,1835,2189,-354,0,329,117
1,1748,1713,35,1,-4,55
1,1409,1307,102,4,36,43
1,1895,1737,158,0,83,109
1,1372,1216,156,13,325,47
1,1620,1432,188,3,99,57
1,1858,1640,218,1,49,73
-1,1817,1872,-55,0,-121,96
1,1418,1394,24,1,214,97
1,1479,1600,-121,2,447,193
-1,1560,1557,3,1,31,44
-1,1738,1787,-49,-1,-723,142
-1,1537,1653,-116,-4,-48,48
-1,2084,1870,214,-1,-110,110
-1,1417,1829,-412,-1,-40,58
1,1932,1844,88,0,152,81
1,1454,1656,-202,0,-4,61
1,1401,1442,-41,2,559,99
1,1890,1510,380,-3,-37,71
-1,1500,1553,-53,1,4,106
1,1527,1455,72,8,662,89
-1,1546,1861,-315,2,48,72
1,1469,1661,-192,2,-96,53
1,1884,1562,322,-3,-3,41
-1,1582,1669,-87,4,100,56
1,1602,1501,101,2,175,79
0,2031,1893,138,0,-18,92
-1,1890,1702,188,1,22,60
1,1334,1383,-49,3,158,67
-1,1374,1635,-261,-3,-60,48
1,1665,1591,74,2,202,95
-1,1279,1618,-339,-2,-144,66
-1,1898,2025,-127,-1,-543,108
1,1417,1443,-26,3,613,89
1,1345,1379,-34,0,5,45
-1,1832,1639,193,0,46,64
1,1728,1771,-43,0,106,113
-1,1939,1953,-14,0,-4,76
-1,1247,1415,-168,6,132,50
-1,1485,1714,-229,-4,-389,90
1,2035,1889,146,-1,30,93
1,1370,1347,23,5,164,63
1,1735,1549,186,1,138,79
1,2063,1656,407,0,57,83
-1,1414,1467,-53,0,-105,91
-1,1674,1701,-27,-7,-23,50
1,1877,1832,45,0,-38,55
1,1430,1357,73,14,934,135
1,1720,1874,-154,-1,-31,49
1,1578,1507,71,2,47,49
1,2043,1813,230,-1,-24,81
1,2066,1882,184,2,32,63
-1,1653,1297,356,1,36,84
-1,1654,1706,-52,0,-18,80
-1,1788,1635,153,2,-32,94
1,1655,1240,415,3,130,47
1,1537,1402,135,2,104,63
-1,1717,1543,174,-3,-72,58
-1,1664,1563,101,2,59,80
1,1702,1200,502,1,257,153
-1,1875,2073,-198,4,189,116
1,1422,985,437,9,373,55
-1,1741,1636,105,-2,-506,138
-1,1716,1644,72,-1,-18,74
-1,1274,1020,254,3,24,98
-1,1654,1751,-97,-1,-46,68
1,1591,1423,168,-6,-458,119
-1,1889,1901,-12,1,85,90
1,1573,1404,169,0,-2,51
1,1730,1818,-88,0,44,111
-1,1218,1393,-175,0,-38,58
1,1615,1595,20,0,24,53
0,2080,1868,212,1,121,123
0,1941,1952,-11,0,81,107
1,1717,1498,219,3,205,117
-1,1646,1829,-183,-7,-193,56
1,1668,1658,10,-1,59,59
1,1555,1476,79,-1,4,47
-1,1240,1657,-417,-10,-404,61
-1,1875,2073,-198,-1,-6,60
-1,1493,1287,206,0,-69,54
-1,1634,1844,-210,-2,-54,46
-1,1264,1266,-2,-1,-7,52
1,1628,1703,-75,0,9,61
-1,1398,1239,159,-3,-441,74
1,1351,1250,101,0,-120,79
1,1548,1439,109,3,179,85
-1,1390,1558,-168,-2,-388,78
1,1863,2086,-223,7,174,53
-1,1394,1544,-150,-7,-494,76
-1,1527,1494,33,-3,-259,108
1,2065,1883,182,1,426,107
1,1660,1690,-30,-3,108,63
1,2055,1874,181,5,261,65
1,1726,1502,224,-1,96,71
0,1819,1849,-30,0,12,99
1,1584,1626,-42,0,267,141
1,1704,1772,-68,0,-34,89
1,1952,1941,11,-1,-41,65
1,1876,2072,-196,6,145,49
1,1629,1515,114,1,16,47
-1,1390,1562,-172,0,-56,42
1,1581,1042,539,0,-31,45
1,1678,1711,-33,1,167,121
-1,1572,1644,-72,-3,-183,72
-1,1370,1513,-143,-3,-472,102
1,2062,1673,389,2,77,57
1,2052,1895,157,1,100,77
1,1652,1383,269,4,140,57
-1,1399,1500,-101,3,-234,112
1,1381,1000,381,1,-7,47
-1,1699,1690,9,-1,-26,74
-1,1235,1554,-319,-4,-107,56
-1,1636,1491,145,-3,-33,42
-1,1888,2060,-172,-1,-80,88
-1,1603,1676,-73,0,28,106
1,2068,1668,400,-2,-129,97
-1,1439,1207,232,-4,-359,90
1,1500,1800,-300,-1,573,147
1,1925,1962,-37,-4,-26,43
1,2067,1881,186,-1,-23,50
-1,1362,1531,-169,3,27,52
1,1579,1329,250,-5,245,101
-1,1536,1621,-85,0,-5,44
1,1257,1429,-172,0,-1,45
-1,1477,1565,-88,1,14,48
-1,1666,2070,-404,0,-24,46
1,1874,2074,-200,1,82,59
1,1602,1516,86,2,629,125
1,1331,1383,-52,2,-62,89
-1,1467,1554,-87,-2,-64,46
1,2073,1663,410,0,46,79
-1,1468,1222,246,-3,-386,132
1,1730,1745,-15,-2,19,77
-1,1630,1564,66,-3,-37,50
1,1483,1447,36,-4,-184,79
1,1948,1939,9,-1,-12,42
1,1818,1822,-4,0,3,111
1,1428,1538,-110,-6,-76,47
1,1759,1787,-28,2,44,53
-1,1232,1142,90,-5,-21,46
1,1801,1613,188,-1,358,137
1,1538,1586,-48,-1,27,105
-1,1046,1256,-210,-14,-535,80
1,1577,1616,-39,1,137,73
1,1928,1959,-31,-1,-44,85
-1,1217,1358,-141,0,1,58
-1,1673,1733,-60,-4,-42,84
-1,1651,1593,58,1,-203,88
0,1551,1554,-3,-1,-125,125
1,1606,1500,106,-1,-27,57
1,1599,1403,196,3,101,63
1,1600,1408,192,0,3,47
1,1849,1888,-39,-3,37,111
1,1458,1356,102,2,15,49
-1,2075,1824,251,3,154,72
1,1663,1619,44,0,30,53
1,1810,1692,118,0,204,97
-1,1606,1451,155,-10,-367,84
1,1733,1722,11,-1,0,55
1,1811,1829,-18,-2,239,131
1,1661,1841,-180,7,486,87
1,1682,1815,-133,2,70,61
1,1743,1250,493,0,241,115
-1,1500,1500,0,-1,-122,86
1,1807,1516,291,2,109,57
1,1466,1348,118,12,559,71
1,1632,1286,346,-1,-14,41
1,1358,1403,-45,1,142,62
-1,2052,2054,-2,0,-79,130
-1,1269,1243,26,-5,-423,68
1,1777,1770,7,0,-47,55
1,1378,1473,-95,-4,131,59
1,1932,1996,-64,3,116,119
-1,1488,1676,-188,-4,-69,44
-1,1500,1407,93,-1,-141,114
1,1482,1341,141,2,36,49
1,1573,1496,77,2,131,71
1,1508,1464,44,3,363,63
-1,1189,1294,-105,5,305,110
-1,1759,1788,-29,-8,-437,76
1,1799,1750,49,-2,151,91
1,1721,1518,203,0,10,93
1,1754,1596,158,1,17,41
1,1434,1318,116,1,312,81
1,1721,1661,60,1,39,53
-1,1530,1634,-104,-1,-42,70
1,1348,1273,75,10,939,93
1,1485,1572,-87,-8,-314,55
1,1885,1945,-60,0,-9,69
1,1650,1731,-81,12,254,51
1,1799,1749,50,1,265,91
1,1412,1461,-49,4,239,65
1,1601,1681,-80,0,191,85
0,1456,1656,-200,-7,-307,135
-1,1333,1501,-168,-2,-104,60
1,1404,1244,160,-3,336,99
1,1885,1527,358,2,174,84
-1,1984,1957,27,-4,48,102
-1,1932,1898,34,0,-79,82
1,1739,1808,-69,-1,-45,97
-1,1211,1493,-282,-10,-319,56
1,1527,1466,61,0,6,57
0,1294,1451,-157,-7,-1167,174
1,1593,1407,186,1,475,103
-1,1500,1416,84,-5,-100,54
1,1459,1392,67,0,175,99
1,1780,1591,189,3,174,59
-1,1526,1660,-134,0,-21,92
-1,1763,1726,37,0,-26,94
-1,1661,1687,-26,0,-4,72
-1,1910,1920,-10,-1,-249,94
-1,1795,1752,43,1,-27,94
1,1482,1666,-184,0,43,56
1,1586,1538,48,3,180,77
1,1511,1486,25,-1,235,81
-1,1207,1500,-293,1,-12,62
1,1642,1602,40,10,165,43
-1,1930,1900,30,-1,-99,70
1,1255,1404,-149,0,-146,71
-1,1765,1782,-17,-1,-621,116
1,1589,1549,40,0,-45,79
1,1650,1462,188,0,220,91
1,1551,1354,197,-7,-378,53
-1,1668,1614,54,-5,-177,122
-1,1602,1503,99,4,-97,86
-1,1912,1919,-7,-2,-90,66
1,1621,1888,-267,0,27,125
1,1627,1074,553,4,337,65
1,1225,1524,-299,6,378,66
1,1308,1621,-313,2,8,41
-1,1357,1514,-157,0,-21,54
1,1929,1901,28,0,-165,111
-1,1739,1740,-1,-5,-43,70
-1,1737,1705,32,0,-153,128
-1,1539,1599,-60,0,78,70
1,1456,1656,-200,-3,135,123
-1,1621,1978,-357,-1,-8,60
-1,1500,1545,-45,0,13,50
1,1891,1939,-48,1,48,63
-1,1599,1589,10,-1,-100,124
1,1230,1332,-102,-1,-58,69
-1,1407,1737,-330,-13,-124,40
1,1627,1656,-29,1,-41,121
-1,1758,1543,215,-1,1,71
1,1353,1718,-365,-2,25,45
-1,1579,1488,91,-6,-106,44
-1,1518,1749,-231,-4,-156,54
-1,1965,1927,38,-1,0,116
-1,1568,1510,58,0,-28,50
-1,1537,1609,-72,2,4,86
1,1518,1278,240,0,279,85
-1,1561,1533,28,-3,-75,64
1,1939,1951,-12,0,-12,41
-1,1589,1529,60,-12,-130,48
-1,1378,1270,108,-6,-179,52
-1,1440,1518,-78,-10,-725,84
-1,1872,2096,-224,0,30,82
-1,1409,1434,-25,-2,-121,95
1,1475,1521,-46,0,73,85
-1,1528,1596,-68,-4,-408,80
1,1795,1611,184,-3,-179,97
1,1638,1473,165,0,310,93
-1,1459,1740,-281,-2,-214,58
-1,1206,1579,-373,-2,2,40
-1,1698,1755,-57,-1,-49,66
1,1505,1558,-53,0,9,55
1,1312,1511,-199,6,619,111
0,1716,1726,-10,1,169,106
-1,1298,1528,-230,-2,-19,68
1,1317,1246,71,1,12,53
-1,1501,1581,-80,-2,-89,66
-1,1349,1588,-239,1,60,48
-1,1769,1618,151,7,312,124
1,1281,1444,-163,4,247,71
-1,1746,1628,118,-4,-284,104
1,1619,1528,91,0,81,79
-1,1743,1867,-124,-5,-58,58
-1,1639,1396,243,-3,-53,52
1,2114,1356,758,11,136,41
-1,1516,1866,-350,-3,-9,76
1,1874,1735,139,0,-11,47
1,1551,1556,-5,0,67,87
-1,1728,1881,-153,1,2,44
1,1542,1762,-220,1,203,113
-1,1428,1638,-210,1,39,50
-1,1616,1896,-280,0,5,72
-1,1673,1740,-67,-9,-11,59
1,1394,1500,-106,11,1011,111
1,1263,1236,27,12,271,47
-1,1753,1976,-223,0,-19,54
1,1466,1464,2,1,120,43
1,1725,1717,8,2,45,47
1,1630,1548,82,11,237,51
-1,1634,1988,-354,-8,-727,114
-1,1637,1644,-7,0,32,58
-1,1414,1370,44,-1,-110,84
-1,1515,1492,23,0,27,48
1,1273,1523,-250,5,29,41
-1,1422,1869,-447,-2,-347,74
-1,1072,1285,-213,0,-33,118
-1,1450,1478,-28,-4,-66,40
-1,1497,1513,-16,-10,-90,40
-1,1319,1468,-149,-3,-460,86
1,1488,1406,82,10,236,43
-1,1236,1190,46,-2,-134,79
1,1509,1242,267,1,169,119
0,1735,1706,29,-2,-217,167
-1,1451,1637,-186,-4,-423,102
-1,1643,1750,-107,-2,-46,76
-1,1554,1631,-77,1,41,58
-1,1521,1750,-229,0,90,88
1,1375,1540,-165,16,587,67
1,1626,1437,189,3,400,95
-1,1504,1503,1,0,-34,92
-1,1264,1847,-583,-3,-173,52
1,1731,1621,110,-1,12,61
1,1871,1663,208,3,197,91
1,1593,1420,173,0,5,53
1,1563,1655,-92,0,-2,61
-1,1197,1442,-245,3,-117,72
1,1546,1332,214,4,70,47
1,1486,1628,-142,0,5,55
-1,1734,1702,32,-7,-22,72
1,1640,1545,95,-1,-56,65
1,1861,1618,243,2,32,51
-1,1225,1525,-300,0,-25,84
-1,1475,1279,196,-12,-638,76
-1,1877,1658,219,0,-58,92
-1,1519,1564,-45,1,-19,68
-1,1754,1644,110,-4,-72,48
1,1495,1578,-83,1,89,73
-1,1165,1504,-339,-12,-288,51
-1,1680,1747,-67,0,-12,60
-1,1373,1613,-240,-18,-609,58
-1,1265,1904,-639,0,4,42
1,1446,1191,255,7,210,68
-1,1755,1763,-8,-1,-29,52
-1,1704,1445,259,-1,-59,62
-1,1495,1607,-112,0,19,112
1,1714,1717,-3,-1,-84,79
-1,1500,1401,99,-3,-191,66
1,1528,1263,265,0,-2,53
-1,1707,1735,-28,-2,-106,116
-1,1293,1620,-327,-9,-678,108
1,1888,1722,166,-1,-40,55
1,1739,1641,98,-4,14,85
-1,1240,1604,-364,-9,-131,46
-1,1186,1450,-264,-2,-61,56
1,1500,1581,-81,4,544,101
-1,1066,1253,-187,-3,-99,44
1,1857,1261,596,7,130,45
-1,1423,1403,20,1,64,70
-1,1618,1910,-292,0,-146,110
-1,1515,1516,-1,0,-61,88
0,1290,1158,132,3,239,127
1,1878,1732,146,-6,-267,83
-1,1564,1750,-186,0,-131,140
-1,1508,1744,-236,1,-204,122
1,1614,1235,379,0,98,57
1,987,1140,-153,22,1873,89
1,1685,1701,-16,1,-12,65
1,1653,1652,1,0,51,65
1,1069,1613,-544,-6,-26,59
-1,1702,1765,-63,1,51,44
-1,1725,1885,-160,0,-19,86
-1,1507,1590,-83,1,-2,64
-1,1701,1725,-24,-6,-79,40
-1,1509,1648,-139,2,-186,84
1,1697,1533,164,4,142,69
1,1455,1181,274,0,12,49
1,1574,1509,65,-4,-185,101
-1,1617,1958,-341,-3,-669,122
1,1544,1111,433,15,358,59
-1,1233,1939,-706,-14,-617,60
1,1891,1719,172,1,5,47
1,1964,1779,185,0,66,117
-1,1632,1747,-115,-4,-89,60
1,1541,1171,370,15,145,43
1,1664,1643,21,-1,208,87
-1,1713,1897,-184,-8,-175,50
-1,1903,1707,196,-2,-235,80
-1,1708,1858,-150,-2,-68,56
-1,1107,1550,-443,-10,-380,68
1,1776,1694,82,-4,25,67
1,1505,1528,-23,-1,-13,59
-1,1273,1543,-270,-4,-475,78
1,1387,1355,32,-3,-68,47
1,1709,1457,252,-2,106,61
1,1886,1724,162,-1,-16,77
-1,1502,1445,57,0,4,58
-1,1176,1459,-283,-3,-25,52
-1,1430,1628,-198,-4,-78,72
1,1866,1584,282,0,-9,57
-1,1624,1749,-125,0,81,108
-1,1717,1893,-176,-4,-97,90
-1,1290,1703,-413,-1,-14,74
-1,1781,1881,-100,3,281,84
1,1457,1539,-82,1,68,51
1,1764,1671,93,-1,-8,47
-1,1689,1753,-64,0,89,86
1,1658,1727,-69,1,2,111
1,1599,1498,101,-2,-21,62
1,1977,1613,364,2,100,53
-1,1390,1556,-166,-3,-143,60
-1,1662,1749,-87,-2,-3,40
1,1899,1711,188,-3,-111,67
-1,1312,1524,-212,-2,-31,48
1,1758,1654,104,-1,51,91
1,1774,1970,-196,2,149,83
-1,1573,1870,-297,-2,-229,128
-1,1705,1905,-200,2,16,40
1,1646,1766,-120,0,1,89
1,1910,1700,210,-3,-182,67
-1,1751,1661,90,5,158,52
-1,1408,1513,-105,-1,-41,103
-1,1645,1503,142,1,47,58
1,1674,1736,-62,5,455,75
-1,1694,1915,-221,0,2,56
-1,1095,1495,-400,-1,20,72
1,1278,1239,39,1,25,112
1,1379,1332,47,1,320,81
1,1617,1756,-139,-1,-49,97
1,1920,1689,231,3,168,81
-1,1532,1460,72,0,-143,84
1,1735,1686,49,5,28,40
1,1687,1530,157,-2,17,93
1,1757,1699,58,3,251,115
-1,1684,1925,-241,-1,-45,78
0,1564,1659,-95,5,411,99
1,1762,1680,82,0,1,73
1,1487,1526,-39,0,217,119
1,1091,971,120,10,885,105
1,1875,1504,371,1,140,71
-1,1784,1958,-174,-3,-21,46
-1,1533,1516,17,-3,-11,50
-1,1418,1514,-96,5,131,72
1,1529,1522,7,1,206,93
1,1776,1797,-21,0,33,111
1,1228,1288,-60,2,31,43
1,1647,1745,-98,0,-44,73
1,1913,1930,-17,1,-7,83
-1,1656,1540,116,-8,-132,50
1,1633,1741,-108,-3,-114,129
1,1807,1477,330,5,332,69
1,1557,1700,-143,3,115,61
1,1443,1231,212,5,339,75
-1,1785,1788,-3,0,-109,94
-1,1672,1770,-98,-3,-109,109
-1,1191,1416,-225,5,1021,146
1,1305,1500,-195,5,257,78
-1,1918,1924,-6,0,-144,86
1,1664,1700,-36,3,261,81
-1,1501,1878,-377,-1,-21,72
-1,1393,1488,-95,-5,-360,70
-1,1355,1610,-255,-1,-233,80
-1,1934,1907,27,-5,-218,70
-1,1798,1774,24,-1,-46,76
1,1557,1508,49,0,10,53
1,1282,1424,-142,6,608,105
-1,1919,1923,-4,1,-15,80
-1,1556,1732,-176,-1,-128,62
1,1687,1266,421,6,215,57
-1,1498,1567,-69,4,98,52
-1,1055,1515,-460,-1,-111,74
1,1738,1550,188,2,97,63
-1,1496,1407,89,0,36,46
-1,1786,1787,-1,-4,-168,72
1,1615,1718,-103,-2,-143,79
1,1501,1522,-21,-1,118,93
-1,1556,1908,-352,-1,-46,56
-1,1724,1417,307,-4,-196,76
-1,1544,1535,9,3,20,42
-1,1970,1829,141,0,33,96
-1,1735,1691,44,3,21,78
1,1541,1562,-21,-4,-166,53
1,1661,1737,-76,3,111,85
1,1560,1502,58,-1,247,105
1,1320,1191,129,2,331,133
-1,1676,1549,127,-3,-27,86
1,1633,1500,133,0,223,83
1,1766,1607,159,0,0,49
1,1761,1500,261,2,345,161
1,1722,1696,26,1,72,61
-1,1795,1817,-22,-2,-506,128
1,1458,1587,-129,-1,-16,51
-1,1287,1485,-198,-1,-12,54
0,1525,1588,-63,2,37,98
1,1741,1703,38,0,33,67
-1,1397,1378,19,-1,-191,65
1,1707,1459,248,-5,25,81
-1,1450,1477,-27,3,-473,118
0,1846,1955,-109,-6,-301,133
-1,1693,1751,-58,0,-54,90
-1,1500,1644,-144,-2,-246,138
1,1343,1373,-30,-7,-131,43
-1,1685,1721,-36,-4,-328,98
1,1537,1379,158,3,484,113
1,1286,1128,158,5,46,43
-1,1121,1557,-436,0,-162,98
-1,1697,1686,11,4,164,98
1,1384,1500,-116,13,219,41
-1,1454,1713,-259,-2,-46,66
1,1766,1615,151,0,113,117
1,1612,1361,251,-3,4,46
1,1491,1500,-9,3,102,63
1,1733,1429,304,0,-30,63
-1,1262,1479,-217,-4,-70,46
1,1261,1233,28,0,26,51
0,1852,1779,73,0,40,132
1,2182,1664,518,5,99,43
1,1710,1200,510,2,61,81
1,1783,1000,783,12,124,41
-1,1829,1733,96,0,-65,210
-1,0,978,-978,-9,-841,88
-1,1686,1732,-46,1,23,50
1,1924,1570,354,2,28,45
-1,1952,1850,102,-4,-68,96
0,1676,1590,86,0,95,137
-1,1663,2183,-520,-1,175,128
1,1500,1343,157,0,21,49
1,1657,1493,164,-2,249,113
1,1334,1327,7,4,618,127
1,1742,1677,65,-12,-186,67
1,1466,1492,-26,9,204,49
-1,1488,1783,-295,-2,-377,128
1,1560,1224,336,9,249,73
-1,1452,1584,-132,0,-18,64
1,1197,1431,-234,-5,-35,47
-1,1661,1815,-154,0,214,78
-1,1330,1416,-86,-4,-104,48
1,1500,1499,1,0,-79,105
-1,1540,1562,-22,-1,-50,50
-1,1555,1413,142,-8,-609,107
1,1559,1612,-53,0,291,123
-1,1500,1534,-34,-1,85,84
1,1654,2139,-485,8,396,51
1,1500,1404,96,-1,77,64
-1,1781,1850,-69,-3,-82,56
1,1714,1414,300,0,-8,79
-1,1602,1825,-223,3,-40,68
-1,2115,1793,322,0,9,50
-1,1866,1938,-72,0,-259,92
1,1440,1385,55,-1,74,63
-1,1328,1357,-29,0,-59,56
1,1566,1530,36,0,-32,107
-1,1597,1773,-176,0,108,142
0,1550,1553,-3,-2,-121,144
-1,1339,1294,45,-5,-2,40
1,1569,1457,112,3,42,41
1,1472,1603,-131,3,232,81
-1,1533,1850,-317,1,44,52
-1,1633,1701,-68,-2,-320,96
1,1581,1018,563,8,186,53
1,1686,1775,-89,1,49,45
-1,1141,1227,-86,-5,-163,44
-1,1668,1673,-5,0,-70,74
-1,1858,1787,71,0,-295,158
-1,1813,2102,-289,0,-83,104
-1,1316,1410,-94,-4,-97,60
-1,1534,1763,-229,-3,-232,66
-1,1600,1552,48,-5,-11,40
-1,1803,1906,-103,-5,-231,94
-1,1947,1856,91,-2,27,74
-1,1361,1238,123,3,75,50
-1,1500,1521,-21,-6,-346,64
-1,1535,1466,69,0,8,44
-1,1400,1513,-113,-12,-851,94
-1,1487,1486,1,0,-114,82
-1,1368,1491,-123,-1,-32,58
-1,1315,1500,-185,-5,-492,92
-1,1741,1831,-90,0,10,48
1,1430,1526,-96,3,92,57
-1,1684,1649,35,0,109,80
1,1374,1449,-75,0,65,89
1,1550,1288,262,0,11,46
-1,1718,1824,-106,1,-47,61
-1,1263,1422,-159,-12,-359,56
-1,1389,1316,73,2,122,56
-1,1768,1925,-157,1,48,48
-1,1569,1512,57,-6,-347,64
1,1660,1596,64,-1,10,47
1,1647,1553,94,-2,-52,85
-1,1429,1540,-111,-4,-68,62
-1,1783,1802,-19,-1,-205,120
-1,1452,1760,-308,-10,-300,60
-1,1669,1500,169,-1,-67,82
1,1871,1933,-62,3,168,83
1,1378,1495,-117,1,95,61
1,1805,2105,-300,0,-2,103
-1,1500,1181,319,-1,61,40
1,1307,1280,27,10,536,66
1,1710,1809,-99,0,52,55
1,1700,1419,281,0,-90,85
-1,1489,1280,209,-1,-186,65
-1,1725,1691,34,-3,212,144
1,1398,1345,53,-11,-50,53
1,1846,1932,-86,0,-26,87
-1,1497,1476,21,0,-200,61
0,1762,1678,84,0,50,120
1,1793,1499,294,5,265,69
-1,1500,1513,-13,-6,-289,56
-1,1520,1500,20,-3,-42,44
1,1779,1669,110,0,55,99
-1,1454,1447,7,-7,-257,72
-1,1543,1586,-43,-1,-55,80
-1,1633,1745,-112,-1,-47,58
-1,1444,1672,-228,0,-279,144
-1,1523,1571,-48,5,26,74
-1,1824,1704,120,2,64,54
-1,1284,1247,37,1,63,48
-1,1542,1225,317,2,136,98
1,1712,1692,20,0,-10,67
-1,1500,1372,128,-2,-273,76
-1,1367,1463,-96,-4,-648,92
-1,1724,1688,36,-6,-366,76
-1,1921,2049,-128,-1,10,86
-1,1495,1485,10,-4,-280,86
-1,1859,1917,-58,0,-43,68
-1,1397,1501,-104,-4,-555,116
-1,1826,1797,29,0,1,88
1,1723,1234,489,9,274,46
1,2085,1720,365,1,136,77
-1,1341,1436,-95,3,111,44
-1,1485,2118,-633,0,-14,82
1,1753,1713,40,2,407,129
-1,1218,1950,-732,-2,-37,50
-1,1657,1787,-130,-2,273,156
-1,1151,1258,-107,-6,-172,60
1,1472,1166,306,5,78,43
1,1625,1617,8,7,775,99
1,1700,1712,-12,1,140,95
1,1779,1657,122,0,72,67
-1,1387,1392,-5,-2,-143,62
1,1530,1657,-127,-1,38,47
-1,1681,1760,-79,-1,-124,66
-1,1338,1316,22,0,-255,88
1,1850,1927,-77,0,-16,81
1,1841,1619,222,6,61,53
1,1597,1534,63,1,11,41
-1,1484,1328,156,3,-12,40
-1,1703,1763,-60,0,5,60
1,1508,1496,12,7,60,51
-1,1613,1866,-253,0,3,62
-1,1521,1854,-333,3,231,60
1,1702,1721,-19,-3,-81,73
-1,1700,1711,-11,-3,-211,72
-1,1416,1606,-190,-2,-92,50
1,1496,1484,12,6,114,45
-1,1732,1500,232,-4,-405,98
1,1424,1161,263,6,148,55
-1,1284,1581,-297,-5,-326,81
1,1849,1353,496,-1,-44,57
1,1726,1367,359,13,209,49
1,1555,1655,-100,1,-20,57
1,1471,1358,113,10,236,51
1,1768,1672,96,4,63,63
-1,1424,1870,-446,-5,-6,72
-1,1520,1607,-87,1,13,50
-1,1608,1719,-111,2,21,44
1,1681,1722,-41,7,274,55
1,1612,1511,101,14,392,59
-1,1326,1649,-323,3,60,50
1,1956,1590,366,2,65,51
1,1327,1525,-198,10,792,83
-1,1500,1401,99,1,-166,87
1,1487,1527,-40,-12,-200,132
-1,1852,1795,57,0,-130,82
-1,1863,1914,-51,0,28,56
-1,1795,1645,150,0,-68,66
-1,1407,1811,-404,-7,-221,66
-1,1728,1668,60,-1,-471,120
1,1513,1571,-58,-2,-117,63
1,2093,1872,221,0,20,55
-1,1449,1619,-170,3,7,82
-1,1507,1697,-190,1,180,100
1,1496,1351,145,-9,-265,65
-1,1680,1713,-33,8,111,40
-1,1959,1913,46,-1,-39,98
1,1669,1778,-109,0,-2,49
-1,1508,1337,171,0,-1,99
1,1697,1140,557,3,167,79
-1,1641,1390,251,-1,157,104
-1,1311,1479,-168,3,49,54
1,1503,1725,-222,-2,-28,43
1,1710,1694,16,2,78,79
-1,1500,1483,17,2,5,46
-1,1664,1776,-112,1,208,118
-1,1569,1703,-134,-3,-407,86
1,1763,1691,72,1,55,53
-1,1923,1854,69,0,-113,102
1,1524,1705,-181,-2,-63,75
-1,1520,1340,180,9,530,98
-1,1260,1506,-246,-3,-594,74
1,2099,1867,232,0,-25,81
1,1813,1718,95,0,8,67
1,1678,1773,-95,0,25,57
-1,1563,1410,153,-16,-376,48
1,1323,1159,164,12,202,41
1,1688,1601,87,-8,-570,113
1,1470,1476,-6,10,270,53
1,1507,1344,163,0,408,115
-1,1368,1628,-260,-2,-671,124
-1,1723,1809,-86,0,-101,118
1,1758,1698,60,0,503,129
1,1705,1539,166,1,316,91
-1,1501,1710,-209,-1,-38,56
-1,1482,1408,74,0,-127,112
-1,1822,2057,-235,-1,-94,82
-1,1518,1712,-194,4,103,62
1,1329,1077,252,11,253,46
1,2088,1632,456,2,280,69
1,1549,1689,-140,0,-10,55
1,1548,1291,257,-3,61,73
-1,1566,1697,-131,-8,-518,82
-1,1504,1492,12,3,81,48
0,1783,1656,127,0,-121,141
1,1685,1768,-83,0,-9,53
1,1484,1724,-240,-1,238,77
-1,1520,1504,16,0,26,52
1,1866,1710,156,2,46,47
1,1493,1500,-7,1,100,45
-1,1332,1308,24,-7,-160,40
1,2063,1817,246,-2,182,133
-1,1562,1642,-80,2,47,42
-1,1516,1508,8,-6,-765,118
-1,1745,1630,115,3,251,128
-1,1291,1496,-205,-7,-324,64
-1,1500,1513,-13,-8,-141,54
-1,1583,1220,363,5,-83,82
1,1705,1535,170,8,191,55
1,1738,1283,455,1,233,115
0,978,0,978,3,117,89
1,1754,1704,50,0,76,75
-1,1293,1464,-171,-2,-178,64
1,1519,1504,15,0,157,79
-1,1519,1712,-193,-19,-598,58
-1,1956,2090,-134,0,7,86
1,1203,1169,34,4,396,67
1,1547,1500,47,9,616,89
1,1718,1504,214,-2,-85,67
-1,1643,1835,-192,1,29,46
1,1497,1540,-43,1,12,43
-1,1704,1873,-169,-2,-163,98
-1,1514,1554,-40,-5,-80,70
-1,1492,1724,-232,-1,232,90
1,1694,1629,65,0,-10,49
1,1691,1764,-73,5,137,49
1,1346,1554,-208,3,-17,71
-1,1511,1526,-15,1,-106,62
1,1729,1480,249,2,49,51
-1,1750,1709,41,5,106,42
-1,1812,2068,-256,0,1,44
-1,1327,1214,113,-2,-461,110
-1,1687,1412,275,1,-45,78
-1,1519,1554,-35,-5,-88,96
-1,1550,1731,-181,-3,-110,70
-1,1237,1474,-237,-8,-533,98
-1,1397,1525,-128,-4,-449,78
1,1286,1308,-22,-2,125,73
1,1725,1737,-12,0,21,63
1,1540,1545,-5,6,230,61
0,1660,1779,-119,0,86,116
0,2073,1807,266,0,83,187
-1,1476,1471,5,-1,-494,92
1,1352,1391,-39,-5,505,133
1,1625,1544,81,-5,-176,73
1,1726,1739,-13,5,422,77
-1,1308,1563,-255,-14,-345,50
1,1448,1550,-102,1,90,99
-1,1737,1651,86,4,149,64
1,1616,1528,88,-4,-164,119
1,1269,1214,55,0,213,85
-1,1575,1659,-84,-1,-81,74
1,1954,1789,165,0,49,75
0,1667,1567,100,-6,-713,186
1,1329,1463,-134,0,-5,61
1,1671,1734,-63,1,53,49
-1,1681,1611,70,9,83,46
1,2059,1723,336,0,42,65
-1,1570,1665,-95,-7,-384,68
1,1567,1272,295,4,282,87
-1,1023,1379,-356,-1,-203,78
-1,2127,1903,224,-10,-205,60
1,2117,1725,392,2,140,63
-1,1416,1344,72,0,2,42
-1,1434,1720,-286,4,120,54
0,1721,1684,37,0,-68,68
-1,1239,1373,-134,2,59,74
-1,1555,1680,-125,-4,-364,72
1,1827,1509,318,2,51,41
-1,1720,1724,-4,0,-268,100
0,1652,1637,15,-1,-1,123
1,2108,1920,188,2,59,67
1,1624,1749,-125,1,-7,61
1,1735,1708,27,1,89,75
1,2120,2062,58,-6,-176,87
-1,1687,1698,-11,-15,-516,78
1,1463,1493,-30,-1,15,53
1,1676,1709,-33,1,38,61
-1,1722,1745,-23,-3,-89,60
0,1694,1764,-70,-1,134,112
-1,1576,1692,-116,-1,61,130
1,1596,1332,264,6,727,101
-1,1688,1696,-8,6,19,88
0,2052,1532,520,0,190,112
1,1756,1711,45,0,193,165
-1,1731,2105,-374,0,-121,66
1,1678,1707,-29,2,92,61
1,1230,1438,-208,-4,-35,75
-1,1543,2040,-497,7,1,68
-1,1689,1695,-6,1,-75,50
0,1476,1704,-228,1,145,154
1,1689,1695,-6,4,242,57
1,2042,1542,500,0,-7,51
1,1679,1684,-5,0,-15,45
-1,1680,1370,310,-9,-437,114
1,1358,1207,151,1,193,105
1,1701,1765,-64,0,9,73
1,1619,1541,78,4,252,51
1,1689,1672,17,1,155,67
-1,1579,1510,69,0,-11,66
-1,1635,2003,-368,-4,-93,58
-1,1611,1671,-60,0,-37,50
1,1699,1662,37,-8,-256,61
-1,1531,2043,-512,0,-234,66
-1,1301,1751,-450,-8,-56,98
1,1504,1482,22,2,85,67
1,1652,1752,-100,0,31,91
-1,1529,1505,24,0,-281,90
-1,1170,1499,-329,8,119,50
-1,1715,1775,-60,0,-11,42
1,1660,1390,270,0,276,157
-1,1360,1276,84,-1,-175,52
1,1365,986,379,5,173,45
1,1775,1715,60,0,-21,63
-1,1499,1651,-152,2,51,66
1,1518,1516,2,1,66,59
1,1627,1666,-39,3,235,99
-1,1783,1738,45,-2,-135,58
-1,1738,1783,-45,0,-14,88
-1,1376,1368,8,2,128,72
-1,1793,1751,42,3,26,46
1,1422,1323,99,-1,-9,45
1,1639,1654,-15,6,149,49
0,1751,1793,-42,0,77,120
-1,1680,1826,-146,0,26,78
-1,1320,1948,-628,-15,-324,86
-1,1630,1844,-214,-1,-166,92
1,1412,1582,-170,0,-31,52
-1,1747,1909,-162,-2,-54,49
-1,1660,1632,28,-2,-22,40
1,1384,1057,327,-6,-143,81
1,1380,982,398,-5,-137,45
-1,1649,1643,6,-3,-279,74
-1,1525,1584,-59,0,12,50
-1,1327,1370,-43,-1,-309,76
1,1971,1654,317,-1,111,59
1,2084,1781,303,2,292,91
1,1623,1755,-132,0,54,71
1,1386,1713,-327,-1,-11,63
-1,1692,1763,-71,0,-28,84
1,1661,1667,-6,-6,-27,71
-1,1778,2088,-310,3,-1,122
1,1664,1659,5,0,127,117
-1,1651,1651,0,0,11,86
-1,1462,1645,-183,-2,-386,86
1,1429,1312,117,-1,-21,45
1,1919,1739,180,8,234,49
1,1640,1662,-22,-11,-33,45
-1,1428,1705,-277,0,-90,82
-1,1771,1775,-4,-4,372,108
-1,1541,1591,-50,-1,56,76
-1,1782,1605,177,-3,-42,68
-1,1552,1406,146,0,3,58
1,1672,1731,-59,1,27,41
1,1785,1761,24,2,-45,75
-1,1387,1512,-125,-2,-430,96
-1,1638,1740,-102,-1,-55,60
1,1500,1753,-253,-4,-122,61
1,1380,1316,64,0,83,89
1,1751,1795,-44,5,228,73
-1,1641,1662,-21,0,-102,54
1,1908,1787,121,1,39,57
1,1639,1477,162,1,30,63
1,1631,1672,-41,4,126,63
-1,1718,1629,89,0,-4,84
-1,1783,1763,20,2,29,46
1,1655,1600,55,0,287,97
1,1507,1574,-67,-1,-12,49
-1,1774,1772,2,-1,-57,54
1,1695,1565,130,-1,-6,103
1,1816,1660,156,2,57,57
1,1471,1646,-175,1,63,77
-1,1341,1646,-305,1,47,60
-1,1352,1395,-43,-11,-252,46
1,1603,1469,134,3,635,175
1,1660,1530,130,0,-4,53
1,1942,1693,249,2,122,55
-1,1365,1520,-155,-5,-178,54
-1,1490,1500,-10,1,-10,50
-1,1500,1500,0,-5,-258,70
-1,1423,1537,-114,1,-40,68
-1,1826,1950,-124,0,125,74
1,1999,1743,256,1,119,67
1,1961,1643,318,0,-7,55
1,1949,1521,428,0,84,69
1,1473,1493,-20,-1,6,61
0,1662,1590,72,-3,-377,135
1,1419,1437,-18,0,34,107
-1,1640,1965,-325,0,-6,56
1,1768,1379,389,1,271,45
-1,1480,1503,-23,2,535,106
1,1756,1785,-29,-3,126,61
-1,1666,1762,-96,1,-124,116
1,1969,1637,332,3,89,49
-1,1662,1337,325,0,-119,60
1,1568,1780,-212,-1,45,63
-1,1415,1313,102,-2,-89,56
-1,1643,1529,114,-1,-27,64
1,1773,1362,411,3,122,69
-1,1306,1614,-308,1,-104,116
1,1845,1784,61,0,117,81
1,1703,1692,11,-1,57,119
1,1638,1492,146,-11,-489,79
0,1607,1969,-362,-3,-347,115
-1,1382,1665,-283,1,29,120
-1,1655,1531,124,-5,-86,66
-1,1658,1952,-294,-11,-142,46
-1,1474,2041,-567,-2,-377,106
1,1771,1439,332,0,25,47
0,1300,1227,73,-1,475,165
-1,1644,1320,324,-1,-30,52
-1,1355,1502,-147,3,61,82
1,2181,2042,139,0,27,61
1,1744,1378,366,0,97,97
1,2034,2190,-156,-1,-78,59
-1,1669,1945,-276,0,2,56
1,1433,1604,-171,-2,24,73
-1,1585,1581,4,-1,-180,110
-1,1571,1401,170,1,9,54
-1,2171,2052,119,-2,156,110
1,1764,1630,134,5,23,44
-1,1561,1705,-144,0,-29,84
1,1554,1583,-29,3,100,47
1,1739,2003,-264,0,187,117
-1,1348,1453,-105,-20,-789,52
1,1325,1478,-153,2,59,65
-1,1608,1363,245,0,-131,104
1,1306,1455,-149,-2,170,73
1,1375,1617,-242,0,122,77
1,1720,1914,-194,-2,-24,45
-1,1751,1665,86,0,-25,108
1,1556,1594,-38,-2,-48,55
-1,1485,1560,-75,-3,-257,66
-1,1774,1669,105,0,-66,76
-1,1461,1685,-224,-2,-309,118
1,1618,1302,316,-6,221,165
1,1901,1888,13,3,-43,41
0,1395,1716,-321,1,-123,93
0,1714,1806,-92,0,109,128
-1,1189,1566,-377,-1,-644,100
-1,1429,1652,-223,0,-90,70
-1,1500,1341,159,-8,-153,48
1,1633,1682,-49,2,25,40
1,1340,1415,-75,3,471,79
0,1679,1403,276,5,142,55
-1,1918,1756,162,-4,-77,48
1,1235,1258,-23,17,596,55
-1,1690,1668,22,3,275,98
1,1653,1581,72,7,343,85
1,1738,1303,435,-1,-21,53
1,1851,1448,403,0,13,45
1,1431,1592,-161,0,325,101
1,1562,1341,221,4,209,93
-1,1232,1247,-15,-17,-262,42
-1,1842,1903,-61,0,-8,86
-1,1530,1569,-39,0,-55,92
1,1853,1543,310,0,18,91
1,1696,1395,301,8,246,51
1,1711,1740,-29,-1,-2,47
1,1296,1176,120,3,615,129
1,1662,1258,404,0,-40,85
1,1651,1437,214,-1,-143,65
1,1912,1799,113,0,-10,81
1,1199,1170,29,2,220,69
1,1812,1878,-66,4,236,97
1,1759,1761,-2,0,-16,43
1,1597,1454,143,1,96,61
-1,1447,1462,-15,-1,-99,74
-1,1544,1550,-6,-1,-5,48
-1,1751,1428,323,-5,-567,146
1,1975,1857,118,0,197,107
1,1411,1452,-41,2,15,55
0,1766,1771,-5,2,162,124
1,2132,1783,349,1,89,63
1,1610,1759,-149,-1,-5,79
-1,1586,1432,154,0,-33,112
-1,1767,1920,-153,0,-19,76
-1,1656,1586,70,-1,-501,136
-1,1520,1697,-177,3,53,46
-1,2164,1512,652,1,36,66
-1,1316,1848,-532,0,2,44
-1,1529,1727,-198,1,-6,76
-1,1495,1402,93,-4,-194,74
0,2136,1780,356,0,-349,136
1,1750,1671,79,4,105,53
-1,1584,2138,-554,0,-180,102
-1,1788,2124,-336,-9,-395,72
-1,1533,1500,33,0,28,80
1,1757,2114,-357,1,162,105
0,1211,1256,-45,2,84,163
-1,1500,1476,24,1,72,122
-1,1735,1785,-50,3,60,52
-1,1340,1391,-51,-2,-183,74
1,1436,1423,13,1,75,131
-1,1314,1461,-147,0,-13,58
-1,1742,1584,158,-3,-303,134
1,2139,1580,559,0,51,74
-1,1514,1417,97,-1,-57,82
-1,1591,1544,47,-1,1,56
1,1525,1500,25,-3,-15,55
-1,1804,1943,-139,-9,-321,134
1,1020,1556,-536,0,-69,57
-1,1621,1448,173,2,-52,72
1,1676,1824,-148,4,80,43
-1,1579,1472,107,5,76,50
1,1959,1830,129,0,161,94
1,1468,1305,163,-1,88,47
-1,1645,1772,-127,-1,-210,118
1,1565,1508,57,-1,37,63
1,2059,1797,262,0,389,105
1,1739,1511,228,0,83,81
1,1679,1742,-63,-1,-49,141
-1,1438,1807,-369,-4,-230,94
-1,1600,1582,18,-2,-34,48
-1,1574,1686,-112,-9,-142,52
-1,1770,2141,-371,3,63,94
1,1343,1500,-157,1,16,41
-1,1768,1793,-25,1,6,52
-1,1228,1558,-330,-7,-101,45
-1,1652,1571,81,-2,-99,58
1,1309,1201,108,3,239,77
-1,1524,1344,180,-2,-30,48
-1,1756,1803,-47,2,130,68
-1,1456,1394,62,-5,-443,100
-1,1608,1352,256,1,91,66
0,1577,2144,-567,0,-40,115
1,1255,1212,43,-7,-87,49
1,2207,2096,111,-1,95,123
1,1502,1538,-36,-1,615,175
-1,1770,1766,4,-9,-280,66
1,2006,1601,405,16,396,51
-1,1602,1519,83,-1,-372,210
0,1296,1476,-180,0,400,136
-1,1567,1567,0,-8,-73,56
1,2145,1777,368,0,50,55
1,1810,1995,-185,0,-2,57
-1,1926,2142,-216,-1,-64,60
-1,1702,1660,42,-9,-21,40
-1,1265,1405,-140,-4,-164,57
1,1568,1566,2,-1,23,43
-1,1978,1914,64,-2,-93,60
1,1939,1826,113,2,57,95
0,1202,1265,-63,-1,-46,109
-1,1470,1303,167,1,-562,116
1,1797,1822,-25,1,397,117
1,1548,1559,-11,2,143,83
1,1647,1448,199,-2,531,153
1,1296,1335,-39,-9,-392,67
-1,1834,1795,39,-3,-401,134
-1,1921,2152,-231,-2,-34,42
1,1756,1004,752,2,102,71
1,1983,1811,172,1,0,57
1,1811,1810,1,2,174,115
1,1507,1408,99,9,112,41
-1,1353,1690,-337,-1,-265,68
-1,1916,2161,-245,-3,-156,60
1,1466,1586,-120,4,167,73
0,1548,1566,-18,1,374,117
-1,1928,1946,-18,0,9,56
1,1672,1682,-10,4,213,69
-1,1775,2148,-373,-3,-71,68
-1,1805,2000,-195,-4,-349,126
-1,1798,1822,-24,-5,-338,72
1,1515,1400,115,0,9,55
1,1709,1325,384,-1,40,91
1,1379,1164,215,6,373,73
-1,1182,1322,-140,-4,-72,45
1,1789,1575,214,1,71,77
1,2014,1799,215,1,22,55
-1,1601,1855,-254,-3,-403,102
-1,1832,1787,45,1,-537,108
1,2150,1772,378,-1,-17,53
1,1662,1482,180,1,97,67
1,1596,1679,-83,4,172,65
1,1653,1565,88,0,71,61
1,1794,1600,194,-5,25,83
-1,1321,1723,-402,2,-65,74
1,1911,1807,104,1,23,65
-1,1800,1820,-20,-6,-435,82
-1,1970,1698,272,-2,-100,78
-1,1553,1661,-108,0,7,52
1,1204,1161,43,-1,-42,91
-1,1523,1357,166,0,-77,78
1,1917,1754,163,2,146,63
-1,1426,1619,-193,-1,-42,74
-1,1643,1247,396,1,18,40
1,1737,1456,281,0,71,97
-1,1594,1800,-206,-9,-437,78
1,1735,1318,417,1,112,59
0,1770,2153,-383,0,182,176
0,1308,1001,307,-3,-447,155
1,1830,1759,71,0,2,63
1,1805,1588,217,1,58,83
1,2027,1669,358,2,67,53
-1,1570,1554,16,-3,-118,59
-1,1609,1665,-56,0,-16,170
1,1583,1443,140,3,485,87
-1,1821,1638,183,2,22,43
1,1838,1749,89,-2,-125,75
1,1811,1175,636,3,145,59
-1,1390,1745,-355,-1,-46,44
-1,1332,1733,-401,-3,-251,104
-1,1385,1412,-27,1,-101,68
1,1642,1426,216,-1,-14,97
-1,1172,1811,-639,-3,-78,58
1,1619,1577,42,3,549,163
-1,1546,1666,-120,-3,-789,110
-1,1106,1320,-214,-3,-490,122
-1,1384,1476,-92,-10,-333,72
-1,1315,1688,-373,0,12,50
1,1758,1385,373,-1,-53,69
1,1932,1594,338,1,355,114
-1,1740,1846,-106,0,14,54
1,1346,1241,105,-3,-134,43
1,1924,1929,-5,0,300,103
-1,1792,1979,-187,0,-193,84
1,1494,1287,207,0,8,41
1,1558,1492,66,-3,136,101
1,1765,1776,-11,0,13,51
1,1664,1569,95,-3,-62,45
-1,1574,1835,-261,-1,-202,82
1,1701,1312,389,0,36,53
1,1578,1674,-96,0,30,57
-1,1380,1770,-390,-5,-121,56
-1,1506,1719,-213,-1,-251,76
1,1674,1600,74,1,54,51
-1,1538,1850,-312,0,-298,98
1,1436,1574,-138,1,8,45
-1,1592,1660,-68,1,-14,54
0,2052,1525,527,-3,-277,123
-1,1742,1935,-193,-2,-152,88
1,1454,1468,-14,1,12,43
-1,1589,1938,-349,-6,-104,54
-1,1324,1583,-259,1,-167,116
1,1530,1660,-130,-9,97,79
1,1420,1560,-140,1,37,69
0,1115,1193,-78,3,225,118
0,1985,1776,209,0,-9,129
1,1582,1535,47,2,293,79
-1,2091,1853,238,3,18,54
1,1622,1683,-61,-1,-42,67
-1,1705,1829,-124,-1,33,100
0,1459,1568,-109,0,15,83
1,1482,1445,37,1,123,123
-1,1873,2071,-198,-1,-39,66
-1,1648,1493,155,-8,-971,96
1,1951,1637,314,-4,47,43
1,1955,1765,190,0,48,47
1,1508,1558,-50,1,130,91
-1,1941,1735,206,1,18,74
-1,1387,1442,-55,-5,-89,72
1,1491,1363,128,0,-7,50
0,1666,1581,85,1,-4,78
1,1540,1478,62,4,121,47
-1,1600,1633,-33,-8,-34,42
-1,1218,1444,-226,-1,-52,62
-1,1724,1638,86,-2,-673,120
-1,1788,1853,-65,-2,-27,46
-1,1590,1643,-53,0,-26,108
1,1500,1748,-248,-1,-36,185
1,1545,1546,-1,2,45,51
0,1509,1631,-122,0,35,143
1,1594,1572,22,5,889,117
-1,1498,1448,50,-2,-39,46
1,1591,1662,-71,1,-146,95
1,1840,1569,271,3,443,95
1,1954,1639,315,4,264,63
-1,1354,2032,-678,-2,-339,94
-1,1754,1923,-169,0,-15,50
1,1951,1764,187,-1,-217,81
-1,1593,1668,-75,0,-17,60
0,1664,1436,228,0,-332,163
1,1214,1346,-132,-1,-115,93
-1,1780,1636,144,-9,-318,68
1,1930,1747,183,5,54,47
0,1373,1626,-253,-1,169,101
-1,1369,1878,-509,-2,-55,60
-1,1683,1378,305,0,-5,40
1,1650,1717,-67,0,-237,125
1,1485,1476,9,1,137,87
1,1741,1936,-195,-1,106,155
-1,2033,1920,113,-4,-131,128
-1,1353,1525,-172,-3,-160,66
0,1665,1633,32,0,-86,127
1,1492,1435,57,7,76,43
-1,1669,1662,7,0,-15,106
-1,1627,1410,217,0,64,62
1,1663,1535,128,-3,-3,61
-1,1918,1758,160,0,-22,68
-1,1633,1615,18,-6,-18,49
-1,1472,1492,-20,-7,-113,48
-1,1517,1430,87,-6,-244,60
1,1843,1737,106,0,484,111
1,1635,1389,246,-2,18,120
1,1329,1266,63,0,3,45
1,1535,1426,109,1,18,43
1,2045,1673,372,0,52,71
1,1352,1191,161,13,1243,141
1,1634,1664,-30,2,216,113
1,1407,1133,274,4,183,48
-1,1514,1792,-278,-1,1,80
-1,1462,1691,-229,-6,-146,64
1,1456,1369,87,1,33,49
1,2033,1670,363,2,213,103
-1,1627,1622,5,0,-34,59
1,1496,1566,-70,-3,-90,63
1,1966,1886,80,0,16,49
-1,1390,1384,6,-3,-194,102
1,1601,1207,394,14,178,45
1,1934,2004,-70,-2,-71,57
-1,1468,1565,-97,1,27,58
-1,1360,1465,-105,-1,-417,110
0,1652,1647,5,1,133,168
1,1416,1461,-45,0,-27,81
1,1779,1727,52,4,137,63
-1,1796,2039,-243,-3,-307,106
1,1077,1121,-44,3,149,51
-1,1645,1574,71,-1,-72,68
-1,1528,1531,-3,-5,-403,131
1,1713,1668,45,0,105,101
-1,1671,1665,6,-1,-30,72
1,1360,1107,253,3,133,51
-1,1318,1792,-474,-3,-81,54
-1,1330,1321,9,-10,-1015,110
-1,1658,1346,312,0,34,52
-1,1925,1792,133,-1,-10,62
1,1544,1553,-9,-1,-26,51
1,1754,1535,219,0,-43,97
1,2048,1658,390,4,120,71
1,1510,1609,-99,-1,-8,81
1,1627,1758,-131,1,-65,97
-1,1297,1794,-497,7,645,78
-1,1385,1598,-213,-4,-131,60
-1,1121,1634,-513,0,-45,70
1,1378,1327,51,-5,30,49
1,1647,1652,-5,0,14,43
-1,1400,1544,-144,-5,-105,53
0,1541,2050,-509,-13,-787,122
-1,1280,1795,-515,-2,-251,104
-1,1941,1633,308,-1,-374,120
0,1670,1619,51,0,-7,103
-1,1640,1561,79,0,-2,44
-1,1641,1658,-17,0,-31,62
1,1546,1256,290,12,401,57
-1,1718,1979,-261,-2,-45,90
1,1603,1208,395,2,115,59
-1,1589,1696,-107,-4,-220,71
-1,1732,2038,-306,0,2,50
-1,1760,1350,410,-6,-789,106
1,1637,1571,66,-3,329,131
1,1797,1266,531,1,71,47
1,1551,1545,6,-1,24,71
1,1550,1556,-6,3,247,101
1,1388,1389,-1,1,444,79
1,1447,1429,18,0,265,133
-1,1254,1799,-545,-4,-392,90
1,1761,1633,128,3,240,87
-1,1910,1930,-20,0,1,50
1,1374,1422,-48,1,13,45
-1,1713,1986,-273,-10,-75,42
-1,1676,1775,-99,-3,-36,52
-1,1289,1478,-189,2,32,55
1,1701,1708,-7,0,-24,63
-1,1599,1207,392,1,14,44
1,1366,1405,-39,-3,-179,95
1,1414,1502,-88,4,136,69
-1,2008,1709,299,-1,105,60
-1,1661,1739,-78,0,-24,58
-1,1470,1605,-135,0,151,86
-1,1365,1093,272,1,-85,104
-1,1748,1652,96,0,30,72
1,1688,1571,117,3,26,40
1,1702,1420,282,5,31,43
-1,1511,1528,-17,-1,-53,54
-1,1666,1500,166,-6,-121,48
-1,1387,1710,-323,0,-74,82
1,1782,1668,114,-1,65,79
-1,1424,1548,-124,-2,-30,54
-1,1520,1501,19,2,18,52
1,1433,1566,-133,12,929,91
1,1713,1384,329,0,265,85
1,1316,1283,33,-1,40,55
1,1563,1696,-133,2,957,111
1,1672,1444,228,-3,56,75
-1,1658,1990,-332,0,-224,66
-1,1381,1716,-335,-5,-176,54
1,1716,1381,335,1,69,49
1,1701,1709,-8,2,35,47
1,1681,1578,103,0,-54,95
1,1723,1691,32,0,25,57
-1,1240,1556,-316,-5,-195,53
-1,1509,1463,46,-6,-518,104
1,1993,1655,338,-9,185,101
1,1726,1513,213,0,21,65
1,1698,1712,-14,0,241,125
0,1570,1689,-119,-2,580,140
-1,1415,1349,66,-1,81,80
-1,1647,1962,-315,1,49,74
-1,1321,1612,-291,-5,-221,66
-1,1392,1198,194,-2,-227,124
-1,1673,1798,-125,-1,-38,84
-1,1476,1496,-20,-2,37,64
0,1465,1423,42,5,734,91
-1,1652,1996,-344,-3,-158,70
-1,1274,1678,-404,-10,-649,78
-1,1393,1543,-150,0,-322,90
1,1792,1631,161,1,81,71
1,1659,1417,242,9,202,45
-1,1446,1538,-92,-1,-33,62
-1,1685,1591,94,2,-23,132
1,1417,1558,-141,5,839,107
1,1701,1709,-8,1,96,117
-1,1237,1559,-322,-1,-19,60
1,1542,1412,130,7,1387,131
1,1484,1286,198,-7,-264,73
1,1770,1555,215,2,35,60
-1,1560,1671,-111,6,201,70
-1,1378,1734,-356,-7,-236,50
-1,1582,1593,-11,-2,-315,90
1,1392,1318,74,1,28,63
-1,1606,1386,220,-7,-315,66
1,1465,1616,-151,0,-47,61
-1,1656,1677,-21,-1,-139,68
0,1698,1712,-14,0,-19,127
-1,1464,1456,8,-3,-135,72
1,1603,1500,103,-4,-97,81
-1,1348,1392,-44,8,428,58
-1,1490,1481,9,-1,-9,86
1,1689,1646,43,-2,62,89
1,1588,1079,509,-4,-39,47
1,1736,1403,333,8,74,43
1,1760,1687,73,2,-15,143
-1,1556,1377,179,2,71,60
-1,1739,1636,103,0,-63,76
1,1704,1400,304,1,17,49
-1,2104,1868,236,0,14,156
1,1589,1077,512,1,4,53
-1,1650,1700,-50,-1,35,58
-1,1610,1785,-175,2,-77,148
0,1348,1415,-67,-3,-293,114
-1,1249,1260,-11,-2,-269,76
-1,1277,1533,-256,-8,-124,42
-1,1641,1725,-84,-3,-12,61
1,1386,1475,-89,7,318,73
-1,1590,1847,-257,-8,-191,72
-1,1448,1551,-103,-1,-435,118
-1,1556,1676,-120,-1,-69,62
1,1633,1733,-100,-5,-128,61
1,1458,1493,-35,1,109,61
-1,1586,1792,-206,-5,-71,50
-1,1233,1539,-306,-4,-635,108
1,1711,1698,13,0,18,77
1,1719,1646,73,0,236,89
-1,1394,1538,-144,1,50,57
-1,1718,1624,94,-2,-90,106
1,1180,1237,-57,1,-4,75
1,1638,1707,-69,-3,-44,59
1,1630,1693,-63,0,-75,77
-1,1693,1630,63,0,-92,76
-1,1400,1607,-207,0,-33,106
0,1721,1688,33,0,-107,135
1,1413,1350,63,1,32,67
-1,1573,1598,-25,-1,-212,106
1,1678,1770,-92,2,195,127
1,1966,1798,168,0,33,63
-1,1723,1642,81,-4,-25,40
1,1642,1723,-81,11,723,69
-1,1723,1642,81,-6,-689,89
1,1999,1710,289,0,2,51
-1,1420,2120,-700,0,-1,48
-1,1710,1790,-80,-3,-241,68
-1,1546,1721,-175,-2,-47,58
-1,1693,1806,-113,-7,-450,74
1,1791,1615,176,-3,-53,85
1,1656,2121,-465,0,333,133
-1,1475,1570,-95,-2,-698,108
-1,1609,1604,5,0,32,82
1,1435,1399,36,0,383,139
1,1240,1076,164,-3,-94,43
-1,1706,2003,-297,-2,-157,84
-1,1341,1507,-166,0,10,74
-1,1686,1813,-127,-1,-18,40
-1,2031,2093,-62,0,-1,68
1,1674,1820,-146,1,121,71
-1,1521,1638,-117,-3,-87,56
-1,1679,1730,-51,0,-14,122
1,1798,1701,97,-1,-12,53
1,1690,1805,-115,1,47,49
1,1849,1549,300,4,149,41
1,2106,2022,84,0,-20,89
1,1755,1692,63,6,355,65
1,1750,1797,-47,0,364,110
1,1705,1791,-86,6,98,45
1,1629,1703,-74,-1,96,97
1,1570,1230,340,4,398,89
1,1114,1539,-425,-2,136,61
-1,1799,1696,103,-7,-146,48
1,1608,1588,20,1,479,113
-1,1322,1066,256,-1,119,128
1,1608,1400,208,3,143,45
-1,2014,2118,-104,1,4,64
1,1688,1807,-119,-3,178,81
-1,1793,1703,90,1,9,42
1,1542,1245,297,1,137,69
-1,1514,1646,-132,-2,-47,44
-1,1762,2007,-245,-1,-22,52
1,1717,1780,-63,0,-2,43
-1,1683,1764,-81,-2,-67,60
-1,1805,1690,115,0,-12,57
1,1780,1717,63,-2,52,133
-1,1563,1670,-107,0,-229,110
1,1679,1599,80,0,101,69
-1,1195,1577,-382,-1,-11,46
1,2129,1680,449,0,37,69
1,2012,1758,254,1,49,67
1,1521,1277,244,0,85,79
-1,1395,1616,-221,-2,-323,82
1,1689,1643,46,5,46,47
1,1721,1755,-34,0,79,65
1,1578,1687,-109,0,29,53
-1,1733,1743,-10,-1,-25,46
1,1678,1646,32,0,-3,63
0,1733,1743,-10,1,27,113
1,1357,1720,-363,-1,-56,59
-1,1770,2131,-361,-3,-238,110
1,1753,2016,-263,-3,-4,49
-1,1238,1653,-415,-2,-123,60
-1,1466,1442,24,1,-561,104
1,2135,1767,368,0,-30,81
1,1996,1772,224,1,32,55
-1,1947,1855,92,-6,-38,48
1,1673,1611,62,6,115,51
1,1580,1059,521,1,391,115
-1,1774,1674,100,-3,-161,58
-1,1092,1269,-177,1,-59,52
1,1521,1684,-163,3,613,99
0,1692,1765,-73,-5,-167,64
1,1767,2002,-235,0,7,75
1,1933,1887,46,-3,-70,51
1,1685,1646,39,5,262,81
1,1386,1226,160,-7,-119,65
-1,1591,1762,-171,1,83,100
-1,1247,1301,-54,-5,-334,96
1,1654,1681,-27,-8,-55,41
-1,1500,1374,126,-5,-195,66
-1,1240,1549,-309,6,61,60
-1,1866,1943,-77,-11,-253,44
1,1736,1694,42,-2,137,81
1,1806,1455,351,5,425,89
1,1769,1578,191,4,166,81
1,1581,1281,300,0,-31,65
-1,1688,1759,-71,2,6,60
-1,1395,1563,-168,-1,2,96
-1,1636,1695,-59,-1,-147,102
1,1774,1567,207,-7,-85,45
1,1383,1251,132,5,318,65
-1,1746,2004,-258,0,-96,74
-1,1580,1986,-406,-1,-169,100
0,1809,1705,104,-1,-91,127
0,1537,1655,-118,-2,-75,132
1,1768,1679,89,-5,-123,69
1,1555,1235,320,-1,3,45
-1,1588,1737,-149,0,-29,56
-1,1742,2010,-268,0,62,104
-1,1679,1645,34,-3,-345,144
-1,1578,1870,-292,0,-57,64
1,1726,1744,-18,0,4,65
-1,1286,1575,-289,0,-41,50
1,1599,1678,-79,0,26,55
1,1658,1667,-9,4,339,71
-1,1271,1343,-72,1,12,42
-1,1534,1486,48,-8,-232,56
1,1874,1573,301,1,-16,85
1,1988,1708,280,1,62,53
-1,1655,1669,-14,0,-8,74
-1,1729,2015,-286,0,-164,110
-1,1409,1606,-197,3,159,108
-1,1665,1607,58,-2,-160,114
-1,1352,1163,189,-5,-44,50
-1,1539,1500,39,0,-9,64
1,1538,1261,277,0,31,91
1,1499,1519,-20,0,159,81
-1,1570,1877,-307,-1,-229,72
1,1725,1502,223,1,68,63
1,1680,1644,36,2,121,61
1,1662,1610,52,9,730,87
1,1649,1628,21,-2,10,55
-1,1665,1634,31,-1,-3,88
-1,1601,1671,-70,-1,-645,128
-1,1738,1730,8,1,35,52
1,2006,1744,262,1,69,69
1,1742,1727,15,-2,-205,77
-1,1540,1500,40,0,-42,64
1,1680,1592,88,-1,-78,63
1,1506,1511,-5,0,153,81
1,1652,1722,-70,0,58,103
-1,1495,1740,-245,-3,-232,70
1,1583,1688,-105,1,77,49
-1,1716,1753,-37,0,6,80
1,1512,1351,161,3,74,53
-1,1646,1614,32,2,-7,70
1,1598,1550,48,-9,-189,63
1,1763,1706,57,-1,-70,61
-1,1550,1598,-48,-6,-61,44
-1,1488,1745,-257,0,-47,72
1,1697,1772,-75,3,126,73
1,1671,1630,41,-7,59,95
-1,1607,1540,67,-3,-270,84
-1,1500,1501,-1,-2,-112,74
1,1759,1710,49,0,128,77
-1,1797,2025,-228,0,-13,48
1,1554,1594,-40,0,12,45
1,1750,1482,268,-2,-52,55
-1,1701,1769,-68,-2,-6,98
-1,1582,1567,15,-1,-14,40
-1,1586,1612,-26,-1,-115,74
-1,1659,1803,-144,-1,-51,60
-1,1579,1570,9,2,33,46
-1,1574,1529,45,-1,-56,66
-1,1778,1692,86,0,-105,64
-1,1518,1626,-108,0,-187,112
-1,1476,1754,-278,0,-25,52
-1,1175,1344,-169,-5,-422,64
1,1618,1772,-154,2,146,76
1,1582,1567,15,-1,-18,71
-1,1706,1764,-58,-7,-187,40
-1,1403,1761,-358,-11,-323,48
-1,1246,1343,-97,-16,-444,54
1,1773,1697,76,5,10,77
1,1758,1470,288,-2,-121,69
1,1592,1556,36,-1,-8,79
1,1688,1782,-94,1,70,61
1,1576,1608,-32,4,156,59
-1,1509,1623,-114,-3,-339,102
1,1690,1952,-262,0,-30,95
-1,1596,1654,-58,-1,-89,94
-1,1772,1400,372,0,-208,78
1,1684,1506,178,0,59,53
1,1755,1714,41,2,62,57
1,1500,1848,-348,1,127,93
1,1350,1096,254,0,190,107
1,1351,1199,152,9,254,57
-1,1421,1633,-212,-2,-83,82
1,1456,1690,-234,0,48,109
1,1552,1390,162,4,192,81
0,1793,1664,129,0,59,122
1,1755,1705,50,-1,-37,71
1,1682,1549,133,3,91,49
-1,1662,1585,77,1,44,116
-1,1672,1480,192,2,85,78
-1,1388,1500,-112,-7,-97,42
-1,1796,1729,67,-2,-90,60
1,1696,1764,-68,0,98,91
-1,1587,1631,-44,-3,-53,64
-1,1370,1172,198,0,6,88
1,1654,1503,151,1,18,65
-1,1751,1709,42,-2,-74,54
-1,1743,1752,-9,0,-71,64
-1,1638,1614,24,-2,-38,56
-1,1473,1466,7,0,-58,118
1,1951,1754,197,-2,84,107
0,2025,1993,32,0,-17,90
1,1762,1732,30,1,24,41
1,1762,1732,30,-1,-11,45
-1,1519,1546,-27,-2,-152,58
-1,1775,1933,-158,2,31,42
-1,1353,1196,157,0,-294,114
1,1536,1367,169,0,82,49
-1,1725,1781,-56,-6,-41,46
-1,1225,1297,-72,-4,-217,74
-1,1716,1790,-74,-3,1,42
-1,1527,1489,38,-1,-17,46
1,1549,2020,-471,0,-69,75
-1,1723,1772,-49,-3,-174,65
-1,1716,1790,-74,-2,-262,114
-1,1768,1940,-172,0,35,54
1,2023,1748,275,2,242,105
-1,1580,1721,-141,-8,-328,76
1,1358,1394,-36,-1,-38,59
1,1477,1462,15,1,55,53
1,1500,1547,-47,6,274,71
-1,1218,1336,-118,-12,-404,62
1,1727,1573,154,-1,108,75
-1,1577,1783,-206,0,-153,86
-1,1505,1518,-13,-4,-21,42
1,1715,1807,-92,0,51,107
1,1701,1547,154,2,54,57
-1,1229,1328,-99,-2,-13,42
1,1538,1375,163,-1,-6,93
-1,1344,1208,136,4,69,46
-1,1649,1991,-342,-3,33,122
1,1794,1729,65,3,176,73
1,1828,1720,108,6,87,47
-1,1734,1995,-261,0,131,86
-1,1571,1522,49,-1,-71,70
1,1532,1699,-167,-3,105,53
-1,1371,1287,84,-5,-162,56
-1,1957,1960,-3,-4,-63,52
1,1802,1713,89,-4,-215,65
1,1501,1573,-72,0,-5,55
1,1730,2001,-271,1,110,53
-1,1674,1704,-30,0,53,66
-1,1540,1408,132,0,-112,66
-1,1337,1288,49,-1,-262,70
-1,1668,1781,-113,-1,-144,66
-1,1747,1810,-63,0,19,76
-1,1704,1975,-271,-5,-545,126
-1,1708,1789,-81,0,-158,88
1,1357,1460,-103,9,348,73
-1,1819,1738,81,3,54,44
1,1665,1711,-46,0,19,51
1,1619,1234,385,1,766,111
1,1545,1509,36,5,392,79
1,1806,1752,54,-1,-35,69
-1,1664,1714,-50,-5,-223,66
-1,1714,1664,50,1,8,48
-1,1512,1491,21,1,-94,72
-1,1655,1724,-69,0,-20,100
1,1554,1446,108,-1,-25,53
-1,1393,1421,-28,-5,-73,44
1,1500,1683,-183,0,50,83
1,1733,1646,87,6,324,73
-1,1802,1756,46,0,-1,64
-1,1304,1372,-68,-3,-201,69
1,1387,1410,-23,-5,-125,53
-1,1679,1670,9,-4,-292,78
1,1812,1768,44,-1,40,79
1,1748,1661,87,-4,-9,45
-1,1562,1297,265,-1,-124,68
-1,1572,1621,-49,3,-86,96
-1,1257,1568,-311,-3,-99,64
-1,1821,1690,131,1,-32,68
1,1508,1646,-138,9,218,51
-1,1707,1807,-100,0,-6,48
-1,1814,1758,56,2,45,60
0,1631,1534,97,-1,803,151
-1,1554,1643,-89,-4,-309,100
0,2035,1670,365,1,62,102
-1,1497,1468,29,-1,-81,62
1,1802,1771,31,-10,8,75
-1,1500,1382,118,-1,67,70
1,1729,1640,89,-1,-42,45
-1,1753,1652,101,-4,-201,72
1,1399,1438,-39,4,226,75
1,1761,1812,-51,1,23,43
-1,1682,1941,-259,-5,-369,142
-1,1500,1410,90,-3,-668,102
-1,1562,1630,-68,-3,-131,68
-1,1545,1647,-102,0,5,84
-1,1636,1667,-31,2,-168,94
-1,1738,1785,-47,0,-22,68
1,1391,1256,135,10,570,59
-1,1454,1166,288,-4,-261,80
1,1699,1690,9,-2,475,117
1,1545,1350,195,1,187,75
1,1728,1678,50,1,79,83
1,1788,1794,-6,-2,-39,67
1,1488,1823,-335,-3,9,47
1,1556,1631,-75,1,98,65
1,1639,1553,86,3,191,129
1,1945,1678,267,-3,40,67
-1,1218,1579,-361,-1,-9,50
-1,1398,1322,76,5,-5,68
-1,1738,1838,-100,-1,61,92
-1,1214,1567,-353,0,-29,104
-1,1435,1635,-200,-2,-113,74
0,1278,1515,-237,-4,-492,96
-1,1699,1671,28,0,4,50
-1,1570,1168,402,1,29,52
1,1559,1504,55,3,147,73
-1,1384,1338,46,-2,-104,72
-1,1284,1550,-266,-5,-95,46
1,1559,1564,-5,-1,-45,49
-1,1514,1668,-154,-4,-34,48
-1,1736,1489,247,-1,70,74
1,1635,1554,81,0,-69,73
-1,1841,1610,231,-1,-127,130
-1,1416,1691,-275,-3,-89,54
1,1545,1645,-100,3,169,51
-1,1420,1339,81,0,-120,144
1,1730,1675,55,0,-45,101
1,1337,1331,6,5,366,73
1,1242,1371,-129,-4,-155,85
-1,1629,1560,69,1,37,56
-1,1188,1441,-253,-1,-76,120
-1,1622,1650,-28,0,-109,85
1,1411,1182,229,-3,117,107
-1,1260,1409,-149,-3,-49,43
-1,1780,1665,115,0,-14,42
1,1566,1499,67,3,48,41
-1,1396,1680,-284,-2,-64,76
-1,1740,1765,-25,0,-18,90
1,1507,1715,-208,1,24,67
-1,1808,1790,18,1,0,52
1,1684,1392,292,10,280,53
1,1495,1373,122,3,128,57
-1,1569,1570,-1,1,19,48
-1,1576,1730,-154,-2,-71,74
1,1688,1775,-87,-1,-19,41
1,1545,1535,10,1,234,103
-1,1465,1388,77,8,131,48
1,1673,1539,134,1,62,83
-1,1949,1744,205,0,-23,74
-1,1672,1802,-130,0,-11,44
-1,1611,1962,-351,-14,-310,48
1,1403,1448,-45,1,142,61
1,1581,1558,23,-4,7,59
-1,1809,1665,144,-2,-142,84
1,1798,1410,388,9,999,109
-1,1570,1344,226,-8,-475,70
0,1323,1607,-284,-2,157,127
1,1168,1500,-332,-5,-141,49
-1,1317,1634,-317,-6,-458,99
1,1574,1763,-189,-2,17,65
1,1732,1978,-246,0,242,120
1,1757,1522,235,-4,-94,89
1,1416,1338,78,-2,30,53
-1,1266,1356,-90,2,226,60
-1,1570,1667,-97,1,28,62
1,1680,1793,-113,3,214,66
-1,1532,1681,-149,-2,-158,80
-1,1432,1500,-68,0,-5,90
1,1966,1608,358,-3,273,97
-1,1405,1695,-290,-6,-405,62
1,1571,1555,16,-3,57,65
1,1778,1695,83,0,76,95
1,1524,1153,371,-1,7,45
1,1849,1702,147,1,20,95
1,1593,1382,211,0,-65,141
1,1359,1230,129,-1,-15,69
1,1644,1695,-51,4,225,67
-1,1528,1339,189,-6,-129,50
1,1957,1749,208,0,12,58
1,1686,1787,-101,-1,244,111
1,1781,1263,518,0,52,57
1,1498,1416,82,0,1,49
1,1430,1333,97,0,93,77
-1,1408,1800,-392,-3,-458,80
-1,1407,1508,-101,0,25,58
-1,1605,1969,-364,-2,-349,134
1,1794,1856,-62,0,251,99
1,1615,1316,299,5,68,45
1,1364,1500,-136,4,83,53
1,1517,1398,119,3,5,41
1,1772,1700,72,0,66,104
1,1547,1524,23,1,27,59
-1,1390,1526,-136,0,-181,66
1,1495,1355,140,10,689,85
-1,1307,1619,-312,1,-18,85
-1,1383,1534,-151,-3,-35,50
-1,1691,1781,-90,-2,-132,70
-1,1910,1895,15,-4,-49,62
-1,1246,1327,-81,4,154,96
-1,1396,1252,144,-2,-32,52
1,1331,1246,85,2,691,127
-1,1897,1900,-3,6,164,68
-1,1398,1703,-305,-4,-305,64
-1,1369,1549,-180,-2,54,48
1,1685,1682,3,0,64,103
-1,1790,1683,107,2,-45,86
-1,1911,1887,24,-3,-370,98
-1,1540,1228,312,-4,-119,56
-1,1526,1502,24,-1,-208,100
1,1555,1363,192,1,35,57
1,1573,1406,167,20,374,45
1,1898,1899,-1,0,252,83
-1,1968,1761,207,-9,-131,48
-1,1357,1562,-205,1,44,54
-1,1682,1560,122,-5,-64,70
1,1888,1908,-20,-1,4,77
1,1568,1351,217,4,70,53
1,1374,1490,-116,1,132,81
1,1875,1777,98,-3,0,61
-1,1852,1899,-47,-1,-324,78
-1,1573,1690,-117,-11,-336,60
1,1757,1769,-12,0,-20,71
-1,1363,1651,-288,-4,-269,94
1,2145,1441,704,3,120,55
-1,1234,1740,-506,-3,-118,62
1,1368,1396,-28,3,833,129
1,1708,1624,84,10,418,83
0,1265,1641,-376,-15,-499,58
1,1248,1387,-139,10,277,45
1,1484,1461,23,-2,-91,69
-1,1631,1906,-275,0,-54,72
1,1717,1676,41,1,157,93
1,1544,1769,-225,10,413,57
-1,1531,1615,-84,-2,-51,46
-1,1590,1605,-15,-3,-105,66
-1,1686,1704,-18,-6,-255,64
-1,2146,1758,388,-5,-54,76
1,1624,1522,102,0,1,63
-1,1501,1587,-86,-15,-478,70
-1,1726,1666,60,-1,-53,54
1,1734,1412,322,1,225,95
0,1275,1632,-357,-2,-456,118
1,2122,1746,376,4,78,41
1,2011,1773,238,-6,-129,63
-1,1632,1714,-82,0,342,86
1,1487,1652,-165,-9,-225,49
1,1722,1624,98,0,0,47
1,1636,1503,133,0,36,55
-1,1562,1579,-17,-3,-147,56
1,1714,1675,39,3,131,71
1,1523,1630,-107,1,16,41
1,1730,1615,115,0,203,77
-1,1584,1703,-119,0,-1,56
-1,2126,1768,358,3,359,116
1,1390,1743,-353,0,35,85
1,1408,1684,-276,-1,44,59
1,1738,1608,130,0,-263,75
1,1665,1427,238,1,294,93
-1,1599,1550,49,0,-137,68
1,1638,1600,38,4,233,59
1,2095,1789,306,0,-8,49
-1,1600,1638,-38,-6,-45,50
-1,1414,1616,-202,-1,-6,50
1,1562,1328,234,3,442,87
-1,1785,2100,-315,-1,-12,70
1,1710,1619,91,1,2,43
1,1590,1648,-58,-7,-209,63
1,1648,1590,58,-1,221,81
1,1487,1500,-13,1,242,101
-1,1608,1718,-110,0,-266,106
-1,1802,2076,-274,0,-109,140
-1,1581,1635,-54,-9,-233,60
1,1564,1576,-12,-3,19,71
0,1567,1410,157,0,36,125
1,1644,1571,73,17,527,57
-1,1318,1500,-182,0,-303,160
1,1357,973,384,-1,14,79
1,2082,1798,284,-1,-41,57
1,1561,1232,329,3,269,69
-1,1653,1562,91,2,56,56
1,1610,1603,7,-3,240,133
-1,1794,2087,-293,-1,-230,122
-1,1552,1736,-184,-2,-71,104
-1,1415,1562,-147,-2,181,106
1,1567,1648,-81,-3,-138,51
1,2093,1790,303,0,144,133
1,1613,1423,190,3,799,127
1,1500,1580,-80,-1,28,49
1,1576,1500,76,0,-26,95
1,1509,1542,-33,1,12,79
-1,1569,1809,-240,-14,-230,46
-1,1559,1545,14,-8,-318,74
-1,1408,1529,-121,-12,-71,40
-1,1542,1509,33,0,-21,54
1,1814,1564,250,-4,-53,99
-1,1465,1440,25,-2,-36,50
1,1537,1617,-80,7,827,127
1,1298,1175,123,-1,-47,63
-1,1560,1818,-258,-1,-349,84
0,1571,1719,-148,1,48,134
-1,1285,1395,-110,-3,-46,60
-1,1366,1547,-181,-5,-193,78
1,1467,1706,-239,11,388,65
1,1400,1500,-100,4,192,55
1,1743,1595,148,0,-18,71
1,2100,1075,1025,14,215,41
-1,1474,1676,-202,2,-238,92
1,1276,1337,-61,1,95,65
-1,1823,1555,268,0,-512,152
1,1453,1663,-210,9,206,41
1,1669,1574,95,0,62,59
1,1626,1339,287,10,282,59
-1,1618,1572,46,0,-179,78
1,1297,1355,-58,0,110,95
1,1409,1842,-433,1,23,51
1,1360,1465,-105,6,115,53
-1,1277,1739,-462,0,-182,86
-1,1742,1721,21,-4,-206,72
1,1408,1335,73,-5,-179,63
-1,1747,1710,37,0,-395,114
-1,1470,1555,-85,-1,-29,48
-1,2100,1853,247,0,-25,62
-1,2000,2045,-45,0,19,60
1,1928,1228,700,5,293,63
-1,1316,1336,-20,-5,-403,86
-1,1476,1592,-116,-1,-29,64
-1,1313,1523,-210,-4,-82,54
-1,1467,1460,7,-6,-151,94
1,1819,1431,388,3,378,97
1,1989,1645,344,0,25,61
-1,1290,1384,-94,-9,-20,40
1,1375,1447,-72,-5,-78,43
-1,1543,1643,-100,-4,-57,66
-1,1429,1821,-392,-4,-128,56
-1,1484,1412,72,-2,-163,78
1,1276,1500,-224,2,79,53
-1,1628,1546,82,0,-153,102
1,1583,1529,54,0,135,111
1,2074,1327,747,2,202,89
1,1633,1172,461,22,739,63
-1,1548,1619,-71,-1,-61,74
1,1528,957,571,1,52,50
1,1389,1431,-42,0,29,83
1,1351,1528,-177,0,3,45
-1,1456,1411,45,5,28,82
1,1539,1628,-89,-2,159,121
1,1288,1455,-167,1,369,81
1,1529,949,580,0,23,53
-1,1188,1263,-75,-18,-424,50
-1,1689,1603,86,-1,-101,97
1,1535,1353,182,12,131,45
1,1518,1594,-76,1,161,135
1,1424,1443,-19,2,112,137
0,2074,1965,109,0,5,81
-1,1311,1575,-264,2,76,60
-1,1301,1335,-34,0,-51,50
-1,1824,1910,-86,1,47,46
1,2069,1284,785,4,148,45
-1,1170,1358,-188,-3,-466,82
1,1155,1280,-125,0,-57,55
-1,1640,1651,-11,0,-137,58
-1,1307,1500,-193,-8,-792,80
-1,1907,1500,407,-1,-160,116
-1,1346,1541,-195,-6,-271,58
1,1614,1722,-108,1,21,45
1,1265,1183,82,4,246,65
-1,1500,1425,75,1,91,134
-1,1401,1416,-15,0,36,52
1,1617,1551,66,0,155,120
1,1373,1243,130,0,15,55
-1,1630,1743,-113,-7,13,40
1,1547,1340,207,-2,-38,45
1,1546,1579,-33,0,415,97
-1,1167,1274,-107,-2,-312,120
1,1531,1243,288,0,132,77
-1,1238,1537,-299,-3,-35,48
1,1918,2061,-143,1,197,113
-1,1306,1337,-31,-9,-506,86
-1,1334,1552,-218,0,-438,102
1,1467,1477,-10,0,63,65
1,1542,1359,183,1,184,69
1,2004,1905,99,1,21,51
-1,1471,1446,25,-2,-383,96
1,1637,1470,167,-1,96,91
-1,1558,1572,-14,2,18,68
1,1202,1166,36,-3,13,81
-1,1281,1493,-212,1,69,80
1,1681,1434,247,0,365,117
-1,1897,2012,-115,1,33,58
-1,1551,1633,-82,2,147,78
-1,1256,1269,-13,-3,-247,91
1,1601,1430,171,1,-2,47
-1,1465,1479,-14,-3,-253,74
1,1715,1500,215,0,7,53
-1,1514,1540,-26,-9,-180,64
1,1522,1406,116,5,139,51
-1,1889,2020,-131,0,-7,48
-1,1557,1328,229,0,-45,54
1,1538,1642,-104,0,54,63
1,1500,1548,-48,-1,-64,84
-1,1664,1676,-12,0,-63,98
-1,1209,1192,17,-2,-149,56
1,1893,1627,266,0,21,47
1,1387,1423,-36,0,585,159
-1,1882,2028,-146,0,9,66
1,1897,1622,275,0,55,97
1,1902,2070,-168,-1,255,73
0,1280,1244,36,1,145,88
-1,1921,2052,-131,0,-310,86
1,1895,1618,277,0,11,89
-1,1390,1414,-24,-5,-46,44
-1,1400,1377,23,-5,-255,90
-1,1458,1660,-202,-2,-121,54
-1,1594,1227,367,3,100,48
1,1899,1613,286,3,102,59
1,1067,1453,-386,4,90,63
-1,1388,1477,-89,-7,-365,120
1,1564,1348,216,4,151,65
1,1902,1609,293,0,147,75
1,1846,1741,105,1,285,75
-1,1396,1389,7,-2,7,126
-1,1786,1876,-90,0,-3,66
-1,1755,1515,240,-3,-212,80
1,1379,1272,107,0,-92,71
1,1569,1505,64,-3,304,91
-1,1591,1398,193,0,-36,50
1,1540,1700,-160,3,162,61
1,1639,1777,-138,-1,69,105
1,1884,1450,434,4,365,75
-1,1400,1384,16,-1,-169,85
1,1619,1678,-59,1,86,59
-1,1265,1387,-122,3,130,64
-1,1654,1760,-106,-5,-323,82
-1,1495,1681,-186,0,-32,130
1,1411,1444,-33,0,404,107
1,1592,1396,196,1,231,137
-1,1521,1552,-31,0,-228,80
1,1623,1739,-116,4,295,77
1,1571,1487,84,0,226,81
1,1373,1093,280,-11,-335,101
1,1575,1426,149,0,60,65
-1,1526,1505,21,0,-63,98
1,1459,1348,111,5,511,129
-1,1559,1589,-30,-2,-62,80
1,1687,1489,198,2,55,69
1,1289,1584,-295,-2,-23,47
-1,1541,1633,-92,-4,-152,54
1,1600,1548,52,1,491,123
-1,1478,1544,-66,4,41,56
1,1332,1107,225,0,250,79
1,1540,1579,-39,0,16,73
1,1539,1543,-4,1,3,71
-1,1598,1498,100,1,-140,126
-1,1547,1646,-99,-7,-218,60
1,1992,1447,545,-1,-36,43
1,1653,1539,114,0,72,77
1,1516,1318,198,2,36,47
1,1560,1436,124,2,723,103
1,1637,1087,550,6,827,95
1,1375,1686,-311,8,97,43
-1,1566,1426,140,0,-50,72
-1,1477,1553,-76,-1,-25,54
-1,1521,1491,30,-2,2,118
-1,1583,1556,27,-7,-200,56
-1,1710,1886,-176,-4,-179,72
-1,1311,1579,-268,0,-5,58
1,1386,1567,-181,0,-51,63
-1,1468,1562,-94,-2,-96,70
-1,1999,1717,282,3,37,52
1,1193,976,217,7,616,98
1,1829,1908,-79,0,-9,97
1,1892,1705,187,0,0,49
-1,1446,1667,-221,1,-554,80
-1,1661,1600,61,-1,-43,100
-1,1396,1207,189,1,-24,53
1,1769,1738,31,2,110,135
1,1761,1897,-136,-1,-70,183
-1,1301,1580,-279,-1,-427,98
-1,1672,1438,234,-3,-76,42
1,1679,1588,91,0,19,97
1,1896,1861,35,-9,-5,61
-1,1615,1531,84,4,20,52
1,1977,1852,125,-3,-5,45
1,1613,1648,-35,-1,-33,55
-1,1338,1467,-129,0,-502,130
1,1587,1570,17,6,114,43
1,1227,1379,-152,0,41,51
-1,1714,2036,-322,0,-79,108
1,1636,1626,10,-4,242,103
1,1509,1605,-96,0,-41,113
1,1839,1905,-66,1,68,53
-1,1463,957,506,2,-437,118
1,1551,1573,-22,-2,-86,47
-1,1882,1836,46,-4,-93,64
1,1489,1637,-148,-1,20,50
-1,1459,1602,-143,3,34,56
1,1825,2081,-256,0,-12,65
-1,1559,1598,-39,-5,-190,80
-1,1893,1867,26,0,79,104
1,1423,1512,-89,-4,35,53
1,1363,1559,-196,1,6,45
1,1870,1756,114,-2,7,59
-1,1470,1512,-42,-6,-258,54
-1,1844,2060,-216,0,-48,80
1,1306,1354,-48,-1,-23,55
1,1452,1278,174,0,146,65
-1,1711,1849,-138,-7,-166,46
-1,1395,1350,45,-5,-162,56
1,1858,1640,218,-2,-30,67
1,1777,1780,-3,1,133,121
0,1890,1882,8,0,25,78
1,2082,2001,81,0,35,51
-1,1855,1704,151,1,203,96
1,1561,1563,-2,1,100,95
-1,1314,1823,-509,-18,-1074,76
1,1993,1596,397,1,61,43
-1,1992,2093,-101,0,-86,100
1,1522,1460,62,2,246,75
1,1365,1382,-17,3,185,65
1,1623,1531,92,-2,-5,43
-1,1882,1890,-8,0,-617,128
-1,1276,1479,-203,2,69,72
-1,1498,1482,16,-2,-78,50
-1,2102,1983,119,0,-567,140
-1,1381,1404,-23,0,90,84
1,1474,1327,147,5,300,75
1,1544,1572,-28,-2,317,137
1,1588,1653,-65,9,347,67
-1,1312,1529,-217,-1,-34,52
-1,1966,1824,142,1,29,84
-1,1429,1412,17,1,1,46
1,1999,2085,-86,0,608,143
-1,1077,1664,-587,1,68,60
-1,1510,1950,-440,-17,-463,42
0,1450,1531,-81,-4,505,127
1,1628,1488,140,1,131,55
1,1489,1417,72,-3,-161,91
-1,1665,1658,7,0,-11,48
-1,1482,1509,-27,0,-987,150
1,1952,1508,444,4,112,60
1,1357,1686,-329,0,-62,93
-1,1306,1550,-244,-7,-312,68
-1,1538,2069,-531,-1,-615,94
-1,1332,1494,-162,0,-6,56
-1,2013,2049,-36,-1,9,76
-1,1320,1450,-130,-1,-22,88
1,1465,1633,-168,0,-20,53
1,1772,1894,-122,-1,-11,59
1,1659,1620,39,3,78,45
-1,1642,1593,49,-2,-199,108
1,1293,1481,-188,-1,40,65
1,2070,2003,67,2,49,71
-1,1609,1673,-64,0,-501,128
1,1639,1452,187,3,39,53
1,1934,1863,71,-5,-6,41
-1,1246,1471,-225,-1,-132,74
-1,1796,1558,238,0,-297,134
1,1996,1726,270,1,99,107
1,1377,1340,37,2,203,91
-1,1994,2088,-94,0,-57,116
-1,1432,1288,144,0,-104,64
1,1954,1342,612,0,13,47
1,1685,1599,86,0,19,61
-1,1427,1381,46,-7,-130,46
-1,1501,1458,43,1,-15,68
-1,1574,1943,-369,-1,-176,62
1,1634,1563,71,-6,-63,47
1,1644,1410,234,3,64,50
-1,1590,1696,-106,-3,-242,82
0,2103,1985,118,0,71,123
-1,1222,1409,-187,-2,-51,48
1,1466,1436,30,0,614,121
1,1305,1416,-111,0,-16,47
-1,1392,1403,-11,-2,-149,64
1,1700,1352,348,1,-23,63
-1,1582,1706,-124,3,25,44
1,1989,2097,-108,0,-18,107
-1,1715,1574,141,-1,-34,82
1,1867,1840,27,1,12,55
1,1475,1240,235,0,143,73
1,2071,2003,68,-1,-5,49
-1,1703,1702,1,-5,-135,66
-1,1301,1396,-95,-3,-489,86
1,1649,1381,268,-5,65,115
1,1590,1696,-106,1,-95,103
1,1594,1500,94,-9,-285,47
1,1414,1647,-233,-1,-1,57
1,1284,1321,-37,4,197,65
1,1689,1626,63,-1,-56,125
1,1426,1402,24,-5,-78,91
-1,1633,1500,133,3,81,116
1,1629,1380,249,-1,210,63
0,1519,1404,115,-4,-17,74
1,1693,1448,245,0,6,55
-1,1458,1378,80,0,8,54
1,1476,1404,72,-1,3,90
1,1678,1605,73,3,352,79
-1,1558,1393,165,2,64,60
-1,1986,2100,-114,0,204,114
-1,1413,1598,-185,0,-151,114
1,1797,1368,429,0,41,55
1,1422,1628,-206,5,366,91
-1,1211,1569,-358,-3,-669,96
-1,1291,1464,-173,-1,-379,88
-1,1596,1689,-93,0,-13,62
1,2112,1978,134,1,42,79
-1,1425,1697,-272,0,2,48
-1,1311,1509,-198,2,-31,58
1,1439,1537,-98,-9,35,69
1,1504,1434,70,0,84,97
1,1799,1900,-101,-2,-33,73
1,1554,1644,-90,1,792,137
-1,1317,1483,-166,-8,-94,44
1,1307,1377,-70,-2,-33,97
1,1955,1570,385,0,221,67
1,1542,1365,177,0,62,51
-1,1754,1604,150,-4,-14,96
-1,1500,1719,-219,-8,-112,44
1,1682,1602,80,1,208,69
1,1643,1588,55,-2,-64,67
-1,1408,1553,-145,-3,-290,94
1,1691,1591,100,4,272,97
1,1284,1741,-457,-2,-59,73
1,1701,1393,308,0,3,55
-1,1500,1554,-54,-3,-339,80
-1,1666,1797,-131,0,-57,84
1,1712,1539,173,12,206,45
-1,1380,1633,-253,0,-417,132
1,1281,1470,-189,1,127,63
-1,1593,1692,-99,0,-218,118
-1,1700,1863,-163,-2,-93,58
-1,1444,1327,117,0,-568,134
1,1815,1669,146,0,16,64
-1,1489,1679,-190,-4,-202,66
1,1615,1572,43,1,-169,109
1,1561,1349,212,3,106,79
-1,1670,1647,23,-4,-658,114
0,1705,1617,88,0,77,129
1,1364,1322,42,-1,-10,47
1,1517,1726,-209,-1,51,73
1,1701,1585,116,0,41,95
-1,1432,1572,-140,-5,-252,108
-1,1308,1360,-52,-17,-532,48
1,1305,1417,-112,0,-9,45
1,1710,1577,133,0,279,101
1,1958,1500,458,3,409,81
1,1690,1572,118,5,234,73
1,1295,1303,-8,-5,57,57
-1,1332,1326,6,1,77,56
-1,1464,1426,38,1,98,86
-1,1612,1519,93,-2,-75,48
-1,1570,1718,-148,-2,-40,82
1,1623,1642,-19,-1,44,89
1,1707,1432,275,2,79,73
1,1299,1611,-312,3,113,57
1,1416,1220,196,-3,25,57
0,1322,1307,15,0,85,67
-1,1429,1702,-273,-1,-34,58
-1,1263,1338,-75,-11,-123,40
-1,1515,1730,-215,-1,-45,49
0,1579,1393,186,2,-394,126
1,1506,1561,-55,4,187,89
-1,1647,1687,-40,0,-8,74
-1,1438,1452,-14,-6,-489,114
-1,1402,1578,-176,-9,-35,98
1,1333,1326,7,0,216,81
1,1464,1183,281,1,60,65
1,1706,1424,282,3,214,59
-1,1634,1894,-260,-1,-301,150
1,1886,1832,54,0,83,67
1,1740,1502,238,1,-7,63
1,1516,1529,-13,-3,-110,85
1,1395,1327,68,-2,8,79
-1,1319,1567,-248,-5,-677,114
-1,1420,1710,-290,-2,-287,112
1,1515,1476,39,0,31,63
-1,1663,1611,52,-9,-114,52
1,1501,1964,-463,1,281,177
1,1463,1427,36,0,271,159
1,1242,1315,-73,3,529,145
1,1750,1307,443,-9,-181,55
-1,1514,1670,-156,-6,-489,130
1,1579,1655,-76,1,455,165
1,1900,1630,270,0,42,59
0,1395,1310,85,0,-227,160
-1,1364,1811,-447,-1,-58,56
-1,1067,1616,-549,-1,-528,70
-1,1570,1688,-118,-3,-129,64
0,1714,1416,298,-1,-22,69
1,1635,1548,87,-3,142,99
1,1905,1500,405,8,315,67
1,1635,1454,181,6,320,73
1,2060,1854,206,-3,-752,95
1,1701,1554,147,-2,-52,131
-1,1599,1637,-38,-3,-40,60
1,1314,1231,83,-4,-139,69
1,1881,1854,27,0,-8,49
1,1841,1628,213,1,13,50
1,1598,1594,4,0,5,61
1,1320,1627,-307,-7,-148,59
-1,1583,1501,82,-5,-143,42
1,1643,1645,-2,-1,10,41
1,1501,1582,-81,0,39,95
1,1665,1528,137,4,111,51
1,1392,1303,89,1,37,43
1,1848,1803,45,-3,37,87
1,1623,1596,27,2,185,113
1,1889,1791,98,-1,-9,41
1,1754,1648,106,0,22,55
1,1724,1764,-40,0,146,105
-1,1514,1231,283,1,-275,94
-1,1436,1472,-36,-14,-305,68
-1,1500,1655,-155,-2,32,54
-1,1594,1619,-25,-1,-77,94
1,1547,1472,75,2,43,63
1,1539,1712,-173,2,163,89
1,1858,1792,66,0,31,55
1,1552,1641,-89,2,251,111
-1,1494,1390,104,0,-77,78
1,1654,1650,4,2,64,69
1,1523,1417,106,1,65,40
-1,1444,1541,-97,-3,-14,41
1,1557,1500,57,1,321,73
-1,1373,1815,-442,-5,-1098,104
1,1427,1223,204,5,587,105
-1,1579,1622,-43,0,-47,82
-1,1498,1349,149,-12,-90,42
-1,1464,1381,83,-1,-38,76
1,1161,1340,-179,2,255,115
1,1868,1782,86,0,11,51
-1,1057,1517,-460,-2,-139,56
1,1899,1451,448,4,148,59
1,1628,1615,13,0,-9,49
1,1801,1846,-45,-1,2,67
1,1279,1090,189,4,100,47
1,1834,1812,22,0,-33,85
-1,1628,1757,-129,-2,-10,42
-1,1541,1640,-99,-9,-351,62
-1,1832,1814,18,0,42,78
-1,1334,1337,-3,-1,-27,56
-1,1640,1500,140,-4,-273,64
1,1805,1296,509,8,161,53
-1,1825,1822,3,0,-11,70
-1,1436,1695,-259,2,257,76
1,1587,1579,8,-15,-209,61
1,1832,1815,17,0,357,83
1,1940,1629,311,3,64,45
-1,1568,1597,-29,-15,-99,40
1,1427,1604,-177,-7,-227,85
1,1841,1542,299,4,97,57
0,1881,1787,94,-7,-315,83
-1,1607,1805,-198,0,85,64
-1,1580,1625,-45,-1,87,64
1,1805,1607,198,-6,-89,59
-1,1508,1478,30,-13,-350,80
1,1292,1490,-198,1,-13,53
-1,1602,1810,-208,-1,-107,56
0,1685,1421,264,-1,-188,163
-1,1607,1758,-151,-4,-11,94
1,1815,1597,218,4,134,61
0,1589,1495,94,3,451,102
-1,1597,1815,-218,0,-63,76
-1,1636,1570,66,0,-99,86
-1,1592,1819,-227,-3,-20,42
1,1243,1245,-2,0,-97,49
1,1500,1310,190,2,14,63
-1,1601,1605,-4,-4,-628,110
1,1828,1583,245,9,318,71
1,1944,1858,86,1,86,87
1,1836,1621,215,-2,-25,51
-1,1578,1811,-233,-3,-145,62
1,1816,1573,243,-3,-9,45
-1,1573,1816,-243,1,-12,54
0,1590,1617,-27,-1,81,111
1,1884,1615,269,5,210,63
-1,1569,1820,-251,1,-26,48
-1,1533,1387,146,0,10,78
1,1825,1564,261,8,312,69
1,1505,1304,201,2,171,75
1,1499,1473,26,-4,-18,53
-1,1447,1519,-72,0,-216,78
1,1829,1500,329,-5,-257,85
-1,1770,1983,-213,-6,-405,98
1,1490,1266,224,3,24,101
1,1616,1591,25,-2,33,105
1,1435,1832,-397,1,263,77
-1,1258,1308,-50,-15,-658,74
-1,1610,1626,-16,-3,-239,70
-1,1293,1516,-223,-1,-148,74
-1,1444,1598,-154,-2,-57,50
1,1598,1444,154,9,374,63
1,1619,1782,-163,2,39,67
1,1933,1522,411,2,39,45
1,1555,1681,-126,0,8,73
1,1889,1606,283,11,328,55
1,1510,1579,-69,0,95,91
1,1417,1437,-20,5,221,55
-1,1358,1520,-162,1,100,90
-1,1677,1790,-113,0,-306,100
-1,1651,1905,-254,1,-10,66
1,1645,1544,101,1,334,93
-1,1277,1546,-269,-8,-192,44
1,1528,1438,90,3,91,53
1,1603,1197,406,1,79,81
1,1429,1743,-314,1,192,108
1,1536,1653,-117,1,354,125
-1,1518,1389,129,-6,-61,40
-1,1652,1647,5,-2,-213,88
-1,1427,1397,30,-2,-306,91
-1,1601,1709,-108,-1,-179,140
1,1568,1817,-249,-4,-7,47
1,1362,1194,168,9,157,45
1,1638,1550,88,3,93,93
1,1701,1425,276,0,239,83
1,1429,1319,110,-1,-81,93
1,1774,1643,131,0,-45,89
-1,1368,1187,181,-12,-1263,106
1,1279,1294,-15,0,63,57
-1,1592,1717,-125,-2,-314,88
-1,1521,1499,22,-10,-504,68
1,1447,1422,25,1,7,41
1,1542,1647,-105,12,506,65
1,1705,1641,64,1,11,43
1,1622,1744,-122,0,-18,59
1,1422,1351,71,0,499,127
1,2024,1615,409,4,845,103
-1,1340,1668,-328,-3,-10,54
1,1724,1584,140,7,228,45
-1,1511,1509,2,-1,-35,44
-1,1612,2026,-414,-2,-59,48
-1,1576,1731,-155,-2,-589,144
-1,1547,1641,-94,-5,-286,84
1,1729,1798,-69,2,40,87
-1,1610,1506,104,1,-473,106
1,2028,1560,468,5,311,85
1,1522,1444,78,3,183,57
1,1520,1500,20,0,-11,71
1,1556,1595,-39,7,445,79
-1,1710,1588,122,-1,29,50
-1,1566,1531,35,0,31,78
-1,1531,2032,-501,-1,-8,50
-1,1604,1569,35,-4,-121,58
-1,1410,1605,-195,-1,-227,88
1,1876,1992,-116,-1,4,50
1,1489,1589,-100,-1,-147,77
1,1502,1597,-95,2,-20,49
1,2034,1592,442,0,201,83
-1,1595,1745,-150,-7,-102,60
1,1745,1595,150,3,588,115
1,1590,1515,75,0,36,59
-1,1337,1729,-392,-5,-311,78
-1,1633,1540,93,-1,-36,95
1,1649,1517,132,2,181,105
1,1599,1506,93,0,59,77
1,1589,1752,-163,-1,14,69
1,1977,1890,87,0,-10,73
-1,1436,1530,-94,-3,-67,106
1,1497,1608,-111,3,358,71
1,1726,1636,90,0,176,87
1,1593,1512,81,0,24,69
1,1335,1548,-213,0,7,55
1,1575,1503,72,6,258,101
1,2036,1619,417,2,295,65
-1,1742,1785,-43,-6,-54,46
-1,1291,1248,43,2,-10,46
-1,1503,1602,-99,2,112,68
1,2038,1617,421,3,356,87
1,1558,1531,27,0,649,131
1,1610,1495,115,-1,-2,49
1,2041,1818,223,0,90,67
1,1587,1615,-28,1,40,49
1,1500,1531,-31,6,401,89
1,1813,1488,325,-1,-18,41
-1,1603,1600,3,-2,-77,80
-1,1484,1816,-332,1,-2,58
-1,1882,1986,-104,-5,-107,100
1,1612,1592,20,0,158,73
-1,1181,1500,-319,-9,-283,58
1,1212,1340,-128,1,-45,79
-1,1581,1623,-42,-5,-123,72
1,1819,1736,83,0,1,57
-1,1377,1495,-118,-1,-91,58
1,1847,1630,217,1,-6,45
-1,1727,1828,-101,1,-71,70
1,1633,1571,62,0,92,57
-1,1337,1335,2,-3,-218,102
-1,1270,1515,-245,-18,-690,66
-1,1562,1643,-81,-3,-217,76
1,1632,1484,148,0,126,79
1,1500,1665,-165,0,-16,43
-1,1720,1836,-116,-1,114,82
-1,1616,1499,117,2,10,52
-1,1654,1777,-123,0,-36,54
1,1652,1554,98,5,106,69
-1,1624,1989,-365,0,-4,42
1,1742,1790,-48,1,58,55
1,1514,1601,-87,0,138,71
-1,1546,1660,-114,-3,-41,40
-1,1524,1659,-135,0,-51,62
0,1588,1528,60,0,-29,118
1,1969,1844,125,4,144,65
1,1427,1437,-10,12,295,53
1,1628,1639,-11,-3,-683,138
-1,1993,1944,49,-1,-47,68
-1,1538,1668,-130,0,-125,70
1,1228,1213,15,6,292,77
-1,1458,1586,-128,1,9,56
-1,1836,1851,-15,0,-45,76
-1,1530,1586,-56,-6,-26,40
1,1524,1263,261,5,333,59
1,1586,1530,56,0,67,67
1,1675,1531,144,-1,48,81
-1,1369,1594,-225,-10,-212,52
-1,1520,1595,-75,-2,-125,72
-1,1861,1825,36,3,54,64
1,1621,1992,-371,0,213,81
-1,1524,1682,-158,-2,-78,80
-1,1595,1520,75,-1,-6,40
1,2017,1982,35,3,109,73
1,1838,1850,-12,-3,327,101
-1,1463,1356,107,-3,-70,74
1,1534,1604,-70,3,190,93
1,1689,1518,171,2,232,69
1,1754,1425,329,2,287,91
1,1839,1849,-10,0,16,93
-1,1777,1703,74,-1,-123,102
-1,1512,1695,-183,-10,-266,84
1,1264,1257,7,6,129,47
1,1594,1784,-190,0,12,73
-1,1838,1850,-12,-2,-56,66
1,1701,1506,195,-2,19,61
-1,2021,1500,521,-13,-276,60
1,1970,1864,106,-2,-91,95
1,1827,1860,-33,1,37,69
1,1500,1485,15,0,-15,51
-1,1707,1500,207,-1,-146,58
1,1364,1471,-107,2,279,93
1,1849,1839,10,2,27,53
1,1322,1172,150,6,665,85
-1,1517,1689,-172,0,-28,62
1,1343,1438,-95,-2,-177,85
-1,1000,1241,-241,0,-160,66
-1,1829,1859,-30,-8,-312,60
0,2005,1611,394,5,287,125
1,1696,1511,185,1,-110,101
-1,1268,1015,253,3,100,54
-1,1868,1819,49,-5,48,80
-1,1505,1702,-197,-4,-287,66
-1,1831,1856,-25,0,-32,80
1,1707,1500,207,0,87,84
-1,1654,1618,36,-3,-71,60
-1,1866,1821,45,-5,-129,78
1,1457,1379,78,9,226,55
1,1631,1641,-10,0,201,99
1,1494,1713,-219,-5,-183,67
1,1833,1854,-21,-3,-100,73
-1,1063,1250,-187,-8,-463,58
-1,1268,1426,-158,0,35,46
1,1642,1630,12,0,256,117
1,1695,1512,183,-1,95,91
-1,1844,1843,1,-2,-103,60
1,1795,1978,-183,-1,74,73
-1,1506,1701,-195,-1,-300,88
1,1552,1405,147,-2,60,105
1,1641,1631,10,1,8,41
1,1346,1248,98,2,114,67
-1,1411,1649,-238,1,-258,98
-1,1543,1534,9,0,14,96
0,0,1052,-1052,-9,-885,142
1,1978,1499,479,1,-12,95
-1,1196,1256,-60,0,-317,118
1,1659,1606,53,-2,746,114
1,1358,954,404,2,17,77
1,1980,1497,483,-1,-36,71
-1,1355,1236,119,-1,-255,124
-1,1407,1654,-247,0,2,68
-1,1496,1996,-500,-4,-170,94
-1,1577,1599,-22,-6,172,98
1,1500,1485,15,1,170,101
-1,1267,1658,-391,-3,-17,52
1,1336,1266,70,1,46,55
1,1329,1257,72,4,283,89
1,1914,1609,305,4,117,47
-1,1596,1668,-72,-1,-43,52
1,1361,1525,-164,2,59,73
-1,1259,1539,-280,4,22,54
-1,1571,1661,-90,-1,-58,55
-1,1269,1257,12,-6,-444,86
-1,1677,1587,90,0,-149,78
1,1339,1112,227,5,77,41
1,1668,1611,57,0,-2,51
1,1670,1563,107,1,58,57
-1,2000,1936,64,0,34,120
-1,1257,1395,-138,-3,-135,58
1,1500,1571,-71,3,209,79
1,1788,1955,-167,0,25,69
1,1378,1279,99,0,-58,65
-1,1308,1424,-116,4,-132,84
-1,1714,1500,214,0,-113,120
-1,1719,2051,-332,0,-343,128
1,1601,1619,-18,1,80,71
-1,1556,1563,-7,2,-44,56
-1,1085,1344,-259,-7,-168,52
-1,947,1422,-475,-14,-669,64
-1,1716,1493,223,3,88,46
0,1639,1622,17,0,-15,112
-1,1608,1613,-5,1,60,62
-1,1698,2204,-506,-1,-198,92
-1,1387,1690,-303,-7,-724,120
1,1608,1594,14,5,196,67
-1,1381,1676,-295,-6,-118,60
1,1767,1637,130,1,151,101
1,1603,1769,-166,0,139,83
0,1250,1532,-282,-1,123,87
-1,1219,1583,-364,-5,-480,80
-1,1500,1612,-112,0,-259,92
-1,1696,1912,-216,0,-199,76
-1,1663,1540,123,1,0,48
-1,1500,1128,372,0,54,60
1,2020,1948,72,-2,-45,43
1,1681,1571,110,0,59,113
1,1918,1691,227,0,-4,49
-1,1500,1577,-77,0,-23,106
1,2007,1940,67,2,155,67
1,1924,1686,238,-4,-91,73
-1,1668,1578,90,0,-21,64
-1,1518,1632,-114,0,-42,80
0,1929,1681,248,0,-194,139
-1,1932,2050,-118,-2,-262,78
-1,1200,1246,-46,-5,-392,90
-1,1688,2030,-342,-1,-29,88
-1,1447,1634,-187,-7,-48,40
-1,1502,1480,22,-2,-98,60
1,1578,1694,-116,1,55,59
-1,1619,1693,-74,-1,32,88
-1,1685,1922,-237,0,0,46
1,1354,1478,-124,1,-98,43
1,1375,1064,311,-7,-140,55
1,1640,1513,127,0,0,63
1,1500,1624,-124,-2,443,120
1,1677,1695,-18,-8,15,83
-1,1857,2003,-146,3,133,76
-1,1680,2034,-354,-1,-307,110
1,1377,1424,-47,2,50,61
1,1348,1341,7,-7,-163,69
1,1683,1690,-7,2,44,51
-1,1690,1683,7,1,27,66
1,1648,1502,146,-3,49,51
-1,1394,1615,-221,-1,-468,124
1,1666,1492,174,6,448,67
1,1550,1672,-122,0,557,127
1,1679,1510,169,1,197,67
1,1379,1597,-218,0,-80,101
-1,1690,1683,7,-4,-139,74
1,1672,1593,79,-1,-54,85
1,1655,1489,166,0,-6,69
1,1694,1678,16,-1,-56,75
-1,1655,1495,160,0,-477,116
1,1678,1694,-16,-3,-48,57
-1,1479,1576,-97,-2,-385,86
-1,1809,1851,-42,-4,-60,50
-1,1683,1690,-7,0,-69,60
1,1702,1672,30,1,20,46
1,1638,1543,95,-1,-27,43
1,1506,1402,104,1,199,93
1,1652,1473,179,0,40,75
1,1931,1442,489,0,294,93
-1,1693,1657,36,0,131,72
1,1453,1564,-111,-3,-44,83
1,1471,1685,-214,0,-362,141
1,1378,1304,74,2,44,55
1,1584,1685,-101,0,69,91
1,1748,1500,248,4,114,55
1,1647,1370,277,-1,-19,55
1,1534,1567,-33,-10,277,115
1,1514,1511,3,0,33,107
-1,1594,1526,68,0,-331,100
1,1494,1758,-264,2,111,83
-1,1651,1505,146,-5,-937,126
-1,1648,1875,-227,0,-95,82
-1,1500,1665,-165,-2,-155,80
-1,1579,1829,-250,1,29,50
-1,1579,1541,38,-7,-472,92
1,1489,1524,-35,0,22,53
-1,1448,1512,-64,-5,-1,42
-1,1487,1555,-68,-3,-232,78
1,1425,1275,150,0,79,57
1,1647,1267,380,1,104,89
1,1500,1432,68,2,266,109
-1,1439,1522,-83,-5,-613,108
-1,1409,1257,152,-1,-13,54
1,1512,1501,11,2,89,73
1,1360,1140,220,10,400,65
-1,1493,1756,-263,3,88,62
-1,1665,1650,15,1,27,62
1,1397,1500,-103,3,-218,97
1,1818,1871,-53,3,74,71
-1,1274,1393,-119,-1,-165,82
-1,1859,1831,28,1,-2,60
1,1880,1605,275,0,-16,61
1,1365,1122,243,-1,20,133
-1,1843,1847,-4,1,15,48
1,1523,1465,58,2,58,59
0,1382,1411,-29,0,293,169
-1,1818,1929,-111,-2,-48,50
-1,1554,1756,-202,-4,-17,40
1,1468,1049,419,-2,35,47
-1,1860,1922,-62,-5,-29,42
1,1401,1265,136,9,282,51
1,1569,1673,-104,1,97,59
1,1644,1449,195,-1,25,68
1,1927,1832,95,-1,-8,55
1,1453,1367,86,-1,5,49
-1,1635,1837,-202,0,-61,66
-1,1456,1574,-118,0,-177,162
1,1532,1531,1,0,33,115
1,1824,1785,39,0,32,79
-1,1610,1623,-13,0,-49,88
-1,1431,1428,3,-3,-145,72
-1,1719,1940,-221,-9,-166,42
-1,1490,1437,53,0,27,50
1,1775,1833,-58,2,103,93
-1,1738,1513,225,0,-91,78
1,1425,1317,108,2,11,105
-1,999,1258,-259,-5,-711,108
-1,1536,1639,-103,0,114,80
1,1629,1687,-58,16,732,79
1,1801,1501,300,6,94,43
1,1821,1788,33,0,-81,99
-1,1231,1470,-239,-3,-122,62
1,1502,1289,213,4,111,51
-1,1477,1658,-181,0,-168,94
1,1936,1858,78,-3,30,77
-1,1478,1585,-107,-1,-167,78
1,1537,1720,-183,0,10,43
-1,1674,1643,31,0,-91,70
1,1778,1831,-53,1,172,85
1,1543,1521,22,1,84,85
0,1462,1615,-153,-1,-434,116
1,1531,1719,-188,-4,-59,71
1,1850,1805,45,-1,-508,125
1,1776,1524,252,0,21,59
1,1762,1500,262,-3,16,63
1,1655,1662,-7,0,-27,99
-1,1859,1796,63,2,-246,92
1,2124,1790,334,2,237,97
1,1528,1650,-122,2,-59,73
-1,1788,2127,-339,-1,-16,128
1,1262,1195,67,4,238,91
1,1781,1520,261,-7,-362,87
-1,1651,1666,-15,-10,-187,42
1,1471,1567,-96,1,-44,177
-1,1701,1548,153,0,236,88
-1,1566,1384,182,1,-173,80
1,1888,1933,-45,-1,-19,75
1,1846,1809,37,5,191,65
-1,1783,1948,-165,-7,-116,64
-1,1510,1553,-43,0,97,108
-1,1677,1641,36,-1,106,82
1,1587,1650,-63,-5,-228,77
1,1856,1652,204,2,-488,105
1,1388,1466,-78,0,186,75
-1,1548,1414,134,0,-546,88
-1,1646,1861,-215,-6,-195,62
1,1701,1485,216,7,214,56
1,1696,1975,-279,-3,33,71
1,2151,1772,379,-1,-35,117
0,1491,1351,140,5,516,103
1,1866,1641,225,-1,-24,49
1,1920,1902,18,1,72,79
-1,1636,1871,-235,0,13,76
-1,1452,1403,49,-4,-493,80
-1,1818,2131,-313,1,-2,76
-1,1508,1757,-249,-3,-90,56
1,1458,1503,-45,-3,271,119
1,1875,1631,244,1,-240,109
1,1610,1301,309,4,129,63
-1,1796,1784,12,-6,-58,42
1,1581,1641,-60,12,260,45
1,1485,1619,-134,1,39,59
1,2135,1815,320,1,80,69
0,1798,1666,132,0,-39,81
-1,1416,1439,-23,1,-168,106
-1,1891,1931,-40,1,-7,98
1,1812,1627,185,0,72,63
1,1539,1420,119,2,351,71
-1,1621,1818,-197,-1,-31,66
1,1280,1500,-220,1,1175,165
1,1781,1683,98,2,43,46
-1,1880,1799,81,-9,-579,90
1,2139,1823,316,0,115,73
-1,1562,1500,62,0,-11,50
1,1813,1866,-53,0,211,151
1,1615,1686,-71,-2,465,119
1,1450,1405,45,3,139,55
-1,1345,1590,-245,0,-913,142
1,1796,1785,11,0,-30,77
-1,1820,2142,-322,0,-91,106
-1,1940,1880,60,0,10,58
1,1854,1825,29,1,82,77
-1,1395,1460,-65,-3,-122,70
1,2146,1817,329,0,24,103
1,1725,1548,177,-1,-48,53
1,1500,1777,-277,-1,-71,57
-1,1894,1927,-33,-2,-89,66
1,1550,1514,36,2,27,57
-1,1627,1628,-1,0,-94,86
0,1554,1490,64,1,93,82
-1,1712,1771,-59,0,-95,94
-1,1469,1385,84,3,-7,58
-1,1570,1584,-14,1,62,90
-1,1665,1957,-292,0,-9,80
1,1638,1625,13,4,10,71
-1,1937,1883,54,-3,-294,92
-1,1500,1722,-222,0,19,52
-1,1294,1613,-319,-6,-515,88
1,1589,1542,47,-1,-10,53
0,1400,1455,-55,0,-403,128
-1,1608,1649,-41,0,-95,90
-1,1180,1291,-111,-16,-192,42
1,1659,1592,67,0,-13,45
1,1706,1606,100,-2,-8,81
1,1880,1729,151,-1,-18,59
-1,1579,1668,-89,-1,-26,46
0,1897,1925,-28,-1,50,125
1,1384,1299,85,5,278,59
-1,1495,1515,-20,0,-158,84
-1,1453,1569,-116,0,-50,60
-1,1677,1566,111,0,-431,150
1,1559,1746,-187,1,115,97
0,1560,1707,-147,-3,-3,69
1,1634,1415,219,14,119,42
-1,1231,1715,-484,0,-2,52
-1,1631,1621,10,-1,-8,48
-1,1207,1403,-196,-1,-113,76
-1,1521,1401,120,-1,-108,126
1,1442,1440,2,-1,66,67
-1,1661,1606,55,-2,40,58
1,1620,1632,-12,-1,173,77
1,1697,1242,455,-6,356,99
1,1632,1620,12,4,539,81
-1,1610,1643,-33,-4,-407,98
-1,1409,1200,209,2,-90,74
1,1652,1601,51,7,200,47
-1,1525,1457,68,-5,-130,62
-1,1507,1694,-187,0,-1,58
1,1592,1661,-69,-2,-26,49
-1,1842,1596,246,0,12,58
-1,1639,2012,-373,-1,-43,62
1,1898,1369,529,-9,31,85
1,1604,1649,-45,8,43,41
1,1983,2058,-75,0,60,89
1,1877,1589,288,1,56,75
1,1646,1607,39,0,-3,51
0,1719,1586,133,-1,-121,141
-1,1220,1391,-171,0,12,42
0,1936,1956,-20,1,133,126
-1,1433,1235,198,-8,-397,85
-1,1727,1618,109,-3,-183,73
1,1735,1831,-96,1,89,63
1,1329,1233,96,1,37,53
1,1470,1512,-42,-1,33,71
1,1040,0,1040,2,56,57
1,1429,1019,410,10,356,67
-1,1265,1641,-376,0,-307,90
1,1510,1481,29,1,54,105
1,2015,1636,379,0,21,65
1,1702,1501,201,1,80,133
-1,1629,1907,-278,-3,-189,68
-1,1705,1714,-9,-2,-385,108
1,1561,1368,193,0,9,57
1,1551,1933,-382,1,12,47
-1,1812,1950,-138,-2,-193,90
1,1744,1337,407,-4,89,105
-1,1075,1655,-580,-8,-198,46
-1,1625,1518,107,-10,-8,40
0,1727,1694,33,4,427,119
1,1311,1449,-138,2,374,123
1,1566,1361,205,6,428,79
-1,1611,1510,101,-5,-1,44
1,1650,1905,-255,2,43,60
-1,1740,1939,-199,1,-7,56
-1,1398,1500,-102,-2,-117,74
-1,1525,1597,-72,-3,-777,156
1,1636,1711,-75,3,211,59
-1,1777,1955,-178,-6,-398,150
-1,1998,1631,367,-9,-216,54
-1,1726,1645,81,1,-71,158
-1,1535,1503,32,-3,11,90
-1,1606,1515,91,-8,-304,63
1,1622,1660,-38,5,220,65
1,1981,1899,82,0,82,57
1,1949,1733,216,-1,-42,43
1,1530,1592,-62,5,237,59
1,1361,1072,289,1,40,51
-1,1816,1990,-174,0,-479,138
0,1699,1506,193,-1,-52,72
-1,1240,1384,-144,-2,-70,52
1,1580,1544,36,0,26,43
1,1804,1957,-153,0,-5,47
1,1938,1893,45,2,-33,51
-1,1162,1496,-334,-4,-234,86
1,1533,1589,-56,-2,37,63
-1,1996,1768,228,3,140,84
1,1695,1710,-15,0,28,103
-1,1558,1662,-104,-5,-229,60
1,1886,1979,-93,-5,126,117
1,1575,1632,-57,0,55,71
-1,1512,1692,-180,-1,-16,52
1,1746,1453,293,5,221,67
-1,1060,1365,-305,2,-22,73
1,1697,1707,-10,1,72,85
1,1566,1092,474,7,162,43
-1,1231,1396,-165,0,-65,78
1,1364,1822,-458,2,28,46
-1,1672,1965,-293,0,-8,46
-1,1740,1696,44,0,-16,72
-1,1496,1631,-135,-2,-4,44
-1,1696,1710,-14,1,-456,116
1,1550,1577,-27,5,382,95
-1,1883,1966,-83,-1,-70,54
1,1974,1964,10,-1,-41,45
-1,1574,1643,-69,-1,-269,164
1,1739,1668,71,1,87,147
1,1368,1049,319,7,258,81
1,1568,1356,212,7,203,51
-1,1448,1750,-302,0,-12,102
-1,1959,1727,232,1,9,52
1,1557,1582,-25,0,27,51
-1,1565,1722,-157,0,8,46
-1,1722,1565,157,0,1,40
1,1586,1852,-266,1,28,54
-1,1748,2102,-354,3,-24,104
1,1771,2018,-247,0,25,57
-1,1016,1563,-547,-10,-190,52
1,1525,1470,55,-3,-87,57
-1,1575,1711,-136,-3,-699,148
-1,1039,1372,-333,-7,-458,72
-1,1728,1726,2,0,-17,46
1,1568,1719,-151,0,17,49
1,1946,1640,306,7,211,55
1,1719,1568,151,0,157,153
1,1832,1604,228,5,90,43
1,1561,1702,-141,0,15,49
-1,1535,1461,74,0,-21,70
1,1337,1063,274,4,717,105
1,1634,1545,89,4,102,59
1,1685,1576,109,-1,977,105
0,1576,1685,-109,0,55,110
1,1391,1213,178,-4,-44,49
-1,1846,1515,331,-4,-245,90
1,1681,1580,101,0,354,100
-1,1377,1766,-389,-4,-157,50
1,1466,1474,-8,1,-36,63
0,1521,1335,186,0,37,107
-1,1375,1564,-189,-9,-269,54
1,2049,1397,652,-7,35,59
-1,1599,1838,-239,-8,-75,41
-1,1588,1441,147,-8,-86,54
0,1572,1690,-118,0,137,139
-1,1685,2050,-365,-1,-329,92
-1,1551,1586,-35,3,85,56
-1,1586,1686,-100,6,109,68
1,2053,1682,371,0,-11,43
1,1722,1500,222,4,68,47
-1,1680,2056,-376,0,14,44
-1,1284,1369,-85,2,14,74
1,1572,1014,558,10,309,53
-1,1313,1241,72,0,-1589,120
1,1552,1655,-103,-7,-75,47
0,2059,1677,382,-2,-499,154
-1,1463,1478,-15,0,61,104
-1,1578,1657,-79,-3,-198,68
-1,1515,1580,-65,1,17,90
-1,1499,1523,-24,0,-4,100
-1,1460,1572,-112,-3,-302,88
-1,1772,2048,-276,1,134,102
-1,1949,2046,-97,-1,-82,56
1,1642,1616,26,6,159,51
-1,1739,1573,166,-3,-422,118
1,1533,1595,-62,0,-4,51
1,1667,1570,97,-1,195,181
1,1318,1013,305,3,165,55
1,1842,1708,134,4,82,43
-1,1374,1341,33,-2,-829,120
-1,1986,2053,-67,-7,50,74
1,1727,1803,-76,5,284,85
-1,1927,1695,232,0,5,50
1,2064,1976,88,-3,29,45
-1,1910,2044,-134,0,276,106
-1,1639,1589,50,-1,-66,94
-1,1489,1452,37,-3,-134,76
1,2074,1966,108,1,53,73
1,1713,1562,151,1,162,169
1,1497,1615,-118,5,293,87
0,1569,1537,32,-3,-120,73
1,1958,2084,-126,-4,-19,113
-1,2024,1741,283,-1,-492,96
-1,1701,1850,-149,-5,-97,52
-1,1562,1896,-334,-4,-215,64
1,1577,1696,-119,0,-26,47
-1,1952,1974,-22,-2,-267,112
-1,1696,1577,119,-2,-198,90
1,1721,1528,193,2,236,99
1,1849,1431,418,-2,165,155
0,1759,1901,-142,0,-2,116
-1,1909,2052,-143,-3,-15,52
1,1985,1915,70,1,15,109
1,1591,1681,-90,7,675,71
1,1464,1476,-12,1,423,113
1,1254,1300,-46,-1,94,121
1,2018,1789,229,-1,-6,57
1,1528,1526,2,-3,-39,49
-1,1557,1666,-109,-3,-168,70
-1,1864,2003,-139,0,-22,96
-1,1557,1666,-109,0,-27,100
-1,2060,1902,158,0,-72,82
-1,1510,1467,43,2,-11,96
1,1682,1903,-221,-1,-30,69
1,1305,1451,-146,2,16,49
1,1495,1461,34,-1,-107,115
-1,1763,1894,-131,0,-79,70
1,1740,1488,252,5,231,89
1,1844,2010,-166,3,51,67
-1,1549,1674,-125,-2,13,62
-1,1540,1354,186,-1,-127,68
-1,1870,2002,-132,-3,-250,80
1,1429,1456,-27,-1,657,129
-1,1626,1851,-225,-4,-146,70
1,1731,1621,110,-2,71,83
1,1867,1826,41,-1,-15,91
1,1511,1487,24,4,106,69
-1,1687,1751,-64,-1,-185,116
1,2009,1863,146,0,255,83
1,1817,1889,-72,2,22,67
-1,1645,1689,-44,0,76,96
1,1829,1860,-31,0,181,115
-1,1523,1710,-187,0,-657,112
-1,1352,1481,-129,1,-8,56
-1,1817,2219,-402,0,-162,110
1,2066,1699,367,5,186,69
-1,1543,1599,-56,0,-20,74
-1,1835,1840,-5,-10,-208,60
1,2025,1697,328,0,6,43
-1,1329,1450,-121,-3,-161,52
-1,1789,1719,70,1,-147,256
-1,1850,1814,36,2,62,84
1,1747,2069,-322,4,152,51
-1,1621,1419,202,-1,-233,80
1,1760,1693,67,2,12,59
1,1837,1839,-2,6,394,69
-1,1672,2046,-374,-4,-64,76
-1,1396,1443,-47,1,54,58
1,1885,1596,289,6,119,59
-1,1767,1769,-2,3,46,48
-1,1784,2002,-218,0,-34,66
-1,1828,1857,-29,-2,-351,166
1,2075,1857,218,1,2,79
1,2222,1815,407,1,45,47
-1,1493,1613,-120,0,-64,92
-1,1605,1681,-76,-4,-529,111
1,2049,1670,379,0,-3,65
1,1852,2080,-228,2,43,46
1,1806,1740,66,1,120,149
-1,1263,1446,-183,4,38,56
-1,1609,1494,115,-3,-184,62
1,1667,2052,-385,-1,-97,75
-1,1596,1690,-94,1,-117,64
-1,1874,1819,55,0,20,52
-1,1695,1869,-174,-4,-63,42
-1,1456,1604,-148,-1,-46,56
1,1500,1483,17,0,3,47
1,1831,1853,-22,0,4,47
-1,1701,1682,19,-9,-104,52
1,2027,1690,337,0,3,59
-1,1677,1768,-91,-4,-198,74
1,1517,1372,145,11,606,65
1,1684,1623,61,0,157,107
-1,1687,2031,-344,-10,-266,104
1,1614,1694,-80,-9,-2,41
1,1834,1874,-40,1,338,127
-1,1731,1816,-85,-2,-203,114
-1,1340,1453,-113,8,70,88
-1,1680,1628,52,3,56,82
1,1768,1777,-9,3,83,45
-1,1667,1621,46,0,-127,72
1,2034,1683,351,0,-61,101
1,1396,1364,32,1,127,65
-1,1747,1779,-32,0,11,56
-1,1718,1716,2,0,-184,144
-1,1726,1569,157,-1,-155,64
-1,1223,1667,-444,-1,-30,54
-1,1721,1689,32,1,-15,48
1,1863,1688,175,-1,-46,65
1,1669,1219,450,1,20,55
-1,1680,2037,-357,0,-24,64
1,1647,1634,13,2,65,67
1,1155,1291,-136,-3,-85,47
-1,1723,2007,-284,1,-13,73
1,1826,1348,478,3,154,57
-1,1789,1853,-64,1,-162,82
1,1586,1433,153,-1,42,64
1,1534,1476,58,0,481,111
-1,1813,1889,-76,1,109,92
-1,1674,2044,-370,1,50,70
1,1783,1631,152,6,138,61
1,1640,1670,-30,0,-61,81
1,1872,1793,79,5,118,49
-1,1780,1867,-87,0,65,83
1,2047,1671,376,1,81,79
1,1506,1533,-27,0,-4,81
-1,1386,1702,-316,-8,-43,41
1,1651,1658,-7,3,139,67
-1,1879,2050,-171,-2,-113,72
1,1737,1498,239,6,179,61
-1,1662,1646,16,-1,-132,134
1,2058,1871,187,1,179,73
1,1288,1354,-66,1,176,93
1,1898,1881,17,1,16,72
-1,1668,1857,-189,7,838,158
1,1791,1649,142,6,107,55
1,1598,1643,-45,-7,-116,61
1,1582,1595,-13,1,173,141
1,1500,1338,162,4,186,69
-1,2048,2065,-17,1,48,54
-1,1709,1804,-95,4,120,90
1,1651,1658,-7,-1,6,55
1,1493,1451,42,1,89,85
-1,1505,1623,-118,-2,-105,70
1,1515,1770,-255,7,185,61
1,2078,2037,41,0,3,79
1,1862,1661,201,1,61,75
-1,1662,1646,16,1,3,88
1,1442,1237,205,2,181,67
-1,2026,2090,-64,6,91,56
0,1642,1798,-156,0,22,123
-1,1655,1868,-213,0,43,110
1,1916,1361,555,1,19,49
-1,1658,1651,7,1,199,122
-1,2101,2016,85,-1,-89,92
1,1754,1772,-18,0,41,49
1,1873,1648,225,0,62,71
-1,1448,1414,34,0,-258,110
1,1662,1647,15,6,419,69
1,1608,1493,115,0,34,65
1,1844,1789,55,-3,-4,63
1,1533,1344,189,10,383,61
-1,1744,1738,6,0,-53,62
1,1766,1682,84,0,2,67
1,1701,1737,-36,0,38,69
-1,1807,1637,170,3,160,66
1,1610,1367,243,1,277,103
1,1742,1694,48,-1,-115,89
1,1448,1346,102,1,-20,55
-1,1761,1642,119,0,-166,106
1,2031,1626,405,-1,7,47
-1,1739,1734,5,0,2,54
-1,1300,1458,-158,-5,-273,74
-1,1712,1759,-47,1,-85,72
1,1653,1789,-136,-1,-153,83
1,1725,1713,12,2,93,59
-1,2033,1624,409,1,55,66
1,1667,1660,7,4,114,41
1,1757,1290,467,0,155,85
1,2011,1877,134,-2,263,105
-1,1447,1694,-247,0,-107,82
1,1539,1486,53,0,-33,133
1,1763,1796,-33,1,22,49
1,1563,1496,67,5,23,43
-1,1706,1613,93,-10,-406,62
-1,1870,2019,-149,0,-321,70
-1,1759,1780,-21,-3,-69,42
-1,1505,1489,16,-8,-230,50
1,1804,1751,53,0,14,53
1,1611,1535,76,3,55,44
-1,1645,1636,9,0,-1,72
-1,1703,1736,-33,-1,-152,130
1,1773,1668,105,4,439,139
1,1757,1715,42,4,73,46
-1,1426,1436,-10,4,-169,128
-1,2026,1864,162,-3,-35,44
1,1532,1290,242,1,136,159
1,1601,1350,251,9,260,59
1,1691,2105,-414,2,318,69
-1,1879,2009,-130,-4,-91,44
1,1633,1215,418,-7,35,101
0,2009,1879,130,2,104,81
-1,1457,1503,-46,-2,-64,54
-1,1613,1728,-115,-5,-333,98
-1,1556,1699,-143,-3,-159,74
1,1518,1375,143,-6,-202,57
-1,1649,2082,-433,3,133,86
-1,1883,2005,-122,-1,-757,134
-1,1500,1666,-166,-6,-311,124
1,2084,1647,437,2,109,55
1,2013,1876,137,1,16,57
1,1608,1345,263,5,54,43
-1,1751,1790,-39,-1,-83,58
-1,1645,2086,-441,1,23,78
-1,1691,1772,-81,-9,-349,68
-1,1361,1824,-463,-1,-63,50
1,1454,1427,27,0,3,81
1,1635,1750,-115,-3,-146,65
1,1857,1706,151,0,24,95
-1,1642,1715,-73,-1,-77,102
1,1481,1517,-36,4,298,115
-1,1518,1547,-29,-5,-359,116
-1,1828,1945,-117,3,176,80
-1,1725,1632,93,-14,-759,86
1,1735,1650,85,0,141,115
1,1603,1632,-29,1,227,129
1,1476,1476,0,0,4,51
1,2020,1869,151,1,469,151
1,1727,1357,370,-2,-84,45
1,1388,1350,38,-3,19,65
1,2135,1648,487,0,-19,51
1,1473,1353,120,4,142,63
1,1741,1624,117,0,-11,63
-1,1486,1825,-339,0,-10,40
-1,1353,1500,-147,-4,-171,64
1,1756,1862,-106,3,236,71
-1,1540,1500,40,-2,-51,52
-1,1647,2136,-489,0,7,58
-1,1880,1699,181,-1,-102,76
1,1848,1770,78,0,-30,45
1,2138,1645,493,0,26,59
1,1728,1606,122,2,72,45
1,1857,1762,95,-6,-209,69
1,1866,1800,66,0,-189,85
1,1828,1483,345,1,102,67
1,1549,1640,-91,-2,-47,53
1,1906,1744,162,1,16,59
-1,1917,1908,9,-1,-50,56
1,2141,1642,499,0,23,71
1,1754,1865,-111,3,384,89
-1,1505,1493,12,2,-92,54
1,1792,1702,90,1,166,75
1,1696,1531,165,-1,78,52
-1,1934,1559,375,0,-5,43
1,1851,1768,83,3,225,115
1,1863,1646,217,6,67,47
1,1465,1532,-67,0,23,123
-1,1738,1916,-178,1,57,82
-1,1579,1913,-334,-1,-316,104
-1,1758,1813,-55,-1,-13,44
1,2144,1639,505,-6,-142,81
1,1735,1598,137,-1,253,119
1,1714,1747,-33,1,46,85
-1,1859,1760,99,-1,-351,88
-1,1435,1585,-150,-4,-8,42
-1,1637,2146,-509,0,5,50
1,1872,1929,-57,-2,-60,65
-1,1857,1746,111,-5,-186,86
1,1641,1868,-227,0,25,45
1,1455,1617,-162,8,126,51
-1,1845,1773,72,0,-103,66
0,1399,1500,-101,11,759,79
1,1622,1535,87,0,73,93
1,2148,1636,512,0,-18,43
1,1831,1791,40,0,-5,55
-1,1832,1786,46,-1,-371,124
1,1559,1783,-224,0,34,57
-1,1634,2149,-515,-1,-35,52
1,1916,1576,340,1,50,69
1,2151,1633,518,7,135,41
1,1850,1654,196,1,4,45
1,1749,1898,-149,0,14,73
1,1820,1798,22,5,317,105
1,1563,1626,-63,0,-16,131
1,1494,1330,164,11,125,45
-1,1821,1740,81,-8,-179,68
1,1884,1919,-35,-3,-69,109
-1,1887,1906,-19,0,-271,140
1,1856,1657,199,0,7,103
1,1471,1380,91,9,217,59
1,2152,1631,521,0,-5,53
1,1463,1594,-131,4,350,116
-1,1403,1601,-198,4,135,84
-1,1415,1363,52,-6,-57,46
-1,1845,1925,-80,-1,-64,83
-1,2027,1840,187,0,9,52
-1,1808,1753,55,-6,-60,44
-1,1922,2200,-278,-3,-23,50
-1,1855,2010,-155,-1,-535,98
1,1413,1500,-87,0,-27,47
1,1436,1750,-314,-4,99,72
1,2154,1629,525,0,23,73
1,1795,1547,248,-1,-8,49
1,1500,1360,140,6,320,83
-1,1613,1765,-152,-1,-62,74
1,1840,1500,340,-2,81,81
-1,2058,2077,-19,0,-226,108
1,2085,1633,452,2,201,101
1,1651,1709,-58,0,54,85
-1,1939,1836,103,-1,-28,102
1,1328,992,336,2,286,115
1,1402,1315,87,1,-8,63
-1,1799,1542,257,-6,-534,94
-1,1624,1515,109,-1,-89,92
1,1477,1591,-114,-3,-64,57
1,2017,1628,389,7,148,47
-1,1372,1480,-108,0,-500,164
-1,1525,1791,-266,-1,-265,106
0,1438,1321,117,0,36,107
-1,1561,1781,-220,-3,-8,74
1,1873,1693,180,3,127,69
1,1772,1631,141,-1,-60,75
1,1270,1574,-304,16,154,45
1,1785,1863,-78,0,287,145
1,1844,1258,586,7,219,49
1,1917,2059,-142,-1,-46,67
1,1786,1556,230,0,188,61
1,1842,1918,-76,-4,-183,92
-1,1276,1423,-147,-5,-93,46
1,1730,1760,-30,0,1,87
1,1899,1736,163,0,72,97
-1,1507,1568,-61,1,35,68
0,2188,1918,270,-1,-35,43
-1,1625,1779,-154,-1,-116,78
-1,1526,1752,-226,0,-66,68
1,1489,1340,149,4,511,89
-1,1409,1499,-90,0,-154,50
1,1350,1401,-51,-5,-112,45
-1,1695,1941,-246,1,61,84
-1,1543,1744,-201,-1,-79,70
-1,1577,1488,89,-3,-51,54
-1,1571,1634,-63,-3,-170,108
1,1911,1553,358,-1,-6,51
-1,1512,1613,-101,-1,-74,46
-1,1798,1775,23,1,210,124
-1,1685,1681,4,-2,-178,76
1,1539,1538,1,-8,-105,59
-1,1621,1750,-129,-5,-510,108
-1,1551,1913,-362,-3,-47,56
1,1652,1727,-75,-1,-16,47
-1,1777,1664,113,0,62,72
1,1719,1542,177,0,180,96
0,1514,1218,296,2,461,111
-1,1503,1562,-59,0,1,54
-1,1754,1810,-56,-2,35,64
1,1916,1548,368,3,116,59
1,1747,1689,58,0,84,59
1,1287,1347,-60,-2,667,113
1,1868,1772,96,-2,42,53
1,1507,1400,107,-1,-6,55
1,1363,1500,-137,2,-5,62
-1,1745,1819,-74,-1,116,70
1,1703,1440,263,-2,100,77
-1,1546,1629,-83,-2,-30,46
-1,1572,1493,79,-1,-93,104
1,1704,1631,73,2,356,71
-1,1408,1299,109,-3,-239,60
-1,1526,1919,-393,-3,-63,66
1,1827,1938,-111,-1,47,63
-1,1637,1537,100,-7,-213,62
-1,1678,1764,-86,-1,-38,66
-1,1650,1496,154,1,46,66
0,1491,1523,-32,0,59,110
-1,1166,1426,-260,0,-75,72
1,1678,1727,-49,0,225,78
1,1507,1274,233,-1,50,85
-1,1552,1623,-71,0,7,42
-1,1737,1828,-91,-8,-124,44
1,1763,1878,-115,0,177,123
1,2008,1946,62,0,-6,67
1,1921,1524,397,2,121,55
-1,1420,1269,151,0,-283,92
1,1621,1712,-91,0,127,117
1,1923,1836,87,2,92,69
1,1748,1656,92,3,98,59
-1,1568,1498,70,0,3,46
-1,1244,1512,-268,1,-15,52
1,1656,1648,8,4,521,67
1,1666,1637,29,2,448,97
-1,1178,0,1178,-1,26,42
1,1511,1554,-43,-1,-23,49
1,1772,1670,102,-1,-9,43
-1,1517,1925,-408,-8,-511,100
-1,1486,1824,-338,2,150,62
1,1263,1301,-38,4,453,117
-1,1643,1562,81,0,53,64
-1,1321,1500,-179,0,107,66
1,1676,1470,206,-1,63,165
0,1662,1779,-117,0,112,177
-1,1664,1861,-197,0,-249,80
-1,1269,1563,-294,-2,-21,66
1,1927,1515,412,1,527,107
-1,1336,1385,-49,0,-29,52
1,1122,1435,-313,7,314,69
1,1806,1469,337,1,506,119
1,1513,1254,259,2,286,92
-1,1681,1465,216,0,-637,124
1,1699,1518,181,1,161,123
1,1728,1590,138,-1,-20,51
0,1386,1613,-227,2,-468,136
-1,1665,1634,31,-6,-417,96
1,1867,1658,209,-5,-106,119
-1,1735,1582,153,-2,-238,66
-1,1517,1312,205,-1,-261,82
1,1653,1646,7,0,46,71
-1,1832,1929,-97,-1,-19,108
-1,1414,1618,-204,1,18,74
-1,1407,1858,-451,-7,-93,62
-1,1599,1720,-121,0,11,52
1,1664,1636,28,5,124,45
-1,1222,1275,-53,-7,-253,60
1,1416,1216,200,14,467,69
1,1566,1249,317,2,162,63
1,1356,1536,-180,-5,-171,69
-1,1673,1626,47,-4,-105,64
0,1512,1300,212,-1,140,133
-1,1661,1638,23,-1,-752,154
-1,1350,1452,-102,-4,-43,46
-1,1624,1408,216,-2,-54,66
-1,1404,1659,-255,3,50,62
-1,1653,1873,-220,0,28,98
-1,1363,1466,-103,-5,-166,72
1,1661,1648,13,10,164,49
1,1467,1500,-33,14,471,59
1,1809,1394,415,-1,3,71
1,1676,1791,-115,0,17,75
-1,1328,1506,-178,-8,-733,85
-1,1776,1666,110,0,-9,88
-1,1661,1574,87,0,54,84
1,1575,1615,-40,0,44,109
-1,1192,1422,-230,-5,-141,58
1,1426,1606,-180,0,74,71
1,1965,1430,535,0,22,51
1,1690,1640,50,4,434,93
-1,1342,1401,-59,-2,-406,138
-1,1463,1587,-124,3,167,46
-1,1699,1630,69,3,191,80
1,1860,1406,454,4,97,41
1,1342,1494,-152,0,47,85
1,1727,2108,-381,9,336,67
1,1679,1762,-83,0,24,73
1,1687,1643,44,1,-4,63
0,1696,1634,62,1,229,133
1,1429,1259,170,15,482,60
-1,1590,1443,147,-2,-14,48
1,1879,1647,232,0,-54,119
-1,1373,1520,-147,-12,-254,52
1,1427,1172,255,7,186,53
1,1392,1364,28,2,252,83
-1,1744,2087,-343,0,-150,128
-1,1694,1636,58,-1,-63,50
1,1280,1421,-141,0,391,101
1,1459,1574,-115,7,344,61
-1,1486,1512,-26,-2,-206,146
1,1679,1651,28,1,127,65
1,1516,1500,16,0,37,51
-1,1682,1648,34,8,248,44
1,1682,1648,34,2,223,109
1,1156,1432,-276,8,374,69
-1,1404,1862,-458,0,-404,123
-1,1738,2094,-356,1,-26,74
-1,1374,1446,-72,-3,-27,50
1,1524,1647,-123,-1,-37,69
-1,1699,1680,19,-8,-148,44
1,1557,1475,82,-4,-45,131
1,1559,1391,168,5,128,53
1,1643,1884,-241,-1,-105,125
-1,1700,2100,-400,-1,-84,62
-1,1689,1641,48,-2,-265,154
-1,1967,1826,141,3,73,54
1,1473,1368,105,1,106,58
1,1481,1520,-39,2,105,105
1,1527,1366,161,-2,156,65
1,1733,1689,44,-1,-32,55
1,2103,1698,405,-1,30,53
1,1691,1307,384,19,379,43
-1,1384,1565,-181,0,-106,72
-1,1696,2106,-410,-4,-105,52
1,1749,1692,57,1,4,69
-1,1695,1687,8,3,104,48
-1,1461,1463,-2,-4,-143,84
-1,1413,1222,191,-20,-664,58
-1,1561,1500,61,1,207,92
1,1495,1622,-127,4,334,85
1,1249,993,256,5,100,41
-1,1576,1423,153,1,114,56
-1,1693,1764,-71,0,7,44
1,2108,1694,414,1,139,89
1,1365,1261,104,15,377,49
-1,1864,1661,203,0,11,42
-1,1517,1612,-95,-2,-206,92
-1,1684,1758,-74,-2,-79,90
0,1466,1571,-105,0,365,131
-1,1455,1610,-155,-5,-53,74
-1,1295,1452,-157,0,9,52
0,1949,1675,274,1,76,306
-1,1568,1470,98,0,-137,54
1,2116,1824,292,-3,2,81
-1,1766,1675,91,0,-484,120
1,1677,1500,177,1,313,197
-1,1677,1516,161,-1,-21,58
1,2121,1820,301,0,-18,95
1,1554,1484,70,0,315,89
-1,1512,1487,25,5,141,52
1,1554,1253,301,4,457,101
-1,1632,1989,-357,-4,-134,68
-1,1373,1523,-150,0,-13,42
-1,1466,1539,-73,-2,-138,69
-1,1355,1379,-24,-1,-372,90
1,1558,1220,338,-9,-261,57
0,1563,1475,88,-4,-72,112
-1,1629,1995,-366,-12,-142,46
-1,1207,1575,-368,-1,-148,64
0,1688,1753,-65,0,-143,185
-1,1629,1671,-42,-3,-507,88
-1,1475,1108,367,-4,-770,72
1,1553,1478,75,3,106,57
-1,1530,1556,-26,1,-2,48
1,1562,1500,62,6,486,71
-1,1756,1936,-180,-1,-32,68
1,1560,1599,-39,0,110,87
1,1547,1452,95,25,449,47
1,1140,1500,-360,-5,-69,45
1,1309,1331,-22,1,264,75
0,1461,1572,-111,-1,-71,112
1,1595,1520,75,3,56,47
1,1478,1469,9,-1,87,123
1,1402,1651,-249,4,195,65
1,1653,1370,283,1,24,55
-1,1366,1656,-290,-10,-147,106
-1,1204,1632,-428,-14,-380,58
1,1569,1466,103,-6,411,103
-1,1390,1377,13,-3,-94,56
1,1555,1575,-20,0,153,69
1,1359,937,422,11,643,69
-1,1458,1579,-121,2,-13,74
1,1709,1652,57,0,-37,67
1,1652,1429,223,2,57,45
-1,1498,1625,-127,-2,-165,60
1,1513,1945,-432,-3,-150,75
-1,1769,1537,232,0,6,43
-1,1577,1455,122,2,-457,142
-1,1705,1682,23,0,9,68
1,1252,1133,119,5,75,53
0,1795,1942,-147,0,365,111
1,1422,1514,-92,-5,-82,47
-1,1475,1562,-87,-20,-245,42
-1,1555,1513,42,6,325,74
1,1693,1693,0,2,143,93
1,1674,1700,-26,-1,13,45
1,1450,1591,-141,0,-7,49
1,1456,1156,300,9,164,44
1,1937,1747,190,1,17,63
-1,1568,1642,-74,-17,-165,40
-1,1765,1965,-200,0,-41,88
1,1699,1682,17,0,-7,77
1,1499,1437,62,5,365,71
1,1202,1150,52,10,499,99
-1,1500,1525,-25,-10,-317,60
-1,1741,1943,-202,-4,-510,90
-1,1943,1741,202,2,-290,80
1,1629,1732,-103,-1,-28,65
-1,1344,1461,-117,-4,-238,72
-1,1759,1949,-190,-3,-98,60
-1,1685,1672,13,2,-200,98
0,1955,1753,202,0,-132,116
-1,1487,1661,-174,-8,-87,46
-1,1759,1949,-190,0,-192,106
1,1970,1759,211,0,51,77
-1,1542,1768,-226,2,31,46
-1,1955,1691,264,0,-261,86
-1,1421,1455,-34,-2,-659,124
1,1743,1602,141,2,364,77
-1,1758,1709,49,1,18,88
-1,1464,1678,-214,0,-101,88
-1,1773,1537,236,-3,-47,90
-1,1509,1515,-6,0,-64,117
1,1570,1567,3,5,128,65
-1,1754,1975,-221,-1,26,142
1,1936,1684,252,1,-51,83
-1,1592,1750,-158,-3,-24,52
-1,1555,1755,-200,2,85,52
1,1750,1592,158,-4,25,77
-1,1458,1940,-482,2,93,72
-1,1039,1361,-322,-3,-598,84
-1,1583,1757,-174,-3,-92,56
1,1578,1637,-59,1,211,69
-1,1337,1544,-207,-7,-335,64
0,1705,1770,-65,0,-399,133
1,1757,1583,174,-1,-13,51
-1,1575,1763,-188,-5,-77,58
1,1769,1567,202,0,-15,41
1,1683,1803,-120,-5,-19,127
-1,1567,1769,-202,0,-261,92
1,1535,1584,-49,-4,-27,45
-1,1980,1749,231,1,6,104
1,1768,1651,117,1,41,49
-1,1746,1707,39,-3,-74,52
1,1593,1142,451,4,410,77
1,1775,1869,-94,1,170,81
1,1587,1737,-150,-2,-21,49
-1,1856,1624,232,3,80,90
1,1644,1548,96,-2,-39,61
-1,1788,1733,55,-7,-148,56
-1,1719,1734,-15,0,-54,112
-1,1402,1404,-2,-1,-64,70
1,1717,1502,215,-9,26,49
-1,1775,2125,-350,-1,-42,56
-1,1198,1748,-550,-2,-17,52
-1,1212,1650,-438,-4,-99,50
-1,1482,1456,26,-3,-286,100
1,1767,1963,-196,0,141,125
1,1424,1474,-50,-3,-19,45
1,1511,1555,-44,0,3,63
1,1730,1635,95,0,-5,45
-1,1748,1198,550,2,90,48
-1,1454,1492,-38,-5,-600,104
1,1538,1442,96,3,336,109
-1,1744,1708,36,-2,-52,76
1,1583,1742,-159,-5,-221,75
-1,1338,1509,-171,1,59,62
1,1750,1197,553,9,187,55
-1,1652,1578,74,-2,-50,76
1,1726,1601,125,1,115,89
-1,1196,1751,-555,-7,-190,52
-1,1382,1460,-78,0,-48,66
-1,1775,1684,91,-9,-15,40
-1,1593,1733,-140,-4,-603,84
-1,1752,1194,558,0,22,50
-1,1225,1727,-502,-9,-316,62
1,1772,1512,260,1,21,45
1,1728,1223,505,-5,-213,63
0,1396,1444,-48,2,-64,119
1,1740,1585,155,4,265,83
-1,1602,1797,-195,-1,-124,102
-1,1526,1560,-34,6,123,52
-1,1540,1485,55,-7,-257,54
1,1945,1783,162,0,146,135
-1,1753,1571,182,1,-15,54
-1,1221,1730,-509,-4,-107,54
1,1453,1780,-327,-3,-7,43
1,1589,1737,-148,0,9,65
1,1731,1219,512,0,35,53
-1,1219,1731,-512,-9,-237,58
1,1668,1449,219,1,754,141
-1,1755,1593,162,-1,-112,64
1,1434,1546,-112,0,140,91
-1,1356,1281,75,2,182,76
1,1733,1218,515,3,29,45
-1,1295,1398,-103,0,-52,80
-1,1762,1698,64,0,1,76
-1,1711,1701,10,1,22,52
-1,1597,1667,-70,0,9,104
1,1514,1718,-204,-1,-52,89
1,1712,1216,496,-1,-9,49
1,1718,1514,204,0,-7,51
-1,1216,1712,-496,0,21,62
-1,1500,1532,-32,-8,-359,72
-1,1508,1724,-216,-15,-197,48
1,1453,1513,-60,-1,116,73
1,1731,1502,229,3,38,81
-1,1500,1981,-481,-5,-359,98
1,1474,1488,-14,-1,-25,41
1,1662,1984,-322,1,75,69
1,1777,1531,246,3,235,85
-1,1278,1406,-128,6,201,70
1,1609,1517,92,1,343,91
-1,1497,1957,-460,0,-265,80
-1,1714,1464,250,0,-101,62
-1,1749,1812,-63,-1,-12,48
0,2034,1926,108,2,-130,91
-1,1942,1729,213,-4,-235,62
-1,1712,1700,12,-10,-210,72
1,1558,1588,-30,-1,-23,45
-1,1701,1632,69,0,-7,52
1,1378,1525,-147,2,350,89
-1,1923,1959,-36,-2,-68,56
-1,1019,1404,-385,0,-521,112
1,1414,1255,159,1,41,111
-1,1487,1765,-278,-3,-223,82
-1,1500,1569,-69,-5,-169,60
1,1532,1449,83,2,318,83
1,1308,1365,-57,10,563,73
-1,1913,1973,-60,0,-260,120
1,1740,1531,209,0,24,97
-1,1331,1509,-178,8,234,92
1,1863,1577,286,1,35,43
-1,1502,1668,-166,-1,-106,84
-1,1569,1881,-312,1,-154,105
1,1394,1412,-18,0,86,68
-1,1479,1903,-424,0,-21,62
1,1618,1810,-192,0,56,57
1,1406,1354,52,2,122,63
1,1905,1477,428,3,264,83
-1,1009,1283,-274,1,-285,94
-1,1440,1541,-101,0,112,98
-1,1515,1687,-172,-2,-325,76
-1,1508,1985,-477,-3,-88,56
1,1475,1541,-66,0,-14,43
-1,1237,1421,-184,-5,-61,58
-1,1645,1653,-8,-4,-393,84
1,1558,1495,63,0,55,93
-1,1369,1673,-304,-2,-163,74
1,2024,1676,348,0,-2,53
1,1506,1504,2,1,48,57
-1,1296,1581,-285,0,-68,77
1,1491,1474,17,-2,2,55
1,2158,1907,251,0,131,73
-1,1539,1550,-11,-8,-555,94
1,1503,1462,41,1,38,61
1,2163,1902,261,5,145,55
1,1494,1523,-29,0,4,113
-1,1664,1571,93,1,31,50
-1,1452,1514,-62,2,46,54
-1,1518,1898,-380,-15,-558,68
-1,1561,1784,-223,4,156,62
1,1524,1441,83,2,71,53
1,2033,1680,353,2,30,53
1,1927,1528,399,-5,237,63
1,1564,1207,357,-3,-54,63
1,1677,1650,27,-1,-40,65
-1,1534,1900,-366,1,-122,84
1,1546,1486,60,1,589,135
1,1903,1531,372,-5,-492,91
1,1432,1338,94,1,72,63
-1,1775,1929,-154,-3,-82,86
1,1555,1506,49,-2,186,97
-1,1904,1906,-2,0,-72,76
1,1299,1260,39,11,335,55
-1,1640,1687,-47,0,-40,56
1,2045,1624,421,2,53,46
-1,1832,1885,-53,0,22,74
-1,1313,1623,-310,-3,-282,84
-1,1877,1918,-41,0,-781,152
-1,1937,1769,168,-4,-32,56
1,1855,1758,97,1,12,51
1,1928,1933,-5,0,-17,58
-1,1923,1941,-18,-1,-367,112
1,988,1195,-207,0,298,97
1,1715,1711,4,0,-15,73
-1,1752,1750,2,-1,-3,44
1,1515,1125,390,-8,-311,53
1,1952,1913,39,1,155,71
1,1680,1613,67,0,-12,83
1,1761,1740,21,-1,64,73
-1,1784,1919,-135,-2,-252,124
1,1904,1963,-59,-3,98,81
-1,1384,1399,-15,-1,-109,100
-1,1730,1772,-42,-1,-32,54
-1,1916,1949,-33,0,131,88
1,1895,1821,74,3,63,55
-1,1294,1567,-273,0,-7,70
-1,1526,1308,218,-4,-217,76
1,1747,1231,516,-1,-5,47
1,2050,1526,524,6,79,51
1,1960,1907,53,0,-11,47
1,1406,1518,-112,0,86,89
-1,1719,2063,-344,-5,-91,58
-1,1907,1960,-53,0,-2,55
-1,1500,1500,0,-2,20,88
1,1782,1720,62,1,-57,71
-1,1927,1778,149,1,47,96
-1,1797,1929,-132,-1,-61,74
1,1737,1228,509,0,6,65
-1,1553,1451,102,-1,-251,68
1,1969,1898,71,0,9,40
1,1685,1697,-12,0,64,95
-1,1047,1579,-532,-7,-507,70
-1,1890,1979,-89,0,-3,60
-1,1711,1791,-80,0,-137,82
-1,1263,1476,-213,-2,-60,50
1,1662,1305,357,-3,-81,53
1,1333,1516,-183,-1,18,47
1,1689,1683,6,0,437,63
1,2053,1732,321,2,47,42
-1,1987,1882,105,2,-360,104
1,1500,1289,211,8,250,55
-1,1895,1973,-78,1,-8,52
-1,1800,1702,98,0,-36,56
-1,1571,1729,-158,-3,-14,40
-1,1944,1784,160,0,-28,56
1,1982,1887,95,-2,1,89
1,1604,1508,96,1,3,42
-1,1566,1501,65,-8,-179,46
-1,1716,1786,-70,0,45,54
1,1880,1990,-110,0,9,75
1,1699,1635,64,3,275,79
1,1672,1699,-27,1,89,65
1,1595,1556,39,-1,-29,71
-1,1707,1675,32,-3,-19,89
1,1736,1564,172,2,124,65
-1,1975,1893,82,1,-179,92
1,1795,1707,88,0,-1,55
1,1799,1738,61,0,61,79
-1,1481,1480,1,0,-52,86
-1,1906,1961,-55,1,-12,56
1,1961,1906,55,-3,71,93
-1,1872,1498,374,1,-8,56
-1,1500,1576,-76,-2,-154,90
1,1570,1411,159,-1,29,83
1,1421,1405,16,0,-58,67
-1,1448,2072,-624,-3,-17,42
-1,1691,1811,-120,0,-11,50
-1,1500,1342,158,-3,-92,64
1,1661,1612,49,0,6,65
1,1687,1695,-8,0,116,131
1,1830,1897,-67,-1,45,65
-1,1558,1743,-185,0,-820,180
1,1626,1716,-90,1,1,65
-1,1688,1808,-120,8,467,112
1,1857,1684,173,0,246,85
1,1857,1519,338,5,366,65
-1,1432,1729,-297,-6,-999,156
1,1777,1598,179,-1,68,71
-1,1816,1681,135,1,0,56
-1,1103,1381,-278,-11,-192,42
1,1586,1413,173,3,159,59
1,1872,1346,526,-7,-99,47
-1,1695,1801,-106,0,186,96
1,1393,1330,63,2,0,59
-1,1398,1425,-27,5,51,77
1,1512,1450,62,1,2,53
-1,1874,1345,529,2,-54,90
1,1583,1726,-143,0,40,62
-1,1629,1672,-43,-3,-17,82
-1,1610,1661,-51,-1,-47,64
-1,1809,1688,121,-1,-57,62
1,1541,1236,305,1,327,107
1,1869,1416,453,-2,22,51
-1,1735,1603,132,0,10,50
1,1428,1495,-67,4,112,55
-1,1702,1794,-92,1,48,68
1,1640,1732,-92,2,179,57
-1,1725,1737,-12,-4,-292,76
1,1907,1637,270,0,6,67
1,1433,1429,4,0,195,129
-1,1296,1326,-30,-1,15,46
1,1538,1546,-8,1,43,47
-1,1935,2104,-169,-3,-116,54
-1,1416,1547,-131,-1,-232,94
1,1650,1634,16,-3,64,67
1,1568,1291,277,18,494,50
-1,1563,1633,-70,-6,-318,64
-1,1482,1548,-66,-1,-38,52
1,1312,1229,83,6,971,115
-1,1815,2064,-249,-5,5,112
-1,1666,1841,-175,0,-132,70
-1,1484,1536,-52,-3,-9,80
1,1480,1532,-52,-1,-5,77
-1,1286,1468,-182,-4,-25,54
-1,0,1200,-1200,-7,-248,74
1,1557,1437,120,-5,61,63
1,1776,1664,112,-1,71,66
1,1465,1298,167,1,629,125
1,1364,1391,-27,3,107,69
1,1698,1642,56,0,5,63
1,1405,1565,-160,-2,-81,57
1,1307,1389,-82,13,254,49
1,1807,1471,336,4,38,49
1,1579,1159,420,8,215,45
-1,1555,1623,-68,1,4,46
1,2070,1810,260,0,19,53
-1,1280,1221,59,-2,-50,48
-1,1220,1321,-101,-3,-163,84
-1,1633,1707,-74,0,-21,78
1,1531,1387,144,0,73,65
-1,1656,1783,-127,0,5,96
1,1805,1681,124,0,8,51
-1,1345,1474,-129,-8,-226,54
-1,1356,1676,-320,-11,-622,102
-1,1733,1721,12,-1,129,96
-1,1379,1539,-160,-2,-89,74
-1,1669,1814,-145,-4,-82,52
1,1471,1296,175,-4,-88,75
-1,1312,1385,-73,1,-2,68
1,1408,1565,-157,0,28,75
1,1482,1388,94,2,57,93
0,1545,1372,173,-2,-113,140
-1,1267,1347,-80,13,522,54
1,1716,1624,92,-1,80,83
1,1229,1160,69,3,154,51
1,1383,1338,45,7,261,51
-1,1455,1536,-81,-6,-82,42
-1,1377,1821,-444,-4,-142,68
-1,1502,1615,-113,1,-34,76
1,1790,1649,141,0,2,89
-1,1478,1654,-176,-3,-277,92
1,1500,1008,492,12,332,41
1,1443,1543,-100,0,-29,91
1,1378,1540,-162,-1,388,103
-1,1397,1310,87,0,-16,48
-1,1500,1381,119,0,-316,84
-1,1491,1616,-125,-1,-231,94
1,1523,1396,127,-2,-114,99
1,1823,1724,99,0,47,100
1,1353,1500,-147,10,547,73
-1,1416,1492,-76,-3,-135,54
1,1328,1391,-63,3,259,105
-1,1765,1642,123,-6,-48,40
-1,1464,1632,-168,-6,-867,144
1,1881,1827,54,0,258,139
-1,1483,1832,-349,-2,-20,48
-1,1466,1764,-298,0,-27,58
1,1750,1585,165,-1,237,143
1,1496,1524,-28,-2,75,125
1,1644,1592,52,-1,-123,73
1,1329,1316,13,0,130,99
1,1835,1480,355,10,355,65
1,1510,1325,185,0,87,63
-1,1462,1318,144,-4,-139,56
1,1654,1583,71,-1,-352,89
1,1612,1756,-144,1,134,89
-1,1677,1464,213,0,-90,70
-1,1484,1261,223,-3,-555,170
-1,1351,1500,-149,0,48,76
1,1574,1663,-89,0,123,139
-1,1494,1462,32,-3,-140,92
-1,1597,1500,97,-1,-38,76
1,1515,1669,-154,2,64,61
1,1345,1045,300,-2,45,67
-1,1652,1716,-64,-2,-69,54
1,1948,1755,193,1,-8,43
1,1478,1435,43,0,44,69
-1,1768,1806,-38,-3,-28,50
-1,1384,1380,4,-4,-207,60
1,1675,1642,33,1,15,93
1,1725,1665,60,2,106,67
1,1364,1318,46,0,-17,43
-1,1710,1649,61,4,87,54
1,1730,1588,142,0,32,47
1,1400,1468,-68,1,242,67
-1,1891,1817,74,0,-18,100
-1,1413,1570,-157,-1,-109,64
-1,1425,1378,47,-3,-184,134
1,1885,1671,214,-2,-28,59
-1,1071,1500,-429,-13,-197,42
-1,1349,1039,310,0,21,56
1,1340,1396,-56,1,113,65
1,1843,1661,182,4,746,101
1,1455,1486,-31,-4,-108,53
1,1657,1632,25,3,372,76
1,1544,1067,477,6,234,55
1,1475,1295,180,-1,-3,113
-1,1265,1653,-388,-4,-57,52
-1,1444,1544,-100,-2,-103,62
-1,1666,1799,-133,0,8,56
-1,1537,1484,53,6,251,68
1,1815,1576,239,4,135,55
1,1545,1446,99,10,293,57
-1,1573,1467,106,-3,-179,56
-1,1569,1621,-52,-1,7,62
1,1751,1659,92,0,24,47
1,1502,1302,200,-2,-38,59
-1,1337,1689,-352,6,130,88
1,1434,1378,56,0,260,115
1,1379,1629,-250,1,122,157
1,1475,1475,0,4,88,53
-1,1584,1655,-71,0,2,64
1,1580,1364,216,-1,-9,45
1,1438,1553,-115,-1,485,93
1,1522,1585,-63,6,416,95
-1,1734,1762,-28,-1,-204,96
-1,1330,1635,-305,-1,-157,65
1,1435,1255,180,6,520,91
-1,1508,1664,-156,-1,-582,108
-1,1289,1412,-123,-1,-73,68
1,1702,1535,167,4,279,89
1,1484,1262,222,1,179,83
1,1798,1724,74,1,206,127
-1,1669,1748,-79,-9,-49,96
1,1477,1533,-56,2,175,65
-1,1521,1359,162,-8,-76,41
-1,1586,1723,-137,2,57,58
-1,1287,1582,-295,-3,-26,42
1,1442,1552,-110,0,-6,51
-1,1406,1177,229,1,-45,63
1,1826,1670,156,1,57,77
1,1373,1399,-26,1,16,54
1,1448,1391,57,1,44,54
1,1542,1382,160,0,-8,59
-1,1598,1283,315,-10,-58,98
-1,1397,1875,-478,-5,-275,82
-1,1200,1388,-188,1,-231,104
1,1610,1704,-94,1,237,131
1,1862,1658,204,1,637,155
1,1375,1548,-173,0,24,57
1,1283,1500,-217,1,53,55
0,0,1200,-1200,-15,119,107
1,945,0,945,4,737,119
1,1638,1559,79,-4,-69,83
1,1527,1381,146,17,220,43
-1,1500,1325,175,-4,-406,78
-1,1697,2008,-311,-1,-3,50
1,1534,1371,163,6,822,85
-1,1878,1877,1,-1,-267,114
-1,1653,1876,-223,0,-37,116
0,1873,1454,419,-13,-674,72
1,1453,1445,8,4,69,51
-1,1346,1399,-53,-3,-180,72
-1,1555,1657,-102,-1,-50,90
1,1540,1500,40,0,117,73
-1,1518,1647,-129,0,-20,72
0,1484,1598,-114,0,-19,115
-1,1185,1409,-224,2,-119,72
1,1641,1539,102,1,-29,119
-1,1391,1405,-14,-7,-461,76
1,1469,1566,-97,0,373,123
-1,1500,2012,-512,0,39,170
1,1414,1179,235,1,216,79
-1,1550,1484,66,1,-1,78
1,1930,1469,461,1,110,73
-1,1311,1368,-57,6,313,76
1,1649,1563,86,0,-46,79
-1,1080,1384,-304,2,93,50
1,1657,1660,-3,2,218,109
-1,1213,1416,-203,-3,-100,64
1,1499,1549,-50,2,28,49
-1,1656,1539,117,12,120,40
-1,1375,1578,-203,-3,-182,68
1,1889,1637,252,0,-4,43
1,1536,1513,23,-3,158,58
1,1501,1547,-46,1,107,67
-1,1500,1423,77,1,54,54
-1,1554,1641,-87,-8,-232,58
-1,1541,1464,77,-5,-359,72
-1,1703,1762,-59,0,-247,128
-1,1173,1419,-246,-3,-241,80
-1,1559,1420,139,0,-11,46
-1,1527,1522,5,0,-12,58
-1,1500,1427,73,-2,-381,94
-1,1649,1545,104,-1,-364,82
-1,1581,1803,-222,-4,-131,52
-1,1533,1515,18,0,29,66
1,1427,1388,39,2,72,73
-1,1436,1548,-112,2,-90,74
1,1596,1841,-245,0,48,68
-1,1493,1545,-52,1,13,42
-1,1455,1573,-118,2,65,84
1,1528,1522,6,6,189,51
1,1492,1210,282,2,16,64
-1,1423,1168,255,2,35,52
-1,1635,1847,-212,-2,-23,94
1,1576,1770,-194,0,408,95
1,1695,1206,489,8,149,49
1,1692,1444,248,0,1,49
1,1472,1285,187,2,525,87
1,1523,1527,-4,0,-4,47
-1,1477,1527,-50,-3,-118,54
-1,1429,1636,-207,2,-253,146
1,1898,1630,268,13,311,43
-1,1704,1772,-68,-1,-55,60
-1,1201,1436,-235,-5,-331,104
-1,1515,1534,-19,-1,-62,40
-1,1190,1405,-215,1,29,54
1,1626,1656,-30,4,137,57
-1,1626,1932,-306,-3,-119,56
1,1562,1529,33,4,68,63
1,1809,1500,309,-2,-77,75
-1,1296,1498,-202,-2,-5,68
-1,1597,1593,4,0,-39,108
-1,1532,1494,38,-1,-19,58
-1,1218,1478,-260,-9,-351,64
-1,1644,1669,-25,-5,-277,80
-1,1507,1520,-13,0,10,48
1,1781,1695,86,0,15,81
1,1410,1088,322,-1,-13,41
-1,1441,1189,252,0,-49,178
1,1635,1659,-24,5,108,49
-1,1383,1697,-314,0,2,60
-1,1817,1739,78,-3,-457,166
-1,1682,1983,-301,-3,-180,62
1,1462,1290,172,-9,47,89
-1,1899,1881,18,-8,-24,56
1,1599,1576,23,0,87,67
1,1418,1048,370,-2,-52,50
1,1500,1500,0,13,418,48
1,1647,1647,0,4,176,69
1,1556,1429,127,1,400,99
-1,1678,1655,23,0,-160,70
-1,1893,1872,21,0,-216,120
-1,1528,1708,-180,0,67,80
1,1590,1580,10,0,9,143
-1,1605,1500,105,-6,-420,122
1,1714,1521,193,9,386,63
-1,1648,2018,-370,0,1,118
-1,1636,1658,-22,0,-90,64
-1,1022,1437,-415,-2,-474,76
-1,1515,1719,-204,-1,-149,84
1,1283,1468,-185,1,424,151
-1,1482,1457,25,-2,-37,50
-1,1549,1801,-252,-8,-184,56
1,1724,1509,215,-5,-369,93
-1,1324,1422,-98,-5,-264,66
-1,1129,1404,-275,4,66,40
1,1504,1729,-225,1,54,95
-1,1586,2079,-493,-2,-58,46
1,1566,1610,-44,0,162,70
-1,1446,1538,-92,0,35,58
-1,1625,1544,81,1,-239,166
-1,1573,1548,25,-2,-262,94
1,1712,1523,189,-3,-119,65
1,1718,1500,218,-3,-24,97
1,1523,1712,-189,-1,75,67
1,1831,1284,547,-4,-78,49
1,1696,1541,155,4,-130,75
1,1831,1500,331,-2,90,83
-1,1534,1702,-168,3,-613,92
-1,1448,1558,-110,-9,-568,82
1,1366,1427,-61,2,146,77
-1,1836,1651,185,0,-249,126
1,1708,1527,181,0,-171,103
-1,1421,1563,-142,0,13,52
-1,1294,1458,-164,-5,-73,58
-1,1224,1685,-461,-9,-580,72
1,1440,1505,-65,0,255,123
1,1714,1521,193,0,-60,89
1,1440,1501,-61,0,-16,73
-1,1597,1578,19,2,147,50
1,1584,1628,-44,-1,20,107
-1,1515,1720,-205,0,-285,82
1,1634,1393,241,5,225,69
1,1681,1645,36,-1,-39,49
1,1304,1406,-102,1,125,81
1,1509,1509,0,3,16,51
1,1740,1206,534,4,366,76
-1,1831,1405,426,-1,-72,74
-1,1639,1568,71,2,120,88
1,1520,1497,23,8,299,95
-1,1453,1388,65,-1,-176,108
-1,1635,1703,-68,2,67,105
1,1581,1281,300,0,309,141
1,1486,1530,-44,-9,-4,89
-1,1629,1518,111,2,123,72
1,1530,1486,44,5,176,69
1,1390,1266,124,9,362,53
-1,1625,2031,-406,-2,102,112
1,1401,1440,-39,6,309,87
-1,1475,1725,-250,0,263,122
1,1384,1667,-283,0,12,55
-1,1687,1600,87,0,-7,94
-1,1376,1547,-171,-5,-580,78
-1,1411,1443,-32,-4,-126,52
-1,1675,1583,92,0,-64,130
1,1721,1625,96,-2,-12,71
1,1547,1653,-106,-2,-127,61
-1,1257,1411,-154,-4,-135,50
-1,1634,1673,-39,-3,-152,66
1,1734,1466,268,0,339,101
1,1465,1401,64,-5,171,87
-1,1561,1462,99,-3,-120,54
1,1462,1561,-99,1,22,41
-1,1429,1249,180,-3,-124,84
1,1500,1519,-19,6,51,43
-1,1414,1566,-152,0,4,80
-1,1547,1477,70,0,-80,68
-1,1423,1699,-276,-5,-411,104
-1,1364,1460,-96,0,-252,170
-1,1559,1943,-384,0,1,44
-1,1345,1614,-269,-1,-137,70
1,1491,1534,-43,-8,-81,69
1,1898,1625,273,-1,260,97
1,1522,1504,18,7,577,91
1,1573,1407,166,0,29,55
1,1504,1522,-18,3,45,47
1,1533,1711,-178,-1,59,61
1,1732,1584,148,-1,-7,55
-1,1511,1517,-6,1,67,70
1,1950,1557,393,1,231,121
1,1778,1573,205,0,32,51
-1,1444,1489,-45,0,-158,108
1,1583,1578,5,2,131,87
1,1528,1500,28,-1,-112,67
1,1500,1528,-28,-9,22,75
1,1442,1518,-76,-1,-138,103
1,1795,1401,394,-2,125,73
1,1621,1906,-285,-3,-138,59
-1,1516,1490,26,0,293,106
1,1502,1503,-1,5,13,41
-1,1110,1164,-54,-1,29,56
-1,1567,1594,-27,0,-1,52
1,1492,1512,-20,-13,-491,91
-1,1562,1823,-261,1,56,78
1,1550,1423,127,-2,144,83
1,1665,1500,165,15,422,51
-1,1813,1500,313,0,-50,134
1,1501,1504,-3,-1,-18,51
-1,1557,1427,130,-5,-239,72
-1,1554,1957,-403,-6,-79,44
1,1352,1439,-87,-3,346,119
1,1432,1484,-52,0,97,79
0,1511,1601,-90,1,73,100
1,1522,1482,40,-3,-61,53
1,1407,1648,-241,-2,21,43
0,2022,1749,273,-1,-55,131
1,1666,1500,166,6,186,63
1,1537,1268,269,5,249,59
1,1635,1643,-8,-1,3,73
1,1964,1552,412,4,149,45
1,1472,1531,-59,-13,-68,67
-1,1536,1645,-109,-11,-506,95
1,1610,1684,-74,0,378,131
1,1531,1472,59,2,155,73
-1,1434,1416,18,0,-92,96
-1,1468,1993,-525,-5,-119,84
-1,1550,1970,-420,-5,-36,44
1,1881,1762,119,0,17,75
1,1463,1540,-77,-3,-80,63
-1,1527,1476,51,-3,-28,40
-1,1567,1513,54,0,-31,62
1,1783,1507,276,2,177,101
1,1548,1363,185,2,167,51
1,1847,989,858,-2,-35,55
-1,1459,1575,-116,-5,-182,63
1,1341,1359,-18,-3,-116,47
1,1679,1500,179,4,107,53
1,1500,1215,285,10,510,61
-1,1672,1565,107,-3,-215,80
1,1575,1427,148,0,-77,69
1,1805,1754,51,5,76,43
1,1614,1639,-25,0,267,133
1,1946,1432,514,6,378,93
1,1900,1659,241,0,54,57
1,1554,1327,227,5,197,63
-1,1781,1994,-213,-1,-67,78
1,1851,1847,4,0,40,109
-1,1390,1525,-135,4,118,58
-1,1684,1813,-129,0,19,94
-1,1458,1579,-121,3,-13,68
1,1367,1394,-27,4,248,99
-1,1455,1467,-12,-4,0,44
1,1820,1670,150,1,-1,93
1,1752,2014,-262,0,33,69
1,1536,1680,-144,-2,-69,49
-1,1898,1630,268,0,-18,70
1,1663,1353,310,-2,169,81
1,1444,1300,144,13,309,43
-1,1663,1827,-164,-2,-640,106
1,1900,1650,250,0,-25,53
1,1948,1693,255,0,40,57
-1,1374,1834,-460,-4,-353,78
1,1375,1369,6,0,-13,53
-1,1576,1539,37,0,-9,60
1,1676,1657,19,0,16,53
1,1953,1689,264,3,147,61
1,1597,1640,-43,0,-33,61
-1,1414,1593,-179,-3,-123,60
1,1826,1421,405,2,110,81
1,1582,1353,229,0,-16,47
-1,1372,1835,-463,0,-86,70
1,1699,1551,148,-1,62,59
1,1645,1685,-40,0,99,81
0,1687,1735,-48,0,213,130
-1,1573,1704,-131,-3,-372,90
1,1307,1422,-115,4,309,95
1,1833,1664,169,-2,-42,65
1,1837,1370,467,2,34,45
1,1701,1738,-37,-2,-142,91
-1,1387,1438,-51,-2,-16,42
1,1585,1701,-116,1,15,57
-1,1770,2129,-359,-6,-134,48
1,1599,1550,49,1,621,129
1,1545,1474,71,10,1149,89
1,1756,1397,359,-3,-13,43
1,2001,1559,442,-1,282,151
1,1628,1610,18,0,-3,115
-1,1454,1377,77,2,64,68
1,1361,1369,-8,-4,-45,59
-1,1382,1483,-101,2,-41,78
-1,1349,1587,-238,0,-170,82
1,1777,1623,154,0,-67,71
-1,1509,1555,-46,2,-16,92
1,1855,1840,15,-3,97,69
1,1515,1540,-25,-2,-103,61
1,1367,1337,30,0,-6,53
1,1289,1377,-88,7,367,61
-1,1396,1657,-261,-1,-62,60
-1,1662,1519,143,0,-42,98
-1,1391,1454,-63,-1,-159,108
1,1889,1528,361,4,149,55
1,1961,1685,276,0,-6,99
-1,1670,1660,10,0,-12,72
1,1958,1500,458,-6,-147,69
-1,1765,2142,-377,-8,-116,43
1,1363,1347,16,0,154,73
-1,1500,1829,-329,0,18,66
1,1565,1491,74,-1,109,145
-1,1580,1463,117,-1,-6,59
1,1503,1500,3,-1,-27,62
1,1487,1561,-74,-4,6,73
-1,1470,1662,-192,-3,-237,114
1,1777,1410,367,-2,-15,43
-1,1435,1617,-182,8,130,52
1,2148,1762,386,1,11,45
1,1672,1658,14,4,117,89
-1,1897,1934,-37,1,6,82
1,1349,1518,-169,0,121,119
-1,1599,1591,8,-1,-157,86
1,1628,1670,-42,0,-2,43
-1,1451,1382,69,-4,-129,54
-1,1376,1394,-18,-10,-309,42
1,1478,1717,-239,1,57,85
1,1476,1479,-3,0,27,65
-1,1135,1380,-245,4,82,46
1,1491,1373,118,0,-68,55
1,1499,1509,-10,3,97,63
-1,1760,2153,-393,-5,-144,55
-1,1405,1592,-187,2,-20,112
1,1965,1681,284,0,39,119
-1,1667,1448,219,-1,51,44
1,1504,1739,-235,-6,-90,49
1,1647,1682,-35,0,137,107
1,1624,1525,99,1,113,77
1,1706,1471,235,-9,-634,99
-1,1396,1438,-42,1,-60,62
-1,1399,1832,-433,-2,-217,66
-1,1513,1352,161,-1,-78,100
-1,1463,1609,-146,0,-120,90
1,1834,1397,437,2,713,115
-1,1136,1476,-340,1,25,92
-1,1602,1588,14,-1,-21,76
-1,1664,1500,164,-1,-117,98
1,1780,1711,69,4,170,59
-1,1395,1836,-441,-1,-229,82
-1,1370,1536,-166,-9,-352,79
1,1484,1327,157,1,66,73
-1,1617,1682,-65,-1,-53,60
1,1405,1390,15,7,169,43
-1,1484,1700,-216,-4,-564,110
-1,1376,1451,-75,-5,-365,84
1,1974,1818,156,0,-38,95
-1,1646,1679,-33,-2,-86,99
-1,1326,1431,-105,3,34,80
1,2051,1988,63,2,83,61
-1,1812,1982,-170,0,-163,110
-1,1701,1966,-265,0,-31,65
-1,1218,1507,-289,0,-29,48
1,1379,1381,-2,-3,-65,51
1,1588,1770,-182,2,42,55
-1,1708,1691,17,-1,-70,76
1,1370,1416,-46,4,497,77
1,1661,1648,13,1,135,95
1,1801,1994,-193,0,-13,67
1,1633,1709,-76,0,119,93
-1,1451,1465,-14,-1,-32,112
-1,2139,2125,14,0,-47,72
-1,1371,1762,-391,-2,-12,56
1,1743,1525,218,-1,-73,77
1,1989,1725,264,1,8,63
-1,1390,1513,-123,-3,-61,48
-1,1753,1606,147,-3,-149,103
1,1379,1608,-229,1,51,53
1,1549,1604,-55,3,136,69
1,2137,2123,14,0,79,97
-1,1993,1805,188,0,-24,59
1,1786,1979,-193,1,74,69
1,1601,1228,373,-1,-15,51
-1,1737,1753,-16,0,-50,106
-1,1562,1554,8,-1,-245,125
1,1644,1830,-186,0,-4,41
-1,1822,2149,-327,-1,-633,130
1,1591,1218,373,-1,-2,55
-1,1641,1444,197,-4,-767,198
-1,1383,1772,-389,2,61,68
1,1545,1383,162,3,384,103
1,1639,1514,125,5,14,41
-1,1963,1932,31,0,-34,58
-1,1506,1647,-141,-10,-310,56
1,1468,1581,-113,2,163,73
1,1654,1499,155,0,70,57
0,1819,2152,-333,0,-49,128
0,1721,1639,82,0,-11,124
1,1622,1637,-15,0,161,111
-1,1312,1510,-198,-7,-330,76
-1,1892,1546,346,4,149,74
1,1584,1562,22,-1,27,177
-1,1661,1748,-87,2,130,58
-1,1814,1951,-137,-4,-66,76
1,1389,1381,8,10,374,61
1,1500,1506,-6,2,277,83
-1,1828,2143,-315,0,-31,74
-1,1697,1957,-260,-7,-15,40
-1,1551,1832,-281,3,31,46
-1,1215,1593,-378,-8,-163,52
1,1556,1482,74,0,-40,91
-1,1613,1579,34,-1,-35,48
1,1547,1566,-19,-4,-32,67
-1,1843,1445,398,2,-163,94
1,1958,1947,11,2,132,71
-1,1621,1483,138,-3,-7,40
1,2146,1824,322,0,-55,87
-1,1248,1401,-153,-7,-221,76
1,2073,1625,448,2,85,69
1,1369,1400,-31,0,165,95
-1,1465,1785,-320,3,68,74
-1,1559,1553,6,-3,-54,50
-1,1342,1775,-433,-1,-89,58
-1,1641,1719,-78,-1,-604,158
-1,1464,1516,-52,1,59,100
1,1482,1630,-148,4,-69,93
1,1794,1565,229,-1,16,81
-1,1623,2075,-452,0,-73,82
1,2150,1462,688,0,17,59
-1,1604,1627,-23,-3,-121,92
-1,1637,1434,203,0,-72,74
1,1500,1500,0,2,146,71
-1,1441,1499,-58,-9,-203,60
1,1806,1594,212,4,157,57
-1,1328,1440,-112,-5,-182,60
1,1960,1934,26,2,125,77
-1,2092,2151,-59,-2,-328,104
-1,1388,1382,6,-6,46,58
1,1479,1463,16,-3,2,63
-1,1321,1500,-179,1,-4,64
1,1398,1408,-10,1,53,71
1,1526,1304,222,2,107,69
1,1707,1662,45,1,93,79
-1,1551,1577,-26,2,-61,56
-1,1661,1967,-306,0,22,76
-1,1819,1532,287,1,-129,73
1,1744,1683,61,1,2,65
1,1491,1262,229,10,370,63
-1,1509,1377,132,2,121,80
1,1533,1422,111,19,798,63
1,1971,1658,313,10,780,83
-1,1508,1442,66,1,77,72
-1,1214,1547,-333,-5,-20,40
1,2082,1594,488,6,94,43
-1,1638,1639,-1,-2,-124,66
-1,1654,1975,-321,-2,-142,72
1,1406,1419,-13,9,70,47
1,2084,1762,322,0,93,69
-1,1613,1551,62,0,-135,86
1,1672,1621,51,-5,23,87
-1,1338,1452,-114,0,-155,122
-1,1467,1673,-206,3,-215,138
-1,1978,1651,327,1,85,73
1,1367,1440,-73,1,291,93
1,2108,1759,349,1,16,43
-1,1331,1541,-210,1,-177,75
-1,1269,1592,-323,1,97,92
1,2112,1756,356,-1,10,103
1,1594,1668,-74,5,103,45
-1,1704,1528,176,0,7,50
-1,1611,1681,-70,-1,-153,60
-1,1417,1753,-336,0,-189,76
1,1418,1392,26,0,164,87
1,1592,1482,110,3,483,119
1,1499,1577,-78,4,254,80
-1,1561,1406,155,1,-331,88
1,1735,1753,-18,-2,38,69
1,1512,1536,-24,-5,-253,111
1,1685,1413,272,12,278,57
1,1232,1209,23,-5,611,115
-1,1608,1526,82,0,-104,84
-1,1747,1741,6,-2,-71,78
-1,1498,1805,-307,-1,-64,58
1,2115,1980,135,0,93,127
-1,1505,1659,-154,0,8,44
-1,1503,1753,-250,-3,-89,54
1,1346,1126,220,0,195,141
-1,1409,1690,-281,0,-217,122
1,1426,1383,43,3,161,57
-1,1570,1774,-204,0,-85,126
-1,1735,1492,243,-5,-21,40
1,2125,1757,368,0,58,69
1,1351,1785,-434,5,737,161
1,1457,1469,-12,-1,199,75
1,1500,1492,8,-6,-22,63
-1,1828,1755,73,-2,-174,90
1,1679,1461,218,-3,39,49
-1,1656,1671,-15,0,19,50
1,2128,1973,155,0,18,49
1,1862,1567,295,1,236,81
-1,1678,1685,-7,-5,-74,52
-1,1596,1582,14,2,9,46
1,1366,1317,49,-8,50,63
-1,1498,1666,-168,-4,-246,94
0,1627,1773,-146,2,49,180
-1,1519,1500,19,4,91,136
1,1549,1487,62,0,0,47
-1,1469,1550,-81,1,-48,142
-1,1201,1410,-209,-4,-40,64
-1,1978,2137,-159,-1,-91,86
0,1372,1436,-64,0,14,88
1,1572,1393,179,1,-19,47
-1,1486,1642,-156,-3,-139,80
-1,1378,1304,74,1,-200,96
1,1583,1396,187,2,187,73
1,2097,1655,442,0,-3,51
-1,1503,1474,29,-1,-404,76
-1,1453,1408,45,-2,-17,52
-1,1494,1500,-6,-1,-86,72
1,1649,1480,169,-9,163,103
-1,1589,1531,58,2,100,74
1,1663,1468,195,0,56,55
-1,1768,2145,-377,0,0,52
1,1513,1387,126,3,192,64
1,1970,1766,204,3,137,71
1,1416,1193,223,1,13,93
1,1455,1463,-8,0,543,111
-1,1466,1779,-313,-1,-112,72
-1,1589,1300,289,-4,-185,72
-1,1760,1976,-216,0,-17,72
-1,1627,1774,-147,-1,-379,119
-1,1473,1198,275,-2,-229,118
-1,2056,1783,273,1,-379,144
1,1725,1594,131,-1,-21,57
1,1690,1492,198,1,17,43
1,1982,1755,227,-1,21,115
-1,1930,1940,-10,1,5,52
-1,1536,1319,217,0,-5,48
1,1330,1220,110,5,218,67
1,1420,1441,-21,-2,15,74
1,1466,1544,-78,-1,-84,83
1,1737,1519,218,0,52,93
1,1993,1745,248,-3,-49,59
-1,1462,1669,-207,0,-298,94
-1,1500,1624,-124,-3,-885,136
1,1355,1380,-25,-2,46,57
-1,1307,1351,-44,-1,-178,86
-1,1668,1672,-4,-3,-11,54
0,1740,1998,-258,3,119,154
1,1452,1390,62,7,305,53
-1,1431,1635,-204,-7,-85,50
1,1467,1553,-86,0,30,49
1,1866,1350,516,-3,-156,79
1,1508,1271,237,16,339,45
-1,1131,1377,-246,0,46,98
1,1559,1274,285,0,-14,73
-1,1746,1371,375,-7,-824,208
1,1630,1377,253,12,401,51
-1,1501,1742,-241,-1,-133,70
1,1618,1369,249,1,241,97
1,2000,1738,262,2,33,51
-1,1560,1500,60,0,-239,96
-1,1581,1398,183,-5,-98,50
1,1562,1580,-18,3,399,75
1,2120,1620,500,-2,-64,95
1,1733,2005,-272,5,59,45
1,1783,1621,162,-2,-16,44
-1,1998,1982,16,0,117,80
1,1788,1500,288,1,99,67
1,1624,1776,-152,5,178,63
-1,1419,1565,-146,0,33,92
-1,1530,1712,-182,0,-115,86
1,1753,1797,-44,-2,86,63
-1,1728,1695,33,0,-191,92
-1,1540,1351,189,-8,-45,44
1,1601,1789,-188,5,300,117
-1,1674,1786,-112,3,86,64
1,1571,1518,53,0,4,45
-1,1699,1658,41,-3,-46,56
1,1520,1266,254,4,314,57
-1,1987,1855,132,1,56,104
-1,1595,1618,-23,0,-74,73
1,1364,1125,239,2,687,77
0,1432,1381,51,-1,-72,128
-1,1692,1663,29,-1,-98,78
-1,1509,1581,-72,3,195,84
-1,1330,1564,-234,-5,-418,74
1,1531,1262,269,12,691,59
-1,1658,1605,53,-2,-29,60
-1,1718,1718,0,-3,-78,92
-1,1956,1822,134,-2,-118,64
-1,1445,1317,128,2,-175,104
1,1589,1500,89,0,15,79
-1,1248,1821,-573,-1,-80,82
-1,1511,1726,-215,0,-2,104
1,1707,1715,-8,0,75,113
1,1868,1503,365,0,28,59
-1,1674,1781,-107,-6,-182,66
-1,1584,1570,14,-1,-26,54
1,1540,1257,283,10,525,55
-1,1774,1486,288,0,-57,76
1,1569,1325,244,5,155,51
-1,1524,1702,-178,-1,-54,74
-1,1500,1716,-216,-7,-255,58
-1,1492,1598,-106,0,-4,44
1,1328,1119,209,13,268,45
-1,1680,1904,-224,0,-55,73
1,1731,1505,226,1,371,75
1,1980,1862,118,0,10,50
-1,1605,1484,121,0,-163,124
-1,1870,1972,-102,0,-308,102
1,1868,1747,121,0,51,67
-1,1662,1571,91,-1,-103,100
-1,1518,1544,-26,-1,-59,52
-1,1729,1707,22,1,50,80
1,1870,1572,298,0,42,55
0,1756,1908,-152,0,362,126
1,1495,1434,61,0,211,63
-1,1499,1591,-92,0,-72,62
1,1523,1736,-213,-1,145,79
-1,1672,1506,166,0,-159,96
-1,1578,1315,263,3,269,102
-1,1904,1761,143,0,-91,84
1,1599,1491,108,0,64,79
-1,1561,1601,-40,3,-25,66
1,1874,1537,337,6,259,55
1,1875,1739,136,3,402,87
1,1352,1321,31,0,-1,41
-1,1777,1888,-111,0,-17,70
1,1555,1539,16,0,122,159
1,1703,1719,-16,3,99,63
1,1732,1565,167,0,-43,97
1,1759,1372,387,3,49,58
1,2087,1572,515,3,350,93
-1,1440,1241,199,-4,-176,75
1,1896,1769,127,0,-68,77
1,1588,1508,80,-8,115,78
1,1711,1538,173,0,414,95
-1,1483,1607,-124,-3,-23,52
1,1877,1534,343,0,468,101
1,1274,1507,-233,1,76,75
1,1761,1904,-143,1,1031,141
1,1571,1241,330,6,202,145
-1,1056,1191,-135,-1,-259,60
-1,1592,1642,-50,0,-53,64
-1,1335,1559,-224,-4,-67,56
-1,1769,1896,-127,0,-54,92
1,1559,1413,146,0,199,59
1,1276,1167,109,-2,-38,45
-1,1732,1634,98,0,17,42
-1,1500,1406,94,0,-193,64
1,1719,1717,2,1,63,87
1,1573,1530,43,2,174,67
1,1903,1762,141,0,-130,91
-1,1649,1718,-69,0,3,64
-1,1690,1697,-7,0,-295,92
1,1698,1474,224,1,48,53
1,1520,1470,50,1,169,83
0,1884,1635,249,1,57,73
-1,1514,1725,-211,0,-165,104
-1,1744,2018,-274,1,29,72
1,1641,1567,74,3,49,43
1,1548,1556,-8,5,110,43
-1,1664,1726,-62,0,-145,130
-1,1539,1499,40,-5,-353,85
1,1487,1433,54,3,253,71
-1,1502,1319,183,1,-31,86
-1,1468,1557,-89,-2,-37,52
-1,1650,1371,279,0,66,92
1,1494,1357,137,-5,-55,73
-1,1727,1529,198,0,-2,92
-1,1576,1624,-48,0,2,44
1,1442,1411,31,4,20,47
-1,1870,1704,166,0,-76,64
-1,1544,1559,-15,-6,-273,73
-1,1847,1924,-77,0,-29,52
1,1380,1569,-189,0,-36,75
1,1754,1878,-124,0,26,89
-1,1741,1655,86,-2,-120,60
-1,1535,1502,33,1,79,78
1,1708,1735,-27,7,433,93
-1,1401,1457,-56,-5,-153,56
-1,1679,1708,-29,-1,-52,82
1,1740,1774,-34,-2,-20,45
1,1635,1566,69,2,79,61
-1,1598,1589,9,-10,-147,80
1,1587,1588,-1,1,128,99
1,1558,1638,-80,1,428,131
1,1720,1624,96,3,574,141
1,1761,1752,9,0,-3,47
1,1492,1701,-209,-1,-16,47
-1,1756,1724,32,-5,-508,82
-1,1669,1726,-57,-7,0,48
1,1838,1227,611,3,77,51
0,1888,1570,318,-2,226,112
1,1929,1871,58,0,-3,71
-1,1466,1507,-41,-6,-191,52
1,1521,1563,-42,0,-1,49
-1,1625,1662,-37,-3,-102,44
1,1766,1539,227,-1,149,83
-1,1555,1585,-30,0,-64,62
-1,1282,1328,-46,-9,-367,70
-1,1772,1713,59,0,-92,108
-1,1394,1473,-79,-2,-237,74
-1,1462,1576,-114,-9,-12,70
-1,1484,1578,-94,-2,-87,58
1,1862,1938,-76,0,5,49
-1,1470,1325,145,-10,-355,120
-1,1617,1454,163,-2,-45,58
-1,1518,1438,80,-10,-601,86
-1,1732,1810,-78,-3,-107,74
-1,1542,1541,1,0,-1,50
1,1979,1725,254,2,55,72
-1,1754,1368,386,-2,-289,103
1,1729,1359,370,0,18,75
1,1551,1554,-3,4,865,145
1,1500,1557,-57,-2,244,83
-1,1772,1772,0,-1,-76,82
1,1611,1881,-270,-8,42,81
-1,1298,1341,-43,-7,-194,57
1,1559,1532,27,0,-39,75
1,1482,1385,97,2,103,57
1,1272,1051,221,17,743,64
-1,1939,1895,44,-2,-10,42
0,1643,1685,-42,-5,-12,86
1,1351,1364,-13,-1,46,63
-1,1493,1539,-46,-1,-151,58
-1,1541,1587,-46,1,31,120
-1,1911,1925,-14,-3,6,74
-1,1614,1718,-104,0,-49,76
-1,1732,1199,533,-1,-48,64
0,1933,1984,-51,-1,1,107
1,1936,1897,39,0,50,93
1,1377,1491,-114,-2,125,111
-1,1500,1345,155,-1,-18,44
-1,1036,1277,-241,-10,-633,76
1,1911,1925,-14,-2,-77,51
1,1947,1885,62,-3,2,55
0,1407,1180,227,-2,-25,120
1,1797,1549,248,5,229,73
-1,1642,1610,32,-1,-54,60
1,1247,1356,-109,2,76,49
1,1587,1600,-13,0,-16,65
-1,1914,1922,-8,0,68,72
-1,1483,1593,-110,0,124,96
-1,1546,1390,156,2,2,108
-1,1629,1581,48,-1,-269,122
-1,1798,2075,-277,0,-58,80
-1,1473,1338,135,-2,-367,96
1,1670,1645,25,0,79,127
1,1511,1515,-4,6,589,83
-1,1829,1645,184,-1,-38,78
1,1643,1534,109,7,260,73
1,1982,1684,298,4,161,83
0,1336,1597,-261,-1,103,120
1,1836,1544,292,0,-147,99
-1,1191,1400,-209,-9,-314,66
1,1720,1712,8,2,152,63
-1,1526,1651,-125,-3,-183,72
1,1150,1086,64,4,101,45
-1,1680,1780,-100,3,307,96
-1,1565,1519,46,2,36,58
-1,1322,1540,-218,-4,-178,56
1,1883,1600,283,0,219,109
-1,1282,1196,86,-9,-747,82
1,1530,1352,178,4,193,97
-1,1510,1516,-6,0,5,54
1,1615,1735,-120,-8,20,107
1,1424,1447,-23,10,474,79
1,1533,1456,77,-1,197,91
1,1605,1500,105,0,71,87
1,1594,1500,94,1,350,119
1,1720,1623,97,0,20,53
1,1985,1861,124,0,8,117
-1,1791,2084,-293,-4,-22,68
1,1283,1404,-121,11,435,65
1,1452,1317,135,-1,-59,75
-1,1210,1519,-309,2,163,100
-1,1577,1552,25,0,-32,82
1,1933,1903,30,-5,-245,85
-1,1615,1729,-114,1,69,66
1,1661,1689,-28,0,12,81
-1,1641,1730,-89,0,-192,82
1,1598,1589,9,-1,-58,57
-1,1492,1603,-111,-2,-163,66
1,1406,1628,-222,0,28,45
1,1343,1536,-193,0,36,69
1,2146,1959,187,-2,-65,71
1,1893,1943,-50,2,87,67
1,1389,1299,90,-3,4,51
1,1718,1383,335,4,228,67
-1,1953,2153,-200,0,-16,112
-1,1490,1611,-121,-7,-218,48
1,1474,1435,39,1,455,109
0,1942,2166,-224,-2,565,98
-1,1545,1312,233,-7,-310,88
1,1558,1244,314,-1,-14,47
-1,1474,1626,-152,-1,-96,92
1,1957,1573,384,3,84,55
1,1611,1397,214,2,294,65
-1,1606,1695,-89,0,11,88
1,1461,1615,-154,0,-22,59
1,1741,1298,443,5,93,43
1,1930,1906,24,-7,-175,65
1,1888,1542,346,1,159,66
-1,1570,1959,-389,0,-7,44
1,1470,1405,65,6,792,101
1,1572,1520,52,9,263,57
-1,1602,1525,77,-4,-138,59
-1,1736,1574,162,0,3,72
-1,1236,1334,-98,-1,-44,62
0,1605,1845,-240,0,-41,97
1,1501,1433,68,2,35,41
0,1571,1667,-96,0,72,152
0,1507,1585,-78,1,-248,134
1,1828,1482,346,0,99,91
-1,1539,1891,-352,-4,-122,66
1,1756,1940,-184,-10,-94,51
-1,1500,1594,-94,-9,-835,96
1,1490,1809,-319,3,147,87
-1,1129,1546,-417,3,296,72
1,1950,1998,-48,1,21,49
0,1741,1800,-59,-7,470,96
1,1983,1595,388,-1,105,126
-1,1397,1709,-312,-3,-272,94
-1,1576,1643,-67,-3,-283,118
1,1952,1380,572,5,370,103
1,1500,1295,205,2,681,133
1,1743,1799,-56,1,24,41
0,1331,1527,-196,3,868,214
1,2062,1896,166,1,6,117
1,1125,1880,-755,0,37,85
-1,1596,1589,7,-1,-105,105
1,1790,1500,290,-1,-8,41
1,1785,1567,218,6,136,67
1,1925,2023,-98,-1,33,65
-1,1433,1478,-45,-3,-360,116
-1,1831,1745,86,-1,-42,56
-1,1787,1915,-128,-1,-56,60
-1,1347,1395,-48,-5,-293,62
-1,1366,1511,-145,-6,-182,56
1,1496,1412,84,6,121,47
1,1791,1561,230,0,16,53
-1,1653,1567,86,-14,-273,48
-1,1286,1600,-314,-2,-34,54
-1,1555,1795,-240,-3,-38,48
1,1435,1426,9,-1,21,81
-1,1949,2091,-142,0,109,82
-1,1724,1799,-75,-1,-13,52
-1,1494,1671,-177,0,-30,62
0,1580,1638,-58,-1,-73,135
1,1517,1597,-80,3,111,59
-1,1781,1902,-121,-2,13,50
-1,1165,1800,-635,0,11,58
1,1957,1397,560,1,78,53
-1,1759,1815,-56,2,89,78
1,1801,1164,637,3,41,51
1,1453,1207,246,0,253,159
-1,1500,1583,-83,-1,-61,50
1,1331,1404,-73,-1,-56,48
-1,1503,1659,-156,0,2,52
-1,1910,1773,137,-3,-58,76
-1,1629,1673,-44,1,-20,78
1,1750,1438,312,-3,-140,70
1,1895,1716,179,2,332,101
-1,1617,1410,207,-8,-239,64
-1,1436,1607,-171,1,-238,62
-1,1536,2074,-538,-5,-117,52
-1,1798,1834,-36,-3,-53,48
-1,1673,1970,-297,-3,-43,46
1,1726,1618,108,0,9,71
-1,1531,1564,-33,0,-395,134
-1,1459,1666,-207,6,298,98
1,1627,1424,203,1,26,99
-1,1806,2007,-201,-1,-38,96
-1,1753,1974,-221,-2,-230,66
1,1739,1332,407,2,89,59
1,1583,1500,83,0,23,43
0,1398,1542,-144,-1,-582,106
-1,1609,1778,-169,0,34,54
1,1414,1153,261,7,267,63
1,1484,1343,141,3,67,55
1,2014,1800,214,0,145,85
-1,1508,1341,167,-4,-30,48
1,1589,1361,228,1,-19,153
1,1594,1446,148,12,201,47
-1,1569,1670,-101,0,-184,80
-1,1482,1435,47,-1,-33,46
-1,1794,2021,-227,-3,-317,82
1,1728,1586,142,-5,58,53
-1,1622,1597,25,-5,-90,58
1,1938,1861,77,3,88,57
-1,1619,1671,-52,-1,-74,58
1,1574,1651,-77,-1,47,55
-1,1541,1556,-15,2,6,76
1,2028,1788,240,3,65,43
1,1671,1734,-63,0,1,43
-1,1783,2034,-251,0,-4,42
1,1790,1225,565,2,160,85
-1,1853,1947,-94,3,87,48
-1,1578,1458,120,-3,-302,113
1,2040,1778,262,2,72,55
-1,1330,1741,-411,0,-483,130
1,1555,1377,178,2,110,67
1,1788,1836,-48,0,3,51
-1,1773,2045,-272,0,76,110
1,1683,1637,46,0,192,69
-1,1607,1531,76,1,22,46
-1,1458,1468,-10,1,34,50
0,1955,1844,111,-1,-176,66
1,1792,1714,78,5,59,41
1,1632,1500,132,-1,-20,81
1,1521,1337,184,3,1311,169
-1,1874,2100,-226,-3,-37,56
1,2050,1768,282,-8,-287,51
-1,1500,1497,3,-2,-46,52
-1,1545,1594,-49,-3,-128,80
1,1764,2055,-291,-1,208,129
1,1363,1396,-33,4,73,51
1,1733,1739,-6,2,50,45
1,1807,1705,102,0,489,151
-1,1423,1369,54,0,29,74
-1,1756,1786,-30,1,23,56
1,1627,1692,-65,-4,-151,125
1,1800,1822,-22,-4,1,71
1,2107,1868,239,-1,0,81
-1,1603,1535,68,-1,-171,87
-1,1746,2112,-366,-3,-43,48
-1,1550,1797,-247,-3,-415,96
-1,1523,1603,-80,0,-70,92
1,1902,1335,567,7,436,61
-1,1498,1480,18,2,4,56
1,1803,1544,259,3,699,93
1,1700,1749,-49,0,67,114
1,1419,1362,57,-1,38,103
1,1631,1390,241,3,132,70
-1,1539,1807,-268,-1,5,54
-1,1546,1571,-25,-1,17,104
1,1812,1534,278,1,175,95
1,1750,1621,129,-3,166,119
-1,1679,1640,39,-1,-186,106
-1,1529,1817,-288,-7,-254,106
-1,1890,1812,78,0,-44,98
1,1903,1405,498,-1,-10,57
-1,1589,1526,63,-10,-565,74
-1,1892,1862,30,0,-225,128
-1,1662,1436,226,-4,-64,50
0,1572,1239,333,-2,-690,167
-1,1427,2077,-650,-6,-121,70
-1,1750,1589,161,-4,-31,50
-1,1396,1322,74,-2,-280,110
-1,1208,1271,-63,-9,-409,70
1,1652,1667,-15,3,134,69
-1,1472,1564,-92,-5,-257,102
-1,1840,1582,258,0,18,92
-1,1880,1947,-67,-3,-70,42
-1,1744,1599,145,1,106,70
1,1558,1720,-162,-3,-4,75
1,1574,1573,1,0,61,65
1,2067,2038,29,0,68,87
-1,1500,1209,291,0,4,52
-1,1630,1437,193,2,54,72
1,1414,1438,-24,-1,-54,54
1,1594,1337,257,0,359,119
1,1122,1235,-113,-12,17,89
1,1755,1711,44,-1,127,101
1,1582,1674,-92,0,36,71
-1,1760,1901,-141,-1,-349,120
1,2029,1947,82,1,28,49
-1,1805,1861,-56,0,-9,60
-1,1259,1635,-376,4,83,42
1,2026,1995,31,-3,47,157
1,1456,1188,268,0,47,49
-1,1570,1610,-40,-3,-187,80
-1,1337,1399,-62,-4,-80,47
-1,1842,1764,78,-1,-8,72
1,1222,1360,-138,5,169,69
-1,1460,1455,5,-2,-123,56
1,1818,1684,134,1,124,75
-1,1710,1681,29,8,110,48
-1,1560,1613,-53,-2,-98,78
0,1796,1875,-79,-1,-81,113
1,1308,1567,-259,5,210,53
1,1485,1411,74,4,114,53
1,1985,2038,-53,0,153,73
-1,1939,2039,-100,-2,4,50
-1,1472,1383,89,-15,-122,44
1,1638,1322,316,2,198,57
-1,1838,1702,136,0,-7,66
-1,1344,1425,-81,-7,-149,42
1,1339,1261,78,-3,46,77
1,1721,1340,381,14,337,55
1,1622,1448,174,5,444,73
1,1234,1744,-510,1,13,50
0,1997,1971,26,0,36,98
1,1908,1753,155,2,49,65
1,1419,1424,-5,-7,17,45
1,1825,1659,166,0,23,73
1,1894,1796,98,-3,150,102
1,1714,1692,22,10,252,51
1,1442,1629,-187,-3,-133,111
1,1771,1823,-52,0,5,51
1,1909,1945,-36,3,298,113
1,1497,1415,82,0,18,61
1,1705,1569,136,-2,-31,53
-1,1498,1352,146,-3,-122,48
-1,1458,1402,56,0,-129,70
1,1657,1483,174,0,238,129
-1,1534,1425,109,0,-134,62
-1,2104,1997,107,-1,-1147,168
-1,1478,1840,-362,-4,-240,64
-1,1239,1473,-234,-3,-11,62
-1,1340,1568,-228,-1,-152,62
-1,1459,1843,-384,-4,-350,64
0,1526,1486,40,-3,-225,111
1,1845,1457,388,7,552,71
1,1507,1013,494,3,64,57
1,1620,1558,62,3,94,51
1,1855,1764,91,0,224,119
-1,1430,1412,18,-2,-54,54
-1,2010,2073,-63,0,-18,84
1,1744,1551,193,2,217,113
-1,1422,1701,-279,0,21,50
-1,1434,1494,-60,-6,-69,44
1,1734,1529,205,8,439,97
1,1565,1631,-66,0,206,64
-1,1234,1478,-244,0,31,96
-1,1554,1513,41,-4,-136,68
-1,1589,1585,4,4,282,90
-1,1445,1196,249,0,-67,88
1,1847,1611,236,0,-3,43
1,1705,1418,287,0,12,45
1,1982,1945,37,1,12,55
1,1420,1250,170,0,133,51
-1,1733,1668,65,-6,-188,53
1,1607,1852,-245,1,23,43
1,1592,1575,17,0,171,101
-1,1455,1566,-111,-14,-189,46
1,1661,1797,-136,2,305,77
1,1415,1562,-147,1,18,49
-1,1337,1662,-325,-5,-125,84
1,1574,1446,128,22,852,65
1,1843,1487,356,3,490,89
-1,1541,1586,-45,-2,-479,106
-1,1711,1679,32,-1,-84,64
1,1652,1386,266,1,148,77
-1,1681,1719,-38,0,-69,66
1,1912,1910,2,1,47,99
1,1944,1810,134,0,158,93
1,1453,1587,-134,2,892,135
1,1405,1893,-488,0,-120,67
-1,1257,1518,-261,-7,-118,44
-1,1692,2164,-472,0,-21,46
1,1750,1425,325,1,43,55
1,1439,1503,-64,0,24,47
1,1229,1052,177,5,349,74
1,2166,1690,476,0,1,41
1,1608,1619,-11,0,8,61
-1,1686,2039,-353,-2,-70,62
0,1594,1456,138,3,337,81
-1,1609,1869,-260,0,2,44
1,1689,2168,-479,-1,-36,49
1,1476,1368,108,3,57,41
1,1430,1009,421,12,134,41
-1,1681,1874,-193,6,524,86
1,1590,1460,130,4,741,77
-1,1656,1935,-279,1,-37,66
1,1568,1381,187,0,-19,131
1,1931,1797,134,-2,39,49
-1,2042,2023,19,-4,-94,64
-1,1452,1574,-122,-14,-367,48
-1,1546,1752,-206,-6,-134,60
-1,1848,2146,-298,0,-235,110
-1,1443,1515,-72,-2,-747,80
-1,1466,1359,107,1,15,58
1,1513,1609,-96,-8,24,43
1,1598,1533,65,-2,83,57
-1,2030,2037,-7,-1,-208,88
0,1510,1490,20,0,112,106
-1,1613,1508,105,-2,-224,86
1,1371,1540,-169,3,188,87
-1,1432,1326,106,0,5,52
1,1455,1570,-115,1,385,135
-1,1308,1480,-172,0,3,50
1,1418,1476,-58,0,63,105
1,2018,1712,306,0,67,59
1,1390,1421,-31,13,478,59
0,1939,1949,-10,-1,-20,93
0,1803,1923,-120,1,92,89
-1,1631,1707,-76,2,60,104
1,1652,1466,186,0,13,85
1,1633,1337,296,-2,-20,43
-1,1709,2022,-313,-1,-67,82
-1,1256,1386,-130,-2,-509,102
-1,1977,1864,113,0,-9,106
-1,1702,1759,-57,0,-134,96
1,2150,1844,306,2,96,61
1,1511,1846,-335,1,119,92
1,1705,2025,-320,-1,-72,85
-1,1949,1939,10,-1,-36,50
-1,1322,1482,-160,-1,-48,69
-1,1600,1683,-83,0,-27,72
-1,1422,1405,17,2,76,58
1,1841,2154,-313,-1,230,95
0,1573,1373,200,0,-17,108
-1,1587,1572,15,2,282,98
1,1501,1415,86,0,13,41
-1,2049,2004,45,0,-95,78
-1,1728,1623,105,3,297,116
1,1427,1038,389,5,344,79
1,2053,1938,115,1,-6,69
-1,1753,1662,91,0,-272,138
-1,1600,1457,143,-1,-95,86
-1,1443,1253,190,0,-263,72
1,1640,1596,44,0,39,95
1,2035,2018,17,1,35,61
-1,1861,1613,248,0,24,90
1,1568,1727,-159,-1,74,65
-1,1304,1488,-184,-1,-32,52
1,1642,1658,-16,0,193,79
-1,1248,1348,-100,4,2,72
-1,1486,1720,-234,5,415,118
1,1673,1784,-111,1,89,69
-1,1880,2006,-126,0,-24,48
-1,1631,1843,-212,-1,-6,64
-1,1296,1405,-109,-1,2,70
1,1291,1451,-160,0,106,59
-1,1648,1610,38,0,-95,134
1,2014,1872,142,0,67,65
-1,1759,1919,-160,-1,14,52
1,1730,1294,436,0,51,95
1,1637,1736,-99,0,1,85
1,1789,1500,289,0,-3,51
1,1864,2022,-158,6,260,61
-1,1723,1833,-110,-2,-160,70
1,2133,1859,274,1,46,77
-1,1663,1478,185,2,-51,70
-1,978,1642,-664,-13,-343,60
-1,1890,1270,620,-4,-231,58
1,2051,1714,337,1,82,67
-1,2005,1882,123,-1,-112,80
1,1752,1410,342,3,92,55
-1,1487,1842,-355,0,-571,84
-1,1568,1509,59,-1,-18,40
1,1289,1498,-209,3,398,133
-1,1898,1989,-91,0,-341,98
-1,1239,1574,-335,-6,-131,48
-1,1741,1334,407,1,74,48
-1,1721,1651,70,0,25,96
-1,1711,2054,-343,-10,-55,88
1,1844,1484,360,9,118,43
-1,1291,1415,-124,0,23,102
1,1384,1523,-139,1,110,77
1,1472,1533,-61,4,88,55
-1,1292,1732,-440,0,-3,46
1,1401,1291,110,11,334,51
1,1497,1263,234,4,245,43
-1,1692,1907,-215,0,-24,56
-1,1873,2001,-128,-5,-30,42
-1,1376,1504,-128,5,162,62
1,2057,1708,349,3,106,73
-1,1881,2006,-125,0,-59,76
1,1855,2137,-282,1,62,69
-1,1597,1637,-40,4,356,92
-1,1236,1377,-141,-3,-77,50
1,1769,1643,126,0,91,87
1,1704,2060,-356,0,-245,101
1,1646,1688,-42,3,57,44
-1,1792,1742,50,-1,-31,62
-1,1494,1524,-30,0,23,63
1,1416,1174,242,-2,-93,99
1,2009,1865,144,0,152,79
-1,1501,1522,-21,-1,-95,64
-1,1664,1706,-42,-2,-12,46
-1,1674,1363,311,-8,-76,44
1,1618,1545,73,-1,117,57
1,1719,1500,219,1,177,80
-1,1623,1636,-13,-11,-385,60
-1,1350,1657,-307,-2,-72,50
1,1734,1807,-73,0,47,77
-1,1858,2016,-158,-5,-72,58
1,2117,1873,244,0,-26,65
-1,1672,1926,-254,-1,-109,90
1,2024,1851,173,-3,40,55
-1,2140,1728,412,0,-182,62
-1,1228,1314,-86,0,47,44
1,1852,1709,143,-1,-71,69
1,1244,1296,-52,1,5,45
-1,1717,1654,63,0,-4,52
1,1299,1534,-235,11,223,43
-1,1489,1766,-277,-7,-22,76
1,1386,1426,-40,-2,88,93
1,1445,1449,-4,2,47,49
1,1755,986,769,3,79,43
1,1446,1338,108,2,74,67
1,1569,1436,133,6,11,42
-1,1426,1584,-158,-1,-175,68
-1,1659,1441,218,-2,13,62
-1,1456,1438,18,-3,-16,60
-1,1844,2030,-186,0,-297,94
1,1685,1555,130,-3,3,61
1,1702,1752,-50,2,186,103
1,1587,1634,-47,0,24,64
1,1220,1481,-261,0,-22,59
1,1734,1732,2,0,-58,101
-1,1376,1447,-71,-4,-242,66
-1,1667,1703,-36,-4,-28,48
-1,1561,1628,-67,3,71,156
1,1789,1780,9,-4,-102,43
1,2037,1838,199,-1,-23,56
-1,1869,2122,-253,0,8,48
1,1524,1481,43,-2,431,101
-1,1548,1692,-144,-2,-135,56
0,1724,1407,317,-1,281,143
-1,1421,1414,7,-4,-269,88
1,2037,1737,300,-2,12,69
-1,1725,1679,46,-1,-149,70
1,1993,1623,370,0,62,97
-1,1434,1714,-280,-3,-7,50
1,1318,1427,-109,8,186,47
1,1528,1646,-118,0,3,77
1,1590,1328,262,-1,-57,73
-1,1402,1371,31,0,-170,144
1,1832,2043,-211,0,-67,183
1,1749,1794,-45,6,180,63
1,1654,1460,194,-3,-49,59
0,1310,1421,-111,0,-87,111
1,1602,1647,-45,0,12,73
1,1733,1541,192,0,-43,61
-1,1714,1657,57,0,151,68
-1,1426,2061,-635,-3,-200,58
-1,1363,1563,-200,1,-250,74
0,1640,1577,63,0,121,125
-1,1313,1586,-273,-1,-238,104
0,1801,1777,24,0,38,85
-1,1599,1620,-21,1,61,50
-1,1787,1637,150,0,-76,74
-1,1790,1660,130,-3,-81,66
1,1720,1376,344,6,156,41
-1,1770,1826,-56,-3,-36,59
-1,1240,1337,-97,-5,-297,100
-1,1232,1615,-383,-5,-152,42
1,1670,1700,-30,0,38,65
1,1472,1651,-179,0,0,57
-1,1712,1732,-20,-3,-89,82
1,1426,1500,-74,-3,-559,69
1,1589,1667,-78,-1,-5,79
1,1756,1781,-25,0,-19,117
-1,1487,1308,179,0,-89,76
-1,1665,1332,333,-1,-59,51
1,1504,1033,471,2,44,49
-1,1543,1632,-89,-1,-15,62
1,1367,1298,69,-6,-140,67
1,2042,1940,102,0,-8,51
-1,1290,1521,-231,1,37,76
1,1618,1413,205,3,170,61
1,1688,1682,6,-1,113,115
-1,1442,2062,-620,-2,-59,50
-1,1438,1452,-14,0,-497,112
1,1602,1340,262,-1,-59,61
-1,1746,1352,394,10,117,42
-1,1500,1548,-48,-4,-190,90
-1,1628,1500,128,-6,-63,40
1,1547,1639,-92,-9,217,107
1,2044,1612,432,0,26,104
-1,1396,1634,-238,-1,-68,52
0,1737,1618,119,0,-141,156
1,1591,1440,151,-2,-120,77
-1,1754,1910,-156,-1,-9,44
1,1499,1450,49,-1,-7,103
1,1564,1330,234,-2,525,153
1,1675,1774,-99,0,19,71
0,2046,1610,436,0,52,112
1,1597,1561,36,0,146,109
1,1646,1645,1,0,10,68
1,1553,1527,26,-7,-168,55
-1,1294,1387,-93,0,-47,56
-1,1639,1727,-88,1,13,73
-1,1656,1578,78,1,-74,68
1,1869,1726,143,2,20,49
1,1426,1332,94,-1,202,123
1,1656,1523,133,1,127,87
1,1570,1534,36,0,510,85
-1,1967,2089,-122,-1,-49,68
-1,1717,1909,-192,0,-413,124
1,1958,1620,338,1,128,72
-1,1562,1607,-45,-4,-158,82
1,1558,1523,35,7,309,65
1,1960,1984,-24,1,206,91
-1,1787,1747,40,-9,-211,90
1,1970,1971,-1,0,-32,99
-1,1499,1532,-33,-4,-60,44
-1,1760,1775,-15,-1,-61,64
1,1880,1351,529,0,34,51
1,1735,1730,5,0,-76,163
-1,1609,1690,-81,0,-236,126
-1,1786,1749,37,-5,-181,64
1,1523,1580,-57,-1,-186,97
1,1537,1293,244,8,391,69
-1,1856,1983,-127,-4,-101,46
-1,1509,1569,-60,-3,-283,89
1,1730,1664,66,0,7,45
1,1654,1440,214,1,67,63
1,1236,1542,-306,0,693,149
-1,1655,1961,-306,-2,-35,50
-1,1485,1453,32,0,-20,48
1,1504,1323,181,5,84,45
-1,1741,1995,-254,1,-66,74
1,1350,1881,-531,6,1431,119
1,1567,1537,30,-2,23,99
1,1884,1624,260,2,191,87
-1,1606,2057,-451,-3,-318,84
-1,1528,1384,144,-11,-240,48
1,1593,1542,51,1,48,57
1,1785,1652,133,4,72,61
1,1659,1500,159,2,175,63
1,1367,1648,-281,2,57,47
-1,1434,1499,-65,-9,-517,68
1,1736,1746,-10,-1,-50,89
-1,1584,1916,-332,0,-84,114
1,1640,1617,23,1,8,59
1,1087,1434,-347,-9,-9,51
1,2059,1604,455,7,292,57
-1,1965,1654,311,0,-142,70
1,1451,1532,-81,0,21,53
1,1794,2000,-206,-3,-88,101
1,1858,1379,479,-5,29,71
1,1706,1663,43,0,171,113
-1,1603,2061,-458,-1,-21,50
1,1799,1637,162,0,-140,201
-1,1990,2069,-79,2,64,86
-1,1219,1568,-349,1,-219,72
1,2097,2156,-59,0,102,77
-1,1762,1520,242,-7,-786,96
1,1526,1577,-51,1,177,127
1,2164,1765,399,-4,127,94
1,1607,1651,-44,1,11,41
-1,1735,1750,-15,-1,6,106
-1,1726,1799,-73,-1,-171,130
1,1665,1518,147,0,26,69
-1,1578,1639,-61,-3,-176,64
1,1411,1425,-14,0,39,61
-1,1508,1493,15,-6,-253,48
-1,1638,1619,19,-12,-226,66
1,2078,1981,97,-1,-3,53
1,1314,1487,-173,9,618,89
1,1465,1402,63,-1,41,51
1,1612,1630,-18,-2,-110,91
-1,1465,1500,-35,0,22,104
1,1225,1500,-275,1,181,79
-1,1560,1994,-434,-4,-79,52
1,1763,1851,-88,-4,-82,61
-1,1614,1792,-178,0,-678,104
1,1538,1742,-204,4,190,87
-1,1996,1558,438,-1,-3,56
-1,1526,1360,166,0,-134,116
1,1973,1778,195,2,174,63
-1,1582,1816,-234,-3,-18,60
1,1816,1718,98,3,120,55
1,1553,1578,-25,2,563,113
1,1518,1630,-112,0,-78,57
1,1543,1338,205,-6,-343,79
1,1798,1608,190,5,-4,79
1,1422,1508,-86,1,143,81
-1,1399,1551,-152,0,6,48
1,2128,1749,379,0,233,161
-1,1284,1370,-86,-3,-121,74
-1,1669,1500,169,0,12,82
1,1371,1559,-188,0,651,127
1,1861,1375,486,-6,-115,57
1,1406,1581,-175,-5,-52,59
-1,1387,1450,-63,1,62,64
1,1478,1715,-237,1,69,95
-1,1772,1979,-207,-13,-171,44
1,1337,1198,139,12,461,58
-1,1724,1555,169,-2,58,114
-1,2185,1971,214,0,-257,92
1,1882,1830,52,-1,2,75
-1,1460,1365,95,2,63,62
1,1853,1719,134,0,29,71
1,1458,1314,144,-1,3,51
1,1695,1430,265,11,793,91
-1,1547,1603,-56,-1,3,70
1,1592,1813,-221,0,-104,101
1,1497,1618,-121,2,73,79
1,1551,1698,-147,0,13,43
-1,1397,1445,-48,1,79,102
-1,1373,1863,-490,-3,-173,54
-1,1411,1973,-562,-2,-15,50
-1,1747,1984,-237,-1,-138,152
-1,1511,1525,-14,0,-125,88
-1,1465,1683,-218,-2,-97,76
1,1705,1578,127,-1,-111,105
1,1243,1313,-70,12,534,61
1,1712,1731,-19,2,146,75
-1,1760,1711,49,0,-58,62
1,1796,1609,187,4,157,59
1,1974,1410,564,-1,-42,85
1,1689,1473,216,-2,-92,75
1,1540,1627,-87,2,46,58
-1,1612,1537,75,-5,-185,64
1,1685,1568,117,0,1,57
-1,1500,1554,-54,-3,-10,90
1,1569,1503,66,-1,-6,45
1,1743,1892,-149,-5,-180,59
1,2035,1869,166,-1,-12,107
-1,1456,1810,-354,-2,-102,58
-1,1606,1624,-18,0,6,42
-1,1988,1970,18,2,74,56
-1,1523,1416,107,0,-1,42
1,1551,1600,-49,-1,-37,73
1,1641,1565,76,1,8,59
-1,1370,1866,-496,1,44,86
1,1591,1500,91,-5,-25,47
-1,1572,1646,-74,2,-314,128
1,1433,1468,-35,-8,-39,59
1,1349,1466,-117,1,55,51
1,1608,1686,-78,4,263,65
-1,2108,2140,-32,-3,-17,120
-1,1409,1253,156,3,32,84
0,1696,1596,100,-3,-39,138
-1,1509,2131,-622,-8,-693,98
1,1712,1561,151,3,95,47
-1,1496,1560,-64,-1,-136,54
-1,1758,1876,-118,-4,-25,40
-1,1441,1574,-133,1,-1,58
1,1982,1550,432,1,75,73
1,1231,1187,44,8,389,65
1,1588,1563,25,1,1139,123
1,1459,1333,126,-1,0,41
-1,1500,1724,-224,-1,-263,126
-1,2048,1738,310,-3,-517,128
-1,1700,1467,233,0,-59,146
-1,1960,2096,-136,-1,-21,62
-1,1556,1650,-94,-1,-62,69
1,1541,1458,83,0,-2,59
-1,1914,1977,-63,0,-290,133
0,1746,2104,-358,-1,69,105
1,1773,1388,385,1,110,85
0,1256,1269,-13,-3,-119,147
1,1431,1286,145,3,104,61
1,1915,1982,-67,0,-4,69
-1,1553,1597,-44,-6,-511,74
-1,1599,1679,-80,-5,-33,58
-1,1337,1729,-392,-1,-492,88
-1,1466,1718,-252,1,-7,89
1,1893,1622,271,-1,-5,40
0,1399,1530,-131,0,-15,151
1,1607,1284,323,5,58,47
-1,1607,1543,64,0,3,60
-1,1855,2036,-181,0,-57,78
1,1468,1425,43,0,32,49
1,1530,1548,-18,0,22,61
-1,1672,1504,168,-1,-85,66
-1,1656,1486,170,-4,-790,120
1,1614,1570,44,0,-124,127
-1,1474,1323,151,6,72,78
-1,1581,1418,163,-2,-147,65
-1,1905,1969,-64,2,-66,78
-1,1263,1569,-306,-12,-232,44
1,1721,1571,150,2,54,51
-1,1538,1771,-233,2,60,146
-1,2042,1849,193,1,-57,90
-1,1556,1594,-38,-1,-45,60
-1,1614,1948,-334,-2,-233,64
0,1723,1645,78,3,192,115
1,1344,1258,86,1,585,153
1,1678,1564,114,5,380,79
-1,1750,1896,-146,-3,-208,82
1,1902,1916,-14,-2,56,81
1,937,1090,-153,-2,-17,41
1,1561,1584,-23,0,218,91
-1,1403,1348,55,-1,-65,80
-1,1559,1592,-33,1,-25,60
1,1602,1189,413,0,946,138
-1,1545,1550,-5,-4,-49,50
1,1719,1190,529,-3,-31,65
1,1694,1497,197,2,154,117
1,1681,1309,372,-5,-63,45
-1,1645,1659,-14,0,-7,52
-1,1722,1687,35,-1,-306,106
1,1483,1379,104,0,194,79
-1,1648,1720,-72,-8,-236,54
-1,1250,1141,109,7,535,90
1,1424,1537,-113,2,41,43
-1,1547,1985,-438,0,-76,66
1,1450,1477,-27,5,136,41
0,1656,1686,-30,1,89,124
-1,1601,1549,52,-1,-18,48
1,1462,1372,90,8,698,71
1,1534,1562,-28,6,377,85
-1,1503,1988,-485,-4,-408,80
-1,1729,1951,-222,-2,-86,64
-1,1619,1919,-300,-1,-52,48
1,1562,1589,-27,-6,-225,71
1,1877,1328,549,5,103,51
1,1556,1686,-130,3,585,87
1,1670,1573,97,5,338,81
-1,1762,1989,-227,1,-60,80
-1,1533,1716,-183,2,-2,52
-1,1492,1556,-64,-4,-221,92
1,1707,1511,196,-4,-489,105
1,1478,1441,37,1,67,53
1,1458,1499,-41,1,55,43
1,1696,1505,191,5,129,41
1,1995,1757,238,3,84,55
-1,1470,1663,-193,-3,-9,44
0,1635,1689,-54,-3,-133,88
1,1700,1700,0,0,9,61
0,1233,1362,-129,0,139,133
1,1257,1339,-82,-2,103,73
1,1615,1536,79,0,63,49
1,1720,1724,-4,2,67,57
1,1867,1496,371,1,65,47
-1,1752,2001,-249,-3,-146,82
1,1501,1488,13,3,-16,101
-1,1701,1499,202,0,10,52
1,1923,1615,308,-3,328,125
1,1714,1606,108,-6,-30,43
-1,1702,2148,-446,0,-13,84
-1,1928,1982,-54,-1,67,118
1,2007,1748,259,0,172,85
1,1487,1471,16,-6,-152,51
1,1776,1810,-34,0,2,49
-1,1713,1732,-19,0,-9,74
1,1860,1669,191,0,-235,123
1,1743,2012,-269,2,56,65
-1,1474,1882,-408,-1,-54,58
1,1728,1481,247,-3,1,49
0,1516,1681,-165,-5,-38,91
1,1671,1572,99,0,68,87
-1,1871,1656,215,-4,-77,94
1,1565,1618,-53,-7,-363,83
-1,1461,1528,-67,0,-52,84
1,1989,1762,227,0,141,79
0,1603,1477,126,1,-460,139
1,1577,1497,80,15,522,54
-1,1693,1986,-293,-3,-11,42
1,1635,1493,142,0,11,81
-1,1370,1137,233,-3,12,44
1,1572,1179,393,1,136,51
-1,1465,1556,-91,-1,-20,68
-1,1835,1724,111,-3,-9,44
-1,1757,1995,-238,0,-5,58
-1,1362,1376,-14,-3,-168,72
1,1713,1703,10,0,-14,65
1,2001,1752,249,0,-2,57
-1,1701,1838,-137,-9,16,68
-1,1481,1600,-119,1,20,42
-1,1549,1600,-51,1,3,88
-1,1457,1625,-168,-3,-218,74
-1,1525,1521,4,0,-27,142
1,2031,1989,42,-1,389,117
1,1676,1408,268,0,260,89
1,1748,2006,-258,-3,84,91
-1,1623,1612,11,0,-24,64
-1,1577,1605,-28,-4,-32,68
-1,1458,1354,104,-3,-582,108
1,1607,1474,133,3,110,71
-1,1396,1598,-202,-3,-2,42
-1,1697,1620,77,0,-95,78
1,1340,1519,-179,0,413,89
1,1992,1919,73,-1,43,59
1,1738,1788,-50,0,-1,95
-1,1246,1292,-46,4,16,66
-1,1372,1277,95,0,-210,84
-1,1390,1866,-476,1,-44,56
-1,1469,1884,-415,-3,-98,64
-1,1849,1578,271,4,70,54
-1,1352,1396,-44,-13,-926,74
-1,1563,1679,-116,-7,-290,64
1,1435,1467,-32,-1,27,61
-1,1351,1444,-93,2,135,86
-1,1980,2042,-62,0,-122,104
-1,1692,1869,-177,-4,-73,58
1,1595,1827,-232,1,157,73
-1,1657,1790,-133,1,-50,106
1,1725,1910,-185,0,10,57
1,1463,1381,82,0,-19,75
1,1668,1640,28,0,99,125
1,1530,1623,-93,0,-16,49
1,2052,1971,81,0,83,91
-1,1484,1693,-209,0,-241,90
1,1604,1324,280,2,42,51
0,1680,1462,218,-1,51,97
1,1578,1497,81,3,94,52
-1,1236,1353,-117,-4,-218,67
1,1616,1454,162,-3,-49,139
1,1886,1686,200,3,16,41
-1,1491,1886,-395,-5,-262,96
1,1984,2151,-167,0,251,109
-1,1358,1353,5,-1,-79,88
1,1571,1672,-101,0,308,73
-1,1610,1540,70,-7,-76,46
1,1609,1376,233,1,53,49
1,1686,1567,119,2,192,105
1,1406,1374,32,9,435,67
-1,1405,1343,62,-8,-278,68
1,1500,1500,0,0,-3,51
0,1381,1442,-61,3,326,90
-1,1660,1494,166,-1,-52,78
1,1628,1573,55,0,14,57
-1,1761,1697,64,0,0,48
1,1614,1371,243,2,43,55
-1,1561,1630,-69,-3,-12,66
1,1805,1419,386,4,213,75
1,1902,1617,285,1,135,55
-1,1453,1574,-121,0,-596,146
0,1453,1343,110,-3,-378,98
1,2013,1962,51,-5,-74,87
1,1459,1549,-90,4,225,43
1,1689,1511,178,-1,-39,69
-1,1679,1868,-189,0,-166,106
1,1774,1736,38,-1,4,59
-1,1500,1612,-112,-2,-40,58
-1,1468,1673,-205,-2,-68,62
-1,1744,2008,-264,-2,8,80
1,1657,1137,520,-6,-127,65
-1,1014,1229,-215,-4,-348,101
1,1308,1447,-139,-5,-7,46
-1,1430,1580,-150,-4,-593,90
-1,1613,1911,-298,0,-9,68
1,1542,1586,-44,0,501,151
1,1474,1529,-55,-3,-40,47
-1,2013,2152,-139,0,-85,80
1,1553,1687,-134,1,11,41
-1,1740,1588,152,6,125,40
0,1417,1523,-106,0,149,130
0,1364,1489,-125,2,-39,149
0,1488,1600,-112,-6,-607,100
1,1889,1489,400,0,126,99
-1,1587,1711,-124,0,-27,84
-1,1663,1639,24,0,29,66
0,1500,1618,-118,3,830,156
-1,1605,2004,-399,-10,-507,68
1,1239,1410,-171,0,151,77
1,1423,1725,-302,-2,-19,45
-1,1723,1861,-138,0,-10,58
1,1538,1673,-135,-1,110,55
-1,1335,1350,-15,-1,-272,82
1,1768,1902,-134,2,286,125
-1,2026,1967,59,0,148,88
1,1920,1609,311,0,98,73
1,1552,1387,165,1,-46,63
-1,1600,2009,-409,-13,-189,44
-1,1680,1463,217,1,83,68
1,1716,1443,273,1,534,77
-1,1368,1711,-343,0,-51,80
1,1846,1695,151,0,36,53
-1,1346,1563,-217,-4,-380,92
1,1784,1920,-136,0,-20,93
1,2012,1598,414,2,418,105
-1,1979,2013,-34,-4,-68,42
1,1597,1491,106,4,263,77
1,1658,1315,343,-4,-41,53
-1,1439,1720,-281,-3,-357,74
-1,1560,1696,-136,-3,-97,54
1,2023,1970,53,-3,-32,41
1,1720,1439,281,3,311,83
-1,1477,1791,-314,-6,-167,54
1,2130,2161,-31,0,-80,121
1,1479,1189,290,3,135,73
-1,1595,2014,-419,-2,-250,68
1,1960,2032,-72,0,-84,101
1,1576,1490,86,5,162,71
1,1651,1658,-7,-2,375,157
-1,1706,1688,18,0,0,46
1,1619,1366,253,5,194,55
1,2017,1593,424,6,63,41
-1,1234,1287,-53,-2,4,104
1,1760,1476,284,8,445,75
1,2145,1724,421,0,17,73
1,1809,1722,87,-1,-44,75
-1,1688,1605,83,2,36,92
-1,2019,1973,46,-8,57,78
-1,1604,1654,-50,0,-243,126
-1,1591,2019,-428,-7,-309,62
-1,1610,1445,165,3,99,142
1,1483,1652,-169,-3,-16,59
1,1622,1654,-32,5,66,43
-1,1695,1868,-173,0,12,92
-1,1661,1891,-230,1,63,72
1,1567,1437,130,5,661,115
-1,1722,1572,150,-6,-116,44
1,2021,1589,432,1,248,69
0,1623,1361,262,1,-189,90
-1,1587,1705,-118,-9,-484,68
-1,1700,1689,11,0,11,54
-1,1482,1660,-178,0,-1,78
-1,1587,2024,-437,-2,-43,60
1,1747,1650,97,1,210,116
-1,1443,1472,-29,1,329,138
1,1356,1111,245,3,198,87
1,1700,1689,11,1,7,57
1,1713,1580,133,1,39,45
-1,1620,1675,-55,0,-369,108
-1,1635,1723,-88,2,-315,114
1,2026,1585,441,0,171,71
-1,1499,1609,-110,-4,-295,86
1,1874,1677,197,1,126,111
-1,1573,1721,-148,-1,-91,76
-1,1369,1616,-247,-4,-128,65
1,1483,1322,161,4,297,85
-1,1583,2028,-445,-1,2,44
-1,1802,1884,-82,0,-127,108
1,1499,1341,158,0,113,99
1,1728,1567,161,0,-199,85
-1,1811,1729,82,-1,-64,70
1,2031,1580,451,0,92,67
1,1620,1364,256,-1,-69,75
-1,1902,1817,85,1,137,86
0,1607,1646,-39,-1,-14,51
-1,1578,1734,-156,0,-3,78
0,1645,1706,-61,-2,-98,49
-1,1490,1622,-132,-1,-186,64
-1,1811,1475,336,0,-263,140
-1,1669,1533,136,0,-39,94
1,1741,1604,137,-6,-220,53
1,1579,1490,89,-2,-105,57
-1,1316,1341,-25,-6,-367,80
1,1806,1664,142,2,67,41
1,1907,1609,298,1,371,89
1,1672,1574,98,10,408,61
-1,1537,1662,-125,-1,-90,66
1,1880,2053,-173,-5,-25,95
1,1770,1459,311,0,-3,43
-1,1596,1748,-152,1,9,50
1,1637,1600,37,-1,83,58
1,1617,1374,243,12,647,72
-1,1608,1763,-155,0,97,68
1,1647,1608,39,-4,-11,67
1,1669,1530,139,2,80,51
1,1755,1587,168,0,0,53
-1,1880,1672,208,0,35,62
1,1911,1605,306,4,251,97
1,1453,1585,-132,0,899,189
0,1783,1566,217,-5,-256,84
1,1550,1479,71,7,847,111
1,1482,1392,90,-1,-97,87
-1,1580,1762,-182,0,-16,52
-1,1604,1626,-22,-3,-681,130
-1,1897,1627,270,0,-521,168
1,1953,1865,88,1,62,63
1,1618,1501,117,0,601,151
-1,1792,1886,-94,0,-32,56
1,1756,1558,198,1,247,123
1,1417,1534,-117,0,3,49
1,1433,1105,328,2,31,65
-1,1508,1689,-181,-3,-39,90
-1,1602,1915,-313,-7,-179,90
1,1559,1559,0,5,171,55
1,1540,1661,-121,0,46,185
0,1502,1421,81,3,-324,151
-1,1921,1968,-47,0,-157,92
-1,1335,1654,-319,-6,-115,44
-1,1946,1982,-36,3,-153,111
1,1892,1622,270,3,103,71
-1,1346,1356,-10,-2,-405,106
1,1637,1593,44,0,909,161
1,1777,1662,115,1,29,49
1,1567,1523,44,0,-152,123
1,1722,1552,170,5,401,75
0,1461,1450,11,2,147,119
-1,1500,1703,-203,-1,-34,52
-1,1497,1401,96,0,-50,48
1,1640,1617,23,-2,135,59
-1,1571,1244,327,0,-92,90
-1,1405,1370,35,2,28,50
-1,1595,1922,-327,-10,-245,54
1,1528,1388,140,1,97,51
1,1792,1743,49,-2,-36,54
-1,1495,1818,-323,-9,-130,78
1,1591,1648,-57,1,3,137
-1,1463,1734,-271,0,-37,80
1,1491,1575,-84,-1,-84,55
1,1559,1471,88,1,128,75
-1,1588,1661,-73,-3,31,118
1,1926,1592,334,0,163,63
-1,1548,1702,-154,-7,-49,46
1,1794,1899,-105,0,-3,95
-1,1709,1542,167,0,-138,66
1,1833,1785,48,3,93,58
1,1267,1551,-284,2,193,97
-1,1668,1630,38,-9,-223,76
-1,1465,1675,-210,2,-1,68
1,1595,1676,-81,1,654,147
1,1580,1615,-35,0,22,49
1,2001,1840,161,3,67,48
1,1725,1653,72,0,168,79
1,1800,1446,354,3,183,93
-1,1478,1464,14,-5,-297,70
1,1642,1656,-14,-1,-28,73
1,1518,2042,-524,0,1,57
-1,1606,1707,-101,-3,-393,102
-1,1524,1636,-112,0,5,40
1,1644,1594,50,4,175,65
-1,1443,1803,-360,-1,-143,110
1,2016,1548,468,1,60,63
-1,1947,1899,48,0,-5,112
0,1591,1380,211,0,137,122
-1,1399,1185,214,-12,-203,44
1,1693,1393,300,2,150,99
-1,1645,1654,-9,-1,1,114
-1,2053,2018,35,-4,-329,92
1,1314,1301,13,-4,-218,83
-1,1583,1775,-192,1,-302,108
-1,1573,1522,51,-2,-68,70
1,1546,1806,-260,0,1,49
1,1695,1986,-291,1,608,227
-1,1957,1912,45,-1,-38,154
1,2038,1867,171,-4,-35,71
1,1785,1572,213,1,302,73
-1,1982,2033,-51,-3,-126,86
-1,1500,1563,-63,-2,182,96
-1,1381,1453,-72,-1,-597,100
1,1646,1583,63,0,-53,75
1,1760,1660,100,0,278,97
1,1752,1559,193,-1,-45,57
-1,1565,1791,-226,0,-146,90
1,2046,1860,186,0,4,53
1,1791,1581,210,3,99,55
1,1663,1577,86,2,199,71
1,2086,1935,151,3,129,63
1,1663,1609,54,-1,-142,87
-1,1624,1697,-73,-4,-289,72
-1,1418,1459,-41,-1,-202,96
-1,1643,1710,-67,1,-44,58
1,1978,1738,240,0,-2,75
1,1389,1414,-25,1,120,97
-1,1730,2053,-323,-2,-18,42
-1,1902,1949,-47,0,30,94
-1,1797,1558,239,0,-209,126
1,1517,1500,17,11,187,41
1,2056,1727,329,-2,29,61
0,1566,1658,-92,1,171,128
1,1560,1521,39,5,219,41
-1,1369,1409,-40,-4,-338,90
1,1301,1448,-147,-1,50,69
-1,1583,1777,-194,0,-150,68
-1,1706,1983,-277,0,-271,122
1,2060,2045,15,1,74,85
-1,1500,1486,14,-1,-60,59
1,1783,1575,208,4,211,95
-1,1642,1656,-14,0,119,72
1,1454,1540,-86,2,322,73
1,1942,1734,208,-2,3,47
-1,1662,1662,0,2,140,106
-1,1524,1372,152,0,-128,74
1,1659,1413,246,3,284,55
1,2032,2072,-40,-1,217,125
-1,1401,1960,-559,-6,-313,66
1,1688,1838,-150,-9,-26,115
1,1437,1184,253,-1,82,61
-1,1568,1789,-221,-4,-314,68
1,1648,1500,148,0,-17,85
1,1733,1703,30,0,-4,47
-1,1453,1372,81,0,-177,90
1,1950,1554,396,-5,55,74
1,1809,1765,44,0,69,70
1,1799,1595,204,2,69,63
1,1280,1455,-175,4,124,69
1,1760,1599,161,-1,-7,53
1,1795,1561,234,0,125,85
-1,1961,1892,69,-7,-162,80
1,2058,1221,837,7,255,51
1,2047,1588,459,0,2,67
1,1613,1396,217,3,109,56
-1,1353,1466,-113,0,188,82
-1,1779,1593,186,0,-4,48
1,1955,1941,14,0,-2,83
-1,1469,1408,61,-3,-221,88
1,1962,1400,562,-1,-24,49
-1,1359,1309,50,-4,-192,134
-1,1586,2049,-463,0,2,74
1,1561,1441,120,1,147,55
0,1626,1701,-75,-3,-2,131
-1,1439,1473,-34,-8,-376,74
-1,1433,1568,-135,3,95,72
-1,1388,1330,58,0,-98,86
1,1761,1565,196,-4,-91,61
-1,1508,1443,65,-1,-71,68
0,1692,1652,40,-1,110,152
-1,1567,1726,-159,-6,-186,58
1,2050,1638,412,-2,12,45
1,1990,1743,247,0,16,75
-1,1604,1664,-60,1,-32,76
1,1575,1426,149,1,22,71
1,1514,1514,0,3,165,53
-1,1419,1582,-163,-1,-80,74
-1,1930,1915,15,-3,34,74
-1,1425,1524,-99,0,-155,102
1,1758,1199,559,1,17,44
-1,1617,1905,-288,0,-139,126
-1,1973,1723,250,0,-223,76
-1,1375,1389,-14,-1,-72,63
-1,1494,1456,38,-1,-194,90
1,1429,1653,-224,0,4,44
1,2128,1504,624,-2,21,49
-1,1701,1555,146,0,-7,46
1,1412,1588,-176,-1,7,63
1,1368,1452,-84,2,48,51
1,1759,979,780,7,805,111
1,1607,1945,-338,2,206,97
-1,1430,1197,233,0,3,88
1,1623,1389,234,7,268,55
-1,1385,1653,-268,-4,-185,74
1,1880,1927,-47,0,54,59
-1,1283,1569,-286,-1,190,68
-1,1594,1406,188,4,297,60
-1,1268,1447,-179,0,-64,114
-1,1566,1925,-359,-1,-40,47
-1,1511,1919,-408,-3,-6,44
-1,1739,1995,-256,-3,4,51
1,1343,1473,-130,-3,-181,77
1,1364,1455,-91,4,152,58
-1,1714,1695,19,-3,-123,64
-1,1423,1577,-154,-1,-281,78
-1,1377,1831,-454,-8,-137,48
1,1921,1509,412,2,124,67
1,1914,1926,-12,-1,30,75
1,1471,1384,87,8,360,61
1,1584,1416,168,3,-54,63
1,1421,1647,-226,0,30,47
1,2099,1921,178,0,36,87
-1,1628,1966,-338,-3,-20,46
1,1888,1844,44,2,-28,103
1,1573,1756,-183,-1,94,58
-1,1482,1468,14,-2,-30,50
1,1587,1317,270,0,4,57
1,2131,1595,536,1,167,65
1,1507,1923,-416,-1,-44,73
1,1500,1313,187,3,251,59
-1,1382,1495,-113,-4,-207,70
-1,1767,1735,32,0,-77,114
-1,1336,1452,-116,6,273,97
1,1359,1351,8,-1,50,75
1,1441,1378,63,4,143,65
1,1500,1494,6,1,195,101
1,1909,1613,296,6,65,45
1,1594,2133,-539,-1,-3,131
0,1893,1673,220,0,68,147
1,1760,1779,-19,-2,120,59
-1,1339,1395,-56,-3,-99,82
-1,1747,1667,80,2,103,72
-1,1628,1625,3,0,-177,132
-1,1545,1443,102,-5,-104,58
1,1618,1336,282,0,49,51
-1,1500,1320,180,-2,-257,112
1,1702,1721,-19,0,-1,83
1,1594,1482,112,0,204,106
-1,1622,2053,-431,-4,-224,80
1,1972,1664,308,0,10,72
-1,1729,2105,-376,-2,-82,56
-1,1914,2106,-192,0,-75,122
1,1590,1413,177,7,125,45
-1,1740,1591,149,0,-24,84
1,1650,1573,77,0,593,171
-1,1413,1325,88,-10,-408,88
-1,1543,1450,93,0,16,62
-1,1681,2058,-377,0,-146,92
-1,1399,1596,-197,-10,-74,40
1,1535,1560,-25,2,58,143
-1,1773,1747,26,0,-52,105
1,2108,1726,382,0,8,53
-1,1661,1978,-317,0,-7,72
1,1636,1377,259,0,198,75
-1,1878,1767,111,-9,-53,44
-1,1310,1484,-174,-2,-2,40
-1,1665,1620,45,-9,1,46
-1,1754,1778,-24,-2,-95,56
1,1374,1402,-28,-3,-36,49
1,1445,1369,76,2,70,63
-1,1676,2064,-388,0,-96,76
1,1525,1581,-56,2,325,61
1,1855,1822,33,0,68,103
-1,1723,2111,-388,0,-21,58
-1,1291,1566,-275,-15,-237,44
-1,1645,1518,127,1,264,90
-1,1621,1530,91,-5,-111,42
-1,1633,1637,-4,0,-65,68
1,2067,1673,394,0,41,71
-1,1491,1609,-118,1,-48,56
-1,1804,1774,30,-2,-36,114
-1,1308,1368,-60,-2,-91,54
1,1568,1538,30,16,592,61
1,1640,1465,175,3,185,87
-1,1271,1461,-190,3,117,60
-1,1671,2069,-398,0,-37,64
0,1686,1373,313,0,19,111
-1,1528,1578,-50,0,-443,136
1,1743,979,764,14,304,51
1,2114,1721,393,1,73,65
1,1988,1552,436,0,11,71
-1,1500,1500,0,-1,-396,110
1,2072,1669,403,0,47,71
0,1876,1812,64,1,200,218
1,1758,1759,-1,0,120,117
1,1895,1797,98,-1,60,69
1,1607,1662,-55,3,103,49
-1,1389,1588,-199,-7,-262,76
-1,1415,1492,-77,-5,-61,44
-1,1714,1725,-11,-1,-251,72
-1,1216,1229,-13,1,81,54
-1,1386,1518,-132,0,-641,140
1,1470,1545,-75,-1,-40,105
1,1545,1693,-148,0,-5,47
-1,1334,1607,-273,-4,-533,137
-1,1660,1627,33,0,-164,82
-1,1666,2075,-409,-2,-44,74
-1,1588,1518,70,-9,-37,104
1,1646,1363,283,1,119,81
-1,1740,1851,-111,-2,-127,79
1,1907,1948,-41,0,-2,91
1,1548,1644,-96,-9,29,99
-1,1629,1544,85,-4,-65,50
-1,1613,1619,-6,1,-109,82
-1,1260,1699,-439,-7,-176,48
0,1713,1992,-279,-1,-112,163
-1,1863,1926,-63,1,-42,58
1,2077,1664,413,-2,140,79
1,1591,1458,133,0,-23,105
-1,1249,1050,199,3,31,108
-1,1626,2055,-429,0,-104,70
-1,1872,1814,58,0,19,124
-1,1662,1337,325,4,82,62
-1,1628,1701,-73,-1,-30,56
1,1496,1344,152,1,38,45
1,1515,1475,40,5,146,61
-1,1432,1404,28,2,58,46
1,2080,1662,418,0,118,99
-1,1896,1601,295,0,-7,74
-1,1721,1474,247,-3,-354,102
1,1678,1561,117,4,513,101
-1,1457,1460,-3,-1,-57,72
1,1146,1275,-129,2,6,45
-1,1501,1542,-41,-7,-388,62
1,1747,1769,-22,0,3,83
0,1639,1922,-283,0,-29,133
-1,1359,1358,1,-5,-102,50
1,1773,1660,113,0,-60,99
1,1653,1339,314,2,280,65
-1,1701,1904,-203,0,-40,64
1,1381,1265,116,1,193,57
1,1387,1567,-180,1,-8,41
1,2131,2082,49,0,167,133
-1,1598,1634,-36,-1,-169,112
1,1781,1651,130,0,11,59
1,1482,1525,-43,3,-2,41
-1,1903,1826,77,0,18,74
-1,1376,1425,-49,1,-28,46
1,1788,1640,148,-7,74,95
1,1530,1572,-42,9,461,71
-1,1399,1963,-564,-4,-596,100
-1,1697,1928,-231,0,-15,84
-1,1569,1562,7,1,-466,123
-1,1403,1734,-331,-3,-50,46
-1,1495,1513,-18,0,-120,100
-1,2086,2047,39,1,-24,82
-1,1782,1913,-131,-3,-74,52
1,1590,1631,-41,0,1,61
-1,1657,1685,-28,0,-335,145
1,1792,1934,-142,-1,-15,53
1,1842,1807,35,0,-2,61
1,1286,1641,-355,-9,-89,47
1,1766,1621,145,-1,257,103
-1,1388,2079,-691,-6,-113,48
-1,1258,1481,-223,0,-81,85
-1,1427,1447,-20,-11,-161,50
-1,1651,1653,-2,-1,-17,50
-1,1524,1656,-132,-1,107,74
1,2070,2077,-7,0,167,113
-1,1757,1628,129,-9,-235,46
-1,1611,1647,-36,-4,-101,54
1,1521,1646,-125,-1,154,66
1,1758,1760,-2,-1,-1,57
1,1552,1506,46,-1,96,89
1,1473,1384,89,10,81,45
1,1521,1400,121,0,18,53
-1,1491,1713,-222,-1,123,130
-1,1376,1481,-105,-7,-339,56
-1,1336,1618,-282,-8,-721,82
-1,1742,1820,-78,-8,-162,50
1,1580,1620,-40,1,104,51
-1,1466,1503,-37,-1,-543,202
-1,1253,1439,-186,-6,-333,86
1,2062,1694,368,-1,120,89
-1,1687,1482,205,-2,-231,117
-1,1563,1963,-400,-1,-109,74
-1,1330,1436,-106,-12,-258,56
-1,1660,1749,-89,2,97,52
1,1773,1500,273,-1,-73,75
1,1370,1404,-34,0,103,81
-1,1519,1631,-112,0,-15,64
1,2070,1795,275,0,5,53
1,1777,1261,516,-8,1,45
1,1745,1966,-221,4,83,57
-1,1482,1556,-74,-6,-425,124
-1,1351,1564,-213,-4,-121,58
1,1768,1603,165,0,-305,111
1,1531,1482,49,3,261,61
-1,1337,1662,-325,-14,-546,64
-1,1229,1416,-187,1,0,108
-1,1260,1779,-519,-1,-36,68
-1,1791,2075,-284,0,-9,70
-1,1554,1367,187,2,38,84
0,1461,1312,149,8,629,71
1,1614,1320,294,13,240,43
1,1631,1584,47,0,-32,75
1,1434,1452,-18,7,541,89
-1,1839,1757,82,2,-1,62
1,1780,1500,280,-1,-269,115
0,1333,1413,-80,5,727,73
1,1762,1572,190,2,63,51
1,1659,1419,240,2,68,63
-1,1562,1945,-383,-1,-62,68
-1,1767,1784,-17,-1,-80,86
1,1289,1444,-155,-10,-48,77
-1,1382,1390,-8,0,-39,70
-1,1438,1410,28,-5,-146,62
1,1557,1638,-81,-2,-23,53
-1,1322,1519,-197,-6,-258,70
-1,1797,2066,-269,0,1,66
1,1948,2109,-161,0,-227,85
1,1937,1368,569,0,163,79
1,1324,1407,-83,-1,823,149
1,1756,1286,470,-3,-13,41
1,1608,1558,50,0,6,83
1,1757,1561,196,0,-16,73
-1,1549,1707,-158,0,-281,78
-1,1247,1752,-505,-12,-1033,138
1,2090,1967,123,0,66,75
1,2071,1792,279,1,40,43
1,1500,1128,372,6,239,57
-1,1567,1564,3,0,-30,58
-1,1639,1509,130,-5,-136,104
0,1537,1315,222,1,27,115
-1,1620,1844,-224,-4,-86,48
1,1431,1422,9,-1,48,66
1,1541,1473,68,3,438,121
1,1762,1555,207,1,118,79
1,1558,1572,-14,3,134,47
1,1428,1309,119,6,123,53
-1,1199,1597,-398,-4,-216,82
1,1325,1272,53,-1,145,83
0,2107,1950,157,2,-299,103
-1,1415,1451,-36,-1,-687,124
1,1402,1371,31,1,108,85
-1,1666,1717,-51,1,44,60
1,1704,1640,64,0,21,43
1,1426,1500,-74,-6,-221,73
-1,1724,1849,-125,-1,-76,63
1,1955,2102,-147,-3,-82,59
1,1714,1543,171,-2,-148,73
1,1618,1682,-64,0,2,83
-1,1543,1550,-7,0,16,88
-1,1108,1560,-452,1,-15,70
-1,1592,1759,-167,-14,-258,42
-1,2084,1973,111,-1,-183,106
-1,1554,1865,-311,0,-6,46
-1,1436,1575,-139,-1,-83,72
1,1767,1639,128,3,15,41
-1,1669,1632,37,-2,-172,70
-1,1525,1316,209,1,-17,46
-1,1990,2067,-77,-3,-224,80
-1,1568,1750,-182,-6,-462,96
0,1553,1408,145,1,164,91
-1,1726,1833,-107,-5,-83,60
1,1561,1531,30,1,108,69
-1,1547,1516,31,-3,0,61
1,1531,1695,-164,3,289,109
1,1705,1528,177,2,35,61
-1,1665,1717,-52,-5,-88,46
-1,2077,1980,97,-1,-24,52
1,1775,1505,270,3,304,73
-1,1191,1311,-120,-5,-625,84
1,1377,1379,-2,0,-86,69
1,1462,1405,57,0,597,149
-1,1673,1581,92,0,12,76
-1,1996,2061,-65,-2,-144,78
-1,1323,1429,-106,-6,5,116
-1,1551,1582,-31,-3,-118,63
-1,1645,1668,-23,0,-30,64
1,1604,1575,29,6,407,67
1,1634,1503,131,1,527,147
1,2071,1986,85,0,-190,119
1,1666,1713,-47,-3,-37,47
-1,1424,1255,169,-4,-279,88
1,1500,1303,197,1,91,67
-1,1539,1413,126,3,28,72
1,1311,1245,66,0,161,69
1,1764,1841,-77,-2,-35,65
-1,1976,2081,-105,-1,-101,84
-1,1554,1598,-44,0,-5,54
-1,1548,1219,329,-4,23,40
0,1319,1181,138,-3,-761,166
1,1719,1652,67,-2,-45,115
-1,1537,1549,-12,-2,-95,60
1,1779,1541,238,2,188,71
1,1726,1655,71,1,51,59
-1,1700,1678,22,0,41,58
-1,1634,2089,-455,-8,-257,54
-1,1689,2042,-353,-1,-45,90
1,1941,1495,446,3,121,69
-1,1333,1508,-175,-7,-198,48
1,1529,1348,181,0,63,61
-1,1026,1243,-217,2,-12,74
-1,1541,1637,-96,-3,-638,126
1,1443,1498,-55,-2,-26,45
-1,1312,1603,-291,-11,-199,48
1,1609,1774,-165,0,285,179
1,1783,1778,5,1,-10,63
-1,1446,1778,-332,-6,-55,62
-1,1632,2091,-459,0,-115,84
1,1500,1320,180,-2,-26,53
-1,1484,1672,-188,-1,-11,48
-1,1735,1709,26,0,-7,42
1,1524,1430,94,-1,28,67
1,1258,1519,-261,0,6,61
-1,1272,1519,-247,-2,-5,40
1,1652,1642,10,0,31,57
1,2093,1534,559,1,54,61
1,1531,1580,-49,3,77,47
0,1317,1767,-450,6,401,74
1,1521,1640,-119,0,66,63
1,1902,1758,144,0,97,91
1,1651,1599,52,4,368,91
1,1944,1739,205,0,154,57
1,1612,1540,72,2,424,85
1,1706,1390,316,0,30,72
1,1508,1466,42,4,192,87
-1,1781,1679,102,-9,-89,91
1,1546,1443,103,0,65,95
1,2094,1757,337,-2,-43,47
-1,1653,1555,98,-1,-138,88
1,1829,1460,369,3,371,73
-1,1815,1788,27,-3,-368,94
-1,1332,1227,105,-8,-390,132
-1,1622,1814,-192,-1,-71,111
-1,1522,1421,101,-23,-339,40
1,1493,1315,178,1,13,59
-1,1754,2097,-343,0,12,56
1,1836,1910,-74,-1,-17,41
1,1498,1713,-215,-3,-81,61
1,1436,1495,-59,0,145,83
-1,1339,1408,-69,5,251,88
-1,1518,1533,-15,-1,-36,60
-1,1407,1566,-159,-1,-5,49
-1,1767,1658,109,2,69,64
1,1408,1274,134,0,297,83
0,1631,1650,-19,0,181,128
-1,1894,1849,45,0,-22,104
1,1709,1210,499,-2,130,103
-1,1725,2217,-492,0,-29,82
1,1794,1500,294,3,833,129
-1,1661,1652,9,-2,-39,48
-1,1471,1449,22,2,-167,118
1,1954,1840,114,1,10,65
-1,1436,1640,-204,-1,-101,58
-1,1270,1535,-265,1,-104,112
-1,1550,1309,241,1,133,98
1,1635,1746,-111,5,607,103
1,1442,1301,141,0,156,66
-1,1448,1500,-52,-3,-36,60
-1,1589,1756,-167,-1,-64,62
1,1462,1543,-81,-8,-110,73
-1,2001,1820,181,-4,-123,58
-1,1509,1465,44,-13,-67,40
0,1753,1526,227,0,-6,129
-1,1800,1803,-3,-2,62,72
1,1722,1701,21,1,115,61
1,1861,1672,189,-6,55,59
-1,1543,1468,75,-3,-348,97
-1,1335,1285,50,-1,-195,90
-1,1539,1578,-39,0,6,64
-1,1247,1431,-184,0,-2,44
0,1425,1435,-10,4,665,117
-1,1798,1796,2,-3,-184,90
-1,1631,1713,-82,0,-511,114
0,1599,1750,-151,0,552,156
-1,1519,1497,22,-2,-23,64
-1,1500,1577,-77,4,68,46
1,1690,1740,-50,1,86,67
-1,1711,1462,249,0,2,40
1,1241,1287,-46,-3,-126,85
-1,1614,1569,45,-1,-117,62
1,1839,1720,119,-1,191,91
-1,1667,1867,-200,-1,2,44
1,1656,1561,95,-1,-31,69
1,1437,1254,183,-5,-14,57
0,1481,1691,-210,0,58,94
-1,1476,1529,-53,-5,-139,57
1,1466,1406,60,9,322,57
1,1872,1661,211,3,208,103
1,1787,1582,205,1,29,67
1,1851,1879,-28,2,253,97
1,1675,1572,103,1,278,75
-1,1265,1537,-272,0,2,62
1,1723,1589,134,0,104,103
-1,1475,1573,-98,-1,-59,72
1,1713,1848,-135,7,311,75
1,1508,1518,-10,3,135,65
1,1581,1746,-165,-2,68,69
1,1832,1763,69,-1,-25,63
1,1649,1496,153,3,268,107
-1,1656,1877,-221,0,7,54
1,2101,1522,579,2,119,91
1,1651,1642,9,0,137,97
1,1792,1571,221,-1,-1,61
1,1255,1238,17,0,-42,61
-1,1538,1442,96,1,-44,74
-1,1260,1400,-140,-6,-213,81
1,1986,1487,499,1,-61,71
1,1528,1384,144,0,354,113
-1,1348,1426,-78,4,-66,92
1,1830,1962,-132,1,-30,69
1,1699,1450,249,-2,5,41
-1,1651,1647,4,-3,-8,58
1,2043,1811,232,0,-4,85
1,1797,1566,231,1,-3,81
1,1865,1500,365,2,70,47
-1,1544,1392,152,-1,-37,72
-1,1532,1382,150,-2,-374,114
-1,1700,1523,177,1,-37,56
-1,1665,1676,-11,-1,-113,74
1,1519,1466,53,-5,-36,45
-1,1507,1651,-144,-2,-333,134
-1,1804,2048,-244,0,8,50
0,1754,1869,-115,0,-193,136
1,1532,1500,32,1,243,61
1,2054,1799,255,-4,-22,57
-1,1719,1882,-163,-1,-102,92
1,1467,1353,114,-2,46,118
0,1455,1169,286,-2,-86,58
-1,1500,1275,225,-16,-843,88
0,1793,2059,-266,0,59,136
1,1377,1536,-159,5,197,65
-1,1522,1628,-106,0,-363,92
1,1604,1563,41,0,50,53
1,1232,1437,-205,1,15,42
-1,1658,1500,158,6,107,52
0,1762,1832,-70,1,26,83
-1,1476,1647,-171,2,44,54
1,1583,1435,148,-4,-170,79
1,2051,1802,249,-2,-92,63
-1,1708,1690,18,-4,-66,54
1,1758,1864,-106,1,117,135
-1,1951,1841,110,0,-75,98
-1,1406,1561,-155,-3,-114,118
1,1470,1533,-63,0,103,139
-1,1537,1448,89,-6,-206,62
1,1471,1086,385,3,288,75
1,1633,1766,-133,0,55,107
-1,1516,1946,-430,-4,-169,60
1,1393,1042,351,-1,42,77
1,1328,1435,-107,-5,232,81
1,2056,1722,334,0,4,41
-1,1447,1453,-6,-4,-130,62
-1,1181,1622,-441,-1,-289,76
1,1475,1488,-13,-6,-46,59
-1,1802,1524,278,-4,34,78
-1,1251,2059,-808,-2,-174,82
1,1277,1285,-8,-6,-32,57
1,1637,1511,126,2,234,91
1,1948,1514,434,3,42,47
-1,1553,2060,-507,-5,-336,72
-1,1486,1710,-224,-1,-72,79
1,1520,1483,37,5,97,50
1,2061,1551,510,-2,6,49
-1,1645,1814,-169,3,-52,118
1,1524,1462,62,1,-21,77
1,1614,1644,-30,2,73,51
1,1848,1643,205,2,39,47
1,1754,1250,504,0,14,45
-1,1473,1529,-56,0,-6,49
1,1288,1027,261,11,534,57
-1,1658,1637,21,0,-90,100
1,1431,1541,-110,-2,-37,59
1,1645,1428,217,1,65,52
1,1931,1481,450,-4,276,121
0,1783,1755,28,-1,371,138
1,1624,1179,445,4,95,55
1,1547,1234,313,6,135,47
-1,1576,1552,24,-2,-333,115
-1,1298,1362,-64,-7,-1313,140
-1,1230,1552,-322,-1,10,44
1,1576,1539,37,0,-47,49
-1,1720,1764,-44,1,87,84
1,1533,1453,80,7,149,51
-1,1158,1757,-599,-15,-974,72
1,1842,1913,-71,-1,-70,131
1,1897,1909,-12,3,151,73
1,1908,1898,10,1,81,85
1,1698,1565,133,0,257,89
-1,1500,1714,-214,-1,-573,102
1,1566,1514,52,-6,487,108
1,1887,1918,-31,4,227,57
1,1862,1749,113,-3,-147,69
1,1918,1887,31,-1,134,75
-1,1285,1429,-144,1,-161,112
1,1476,1390,86,4,301,73
1,1602,1620,-18,2,224,103
1,1381,975,406,13,555,59
1,1857,1870,-13,2,16,57
-1,1877,1907,-30,-2,6,60
1,1324,1514,-190,6,81,47
-1,1504,1575,-71,-1,-113,109
1,1870,1857,13,0,425,153
-1,1916,1867,49,-2,-65,44
1,1705,1569,136,1,97,65
1,1867,1916,-49,6,247,55
0,1296,1334,-38,0,407,129
-1,1905,1879,26,0,-242,86
1,1713,1818,-105,1,177,71
-1,1528,1514,14,0,-45,80
1,1765,1619,146,2,149,59
-1,1891,1894,-3,1,142,107
1,1381,1440,-59,9,209,49
1,1484,1381,103,6,258,151
1,1528,1660,-132,0,-108,109
-1,1880,1769,111,-1,-362,76
1,1770,1727,43,0,-3,47
1,1508,1366,142,0,-2,51
1,1904,1880,24,1,517,93
1,1649,1685,-36,5,368,81
1,1814,1867,-53,3,166,67
-1,1427,1396,31,-10,-393,58
-1,1852,1552,300,-4,-71,50
-1,1683,1470,213,-1,-70,80
1,1952,1717,235,3,81,41
1,1338,1526,-188,1,365,97
-1,1612,1773,-161,0,-89,64
1,1854,1870,-16,-9,-69,83
1,1426,1398,28,0,6,57
1,1608,1615,-7,4,147,61
-1,1410,1415,-5,0,-137,69
1,1619,1492,127,1,5,49
-1,1859,1866,-7,-10,-125,60
1,967,1383,-416,-13,-268,49
-1,1301,1500,-199,0,-85,74
1,1387,1436,-49,6,162,61
1,1932,1744,188,0,10,71
-1,1559,1649,-90,-1,-303,126
1,1797,1590,207,4,34,43
1,1376,1508,-132,9,241,52
1,1418,1353,65,0,249,89
-1,1674,1708,-34,0,5,56
1,1602,1619,-17,0,8,57
-1,1712,1877,-165,-5,-431,78
-1,1333,1544,-211,0,-8,68
1,1493,1392,101,0,18,53
-1,1518,1705,-187,-1,-45,100
1,1780,1606,174,4,209,79
-1,1626,1716,-90,0,25,82
1,1681,1394,287,15,373,45
-1,1211,1520,-309,4,-87,82
1,1608,1615,-7,9,77,47
-1,1883,1851,32,0,1,60
-1,1356,1579,-223,-9,-472,91
-1,1507,1711,-204,-2,-97,62
-1,1402,1543,-141,-5,-168,50
-1,1266,1527,-261,2,-124,82
-1,1327,1111,216,-2,-94,68
1,1384,1501,-117,5,501,139
1,1622,1564,58,-1,81,125
1,1717,1497,220,0,122,107
-1,1666,1707,-41,1,-48,70
-1,1739,1618,121,0,-58,68
1,1514,1678,-164,-1,-10,53
1,1357,1351,6,10,578,79
1,1680,1491,189,-1,-19,73
-1,1722,2159,-437,1,70,60
-1,1230,1655,-425,-6,-179,40
0,1099,1373,-274,0,207,152
-1,1871,1883,-12,0,-44,84
-1,1584,1500,84,-16,-716,95
1,1636,1517,119,3,93,51
1,1719,1646,73,1,163,73
1,2161,1720,441,0,32,63
1,1657,1224,433,2,285,81
-1,1780,1599,181,0,-8,54
-1,1408,1567,-159,0,-279,122
1,1909,1861,48,-5,-22,51
-1,1513,1556,-43,-11,-53,48
-1,1718,1848,-130,-2,-36,44
1,1492,1441,51,-4,-185,133
1,1932,1852,80,0,61,89
-1,1500,1602,-102,-1,-7,76
1,2164,1855,309,2,226,73
1,1701,1466,235,6,15,40
0,1661,1632,29,-3,-65,55
-1,1311,1738,-427,-2,-236,124
-1,1852,2168,-316,-3,-244,73
1,1844,1951,-107,1,76,79
1,2172,1849,323,0,2,77
1,1398,1713,-315,-1,112,123
1,1921,2061,-140,-1,-23,53
-1,1845,2176,-331,-3,-86,64
-1,1633,1660,-27,2,37,66
1,2179,1842,337,0,-16,65
-1,1644,1667,-23,1,14,54
-1,1396,1146,250,-8,-502,82
-1,1256,1538,-282,-9,-688,92
-1,1951,2042,-91,-6,-235,96
-1,1744,1950,-206,0,-42,65
1,1629,1512,117,0,-4,57
-1,1474,1495,-21,0,-7,98
0,1839,2183,-344,-1,-67,109
1,2176,1854,322,1,94,59
-1,1055,1422,-367,-2,-275,76
1,1710,1602,108,-4,-76,51
-1,1677,1633,44,0,-32,60
-1,1854,2176,-322,0,-551,144
1,2052,1935,117,-1,303,97
1,2172,1848,324,0,-3,55
-1,1340,1591,-251,-3,-308,100
-1,1845,2176,-331,-4,-59,50
1,1555,1309,246,4,185,59
-1,1668,1956,-288,-6,-146,72
-1,1115,1365,-250,-1,-10,66
1,1671,1623,48,-1,2,111
1,1740,1505,235,-5,71,91
-1,1729,1763,-34,0,-5,66
1,2180,1842,338,0,181,93
1,1641,1290,351,-1,-17,43
1,1851,1751,100,-1,-63,75
1,1703,1550,153,-3,-42,47
1,1609,1710,-101,-1,154,69
-1,1839,2061,-222,0,-234,106
1,1744,1252,492,0,4,53
0,1745,1710,35,0,-176,143
1,1500,1630,-130,0,7,51
-1,1500,2118,-618,-3,-64,54
-1,1646,1501,145,1,23,66
1,1518,1105,413,-3,-24,41
-1,1300,1680,-380,1,50,54
-1,1686,1960,-274,0,-226,138
-1,1497,1619,-122,-9,-811,94
1,1397,1250,147,2,102,46
-1,1516,1630,-114,-1,-4,64
1,1538,1613,-75,-1,-77,121
1,1962,1719,243,2,218,75
-1,1626,1489,137,-4,-155,94
-1,1560,1561,-1,3,68,86
-1,1825,1619,206,0,-28,60
1,1101,1520,-419,-2,126,107
-1,1582,1349,233,-1,-172,74
0,1596,1303,293,1,108,80
-1,1638,1508,130,-1,53,76
-1,2027,1921,106,-3,-28,50
1,1714,1967,-253,-1,-115,123
1,1405,1052,353,1,91,69
1,1382,1243,139,13,197,45
1,1964,1682,282,-2,18,43
1,1505,1611,-106,-2,-18,54
-1,1523,1622,-99,1,-17,68
-1,1482,1744,-262,2,5,40
1,1995,1969,26,-2,41,51
1,1678,1968,-290,0,198,139
-1,1729,2138,-409,0,35,80
-1,1389,1351,38,-2,-259,86
-1,1593,1765,-172,0,-16,44
1,1467,1513,-46,-3,172,117
1,1564,1358,206,4,89,45
1,1630,1515,115,-5,1,55
-1,1613,1525,88,2,91,66
1,2141,1733,408,-1,81,97
-1,1597,1757,-160,0,-37,54
0,1772,1609,163,-5,-151,110
1,1526,1524,2,5,649,115
-1,1558,1731,-173,-11,-244,86
-1,1723,2011,-288,-3,2,52
-1,1538,1416,122,-4,-73,56
1,2144,1723,421,0,95,79
1,2015,1952,63,0,306,79
1,1808,1715,93,0,91,83
-1,1286,1593,-307,-10,-149,48
-1,1432,1538,-106,0,-6,44
1,1937,2147,-210,0,5,63
0,1288,1417,-129,-3,-33,55
1,2026,1810,216,0,-24,71
1,1235,1363,-128,4,113,81
-1,1485,1738,-253,0,4,52
1,1554,1541,13,0,3,77
1,2180,2123,57,-2,69,65
1,1601,1296,305,8,289,67
1,2032,1721,311,-3,-33,43
-1,1803,1841,-38,-3,-163,64
-1,1766,1753,13,0,-4,132
1,1277,1596,-319,1,209,91
-1,1697,1919,-222,0,-205,102
-1,1490,1578,-88,0,-20,68
1,1551,1976,-425,1,129,61
1,1283,1529,-246,-7,-132,61
-1,1742,1698,44,0,-91,66
-1,1813,1048,765,15,432,50
1,1706,1556,150,0,0,43
-1,1494,1632,-138,-8,-237,58
1,1627,1649,-22,1,39,63
1,1926,1571,355,4,106,49
-1,1529,1564,-35,-1,-51,117
1,1948,1614,334,1,71,74
-1,1571,1926,-355,0,5,48
-1,1753,1775,-22,0,4,76
1,1817,1792,25,2,145,71
-1,1766,1905,-139,-2,-224,82
-1,1252,1348,-96,-4,-132,62
1,1746,1390,356,1,13,43
1,1523,1666,-143,4,328,88
-1,1594,1786,-192,1,1,54
-1,1242,1356,-114,-9,-286,61
1,1454,1678,-224,1,-6,53
1,1937,1758,179,0,-405,107
1,1956,1792,164,-4,-79,59
1,1457,1462,-5,-1,54,65
-1,1723,1945,-222,-5,-136,72
1,1933,1729,204,0,0,123
1,2119,1912,207,1,85,95
-1,1538,1574,-36,-1,-16,86
1,1080,1790,-710,-2,289,75
-1,1906,2125,-219,-2,-228,100
1,1607,1211,396,-2,175,79
-1,1269,1204,65,0,-18,58
1,1364,1234,130,1,154,120
-1,1786,1969,-183,-6,23,82
1,1473,1500,-27,0,317,145
-1,1588,1639,-51,-3,-238,116
-1,1519,1481,38,-12,-47,74
1,1444,1500,-56,11,195,52
-1,1658,1471,187,1,-65,135
1,1791,1588,203,0,-176,111
-1,1718,1780,-62,-1,-65,100
-1,1433,1487,-54,3,8,75
1,1524,1397,127,1,12,65
-1,1607,1803,-196,0,-83,120
1,1429,1289,140,1,169,91
-1,1042,1201,-159,-2,-393,96
1,1660,1713,-53,1,146,99
-1,1487,1456,31,1,-73,104
-1,1362,1294,68,0,21,42
-1,1498,1611,-113,-10,-158,50
-1,1943,1901,42,1,-415,110
1,1645,1400,245,6,866,95
1,1599,1734,-135,2,292,109
1,1802,1577,225,1,61,53
1,1376,1392,-16,1,162,89
-1,1749,1488,261,1,-481,122
-1,1514,1430,84,-5,-408,100
0,1440,1184,256,1,39,114
1,1371,1237,134,0,39,69
-1,1226,1500,-274,-4,-157,62
-1,1584,1506,78,-1,135,94
1,1649,1578,71,1,337,147
-1,1931,1914,17,0,-21,84
-1,1282,1437,-155,3,-184,106
1,1556,1591,-35,-2,-58,51
-1,1807,1913,-106,1,18,58
-1,1525,1507,18,-4,-18,44
1,1451,1301,150,18,250,45
1,1627,1348,279,-4,459,129
-1,1579,1520,59,-4,-180,106
-1,1378,1465,-87,-4,-92,54
1,1925,1854,71,1,99,67
1,1500,1686,-186,0,65,71
-1,1393,1415,-22,-2,-238,86
-1,1827,1978,-151,0,-15,108
-1,1678,1729,-51,0,-15,54
0,1511,1367,144,0,-504,192
1,1500,1615,-115,0,1,89
0,1528,1646,-118,-1,-26,56
1,1691,1437,254,3,36,45
-1,1845,1934,-89,-1,-364,126
-1,1221,1486,-265,-4,-140,56
-1,1725,1533,192,-3,6,96
1,1739,1669,70,0,-16,65
1,1462,1595,-133,-4,74,107
1,1538,1608,-70,5,144,53
1,1518,1443,75,2,137,63
-1,1601,1717,-116,-1,-33,64
1,1370,1276,94,4,367,83
-1,1577,1344,233,3,-167,100
1,1431,1676,-245,2,130,108
1,1433,1382,51,6,717,95
-1,1537,1722,-185,-2,-108,59
1,1952,1709,243,0,-13,141
1,1781,1807,-26,0,295,121
1,1507,1344,163,6,57,41
1,1852,1488,364,-1,-108,63
1,1642,1679,-37,1,85,113
1,1544,1468,76,0,-21,85
1,1568,1549,19,3,181,87
-1,1311,1605,-294,-3,-258,70
1,1432,1423,9,-1,-43,104
1,1956,1870,86,1,18,49
-1,1135,1028,107,0,59,54
1,1714,1353,361,1,77,76
1,1963,1774,189,-3,-58,57
-1,1922,1737,185,0,-36,106
-1,1604,1731,-127,2,209,96
-1,1825,2088,-263,0,-28,122
-1,1478,1601,-123,-10,-1156,80
-1,1877,1965,-88,-2,-125,92
1,1609,1470,139,7,425,89
1,1585,1284,301,-1,56,67
-1,1407,1526,-119,-3,-294,96
-1,1463,1616,-153,0,-6,52
1,1489,1440,49,-2,-3,53
-1,1867,1973,-106,-4,-36,76
1,1374,1220,154,0,63,87
1,1905,1406,499,6,200,47
-1,1677,1687,-10,0,11,90
-1,1752,1600,152,2,256,78
1,1981,1857,124,0,229,85
-1,1772,1748,24,0,-1,56
-1,1716,1843,-127,-2,-68,49
-1,1614,1757,-143,0,-46,58
-1,1589,1743,-154,-5,-145,84
-1,1329,1564,-235,0,15,102
0,1988,2092,-104,-2,-61,62
1,1989,1845,144,1,69,83
0,1615,1371,244,-6,165,106
1,1740,1357,383,-5,37,93
1,1100,1326,-226,5,557,105
-1,1497,1481,16,-7,-116,65
1,1638,1478,160,1,14,97
1,1903,1843,60,0,13,101
-1,1615,1737,-122,0,-79,76
1,1533,1683,-150,1,77,113
1,1837,1996,-159,0,48,63
1,1754,1821,-67,8,239,45
-1,1453,1508,-55,0,-133,92
1,1980,1854,126,0,31,73
1,1644,1171,473,5,65,43
1,1572,1464,108,-1,-7,45
-1,1343,1388,-45,-7,-349,78
1,1768,1866,-98,2,211,63
1,1381,1423,-42,-1,94,97
-1,1510,1596,-86,-1,-425,118
1,1851,1760,91,0,17,51
-1,1507,1404,103,-5,-474,94
1,1968,1771,197,0,108,97
-1,1354,1742,-388,-1,-35,52
-1,1540,1575,-35,-3,-158,60
1,1806,1767,39,4,93,79
1,1426,1448,-22,0,65,53
1,1701,1582,119,0,424,135
1,1906,1750,156,3,159,65
1,1757,1817,-60,-3,-20,75
-1,1652,1992,-340,0,-31,99
1,1877,1967,-90,-1,-39,57
-1,1802,1770,32,-2,-137,56
0,1751,1821,-70,-3,45,177
-1,1316,1248,68,0,0,52
-1,1781,1723,58,0,-4,94
-1,1411,1426,-15,0,-13,54
1,1492,1363,129,4,260,75
-1,1873,1984,-111,0,4,56
-1,1782,1789,-7,7,210,68
-1,1065,1252,-187,-14,-1151,94
1,1684,1602,82,1,188,127
-1,1424,1600,-176,-1,6,64
-1,1801,1771,30,-5,-72,42
-1,1801,1725,76,-6,-96,48
0,1954,1890,64,2,148,117
1,1733,1662,71,0,-5,97
-1,1783,1788,-5,-2,60,110
-1,1322,1447,-125,-1,-1045,94
1,1605,1502,103,1,89,65
-1,1444,1804,-360,0,-253,98
-1,1493,1504,-11,-2,-46,134
1,1599,1316,283,-3,81,103
-1,1689,1556,133,-2,-44,54
1,1800,1772,28,-2,-107,69
-1,1410,1418,-8,0,12,44
-1,1537,1686,-149,0,1,58
1,1593,1436,157,0,26,49
-1,1693,1750,-57,0,-57,94
-1,1269,1171,98,-7,-632,76
-1,1475,1709,-234,-5,-16,40
1,1669,1813,-144,-2,71,77
-1,1289,1421,-132,-10,-162,42
-1,1403,1494,-91,-1,-117,62
1,1892,1952,-60,0,-69,79
-1,1831,1568,263,0,14,70
1,1759,1683,76,0,7,45
1,1668,1591,77,-1,0,49
1,1807,1441,366,3,368,77
1,1529,1577,-48,0,239,121
1,1600,1714,-114,1,90,73
1,1429,1519,-90,3,71,51
1,1541,1486,55,5,102,45
1,2166,1768,398,3,105,43
-1,1684,1793,-109,-1,-129,66
1,1713,1613,100,0,139,77
1,1585,1057,528,0,506,69
-1,1674,1768,-94,-1,-57,86
-1,1328,1403,-75,1,74,58
-1,1518,1352,166,4,58,52
1,1806,1764,42,0,-1,55
-1,1350,1922,-572,-4,-371,76
-1,1502,1935,-433,-3,-326,82
-1,1497,1599,-102,-1,-9,88
1,1589,1385,204,1,49,65
1,1735,1768,-33,0,241,169
-1,1939,1904,35,0,0,84
1,1412,1203,209,0,-17,43
-1,1895,1971,-76,-3,-289,84
-1,1616,1988,-372,0,-188,120
1,1522,1542,-20,0,679,123
0,1707,1628,79,0,-37,109
-1,1429,1250,179,0,50,50
1,1698,1327,371,-2,-23,41
1,1807,1807,0,0,278,95
1,1767,1533,234,-3,-36,57
-1,1076,1402,-326,1,170,144
-1,1430,1462,-32,0,3,66
1,1491,1336,155,4,667,107
1,1989,1811,178,-4,-32,63
-1,1605,1836,-231,-6,-314,65
1,1611,1500,111,1,201,85
-1,1471,1318,153,-2,-181,76
1,1676,1803,-127,0,78,101
1,1815,1814,1,0,-7,103
-1,1397,1514,-117,1,2,42
1,1833,1808,25,-1,-35,113
1,1267,1261,6,-3,-152,105
-1,1607,1489,118,-3,-101,128
-1,1963,2169,-206,0,-233,126
1,1916,1927,-11,0,-2,42
1,1500,1605,-105,1,-275,87
-1,1613,1714,-101,-3,-48,88
1,1192,1240,-48,11,413,55
-1,1446,1580,-134,0,9,54
1,1521,1329,192,1,291,101
1,1605,1528,77,-1,-171,81
-1,1457,1420,37,0,-195,77
-1,1798,1863,-65,-1,-63,68
1,1785,1771,14,0,28,53
-1,1417,1500,-83,-3,-3,55
1,1394,1584,-190,0,8,51
-1,1525,1522,3,-1,-57,80
1,1562,1542,20,-1,29,61
0,1586,1500,86,-2,-267,132
1,1924,1363,561,0,-8,69
-1,1888,1790,98,-5,-11,54
-1,1732,1810,-78,-5,-126,84
1,1606,1538,68,0,44,50
-1,1572,1549,23,1,-204,113
1,1335,1455,-120,3,61,51
-1,1711,1957,-246,0,-25,84
1,1927,1886,41,-5,-6,53
-1,1304,1615,-311,-14,-437,54
1,1803,1852,-49,3,64,43
-1,1728,1841,-113,0,-152,74
-1,1691,1784,-93,0,-32,100
1,1213,1055,158,8,240,53
1,1999,1581,418,0,18,75
-1,1393,1412,-19,-8,-267,46
-1,1674,1676,-2,-7,-269,52
0,1962,1693,269,1,98,126
1,1761,1645,116,-1,87,67
-1,782,1467,-685,-22,-222,40
-1,1561,1975,-414,-1,-408,134
1,1633,1644,-11,0,304,77
1,1733,1705,28,-6,-177,61
1,1432,1412,20,1,19,43
-1,1701,1844,-143,0,142,98
-1,1651,1661,-10,-1,-21,58
1,1777,1615,162,0,408,133
-1,1877,1936,-59,0,-47,83
-1,1738,1815,-77,-3,-47,48
1,1613,1592,21,-2,-113,65
-1,1700,1954,-254,0,94,150
1,1503,1587,-84,0,80,163
1,1502,1476,26,0,27,49
-1,1766,1826,-60,-2,-360,90
1,1724,1689,35,-1,-48,139
1,1442,1299,143,0,134,105
1,1575,1107,468,1,328,123
1,1433,1418,15,2,86,51
1,1618,1579,39,0,22,91
1,1959,1729,230,-2,9,41
-1,1510,1467,43,0,-563,142
-1,1587,1756,-169,-3,-223,92
1,1868,1945,-77,-1,-125,87
1,1755,1522,233,3,293,89
1,1406,1584,-178,-1,-173,91
-1,1868,1694,174,0,-64,66
-1,1692,1581,111,-4,-2,78
1,1937,1666,271,7,226,66
1,1624,1582,42,1,2,53
1,1500,1480,20,10,114,41
0,1757,1613,144,-1,-78,135
-1,1730,1467,263,-1,0,50
-1,1046,1111,-65,9,603,138
-1,1450,1284,166,-10,-66,42
1,1617,1591,26,-3,-367,101
0,1718,1803,-85,0,-18,74
-1,1497,1529,-32,-2,-74,74
0,1710,1815,-105,0,28,107
1,1476,1595,-119,-6,-115,67
1,1450,1609,-159,0,311,145
-1,1783,2006,-223,-9,-142,42
1,1449,1565,-116,-5,-30,71
-1,1357,1516,-159,0,-82,56
1,1548,1429,119,3,76,51
-1,1626,1995,-369,0,-120,93
1,1724,1316,408,1,313,63
-1,1558,1491,67,1,-17,42
-1,1449,1569,-120,0,-327,204
-1,1634,1662,-28,1,-90,72
1,1576,1398,178,0,24,55
1,1723,1754,-31,0,3,63
-1,1226,1362,-136,-1,-22,46
-1,1461,1502,-41,1,-761,90
1,1507,1583,-76,0,180,99
1,1317,1329,-12,2,20,107
-1,1302,1435,-133,-5,-263,64
1,1212,1332,-120,3,535,99
1,1500,1697,-197,1,50,51
1,1759,1610,149,-4,-75,53
1,1778,1742,36,-1,-10,55
-1,1494,1463,31,-5,-91,48
1,1606,1455,151,0,293,129
-1,1763,1643,120,2,39,88
-1,1603,1721,-118,-3,51,76
-1,1323,1680,-357,-5,-220,72
1,1555,1300,255,-6,-90,53
-1,1707,1667,40,-2,-101,66
1,1932,1881,51,-2,28,65
-1,1735,1835,-100,0,-83,68
-1,1569,1521,48,-3,-137,90
-1,1523,1360,163,4,120,82
1,1412,1354,58,5,271,67
1,1599,1624,-25,-3,-95,65
-1,1556,1593,-37,0,-353,128
-1,1320,1729,-409,-3,-486,92
1,1788,1732,56,4,152,68
1,1595,1658,-63,0,-5,55
0,1925,1734,191,-1,94,90
-1,1294,1250,44,0,-329,101
1,1562,1634,-72,0,238,67
1,1687,1420,267,3,40,41
-1,1703,1991,-288,0,-14,50
1,1560,1293,267,-3,3,57
1,1539,1478,61,3,87,93
1,1746,1581,165,-2,106,63
-1,1757,1609,148,-1,93,90
1,1645,1674,-29,1,403,165
1,1727,1743,-16,3,383,115
-1,1533,1555,-22,1,60,112
-1,1843,1872,-29,-1,-40,98
-1,1276,1240,36,0,-135,88
-1,1484,1377,107,0,190,76
-1,1515,1723,-208,0,230,110
-1,1798,1993,-195,-2,-100,84
1,1552,1107,445,2,58,51
-1,1422,1510,-88,-2,-595,92
-1,1625,1731,-106,0,-356,90
1,2177,1295,882,6,277,57
-1,1384,1576,-192,1,16,60
1,1595,1551,44,2,148,73
-1,1318,1742,-424,0,-233,80
0,1505,1369,136,3,115,136
1,1730,1582,148,-1,69,147
1,1760,1531,229,9,250,43
-1,1738,1794,-56,-1,-7,44
1,1288,1444,-156,-3,-25,46
1,1576,1614,-38,2,569,123
1,1766,1553,213,-4,-331,95
1,1383,1412,-29,15,342,51
-1,1826,1833,-7,3,46,54
1,1617,1661,-44,-3,-70,51
-1,1564,1576,-12,-1,-12,62
-1,1934,1881,53,-1,-36,86
-1,1729,1686,43,0,-4,42
1,1416,1344,72,0,-12,55
-1,1582,1854,-272,-1,-289,142
-1,1566,1523,43,0,-377,150
1,1913,1714,199,0,18,53
1,1461,1548,-87,5,290,69
1,1898,1728,170,1,309,97
1,1719,1366,353,-1,392,99
-1,1400,1395,5,2,-35,76
1,1771,1548,223,-1,444,125
1,1257,1174,83,-2,-36,47
1,1330,1429,-99,-4,-379,92
1,1628,1574,54,-2,-42,56
1,1918,1581,337,5,597,107
0,1455,1567,-112,0,29,115
1,1801,1717,84,1,10,85
-1,1738,1999,-261,-1,-115,68
1,1765,1527,238,4,66,43
1,1436,1216,220,1,44,48
-1,1357,1467,-110,0,0,122
-1,1293,1396,-103,2,37,46
1,1893,1853,40,1,50,67
0,1424,1416,8,16,1303,85
1,1516,1034,482,7,125,41
1,1722,1569,153,-2,-14,137
1,1421,1231,190,1,-18,61
1,1288,1236,52,1,498,141
1,1782,1804,-22,-1,-63,63
-1,1776,1590,186,-1,-909,142
-1,1737,1698,39,0,8,59
-1,1367,1527,-160,-4,-269,60
1,1543,1689,-146,0,87,69
-1,1550,1564,-14,-1,-116,90
-1,1693,1600,93,-4,-95,82
-1,1347,1732,-385,0,0,42
-1,1791,1708,83,-4,-212,74
-1,1522,1770,-248,-1,-120,98
1,1153,1378,-225,3,463,125
1,1499,1245,254,3,185,81
-1,1775,1900,-125,-1,8,64
-1,1726,1684,42,3,64,80
-1,1559,1518,41,0,-18,60
1,1683,1706,-23,-1,-14,63
-1,1418,1815,-397,-1,-65,84
-1,1360,1527,-167,-10,-74,64
1,1390,1300,90,2,95,59
-1,1563,1729,-166,1,19,46
1,1392,1358,34,-3,-18,69
1,1391,1367,24,5,188,55
1,1459,1391,68,3,13,41
1,1642,1559,83,2,66,47
1,1858,1624,234,-11,-206,51
1,1669,1744,-75,2,128,71
1,1589,1544,45,3,147,59
1,1493,1578,-85,2,206,65
1,1546,1382,164,8,201,49
0,1736,1556,180,-1,50,117
1,1760,1708,52,1,-298,85
1,1651,1553,98,0,170,137
1,1818,1630,188,0,1,75
1,1775,1529,246,0,165,129
1,1637,1365,272,-1,10,57
1,1710,1751,-41,1,86,62
1,1464,1416,48,4,91,49
0,1539,1345,194,0,9,98
-1,1737,1903,-166,-2,-162,124
0,1922,1578,344,-5,2,113
-1,1607,1608,-1,0,-212,88
-1,1542,1565,-23,-5,-668,136
1,1619,1596,23,0,9,107
1,1930,1631,299,5,221,69
1,1840,1485,355,4,154,55
1,1457,1449,8,-6,-113,41
-1,1535,1460,75,-8,-115,46
1,1627,1942,-315,6,69,45
1,1500,1175,325,11,433,59
1,2086,1780,306,4,44,47
-1,1507,1351,156,2,-33,69
1,1825,1520,305,8,281,55
1,1606,1416,190,17,382,49
-1,1470,1514,-44,1,85,62
1,1187,1515,-328,3,240,113
0,1731,1843,-112,-1,-221,100
1,1830,1795,35,1,-98,75
1,1810,1777,33,0,146,121
-1,1521,1517,4,-11,-359,50
-1,1522,1668,-146,0,-14,78
-1,1562,1730,-168,0,-50,94
1,1689,1878,-189,3,285,87
1,1688,1473,215,0,-7,41
0,1544,1661,-117,0,34,107
1,1401,1284,117,-1,-277,95
1,1846,1629,217,-1,-30,85
-1,1629,1661,-32,1,-21,76
1,1600,1303,297,-5,-23,51
-1,1407,1376,31,-6,-72,40
1,1257,1457,-200,2,595,91
1,1739,1812,-73,2,309,59
-1,1423,1596,-173,-3,-92,50
1,1439,1278,161,-11,-113,65
-1,1566,1575,-9,0,-124,76
1,1863,1576,287,0,-15,71
1,1367,1676,-309,-1,24,56
1,1270,1446,-176,-4,-150,59
1,1553,1486,67,-2,-24,55
1,1769,1587,182,3,83,59
1,1282,1436,-154,1,92,51
-1,1779,1801,-22,0,-46,71
1,1624,1881,-257,2,217,81
1,1839,1795,44,4,303,63
-1,1501,1938,-437,-3,-121,120
1,1319,1211,108,-2,52,81
-1,1292,1428,-136,-7,-28,44
-1,1515,1675,-160,0,-31,108
1,1657,1548,109,1,126,91
-1,1737,1631,106,1,-152,126
-1,1275,1442,-167,-4,-112,52
-1,1446,1510,-64,1,-179,144
-1,1827,1500,327,-3,-177,74
1,1345,1160,185,5,403,65
1,1448,1268,180,10,338,53
-1,1416,1586,-170,0,85,134
-1,1305,1553,-248,-7,-813,120
1,1632,1603,29,-1,-8,49
1,1775,1581,194,0,-11,63
-1,1662,1589,73,0,-28,62
-1,1423,1200,223,-2,-628,118
-1,1568,1615,-47,-6,-259,58
1,1633,1638,-5,2,10,41
1,1441,1500,-59,-1,-80,80
-1,1770,1640,130,-5,-15,40
-1,1532,1620,-88,-1,-259,128
-1,1586,1911,-325,-3,-142,82
1,1723,1007,716,10,224,47
-1,1408,1533,-125,-15,-341,58
0,1626,1677,-51,0,-352,189
1,1603,1713,-110,-1,-72,71
-1,1752,1610,142,1,-535,134
-1,1445,1867,-422,-3,-220,66
1,1754,1874,-120,0,-3,67
-1,1745,1849,-104,0,169,104
-1,1584,1642,-58,2,76,50
1,1405,1356,49,4,120,53
1,1682,1509,173,0,1,53
-1,1382,1572,-190,-8,-121,40
1,1466,1316,150,5,695,109
-1,1683,1723,-40,1,21,78
1,1668,1764,-96,6,180,51
-1,1428,1737,-309,-2,-103,78
1,1328,1452,-124,-4,-104,53
-1,1670,1710,-40,2,60,54
1,1629,1558,71,0,33,83
1,1682,1597,85,1,152,67
-1,1558,1300,258,-2,-116,60
1,1503,1688,-185,-1,-51,63
-1,1781,1861,-80,-1,-23,60
-1,1363,1592,-229,-1,-54,40
1,1747,1682,65,7,561,104
-1,1297,1489,-192,-6,-47,44
1,1985,1893,92,1,132,77
-1,1651,1567,84,-2,-379,98
1,1518,1139,379,0,-15,79
-1,1293,1315,-22,3,67,53
-1,1839,1768,71,-7,-439,82
1,1774,1451,323,0,125,81
-1,1358,1316,42,-8,-84,50
-1,1536,1578,-42,-3,-182,94
1,1519,1435,84,-3,6,53
-1,1756,1752,4,2,89,114
-1,1669,1783,-114,-3,-78,46
-1,1678,1731,-53,-4,-35,66
1,1709,1607,102,1,154,81
1,1992,1450,542,5,71,43
1,1649,1429,220,0,5,59
1,1372,1350,22,4,125,61
-1,1308,1473,-165,0,8,52
1,1401,1343,58,-4,-156,61
-1,1589,1691,-102,0,-61,104
1,1772,1768,4,1,30,54
1,1496,1549,-53,5,331,77
-1,1696,1518,178,-1,-106,85
1,1673,1758,-85,0,327,127
1,1562,1736,-174,-1,-34,59
1,1856,1870,-14,0,40,77
1,1511,1486,25,8,186,41
1,1736,1539,197,0,148,93
1,1123,1351,-228,4,600,113
1,1994,1830,164,0,217,103
1,1662,1345,317,2,1,45
1,1807,1855,-48,-1,-56,117
0,1482,1402,80,-1,9,116
-1,1597,1712,-115,-3,-36,48
1,1599,1530,69,-1,197,99
-1,1479,1301,178,-1,-112,70
0,1476,1250,226,-1,-65,134
-1,1782,1825,-43,1,-66,98
1,1724,1588,136,-1,-30,63
1,1741,1616,125,0,25,53
1,1915,1583,332,1,93,93
1,1686,1235,451,3,213,61
1,1783,1492,291,0,25,69
-1,1422,1654,-232,-2,-56,44
-1,1646,1921,-275,-8,-101,44
1,1398,1498,-100,8,259,111
1,1387,1484,-97,-10,-49,99
1,1577,1446,131,-1,-87,99
-1,1517,1606,-89,0,14,66
-1,1898,1961,-63,0,17,66
1,1587,1662,-75,0,-5,55
-1,1291,1471,-180,0,15,70
1,1713,1436,277,1,5,51
1,1500,1662,-162,0,30,83
1,1649,1606,43,0,22,79
-1,1593,1659,-66,0,6,66
1,1532,1380,152,1,6,49
-1,1485,1575,-90,-1,-120,66
1,1731,1583,148,1,113,83
-1,1728,1587,141,-3,-22,82
1,1407,1367,40,-4,-95,77
1,1334,1466,-132,1,48,67
-1,1669,1409,260,-3,-260,72
1,1535,1583,-48,-3,80,71
-1,1598,1714,-116,-2,-63,58
-1,1564,1607,-43,-2,-73,61
1,1668,1580,88,3,99,47
-1,1580,1668,-88,3,41,62
0,1525,1338,187,0,111,112
-1,1676,1569,107,0,-10,64
1,1370,1213,157,11,539,77
1,1476,1559,-83,3,148,63
-1,1588,1662,-74,-2,-123,84
-1,1931,2088,-157,-1,-27,68
-1,1554,1762,-208,-2,-157,62
-1,1662,1633,29,-1,-159,91
1,1617,1107,510,0,65,53
1,1541,988,553,2,89,49
1,1490,1039,451,5,108,47
0,1671,1577,94,0,-19,61
-1,1722,1590,132,-7,-692,106
-1,1342,1476,-134,-3,11,42
-1,1773,1711,62,-1,-9,42
-1,1599,1887,-288,0,-291,182
-1,1812,1651,161,0,-56,98
1,1500,1491,9,0,16,65
-1,1864,2154,-290,0,-339,76
-1,1641,1888,-247,-5,-292,78
-1,1654,1597,57,-2,-16,50
-1,1483,1670,-187,-10,-336,44
1,1570,1561,9,1,-129,107
1,1736,1477,259,1,85,55
1,1299,1099,200,-1,501,167
-1,1924,2095,-171,0,94,100
-1,1492,1741,-249,-1,-146,260
-1,1432,1656,-224,-4,-130,54
1,2159,1860,299,-6,239,141
-1,1854,2011,-157,-1,-330,94
1,1528,1335,193,-1,132,67
1,1651,1601,50,0,-61,85
1,1389,985,404,13,365,57
-1,2163,1857,306,-3,-289,72
-1,1761,1955,-194,0,-26,72
1,1679,1962,-283,0,96,104
-1,1706,1754,-48,-5,-170,54
1,1526,1550,-24,0,3,51
1,1714,1427,287,1,14,69
-1,1657,1775,-118,0,163,102
0,1417,1378,39,0,-59,118
1,1377,1022,355,11,1118,91
1,1725,1703,22,1,67,69
-1,1391,1832,-441,-9,-1057,96
-1,1715,2102,-387,-1,-30,58
1,1832,1650,182,0,127,85
1,1714,1545,169,1,488,121
1,1785,1486,299,-2,55,65
-1,1553,1665,-112,-3,-138,56
-1,1538,1644,-106,0,-40,53
-1,1639,1664,-25,0,-276,110
-1,1644,1869,-225,1,153,98
-1,1751,1582,169,0,-47,124
1,2104,2185,-81,0,3,63
1,1928,1878,50,2,131,97
1,1896,1640,256,2,15,67
1,1979,1493,486,-1,122,61
-1,1635,1918,-283,-5,-136,50
1,1962,1581,381,5,221,84
1,1965,1975,-10,-5,9,89
1,1935,1631,304,-4,-67,69
1,2171,2119,52,2,70,59
1,1628,1950,-322,0,49,85
-1,1389,1314,75,0,-235,144
0,1469,1500,-31,6,407,72
-1,1341,1491,-150,-8,-113,45
-1,1018,1380,-362,-4,-1518,134
-1,1539,1720,-181,-5,-232,58
1,1871,1646,225,-1,-147,145
1,1791,1555,236,8,274,57
1,1370,1341,29,-2,134,65
1,1500,1563,-63,3,345,83
-1,1641,1890,-249,-1,-399,94
1,1748,1711,37,4,108,55
0,2109,2181,-72,0,-17,131
1,1560,1655,-95,-1,289,137
1,1024,1100,-76,1,536,121
-1,1522,1619,-97,-1,-85,83
1,1905,1636,269,0,46,95
-1,1500,1568,-68,-18,-362,44
-1,1675,1545,130,4,67,48
1,1622,1697,-75,1,33,69
1,1979,1850,129,-8,210,101
-1,1843,1986,-143,-6,-146,56
-1,1483,1791,-308,0,-161,90
-1,1709,1376,333,-1,-3,56
1,1500,1501,-1,-1,-24,73
1,1458,1461,-3,0,1,45
1,2011,1429,582,0,-5,55
0,1846,1983,-137,-2,-615,125
1,1830,1999,-169,0,-70,67
-1,1692,1737,-45,0,-85,123
1,1703,1324,379,3,277,83
1,1891,1989,-98,0,-29,77
-1,1701,1758,-57,3,12,74
1,1627,1513,114,0,-19,57
-1,1328,1337,-9,-10,-363,68
-1,1697,1687,10,-1,-513,142
-1,1367,1499,-132,-5,-217,54
-1,1659,1535,124,-13,-832,68
-1,1650,1500,150,-9,-427,72
1,1505,1397,108,1,285,97
-1,1706,1893,-187,-2,-70,64
1,1383,1014,369,15,734,65
1,1919,1839,80,2,1121,157
1,1649,1682,-33,-5,-168,67
1,1984,1846,138,0,235,93
1,1572,1431,141,0,-1,47
1,1548,1506,42,4,362,69
1,1938,2111,-173,-1,61,73
-1,1458,1502,-44,0,92,70
1,1691,1767,-76,2,-3,73
1,1473,1738,-265,6,106,43
1,1830,1686,144,0,-8,83
1,1906,1754,152,4,122,54
-1,1348,1390,-42,-1,-13,74
1,1533,1500,33,-1,62,65
1,1731,1799,-68,0,9,89
-1,1423,1511,-88,2,-79,86
-1,1318,1316,2,-1,-76,80
1,1844,1673,171,4,3,42
-1,1549,1669,-120,-1,-126,68
-1,1428,1310,118,-1,-172,104
1,1490,1011,479,0,776,91
1,1775,1682,93,0,20,67
1,1899,1699,200,-1,-33,65
-1,1461,1429,32,-1,-963,142
-1,1549,1606,-57,0,95,98
1,1783,1661,122,0,84,59
1,1466,1456,10,2,149,65
-1,1681,1659,22,-5,-131,70
-1,1405,1677,-272,0,-48,64
1,1412,1520,-108,1,205,145
-1,1721,1850,-129,-7,-927,116
-1,1275,1747,-472,3,98,54
-1,1673,1783,-110,-3,-81,64
1,1563,1009,554,9,605,69
-1,1693,1905,-212,-5,-75,100
-1,1446,1477,-31,1,-15,56
-1,1395,1585,-190,-1,-203,88
-1,1586,1283,303,-5,-91,46
-1,1394,1506,-112,0,-22,62
1,1785,1979,-194,3,26,69
-1,1764,1722,42,3,119,90
1,1993,1836,157,7,108,47
-1,1502,1443,59,0,111,68
1,1416,1053,363,0,99,53
0,1413,1322,91,4,720,113
-1,1313,1298,15,-6,-244,68
-1,1026,1500,-474,-8,-351,70
-1,1774,1913,-139,1,11,48
1,1797,1545,252,2,148,67
1,2037,1734,303,0,-33,45
1,1446,1410,36,0,-6,41
-1,1492,1695,-203,-2,8,84
-1,1511,1411,100,-5,-119,46
-1,1270,1376,-106,4,170,70
-1,1636,1438,198,1,36,64
-1,1681,1991,-310,0,7,78
1,1669,1504,165,4,138,61
1,2155,1643,512,2,198,59
1,1921,1767,154,1,11,41
-1,1745,1851,-106,0,-101,70
-1,1497,1426,71,-2,-557,102
-1,1702,1792,-90,0,-561,124
-1,1341,1007,334,-3,-126,62
-1,1674,1654,20,-2,-217,104
-1,1456,1479,-23,-5,-395,92
1,1455,1585,-130,0,163,65
-1,1307,1384,-77,-9,3,40
-1,1440,1450,-10,-1,-139,98
-1,1680,1837,-157,3,150,64
-1,1516,1510,6,0,-61,80
1,1445,1478,-33,-2,-59,47
1,1973,1792,181,6,145,65
1,1665,1564,101,0,-55,56
-1,1486,1653,-167,0,-123,72
1,1569,1470,99,3,9,41
-1,1638,2160,-522,-8,-610,80
-1,1343,1320,23,-2,48,74
-1,1431,1460,-29,-14,-49,40
-1,1815,2015,-200,2,56,46
-1,1664,2042,-378,1,-64,72
-1,1262,1644,-382,0,-397,120
1,2162,1636,526,7,521,75
-1,1411,1500,-89,0,7,42
1,1803,1735,68,0,251,123
-1,1419,1305,114,1,-36,40
-1,2090,1814,276,0,-24,108
-1,1342,1321,21,-2,-68,70
-1,1440,1660,-220,-6,-184,54
1,1604,1513,91,-5,254,111
-1,1567,1266,301,-3,-251,94
1,2045,1716,329,1,50,43
-1,1542,1467,75,-4,-84,42
1,1439,1484,-45,1,44,65
-1,1653,1636,17,0,-156,92
1,1473,1591,-118,-1,231,107
1,1712,2048,-336,0,80,67
1,1468,1299,169,22,654,45
-1,1182,1355,-173,-2,-146,86
-1,1729,2028,-299,-4,-243,86
-1,1987,1500,487,-2,-52,60
1,2165,1632,533,0,-38,131
-1,1584,1707,-123,1,-212,74
1,1543,1036,507,8,394,55
1,1488,1554,-66,-1,72,97
-1,1262,1400,-138,-13,-783,82
1,1995,1884,111,-1,76,95
-1,1500,1763,-263,-3,-449,104
-1,1634,2164,-530,-1,-120,90
1,1692,1757,-65,4,580,103
1,1868,2016,-148,0,-102,141
1,1578,1755,-177,1,22,51
-1,1641,2157,-516,0,-169,68
1,1748,1584,164,2,84,51
0,1442,1449,-7,-1,402,130
1,1338,1330,8,-1,14,59
1,1833,2064,-231,0,-79,107
-1,1528,1581,-53,-6,-92,56
0,1684,1595,89,-1,11,117
1,1860,1663,197,0,85,169
1,1630,2167,-537,8,194,61
1,1513,1497,16,2,83,65
1,1489,1446,43,-1,304,125
-1,2039,1851,188,0,-53,52
0,1462,1534,-72,5,591,109
-1,1715,2033,-318,-1,-331,94
1,1876,2005,-129,0,8,51
0,1434,1450,-16,3,53,77
0,1505,1691,-186,-2,54,164
-1,1591,1688,-97,-13,-404,86
1,1451,1665,-214,1,31,127
-1,1347,1393,-46,-1,-257,102
-1,1288,1383,-95,-2,-334,86
1,1472,1451,21,-4,270,81
1,1500,1378,122,-3,-172,71
1,1578,1494,84,-1,-24,45
-1,1459,2006,-547,-4,-9,40
-1,1470,1421,49,-6,-184,48
1,1500,1491,9,0,110,77
1,1673,1746,-73,0,-6,53
-1,1501,1506,-5,0,22,70
1,1637,1468,169,2,521,99
1,1661,1554,107,-2,409,195
-1,1671,1500,171,-1,-275,144
-1,1554,1522,32,1,6,82
1,1877,1911,-34,0,26,107
-1,2100,1894,206,0,-36,86
-1,1650,1034,616,3,95,54
1,1436,1499,-63,-2,171,227
-1,1456,1623,-167,-1,-24,66
1,1692,1773,-81,-3,37,60
1,1473,1436,37,-8,-32,83
1,1765,1401,364,1,57,65
-1,1784,1971,-187,-1,-67,78
1,1500,1412,88,6,220,59
1,1664,1658,6,0,-3,43
-1,1446,1445,1,0,-319,106
1,1403,1255,148,8,567,69
1,1446,1206,240,6,528,71
1,2064,1768,296,1,102,73
1,2020,2036,-16,-3,-22,45
1,1453,1361,92,4,281,87
-1,1686,1500,186,-4,-642,114
1,2022,2035,-13,-5,15,119
1,1553,1550,3,4,107,51
0,2037,2019,18,-2,19,144
1,2100,1887,213,0,23,69
-1,1598,1508,90,-5,-32,40
-1,2135,1986,149,1,29,84
1,1738,1531,207,3,367,85
-1,1814,1576,238,-3,-141,116
-1,1546,1669,-123,-3,-114,94
-1,1756,1708,48,0,23,63
1,1953,2178,-225,-1,17,75
1,1600,1483,117,0,362,91
-1,1483,1670,-187,0,-6,48
-1,1891,1611,280,-1,20,70
0,1694,1638,56,1,150,127
1,1777,1845,-68,0,250,111
-1,1440,2064,-624,-8,-268,54
1,1347,1500,-153,0,-15,59
1,1601,1672,-71,-3,-45,77
1,2064,1439,625,4,86,57
1,1996,1627,369,1,-30,59
1,1578,1459,119,1,66,68
-1,1615,1855,-240,2,44,72
-1,1579,1231,348,3,113,58
1,1638,1345,293,-1,235,115
1,1770,1769,1,3,318,97
0,1653,1770,-117,0,-159,184
-1,1828,2010,-182,-3,-230,108
-1,1748,1702,46,-4,-177,64
1,1461,1448,13,2,146,75
-1,1505,1640,-135,-5,-124,54
1,1571,1510,61,0,-150,81
1,1517,1654,-137,4,116,51
1,2114,1739,375,0,13,45
-1,1334,1629,-295,0,-24,45
1,1849,1534,315,0,108,68
-1,1376,1477,-101,-3,-117,58
-1,1475,1424,51,-2,-326,130
-1,1559,1762,-203,5,-286,86
1,1561,1327,234,7,567,89
-1,1399,1478,-79,-2,-51,48
-1,1955,1801,154,-1,-85,184
1,1705,1951,-246,-2,-90,83
1,1607,1590,17,4,215,75
-1,1460,1383,77,0,24,94
1,1367,1375,-8,-1,-2,41
-1,1624,1647,-23,-7,-123,46
-1,1407,1488,-81,-5,-111,64
-1,1642,1628,14,0,-53,110
-1,1793,1790,3,0,-72,54
1,1458,1618,-160,1,30,47
-1,1511,1776,-265,-6,-636,132
1,1790,1781,9,1,257,110
-1,1321,1565,-244,0,15,58
1,1532,1608,-76,-1,-6,73
1,1615,1470,145,0,-7,65
-1,1598,1703,-105,-2,-233,86
-1,1637,1659,-22,-5,-166,76
1,1356,1497,-141,3,201,61
1,1933,1459,474,2,96,59
1,1853,1593,260,2,203,99
-1,1249,1222,27,-6,-116,46
1,1585,1031,554,12,393,53
1,1652,1737,-85,9,165,65
1,1930,1748,182,2,67,59
-1,1447,1585,-138,0,-75,62
-1,1579,1618,-39,0,161,230
-1,1801,1725,76,-1,16,66
1,1233,1347,-114,3,286,67
1,1611,1575,36,1,39,73
-1,1410,1497,-87,-10,-518,70
0,1671,1316,355,0,7,113
0,1862,1832,30,0,142,231
1,1959,1509,450,1,106,89
1,1471,1361,110,-3,-38,45
1,1695,1513,182,5,207,105
-1,1586,1671,-85,-7,-306,72
1,1512,1439,73,1,62,57
1,1621,1634,-13,0,0,49
-1,1397,1446,-49,-3,-208,74
1,1237,1301,-64,-2,-6,41
1,1536,1604,-68,-2,12,49
-1,1622,1598,24,-2,-37,86
-1,1458,1934,-476,-1,-124,80
-1,1742,1928,-186,-5,-399,128
1,1680,1681,-1,3,939,123
-1,1573,1696,-123,1,99,54
-1,1766,1730,36,-5,-193,70
1,1519,1268,251,-1,36,65
-1,1250,1700,-450,1,-145,100
1,1605,1583,22,2,53,61
-1,1591,1549,42,-4,-107,47
1,1551,1442,109,8,252,53
-1,1781,1858,-77,-1,84,72
1,1640,1575,65,0,52,65
1,1915,1936,-21,0,22,41
1,1610,1326,284,0,-9,41
-1,1453,1530,-77,0,-185,84
1,1739,1788,-49,-1,-12,43
1,1401,1500,-99,3,74,63
-1,1407,1274,133,-15,-570,72
-1,1332,1464,-132,-9,-156,54
1,1322,1500,-178,4,639,99
1,1704,1565,139,3,102,63
1,1499,1379,120,5,96,53
0,1663,1862,-199,0,14,108
-1,1573,1616,-43,4,398,86
1,1630,1510,120,0,-9,49
1,1739,1597,142,2,-2,41
-1,1787,1699,88,-1,-55,72
-1,1816,1833,-17,0,-85,98
1,1610,1361,249,-1,-11,63
-1,1430,1429,1,1,-16,89
-1,1934,1736,198,0,-72,118
1,1725,1588,137,0,285,83
1,1790,1794,-4,0,170,173
-1,1543,1579,-36,-1,-62,78
1,1380,1602,-222,0,17,49
-1,1594,1622,-28,1,27,114
-1,1757,1617,140,-2,-261,120
1,1525,1557,-32,0,-1,49
1,1711,1936,-225,0,264,113
1,1538,1868,-330,-1,-26,57
-1,1040,1476,-436,-12,-219,56
-1,1171,1369,-198,-1,3,48
-1,1639,1453,186,-3,-427,84
-1,1393,1564,-171,2,-126,80
1,1856,1744,112,3,14,41
1,1668,1622,46,-1,-7,81
1,1106,1153,-47,-4,-299,67
1,1638,1583,55,3,258,97
1,1431,1313,118,3,159,61
-1,1847,1802,45,-7,-509,86
1,1843,1805,38,0,87,131
-1,1690,1764,-74,0,-94,94
-1,1657,1506,151,1,-119,73
-1,1377,1386,-9,-3,-207,91
1,1789,1699,90,0,8,75
0,1732,1581,151,-13,-693,144
1,1917,1728,189,1,41,71
-1,1485,1480,5,-2,-165,80
-1,1449,1285,164,-1,-330,94
1,1614,1632,-18,-1,-61,61
-1,1846,1558,288,2,57,72
-1,1649,1520,129,-2,-51,44
-1,1774,2016,-242,0,-69,72
1,1495,1545,-50,-1,-32,55
-1,1753,1917,-164,3,-24,50
1,1557,1563,-6,-1,10,86
1,1632,1356,276,6,437,91
-1,1432,1303,129,-6,-505,144
-1,1137,1146,-9,0,18,44
-1,1579,1377,202,1,-90,72
1,1539,1448,91,6,324,67
-1,1807,1720,87,-1,-45,64
1,1248,1345,-97,14,1247,183
-1,1539,1588,-49,0,-199,70
1,1574,1648,-74,-1,-74,65
1,1722,1923,-201,0,2,53
-1,1178,1123,55,3,100,42
1,1798,1691,107,0,8,55
1,1765,1873,-108,-4,20,57
1,1363,1417,-54,-2,109,103
1,1552,1569,-17,-2,38,75
1,1739,1666,73,-1,47,111
1,1626,1471,155,0,14,71
1,1143,1139,4,-5,-64,57
-1,1802,1761,41,1,48,68
1,1507,1454,53,1,122,73
1,1905,1739,166,3,245,86
1,1583,1554,29,4,46,43
-1,1480,1564,-84,-1,-290,122
1,1579,1542,37,0,36,53
1,1923,1747,176,-2,-60,69
-1,1619,1586,33,-1,-26,46
1,1934,1416,518,1,46,61
-1,1715,1723,-8,0,6,54
1,1503,1438,65,-1,18,93
-1,1792,1626,166,0,41,70
1,1727,1725,2,-1,5,51
-1,1126,1404,-278,-19,-444,60
1,1634,1587,47,-1,12,88
-1,1657,1749,-92,0,-227,88
1,1378,1540,-162,2,226,71
1,1507,1414,93,10,173,44
1,1596,1511,85,1,90,49
1,1597,1530,67,6,280,59
-1,1301,1411,-110,-2,-51,44
-1,1824,2021,-197,1,40,84
1,1565,1469,96,1,106,73
1,1573,1450,123,1,197,113
-1,1711,1749,-38,-3,1,74
-1,1419,1292,127,-12,-395,62
-1,1494,1379,115,-2,4,50
1,1772,1500,272,-6,-368,119
1,1910,1772,138,1,-2,55
-1,1738,1737,1,-1,-133,92
-1,1598,1721,-123,0,54,72
1,1636,1315,321,0,104,67
-1,1678,1430,248,1,-3,60
-1,1606,1590,16,2,108,58
1,1309,1404,-95,2,281,69
-1,1754,1796,-42,1,54,110
-1,1652,1668,-16,-2,-65,70
-1,1438,1432,6,0,-69,84
-1,1460,1653,-193,-3,-86,46
-1,1381,1263,118,-1,-84,50
1,1717,1605,112,-2,-13,83
1,1747,1768,-21,4,106,55
-1,1578,1644,-66,-3,-302,125
1,1741,1828,-87,-1,114,83
1,1563,1673,-110,-2,-22,133
1,1878,1747,131,0,150,79
-1,1756,1760,-4,0,-153,104
1,1929,1735,194,-7,-66,51
-1,1263,1315,-52,-1,-89,96
1,1598,1688,-90,-2,-188,79
-1,1916,1895,21,-5,-23,40
1,1325,1541,-216,0,10,63
1,1425,1277,148,-1,-61,63
-1,1805,2027,-222,-5,-61,43
1,1437,1849,-412,0,34,91
1,1548,1237,311,4,220,61
1,1530,1532,-2,3,353,81
1,1370,1295,75,-3,-14,55
1,1660,1543,117,0,123,79
1,1745,1772,-27,0,38,65
-1,1344,1775,-431,-1,-102,62
1,1178,0,1178,-3,-251,137
1,1710,1505,205,5,135,45
1,1581,1657,-76,0,483,171
-1,1759,1757,2,-3,-58,160
1,1591,1565,26,3,74,57
1,1743,1212,531,0,442,81
1,1562,1554,8,3,183,66
1,1724,1633,91,6,78,43
-1,1748,1727,21,-1,-11,52
1,1740,1536,204,3,139,169
1,1776,1342,434,2,173,73
-1,1597,1701,-104,-1,-83,74
-1,1512,1450,62,3,-18,76
1,1437,1461,-24,-1,-46,45
1,1253,1373,-120,-7,-161,41
-1,1723,1753,-30,-3,-93,54
-1,1624,1733,-109,0,-145,63
-1,1640,1530,110,1,9,80
-1,1739,1800,-61,0,-70,98
1,1522,1407,115,0,22,74
-1,1095,1744,-649,-6,-3,40
-1,1769,1689,80,-3,-1101,152
1,1659,1455,204,15,359,49
-1,1776,2032,-256,-1,-22,50
-1,1768,2024,-256,0,-86,85
1,1379,1484,-105,-1,95,110
1,1745,1515,230,2,23,43
-1,1738,1759,-21,-11,-679,92
-1,1604,1680,-76,-3,-296,98
1,1415,1413,2,0,-22,91
1,1764,1683,81,-1,153,81
-1,1665,1765,-100,0,-181,106
-1,1285,1598,-313,-1,-37,86
1,1266,1243,23,3,214,63
1,1770,1728,42,0,769,127
1,1403,1649,-246,1,59,51
1,1961,1845,116,1,69,111
-1,1608,1747,-139,-1,-71,68
1,2029,1649,380,0,-14,81
1,1780,1338,442,3,132,57
-1,1464,1499,-35,0,-36,76
-1,1618,1770,-152,-2,-132,78
1,1715,1774,-59,1,277,103
-1,1384,1392,-8,-3,-238,72
-1,1208,1500,-292,0,-66,59
1,1475,1521,-46,5,199,59
1,1675,1773,-98,-4,5,61
1,1718,1781,-63,-1,-218,81
1,1465,1745,-280,5,198,79
1,1809,1730,79,-1,-21,49
-1,1646,2031,-385,-1,-47,92
-1,1536,1613,-77,4,183,72
-1,1484,1485,-1,1,13,68
-1,1667,1643,24,-1,-54,82
1,1600,1326,274,6,258,77
1,1368,1834,-466,-1,-110,74
-1,1594,1500,94,-2,-85,58
-1,1767,1731,36,0,123,88
-1,1754,1601,153,0,45,142
1,2034,1644,390,0,207,87
-1,1759,1689,70,2,98,108
1,2037,1773,264,0,51,73
-1,1336,1782,-446,0,-128,74
1,1666,1742,-76,1,88,75
1,1818,1772,46,-1,-102,111
-1,1721,1604,117,0,-84,76
-1,1484,1544,-60,0,-147,114
1,1509,1518,-9,2,244,75
1,1393,1374,19,8,228,61
-1,1666,1450,216,1,10,72
-1,1641,2036,-395,-1,-119,112
1,2078,1754,324,0,7,49
1,1745,1724,21,-2,50,145
1,1276,1227,49,1,112,72
-1,1531,1583,-52,-1,-51,52
1,1645,1738,-93,0,-131,123
1,1728,1585,143,1,75,75
-1,1491,1668,-177,-1,1,60
1,1746,1432,314,0,120,69
1,2039,1639,400,-1,18,53
-1,1474,1531,-57,-5,-31,48
-1,1809,1398,411,3,203,50
-1,1500,1751,-251,-4,-332,90
-1,1470,1466,4,0,-22,51
-1,1424,1786,-362,-11,-27,40
1,1772,1680,92,0,24,101
1,1702,1656,46,2,119,65
1,1726,1573,153,4,177,63
1,1905,1852,53,-2,103,83
-1,1459,1729,-270,-2,-274,106
1,1605,1551,54,3,610,89
-1,1359,1761,-402,-4,-235,76
1,1321,1631,-310,-1,0,85
-1,1563,1782,-219,1,-72,70
1,1353,1398,-45,6,161,55
1,1569,1473,96,0,-1,71
1,1749,1536,213,0,70,69
1,1850,1675,175,-4,-46,57
1,1762,1769,-7,0,12,91
1,1756,1757,-1,2,0,40
0,1656,1739,-83,3,253,132
-1,1515,1424,91,0,-74,88
-1,1578,1785,-207,-2,-102,64
1,1617,1540,77,-10,-80,85
1,1857,1669,188,-2,-27,43
-1,1491,1736,-245,0,-115,64
-1,1595,1601,-6,-7,-43,40
1,1764,1357,407,7,229,41
1,1863,1663,200,1,18,43
-1,1695,1662,33,-4,-217,67
-1,1531,1754,-223,-7,-59,40
-1,1354,1766,-412,0,-18,66
-1,1869,1657,212,-1,-59,102
-1,1393,1645,-252,-1,-324,120
-1,1465,1577,-112,-4,-130,84
-1,1539,1734,-195,-1,-113,62
1,1792,1572,220,-1,-53,67
-1,1914,2041,-127,-2,-95,58
1,1380,1479,-99,7,172,43
1,1759,1646,113,3,14,41
1,1675,1850,-175,5,346,87
-1,1464,1450,14,-1,-100,90
-1,1470,1925,-455,-16,-399,52
-1,1334,1363,-29,0,5,52
1,1449,1413,36,0,262,75
1,1287,1179,108,-2,-54,53
-1,1373,1288,85,-5,-91,48
1,1736,1323,413,0,30,63
1,1833,1692,141,-1,-10,45
1,1567,1798,-231,0,-130,69
1,1653,1509,144,0,138,85
-1,1380,1482,-102,-1,-270,78
-1,1403,1459,-56,-14,-622,70
-1,1579,1612,-33,-3,-75,52
-1,1476,1401,75,0,-147,172
1,1840,1685,155,5,132,47
1,1528,1792,-264,-1,-26,95
1,1753,1769,-16,-2,53,42
1,1768,1351,417,1,69,55
-1,1683,1767,-84,-3,-29,55
-1,1467,1931,-464,-4,-743,110
1,1468,1394,74,5,213,107
1,1724,1520,204,2,61,53
1,1695,1776,-81,1,323,99
1,1541,1438,103,-4,-137,59
1,1733,1569,164,-1,-7,101
1,1490,1371,119,-3,-460,83
1,1740,1514,226,3,128,59
1,1417,1553,-136,-1,17,51
0,1658,1777,-119,0,-99,133
1,1685,1792,-107,-3,-191,73
1,1756,1614,142,7,109,47
1,1847,1587,260,0,-10,69
1,1567,1585,-18,0,607,125
1,1385,1477,-92,6,280,63
1,1555,1467,88,-1,95,64
-1,1758,1907,-149,-3,-137,76
0,1595,1418,177,-1,27,44
1,1403,1565,-162,-5,-24,55
1,1852,1834,18,0,27,55
1,1515,1729,-214,-4,253,109
1,1515,1381,134,0,-10,46
1,1934,1465,469,0,268,65
-1,1823,1863,-40,-3,-226,78
-1,1295,1432,-137,1,-124,58
1,1433,1321,112,2,47,63
-1,1269,1500,-231,-1,-72,90
-1,1775,1596,179,-5,-200,106
1,1675,1481,194,-3,31,55
1,1534,1538,-4,0,23,50
-1,1339,1473,-134,-2,-340,72
1,1407,1637,-230,18,936,73
1,1774,1589,185,-3,-244,97
1,1575,1359,216,3,132,49
-1,1493,1745,-252,-3,-25,58
-1,1931,1836,95,-1,34,68
-1,1419,1500,-81,1,-177,86
-1,1873,1582,291,-1,-22,64
-1,1463,1936,-473,-1,-28,68
-1,1484,1650,-166,-1,-116,76
1,1703,1679,24,0,35,79
1,1460,1591,-131,-2,143,65
1,1079,1452,-373,5,69,43
-1,1581,1500,81,0,11,80
1,1527,1525,2,-6,87,129
1,1936,1429,507,-2,210,80
-1,1421,1580,-159,0,-23,74
1,1396,1527,-131,1,17,43
-1,1439,1476,-37,-2,-174,72
-1,1287,1570,-283,-5,-180,54
1,1803,1830,-27,3,349,107
-1,1752,2127,-375,-6,-1,78
-1,1717,1662,55,1,29,72
1,1854,1713,141,0,-63,87
-1,1551,1451,100,-3,-53,58
1,1939,1462,477,1,667,129
1,1719,1571,148,1,90,103
1,1918,1850,68,4,174,59
-1,1322,1499,-177,-5,-257,56
1,1413,1625,-212,-2,-38,65
1,1589,1456,133,-2,63,77
-1,1476,1639,-163,0,-265,120
1,1907,1755,152,-3,19,47
1,1549,1463,86,2,303,131
1,1657,1475,182,8,228,55
1,1571,1780,-209,-2,-93,91
-1,1640,1772,-132,0,-322,104
1,1738,1439,299,14,529,59
-1,1354,1257,97,-24,-508,46
1,1532,1579,-47,-2,-90,95
-1,1926,1748,178,0,-5,48
-1,1659,1749,-90,2,-1,94
-1,1507,1578,-71,0,-4,48
1,1511,1315,196,0,-3,63
-1,1638,1500,138,-3,-569,84
-1,1279,1274,5,-10,-16,40
-1,1633,1576,57,0,-60,84
1,1264,1494,-230,1,98,65
-1,1339,1168,171,-13,-585,68
0,1447,1688,-241,-9,-68,59
-1,1467,1663,-196,0,6,70
1,1274,1321,-47,-1,106,53
-1,1832,1922,-90,-4,-104,40
-1,1232,1399,-167,-4,-44,42
-1,1430,1608,-178,-6,-166,48
1,1681,1500,181,1,269,117
-1,1565,1796,-231,-2,-198,92
1,1598,1760,-162,-1,572,117
-1,1781,1633,148,3,69,48
-1,1440,1459,-19,-11,-232,50
1,1761,1769,-8,0,24,93
-1,1405,1224,181,-1,-62,54
-1,1648,1642,6,-1,-27,48
-1,1308,1521,-213,0,-6,42
1,1437,1675,-238,0,381,128
-1,1245,1389,-144,-5,-130,40
-1,1765,1911,-146,-1,-74,65
-1,1201,1500,-299,0,3,44
1,1750,1824,-74,0,5,67
-1,1583,1739,-156,-1,-487,98
1,1937,1750,187,4,342,91
1,1422,1270,152,-1,51,94
1,1763,1622,141,3,66,55
1,1571,1196,375,0,75,63
-1,1491,1502,-11,0,-28,74
-1,1476,1762,-286,-1,-164,82
-1,1757,1651,106,1,12,110
1,1365,1275,90,0,9,71
-1,1806,1760,46,0,11,78
-1,1383,1486,-103,-1,-190,76
-1,1193,1505,-312,0,-8,66
1,1417,1422,-5,1,29,43
1,1714,1667,47,7,623,95
1,1436,1425,11,9,308,59
1,1611,1524,87,-6,-177,75
1,1620,1623,-3,0,-8,67
-1,1596,1831,-235,-3,-236,80
1,2129,1933,196,4,98,43
-1,1550,1578,-28,-3,-18,114
-1,1766,1745,21,-1,-73,96
-1,1577,1694,-117,-1,-182,86
-1,1264,1373,-109,0,-10,62
1,1412,1614,-202,-2,-613,127
-1,1280,1416,-136,-3,-107,62
-1,1900,2049,-149,-2,-93,56
1,1678,1504,174,0,143,63
-1,1818,1815,3,0,-102,68
1,1917,1811,106,1,138,65
-1,1663,1795,-132,1,-138,90
-1,1521,1682,-161,1,-390,124
1,1381,1255,126,-1,-28,73
1,1686,1396,290,1,584,106
0,1750,1772,-22,-4,-137,62
-1,1754,1816,-62,-3,-31,106
-1,1318,1369,-51,-10,-331,66
1,1668,1546,122,2,298,105
1,1767,1435,332,7,210,57
-1,1246,1388,-142,0,-165,84
-1,1753,1770,-17,-1,-14,66
1,1527,1598,-71,0,-1,47
1,1837,1591,246,-7,573,135
1,1588,1506,82,0,79,125
-1,1740,1757,-17,1,392,92
1,1527,1626,-99,6,391,113
-1,1945,1677,268,0,-127,120
1,1471,1593,-122,2,180,101
-1,1624,1629,-5,-9,-175,46
-1,1500,1728,-228,-19,-529,50
-1,1214,1477,-263,1,-55,112
1,1690,1629,61,-3,-161,91
1,2015,1927,88,-2,34,65
1,1395,1238,157,3,105,71
-1,1684,1826,-142,-2,1,48
-1,1576,1614,-38,0,-525,140
-1,1881,1620,261,0,-493,140
-1,1916,1925,-9,-3,-128,60
-1,1254,1845,-591,-6,-235,56
-1,1458,1616,-158,-4,-135,66
1,1797,1616,181,0,-22,55
-1,1925,2181,-256,0,-236,156
1,1835,1798,37,0,9,47
1,1803,1608,195,2,73,65
1,1664,1795,-131,-1,-8,43
1,1619,1384,235,-2,-25,53
-1,1903,1855,48,-2,-72,74
1,1424,1331,93,4,66,53
1,1770,2160,-390,0,1,125
0,1781,2059,-278,0,-19,111
-1,1944,1906,38,0,54,96
1,1624,1379,245,1,240,83
1,1627,1679,-52,0,-2,63
1,1608,1436,172,0,131,115
-1,1530,1609,-79,-9,-295,108
-1,1500,1604,-104,-2,-129,76
1,1364,1497,-133,-9,-187,81
-1,1815,1952,-137,-1,-158,125
-1,1374,1629,-255,-3,-177,68
1,1498,1463,35,4,56,45
-1,1858,1683,175,0,-188,98
0,1719,1621,98,1,23,104
1,1580,1763,-183,2,79,55
1,2087,1601,486,-2,239,117
0,1429,1578,-149,0,-175,146
1,1634,1370,264,0,265,109
-1,1348,1550,-202,-6,-137,56
1,1940,1851,89,0,71,75
-1,1809,2149,-340,0,-7,54
1,1417,1414,3,1,120,79
-1,1599,2089,-490,0,-47,94
1,2153,1806,347,-5,69,119
1,1500,1758,-258,-1,95,77
-1,1500,1526,-26,-3,-167,62
-1,2116,1918,198,0,-83,78
-1,1365,1638,-273,-3,-339,128
1,2090,1597,493,-2,156,89
1,1924,2012,-88,1,151,85
-1,1837,1698,139,0,-377,190
-1,1908,1489,419,2,130,66
1,1831,1781,50,1,56,63
-1,1544,1641,-97,0,-3,52
-1,1402,1491,-89,-8,-234,44
1,1584,1577,7,6,368,111
-1,1595,2092,-497,-15,-151,66
1,1521,1624,-103,1,-14,41
-1,1842,1952,-110,0,-21,62
1,1451,1693,-242,-8,0,43
1,1557,1057,500,17,321,61
-1,1361,1643,-282,4,239,72
1,1576,1541,35,-1,-42,65
-1,1421,1720,-299,0,-301,140
1,1791,1647,144,0,9,67
1,1624,1717,-93,0,-69,85
1,1507,1325,182,0,3,55
-1,1543,1620,-77,-1,-34,50
1,1374,1349,25,6,318,79
1,1393,1200,193,-4,-121,53
-1,1747,1584,163,0,-16,56
-1,1731,1684,47,-3,-147,92
-1,1867,2074,-207,-1,-83,78
1,1623,1511,112,6,465,83
1,1639,1803,-164,3,122,81
-1,2093,1594,499,-14,-215,50
0,1492,1592,-100,1,-489,134
1,1629,1534,95,0,6,77
-1,1535,1497,38,1,-37,56
-1,1792,1713,79,0,135,122
1,1523,1468,55,-8,141,125
1,1963,2038,-75,1,-19,69
1,1482,1393,89,0,116,117
1,1798,1657,141,0,-5,93
1,1491,1200,291,10,298,55
1,1677,1580,97,0,113,107
1,1399,1149,250,4,79,53
1,1649,1551,98,1,359,159
-1,1945,1934,11,2,-97,124
-1,1513,1520,-7,-2,-13,40
1,1805,1648,157,7,397,79
1,1572,1686,-114,3,99,59
1,1614,1696,-82,2,2,69
-1,1486,1338,148,2,189,120
1,1624,1487,137,-6,-39,45
-1,1525,1699,-174,-2,-66,50
1,1421,1436,-15,-2,175,91
1,1542,1658,-116,-3,-279,91
-1,1400,1572,-172,-3,-267,62
-1,1578,1679,-101,1,9,46
1,1881,1729,152,0,45,71
-1,1939,1881,58,0,-7,60
-1,1764,1870,-106,-3,-143,68
-1,1623,1794,-171,0,-14,44
0,1566,1595,-29,-2,-259,133
-1,1812,1642,170,-2,-168,78
1,1718,1631,87,7,218,57
-1,1612,1800,-188,0,-67,60
1,1632,1574,58,-5,50,57
1,1744,1532,212,4,22,52
-1,1710,1777,-67,-1,-190,100
-1,1688,1981,-293,2,-125,82
-1,1442,1519,-77,1,19,90
1,1878,1754,124,1,9,43
-1,1628,1813,-185,0,-10,84
1,1659,1558,101,2,25,45
1,1523,1509,14,2,90,59
1,1602,1469,133,0,15,45
1,1599,1688,-89,1,85,95
-1,1354,1431,-77,0,1,64
1,1658,1393,265,2,156,87
1,1827,1921,-94,0,1,55
0,1549,1668,-119,0,-3,138
-1,1462,1614,-152,-2,-17,50
1,1718,1654,64,0,13,54
-1,1453,1651,-198,0,-74,69
1,1808,1790,18,1,103,131
1,1892,1737,155,2,56,53
0,1684,1806,-122,-3,-201,152
1,1434,1705,-271,-2,79,89
1,1433,1555,-122,0,305,135
1,1317,1550,-233,-1,33,51
-1,1844,1729,115,0,-112,94
1,1805,1277,528,1,31,49
-1,1424,1433,-9,2,135,58
1,1795,1664,131,2,96,57
1,1688,1986,-298,-1,23,105
1,1890,1496,394,7,50,40
-1,2024,1899,125,-1,-83,126
-1,1874,1782,92,-1,-37,42
-1,1622,1706,-84,0,13,68
1,1309,1531,-222,11,390,61
1,1843,1345,498,2,46,47
-1,1848,1787,61,0,-595,124
1,1513,1828,-315,-3,-78,117
1,1746,1341,405,4,318,84
1,1861,1472,389,-2,-58,57
1,1685,1454,231,4,160,63
-1,1364,1709,-345,7,291,68
1,1684,1657,27,1,79,97
1,1656,1806,-150,1,389,101
1,1499,1501,-2,-4,-57,53
-1,1803,1835,-32,-3,-125,88
1,1642,1534,108,2,115,97
1,1526,1007,519,1,304,71
1,1748,1584,164,0,30,103
1,1845,1338,507,0,-7,43
-1,1712,1331,381,-3,-39,40
1,1749,1343,406,0,26,87
1,1445,1413,32,0,28,77
-1,1621,1548,73,-3,-573,124
-1,1845,1791,54,1,-256,108
-1,1893,1567,326,0,20,66
1,1540,1449,91,0,160,83
1,1807,1846,-39,0,2,49
-1,1449,1691,-242,0,-151,106
-1,1395,1510,-115,-3,-107,54
-1,1806,1832,-26,-3,-273,132
0,1526,1645,-119,-1,-159,123
1,1727,1674,53,0,26,101
-1,1333,1751,-418,-3,186,132
1,2144,1767,377,2,155,61
1,1553,1694,-141,3,114,57
1,1420,1447,-27,3,21,41
-1,1167,1571,-404,0,10,58
1,1645,1694,-49,0,23,61
-1,1788,1755,33,-4,-46,66
-1,1607,1698,-91,0,-243,120
-1,1321,1212,109,-3,-141,62
1,1331,1433,-102,-1,266,91
1,1500,1393,107,1,30,49
1,1431,1331,100,-1,85,79
1,1599,1494,105,-1,-36,63
-1,1005,1754,-749,-7,-80,42
-1,1330,1525,-195,0,28,60
1,1736,1695,41,0,-110,117
1,1440,1549,-109,3,510,101
-1,1578,1767,-189,-3,-189,80
-1,1495,1447,48,2,-97,118
-1,1599,1707,-108,-6,-457,158
-1,1397,1473,-76,-10,-718,74
-1,1642,1776,-134,1,31,50
-1,1702,1787,-85,0,-397,112
1,1707,1187,520,-1,-29,95
1,1428,1585,-157,0,174,109
1,1754,1406,348,1,76,49
1,1651,1322,329,-1,20,67
1,1824,1263,561,-1,6,65
-1,1765,2147,-382,0,-55,72
-1,1392,1613,-221,-1,-101,60
-1,1392,1320,72,-1,-191,90
-1,1820,1604,216,-1,-625,172
-1,1531,1566,-35,-1,-55,132
-1,1498,2067,-569,-2,-34,46
1,1419,1381,38,6,69,51
1,1591,1864,-273,0,11,53
-1,1804,1573,231,3,48,86
1,1350,1394,-44,-3,-84,63
-1,1488,1365,123,2,34,44
-1,1802,1846,-44,1,-176,66
-1,1532,1758,-226,1,-29,54
-1,1345,1465,-120,0,-353,106
-1,1618,1526,92,2,83,74
-1,1318,1825,-507,-4,-150,56
-1,1477,1461,16,-2,-67,100
1,1523,1479,44,-5,-7,51
-1,1978,2069,-91,0,-30,64
1,1762,1424,338,5,651,119
1,1607,1541,66,-1,242,120
-1,1534,1515,19,2,147,68
1,1527,1003,524,9,352,67
-1,1540,1455,85,-8,-354,68
-1,1472,1465,7,-6,-690,130
1,1708,1703,5,1,156,131
1,2080,1857,223,0,4,43
-1,1685,1746,-61,-1,-40,58
1,1764,1334,430,0,-7,47
1,1333,1369,-36,0,-7,95
-1,1857,2080,-223,3,144,92
-1,1589,1682,-93,1,-31,86
-1,1477,1461,16,-3,-50,58
-1,1614,1586,28,6,108,80
1,1682,1600,82,3,267,83
-1,1341,1533,-192,-13,-333,54
1,1533,1470,63,10,199,43
0,1472,1465,7,10,546,75
1,1862,1536,326,0,-1,123
1,1609,1478,131,1,77,89
-1,1793,1852,-59,-1,-79,64
1,1465,1472,-7,2,156,91
1,1461,1542,-81,0,144,65
-1,1756,1675,81,0,-81,92
0,1827,1906,-79,-5,-26,109
-1,1326,1769,-443,1,122,67
1,1672,1532,140,7,82,41
1,1689,1565,124,-3,-6,45
1,1428,1255,173,9,473,63
-1,1460,1464,-4,1,-84,102
1,1743,1557,186,-1,-77,105
1,1970,1862,108,4,307,73
1,1575,1395,180,-1,86,73
1,1673,1488,185,1,157,51
-1,1867,1844,23,-3,-93,58
1,1629,1557,72,0,15,51
1,1783,1622,161,3,101,63
1,1725,1572,153,0,-14,75
1,1774,1392,382,3,95,45
-1,1690,1690,0,1,108,50
1,1526,1522,4,0,89,81
-1,1530,1534,-4,-3,-206,126
1,1482,1679,-197,3,78,67
1,1515,1542,-27,0,122,93
-1,1945,1891,54,-1,-4,48
1,1287,1055,232,2,500,71
-1,1388,1406,-18,-3,-19,48
-1,1616,2087,-471,-3,-208,86
-1,1598,1597,1,-1,47,80
1,1528,1603,-75,-3,-133,63
1,1704,1611,93,3,689,115
1,1549,1638,-89,0,16,59
1,2089,1614,475,1,10,43
1,1544,1533,11,0,19,61
-1,1667,1689,-22,0,42,98
1,1408,1338,70,2,131,71
-1,1533,1661,-128,-1,-5,42
1,1615,1776,-161,0,10,51
1,1389,1581,-192,-6,-58,43
-1,1612,2090,-478,-19,-881,98
1,1472,1393,79,6,140,59
1,1364,1460,-96,4,89,47
0,1662,1500,162,0,-371,150
1,1834,1853,-19,0,123,79
1,1541,1328,213,5,281,61
-1,1758,1518,240,-1,-656,138
1,1637,1501,136,1,-12,49
-1,1584,1674,-90,-1,-14,47
1,1612,1500,112,0,179,123
-1,1803,1903,-100,-1,-212,98
0,1701,1680,21,0,6,72
1,1565,1406,159,0,350,83
1,1996,1959,37,0,122,123
-1,1431,1196,235,-6,-138,41
1,1617,1523,94,-4,-99,49
1,1623,1562,61,0,13,61
-1,1457,1593,-136,-1,-248,92
1,1611,1496,115,-2,-117,149
-1,1650,1759,-109,-1,-10,100
-1,1418,1830,-412,1,28,52
1,1529,1582,-53,0,34,61
1,1653,1579,74,-1,5,63
-1,1497,1740,-243,-3,-141,60
1,1590,1350,240,1,165,89
-1,1449,1700,-251,-1,-31,46
1,1253,1381,-128,8,525,99
1,1487,1619,-132,11,839,131
1,1851,1479,372,1,179,117
-1,1849,2092,-243,-2,-567,86
1,1292,1211,81,-1,313,95
-1,1693,1856,-163,-2,-61,84
1,1565,1286,279,-2,-5,57
1,1625,1513,112,0,80,77
1,1325,1552,-227,2,122,65
1,1941,1858,83,6,105,45
-1,1750,1552,198,0,-203,108
1,1711,1598,113,1,8,49
1,1802,1694,108,0,157,99
1,1368,1214,154,0,12,63
0,1260,1441,-181,-1,-137,109
-1,1714,1781,-67,0,-178,104
-1,1590,1719,-129,0,-74,52
-1,1293,1496,-203,-3,3,40
1,1951,1705,246,0,4,75
1,1686,1810,-124,4,947,135
-1,1618,1686,-68,-1,-58,78
0,1544,1591,-47,-1,-98,145
1,1682,1619,63,0,-18,83
1,1321,1300,21,-1,-12,41
-1,1503,1551,-48,1,-86,92
-1,1812,1654,158,-2,202,90
-1,1282,1507,-225,-2,175,100
1,1500,1716,-216,-1,77,63
-1,1795,1701,94,0,-44,72
-1,1850,1821,29,-3,-58,58
1,1511,1375,136,-1,131,61
-1,1570,1731,-161,-13,-247,88
0,1714,1781,-67,0,195,151
1,1500,1400,100,0,108,89
1,1833,1838,-5,0,-5,51
1,1574,1507,67,5,305,69
1,1704,1740,-36,-1,67,107
1,1828,1844,-16,3,93,65
1,1797,1699,98,1,261,104
1,1290,1331,-41,0,9,53
1,1527,1560,-33,1,83,57
-1,1277,1403,-126,4,161,82
1,1779,1716,63,9,315,81
1,1833,1839,-6,0,-33,61
-1,1500,1661,-161,-1,-58,60
-1,1490,1610,-120,0,-48,156
1,1583,1537,46,4,239,91
1,1632,1526,106,0,77,79
1,1578,1590,-12,1,322,129
-1,1707,1788,-81,3,41,54
-1,1530,1776,-246,-2,-49,52
-1,1578,1589,-11,-4,47,108
-1,1480,1493,-13,-4,-28,48
-1,1337,1375,-38,-2,-164,74
-1,1635,1524,111,0,-4,110
1,1828,1844,-16,0,96,117
1,1738,1563,175,-2,-36,121
-1,1706,1984,-278,-1,-29,48
1,1797,1699,98,1,-3,81
-1,1667,1389,278,-1,-72,72
1,1325,1442,-117,-1,294,81
0,1805,1790,15,-1,-95,138
-1,1691,1805,-114,0,-20,78
-1,1314,1609,-295,-3,-410,106
-1,1371,1227,144,0,-248,100
-1,1839,1972,-133,0,7,72
1,1627,1204,423,3,250,87
0,1410,1600,-190,1,23,127
1,1599,1568,31,1,353,131
1,1356,1342,14,-2,41,77
1,1593,1512,81,0,61,65
-1,1538,1620,-82,2,51,52
-1,1812,1684,128,-4,-91,48
-1,1717,1642,75,-3,-70,46
0,1599,1418,181,-8,21,143
1,1979,1832,147,0,-52,75
0,1628,1309,319,2,224,104
-1,1500,1633,-133,0,-18,80
0,1826,1798,28,2,59,68
-1,1558,1609,-51,-2,-12,48
1,1673,1385,288,3,107,53
1,1805,1704,101,1,29,49
-1,1467,1443,24,1,-4,70
1,1575,1383,192,1,18,69
1,1556,1745,-189,-1,-285,101
-1,1503,1529,-26,1,-1,56
1,1986,1825,161,0,87,89
-1,1358,1677,-319,0,-31,76
-1,1639,1639,0,0,-30,76
1,1202,1633,-431,-2,-25,65
1,1344,1527,-183,-2,-31,43
1,1319,1302,17,1,48,47
-1,1460,1441,19,-1,-599,132
1,1813,1812,1,0,33,53
1,2064,1754,310,0,0,123
1,1242,1383,-141,-16,-639,73
-1,1524,1466,58,1,19,52
-1,1588,1695,-107,0,-248,86
-1,1681,1506,175,0,12,56
0,1200,0,1200,-2,-168,75
-1,1751,1888,-137,-3,-97,56
-1,1043,1342,-299,-5,-120,48
0,1162,1396,-234,-6,-4,115
1,1989,1591,398,-5,181,123
-1,1684,1609,75,0,17,56
1,1377,1313,64,0,-10,43
1,2067,1895,172,0,20,65
1,1726,1574,152,2,38,46
-1,1743,1747,-4,0,14,118
1,1445,1360,85,0,217,89
-1,1653,1808,-155,0,-30,48
-1,1671,1819,-148,0,-67,122
-1,1816,1655,161,0,-155,148
-1,1545,1435,110,-2,-681,112
1,1539,1549,-10,0,21,79
0,1500,1198,302,-1,339,115
-1,1304,1382,-78,2,50,48
-1,1030,1633,-603,-2,-117,66
-1,1406,1498,-92,-3,-331,96
1,1391,1290,101,-6,-266,57
1,1992,1781,211,-1,-149,91
1,1682,1647,35,-1,-47,51
-1,1567,1734,-167,-4,-217,72
1,1665,1697,-32,0,64,81
1,2075,1889,186,0,231,133
-1,1509,1503,6,-3,-104,62
1,1618,1673,-55,-1,-5,47
1,1610,1815,-205,0,-46,93
-1,1506,1579,-73,1,-20,64
-1,1732,1883,-151,-1,-42,66
1,1686,1676,10,0,76,81
-1,1538,1550,-12,-1,356,108
1,1588,1496,92,4,94,49
-1,1666,1696,-30,-1,-67,136
-1,1740,1560,180,0,-263,82
-1,1518,1593,-75,-1,-50,72
-1,1302,1729,-427,-5,-379,76
-1,1493,1264,229,5,87,52
-1,1427,1507,-80,-3,-232,78
-1,2050,2003,47,0,-30,80
1,2082,1890,192,-1,-38,43
-1,1407,1545,-138,-3,-157,62
-1,1476,1339,137,-4,-142,84
-1,1444,1630,-186,-2,-23,44
1,1884,1566,318,2,180,73
0,1563,1627,-64,-4,29,156
1,1367,1435,-68,5,373,92
1,1553,1400,153,13,163,45
1,1516,1418,98,2,339,139
-1,1561,1528,33,0,2,50
-1,1300,1000,300,1,-1,82
-1,1577,1722,-145,2,15,94
1,2088,1560,528,2,79,45
-1,1412,1387,25,0,54,58
-1,1169,1636,-467,-1,-272,70
0,1769,1812,-43,-1,-225,127
-1,1409,1524,-115,0,-7,54
-1,1563,1539,24,-9,-162,56
1,1656,1549,107,1,27,67
1,1342,1237,105,12,126,40
0,2090,1960,130,0,127,185
-1,1414,1424,-10,-6,-290,64
-1,1810,1770,40,0,-45,102
1,1407,1576,-169,-1,31,53
1,1551,1552,-1,2,146,85
-1,1280,1380,-100,0,-107,91
-1,1541,1664,-123,0,17,88
-1,1027,1849,-822,-4,-292,78
-1,1402,1495,-93,-1,-47,156
1,1714,1633,81,-1,-46,111
1,2085,1903,182,-1,8,43
-1,1279,1702,-423,-3,-61,48
-1,1601,1675,-74,-3,-182,85
1,1783,1799,-16,0,39,97
1,1992,1942,50,0,40,117
1,1730,1570,160,3,177,67
-1,1541,1561,-20,2,103,58
-1,1581,1526,55,3,76,58
1,2073,1914,159,7,44,43
-1,1640,1798,-158,0,-11,74
-1,1907,2080,-173,-3,-220,81
1,1271,1277,-6,3,99,63
1,1671,1533,138,0,141,129
-1,1549,1503,46,-3,-143,78
1,1769,1727,42,-2,24,53
-1,1787,1796,-9,0,4,76
1,1462,1202,260,9,292,53
1,1885,1901,-16,1,377,129
-1,1571,1531,40,1,72,98
1,1526,1678,-152,0,4,93
-1,1890,1896,-6,0,-70,76
-1,1335,1566,-231,-1,-68,68
1,1409,1498,-89,0,124,101
-1,1149,1523,-374,-9,-696,78
-1,1265,1284,-19,-6,-15,48
-1,1564,1737,-173,-5,-336,114
1,2018,1690,328,0,-5,47
-1,1663,1542,121,0,-31,128
1,1521,1548,-27,-9,10,85
-1,1543,1559,-16,-2,83,88
-1,1382,1424,-42,-6,-227,54
1,1580,1507,73,2,311,85
1,1253,1257,-4,-2,-45,55
1,2022,1687,335,-1,-21,91
-1,1562,1515,47,-3,-254,72
-1,1042,1525,-483,-13,-494,72
1,1570,1533,37,0,-103,83
1,1924,1864,60,0,22,49
0,1557,1648,-91,0,15,91
-1,1255,1510,-255,0,-65,64
1,1716,1716,0,-1,144,109
1,2011,1502,509,-1,-10,85
-1,1661,1804,-143,-2,-61,82
0,1368,1540,-172,3,511,125
-1,1855,1935,-80,-3,-7,70
-1,1646,1559,87,0,-270,104
1,1811,1680,131,-1,135,95
1,1524,1579,-55,-1,-55,63
1,1525,1336,189,1,35,50
1,1599,1692,-93,0,122,63
-1,1641,1574,67,2,46,70
0,1573,1633,-60,-1,15,133
-1,2031,1992,39,-1,38,88
-1,1819,1800,19,-3,-561,178
-1,1730,1497,233,0,75,76
-1,1453,1363,90,1,18,104
1,1567,1536,31,-2,38,50
1,1777,1846,-69,-3,20,75
-1,1811,1807,4,-1,-481,126
-1,1807,1811,-4,-4,-389,116
-1,1445,1437,8,0,-103,56
1,1631,1575,56,0,56,111
-1,1526,1576,-50,-1,-71,52
-1,1740,1617,123,0,-229,102
1,1539,1330,209,12,794,71
-1,1822,1795,27,-1,-973,98
1,1500,1514,-14,-4,24,101
1,1722,1860,-138,0,5,49
-1,1704,1727,-23,-2,-159,78
1,2013,1547,466,-1,3,101
-1,1833,1790,43,-1,-32,52
1,1586,1565,21,1,294,127
1,1711,1488,223,-3,157,69
-1,1566,1640,-74,0,-32,102
1,1703,1640,63,0,33,97
1,1810,2129,-319,-5,-16,45
-1,1325,1552,-227,1,15,66
1,1654,1474,180,2,234,73
1,1648,1557,91,1,16,47
1,1802,1821,-19,-2,-74,67
1,1692,1593,99,0,26,71
-1,1144,1176,-32,-17,-162,42
-1,1483,1716,-233,-1,5,42
1,1265,1241,24,-1,74,71
1,1673,1660,13,-6,236,207
-1,1870,1909,-39,-3,-160,66
1,2109,1375,734,1,39,47
-1,1514,1724,-210,-8,-83,46
-1,1375,2109,-734,-3,-56,42
1,1825,1673,152,-2,-483,113
1,1596,1377,219,2,113,49
-1,1395,1502,-107,-2,-226,90
1,1683,1650,33,5,152,55
1,2109,1369,740,1,30,63
-1,1650,1831,-181,0,-221,78
-1,1787,1843,-56,-1,-104,112
1,1534,1373,161,-1,-119,99
-1,1419,1642,-223,-1,-89,56
1,1693,1500,193,3,49,47
1,1508,1729,-221,1,53,73
1,1233,1228,5,1,253,105
1,1807,1810,-3,0,20,69
-1,1315,1585,-270,0,-22,60
1,1640,1698,-58,-3,-547,133
-1,1494,1748,-254,-7,-524,84
1,1269,1324,-55,3,243,61
1,1686,1652,34,1,12,81
-1,1575,1548,27,0,-86,74
1,1624,1493,131,-1,5,40
1,1315,1354,-39,0,-37,57
1,1695,1643,52,14,590,81
-1,1510,1408,102,-2,54,45
1,2168,1837,331,5,396,88
1,1816,1485,331,-1,413,77
-1,1834,2172,-338,3,104,132
-1,1589,1715,-126,0,-15,47
1,1330,1239,91,5,941,121
0,1705,1634,71,-2,-765,156
1,1809,1616,193,-2,18,71
-1,1372,1590,-218,4,-135,92
1,2015,1040,975,-1,460,81
1,1302,1520,-218,-5,-209,65
1,1381,1320,61,3,267,75
1,1634,1552,82,-1,-11,65
1,2175,1831,344,3,119,55
1,1702,1636,66,3,352,117
-1,1282,1471,-189,-12,-171,42
-1,1617,1631,-14,-3,-452,104
0,2083,1731,352,0,-19,61
1,1711,1627,84,7,47,41
1,1632,1711,-79,2,113,81
1,1719,1619,100,2,-9,87
1,1589,1040,549,8,675,79
-1,1723,1733,-10,0,-15,54
1,1624,1557,67,0,135,75
-1,1538,1815,-277,-2,-104,60
-1,1487,1543,-56,2,53,56
-1,1038,1432,-394,-1,-96,64
-1,1442,1506,-64,-4,-487,114
1,1280,1589,-309,0,97,78
-1,1478,1422,56,-3,-17,72
-1,1335,1574,-239,2,30,40
-1,1514,1664,-150,-3,-92,70
1,1489,1368,121,3,133,53
0,1890,1839,51,1,266,142
-1,1692,2065,-373,-11,-106,45
-1,1520,1674,-154,-2,-116,60
1,1639,1964,-325,-6,-38,55
1,1748,1768,-20,-1,-2,65
1,2068,1689,379,1,145,57
1,1562,1361,201,1,12,77
1,1944,1792,152,0,106,109
1,1386,1372,14,1,395,113
1,1668,1439,229,3,62,51
1,1401,1248,153,5,152,46
-1,1049,1125,-76,3,34,60
-1,1733,1869,-136,0,-25,136
1,1392,1528,-136,2,216,87
1,1695,1644,51,2,31,57
1,1622,1343,279,9,413,75
1,1417,1474,-57,-3,-661,147
1,1574,1463,111,0,72,68
1,1835,1670,165,1,146,111
-1,1496,2072,-576,-2,-38,44
-1,1612,1614,-2,1,34,50
1,1841,1889,-48,1,213,151
-1,1757,1761,-4,-2,-74,84
-1,2064,2139,-75,-2,-145,106
-1,1367,1747,-380,1,-158,98
1,1495,1364,131,-1,257,71
1,1445,1247,198,1,23,49
1,1517,1513,4,-9,11,79
1,1939,1618,321,1,32,45
-1,1445,1523,-78,-3,-115,64
-1,1743,1417,326,2,33,42
-1,1661,2093,-432,-9,-14,40
1,1633,1336,297,0,325,213
0,1608,1355,253,3,384,114
1,1764,1828,-64,-4,-40,43
-1,1733,1673,60,0,-177,102
1,1351,1076,275,2,80,51
-1,1319,1579,-260,-4,-68,44
-1,1460,1630,-170,-7,-228,46
1,1701,1486,215,8,181,49
-1,1877,2095,-218,1,60,86
1,1659,1625,34,1,213,99
-1,1583,1580,3,-1,10,114
1,1391,1381,10,1,10,43
-1,1178,1410,-232,-2,-167,85
-1,1943,1640,303,-2,-60,70
-1,2056,1935,121,-1,-22,44
1,2149,2052,97,8,54,41
-1,1722,1811,-89,-1,-15,56
-1,1241,1451,-210,-9,-372,60
1,1718,1456,262,5,365,73
1,2043,2159,-116,-3,46,55
1,1502,1382,120,1,68,49
1,1603,1360,243,3,459,73
-1,1797,1778,19,0,-25,48
-1,2142,2059,83,0,-10,56
1,1528,1757,-229,10,462,63
-1,1721,1635,86,0,17,106
-1,2086,1935,151,-1,23,60
1,1421,1615,-194,-4,-91,49
1,1789,1872,-83,0,159,71
1,1772,1746,26,0,-12,119
-1,2074,2127,-53,-1,-24,56
-1,1500,1339,161,0,-339,132
-1,1402,1575,-173,5,207,110
-1,1584,1705,-121,-4,-526,115
-1,2137,2064,73,-3,-229,160
1,1749,1650,99,6,115,45
-1,1510,1599,-89,-6,-75,46
-1,1954,1680,274,-5,-86,52
1,1819,1790,29,0,1,123
1,1572,1630,-58,0,-20,51
1,1631,1119,512,3,97,49
1,1481,1759,-278,3,299,89
1,1412,1398,14,1,302,71
1,1859,1802,57,0,3,55
-1,1498,1615,-117,5,140,60
1,2078,2123,-45,0,8,65
1,1543,1586,-43,1,51,61
1,1669,1507,162,7,876,109
1,1751,1579,172,0,30,67
0,1793,1868,-75,0,7,47
1,1632,1806,-174,-3,-112,67
1,1637,1372,265,1,29,51
1,1757,1640,117,-6,-25,55
-1,1468,1417,51,0,-27,50
1,1461,1435,26,-2,68,81
-1,2104,2096,8,0,-66,74
-1,1660,1918,-258,-1,-78,78
-1,1387,1442,-55,-1,-63,54
-1,1514,1558,-44,-6,-188,54
1,1503,1635,-132,-1,6,91
0,1764,1648,116,5,333,95
0,1671,1625,46,-3,-123,93
-1,1400,1521,-121,-2,-2,42
-1,2109,2092,17,0,65,82
1,1783,1725,58,-1,-40,57
-1,1502,1501,1,-5,-62,54
1,1623,1490,133,4,9,45
1,1652,1518,134,-3,91,97
1,1598,1656,-58,1,49,51
0,2155,2057,98,0,17,107
1,1632,1763,-131,-9,-101,43
1,1395,1500,-105,-2,-102,101
-1,1620,1678,-58,0,-1,42
-1,1608,1500,108,1,-20,48
0,1575,1627,-52,1,104,125
-1,1890,1919,-29,0,-24,112
-1,1688,1610,78,-1,-290,94
1,1581,1580,1,0,46,69
-1,1659,1678,-19,-2,-23,60
-1,1511,1500,11,-3,-152,56
-1,1377,1572,-195,-1,-789,142
0,1676,1922,-246,0,-15,128
1,1624,1674,-50,1,375,83
-1,1483,1630,-147,0,-8,44
1,1226,1100,126,0,3,55
1,1829,1786,43,0,2,45
-1,1896,1586,310,5,159,54
1,1429,1443,-14,4,236,59
1,1390,1434,-44,-2,-28,55
1,1878,1793,85,1,68,125
1,1866,1936,-70,5,248,77
1,1514,1442,72,-1,-114,61
1,1680,1503,177,3,210,79
1,1712,1577,135,0,92,66
1,1725,1636,89,0,126,75
-1,1809,1636,173,0,-58,102
1,1410,1400,10,6,589,79
-1,1653,1556,97,-3,-29,44
1,1924,1655,269,3,384,117
-1,1714,1656,58,-1,-207,92
1,1707,1649,58,1,283,113
1,1522,1504,18,7,254,68
1,1474,1660,-186,0,257,109
-1,1405,1469,-64,-3,-89,62
-1,1639,1731,-92,-4,-419,90
1,1800,1737,63,-6,-225,65
1,1601,1628,-27,-5,11,45
-1,1780,2060,-280,0,-4,78
0,1415,1152,263,-2,-130,112
1,1533,1453,80,7,142,55
-1,1545,1528,17,0,-105,84
-1,1094,1643,-549,-3,-62,56
1,1712,1523,189,-1,-9,41
-1,1442,1433,9,-9,-34,112
1,1639,1767,-128,0,-18,69
1,1722,1512,210,9,122,47
1,1719,1559,160,1,60,65
-1,1382,1422,-40,-15,-334,46
1,1752,1631,121,3,163,91
1,2065,1644,421,5,43,47
-1,1914,1613,301,0,4,70
1,1447,1794,-347,0,-19,77
-1,1777,1779,-2,0,-130,107
1,1878,1913,-35,1,25,55
1,1668,1701,-33,3,172,71
-1,1545,1559,-14,-2,-150,94
-1,1298,1648,-350,-3,-57,84
1,1642,2067,-425,-3,-11,65
1,2042,1664,378,12,555,71
1,1776,1529,247,8,540,73
1,1512,1631,-119,-1,-25,47
-1,1556,1683,-127,-7,-130,58
-1,1624,1769,-145,-3,-69,46
1,1524,1781,-257,-1,-7,83
-1,1625,1577,48,1,8,44
1,1608,1593,15,3,41,45
-1,1662,2045,-383,-2,-56,52
-1,1478,1395,83,7,165,120
1,1584,1371,213,0,1039,161
-1,1784,1617,167,1,90,70
1,1748,1500,248,8,226,61
1,1494,1659,-165,4,305,63
1,1760,1543,217,0,226,87
1,1360,1500,-140,2,73,51
1,1745,1416,329,2,729,171
-1,1784,1886,-102,0,-58,92
1,1433,1366,67,17,362,44
-1,1486,1454,32,-2,-11,58
-1,1651,1675,-24,0,-64,92
1,1679,1757,-78,-3,-96,69
-1,1690,1631,59,0,31,88
-1,1415,1752,-337,-12,-113,40
1,1900,1890,10,0,-26,121
1,1532,1417,115,0,2,101
-1,1538,1766,-228,-1,40,98
1,1641,1636,5,0,147,71
1,1756,1371,385,-1,171,75
-1,1651,1795,-144,0,-234,106
1,1423,1303,120,2,28,51
1,1951,1791,160,-1,-63,79
1,1625,1653,-28,-3,327,123
1,1772,1533,239,1,217,75
-1,1623,1579,44,-3,-21,46
-1,1670,1699,-29,0,-42,72
-1,1326,1719,-393,0,33,54
1,2041,1725,316,0,-16,58
1,1633,1755,-122,2,88,65
1,1237,1224,13,-10,-196,49
1,1685,1640,45,1,107,77
-1,1533,1592,-59,0,-28,110
1,1345,1298,47,8,311,63
1,1804,1654,150,1,124,73
1,1637,1640,-3,13,618,75
1,1934,1756,178,0,67,78
1,1606,1210,396,-5,-59,57
1,1880,1911,-31,1,52,59
1,1045,1417,-372,3,136,63
1,1434,1258,176,2,122,69
-1,1720,1695,25,-2,-219,82
-1,1777,1952,-175,-1,-117,74
1,1627,1648,-21,-1,-2,63
1,1694,1506,188,-1,343,65
-1,1444,1533,-89,2,-116,116
-1,1630,1694,-64,2,166,54
-1,1512,1570,-58,-3,-207,82
-1,1611,1652,-41,0,-8,46
-1,1636,1640,-4,-4,-113,60
1,1675,1479,196,0,7,103
-1,1332,1657,-325,-1,-228,78
-1,1472,1335,137,-1,-54,106
1,2050,1770,280,0,399,87
-1,1766,1784,-18,-1,-202,90
-1,1601,1565,36,-1,-78,70
1,1647,1496,151,0,10,119
-1,1650,1719,-69,0,18,60
1,1648,1645,3,0,-11,59
-1,1621,1637,-16,-11,-350,104
-1,1545,1656,-111,0,-122,72
-1,1290,1323,-33,-9,-200,56
1,1765,1626,139,2,71,107
-1,1598,1704,-106,-7,-685,114
1,1665,1582,83,2,785,173
-1,1287,1356,-69,-1,-83,142
1,1721,1859,-138,-2,-242,79
1,1709,1776,-67,0,9,45
1,1609,1553,56,3,237,73
-1,1619,1774,-155,-3,-274,84
-1,1654,1711,-57,-2,-123,60
1,1590,1500,90,-2,1,81
-1,1541,1538,3,-4,-621,120
-1,1451,1323,128,0,-36,64
-1,1408,1556,-148,-1,-20,86
1,1528,1620,-92,0,46,63
1,1891,1721,170,4,209,55
1,1781,2055,-274,0,-74,77
1,1596,1364,232,6,148,53
-1,1715,1922,-207,2,61,60
-1,1720,1644,76,-1,11,100
1,1602,1524,78,0,21,119
-1,1724,1584,140,-1,-105,64
1,1598,1200,398,1,88,59
-1,1614,1804,-190,-5,-172,74
1,1460,1440,20,10,269,59
-1,1440,1728,-288,-2,-244,78
-1,1722,1762,-40,-5,-6,58
1,1357,1337,20,-1,350,93
-1,1540,1453,87,1,24,54
-1,2009,1951,58,-10,-37,52
1,2031,1802,229,1,38,59
1,1680,1659,21,0,48,103
-1,1199,1924,-725,-23,-510,44
-1,1205,1422,-217,2,35,122
-1,1708,1897,-189,-6,-277,76
1,1379,1501,-122,1,419,133
1,1439,1508,-69,1,61,79
1,1298,1229,69,-2,24,55
-1,1693,1843,-150,-1,-20,58
-1,1658,1707,-49,-3,-298,100
1,1504,1772,-268,-2,-26,73
1,1664,1548,116,1,27,45
1,1938,1889,49,0,-6,57
0,1712,1705,7,2,378,136
1,1850,1687,163,0,24,47
-1,1591,1691,-100,1,-25,66
1,1902,1697,205,6,149,53
1,2041,1571,470,0,382,103
1,1716,1648,68,0,-5,51
-1,1625,1631,-6,0,-25,70
1,1649,1402,247,1,10,57
1,1690,1760,-70,5,28,43
-1,1471,1486,-15,-1,-56,54
-1,1497,1523,-26,-2,-267,76
0,1226,1366,-140,-4,-141,156
1,1570,1613,-43,-3,170,129
-1,1644,1552,92,-7,-174,72
1,1414,1355,59,1,235,73
-1,1443,1441,2,-2,-54,84
-1,1703,1857,-154,-1,-50,68
-1,1314,1370,-56,2,105,56
1,1383,1750,-367,1,38,61
1,1235,1570,-335,-3,-13,53
1,1338,1289,49,1,47,69
-1,1608,1762,-154,0,-71,64
-1,1516,1611,-95,-6,-389,92
-1,1424,1346,78,-6,-100,56
-1,1639,1583,56,-4,-228,76
-1,1592,1571,21,-6,-557,98
1,1874,1809,65,-1,3,55
1,1460,1539,-79,7,138,47
-1,1488,1503,-15,0,-259,114
1,1786,1695,91,-2,-55,105
1,1640,1602,38,0,66,95
-1,1709,1925,-216,0,-124,112
1,2092,1721,371,-1,-43,55
1,1588,1397,191,-4,-85,59
-1,1369,1359,10,1,57,92
1,1578,1501,77,2,11,41
-1,1545,1557,-12,-2,-70,88
1,1613,1546,67,0,84,123
1,1879,1925,-46,0,9,59
1,1948,1754,194,0,-14,53
1,1863,1587,276,4,278,75
-1,1486,1534,-48,5,-156,96
-1,1712,1705,7,-1,-181,100
1,1804,1496,308,0,116,77
-1,1696,1767,-71,2,34,102
-1,1092,1371,-279,-4,-350,78
1,1420,1358,62,0,142,79
-1,1707,1589,118,-6,-88,56
1,1586,1724,-138,-1,203,81
1,1769,1726,43,-1,91,69
-1,1557,1681,-124,-5,-61,40
1,1700,1737,-37,-1,20,85
-1,1335,1392,-57,0,-151,96
-1,1513,1460,53,-1,-13,46
1,1619,1508,111,1,5,45
1,1762,1461,301,1,281,102
1,1885,1411,474,1,102,65
1,1589,1375,214,8,316,65
1,1707,1602,105,-2,73,69
1,1748,1217,531,0,73,91
-1,1554,1624,-70,-1,-241,88
-1,1370,1594,-224,-12,-867,84
-1,1255,1427,-172,-3,-87,44
-1,1860,1929,-69,0,-153,96
1,1953,2100,-147,-1,116,97
1,1595,1198,397,1,48,93
1,1545,1567,-22,16,471,61
1,1599,1365,234,4,455,97
1,1871,1580,291,0,-131,63
-1,1819,2084,-265,-1,-166,76
1,1759,1576,183,3,115,63
1,1613,1531,82,0,-2,55
-1,978,1407,-429,-16,-790,84
1,2089,1815,274,-3,83,102
-1,1360,1604,-244,-8,-279,60
-1,1458,1698,-240,-5,-338,72
-1,1477,1537,-60,0,1,54
1,1598,1627,-29,2,487,133
-1,1680,1788,-108,1,58,52
1,1531,1308,223,1,67,43
0,1459,1500,-41,0,209,113
1,1609,1355,254,2,195,69
1,1841,1531,310,1,-1,57
1,1426,1409,17,1,307,80
1,1480,1535,-55,2,884,111
-1,1402,1312,90,-4,-171,87
1,1460,1500,-40,16,335,43
1,2043,1601,442,0,-2,47
-1,1756,1802,-46,-5,-40,46
1,2009,2094,-85,1,68,59
-1,1814,1659,155,1,47,56
-1,1309,1465,-156,-3,-396,90
1,1599,2045,-446,-2,-137,91
-1,1351,1613,-262,-4,-91,68
1,1797,1672,125,0,-19,69
-1,1302,1594,-292,0,-13,74
-1,1642,1712,-70,-1,55,78
1,1721,1536,185,2,51,99
-1,1232,1319,-87,-1,-145,92
1,2017,1620,397,-1,65,55
1,1489,1510,-21,5,699,74
-1,1797,1973,-176,-2,-109,68
1,1594,1583,11,1,34,50
-1,1618,2020,-402,0,-2,54
1,1597,1556,41,-1,395,85
1,975,1412,-437,0,-26,57
-1,2077,2023,54,-4,-141,60
1,1894,1812,82,0,72,87
1,1568,1380,188,-5,-115,59
-1,1721,1732,-11,3,-10,98
1,2023,1615,408,1,152,49
0,1616,1370,246,-4,-186,97
1,1297,1530,-233,2,60,59
1,1348,1357,-9,0,279,105
1,1978,1790,188,2,298,77
1,1598,1734,-136,0,463,107
-1,1613,2026,-413,0,-281,78
-1,1388,1888,-500,1,6,42
0,1524,1346,178,0,181,115
-1,1476,1665,-189,-8,-307,62
1,1783,1984,-201,-1,461,145
-1,1765,1690,75,-1,-385,82
1,1665,1805,-140,1,62,79
1,1654,1531,123,1,283,83
1,1623,1340,283,0,19,55
1,2062,1611,451,-2,164,93
-1,2064,1478,586,0,121,78
-1,1803,1902,-99,0,-11,96
-1,1007,1342,-335,-16,-231,54
-1,1802,1968,-166,-3,-139,58
-1,1571,1528,43,-3,-213,102
1,1420,1304,116,9,300,54
1,1765,1753,12,-1,234,115
1,1613,1321,292,0,1,57
1,2042,1609,433,3,142,49
-1,1351,2044,-693,-4,-63,40
1,1573,1548,25,-4,287,189
1,1983,1549,434,1,289,133
-1,1500,1573,-73,-2,-57,50
-1,1789,1788,1,0,0,60
-1,1467,1624,-157,0,17,86
1,2044,1802,242,1,22,51
1,1680,1655,25,0,-1,69
1,1701,1617,84,1,80,109
1,1532,1519,13,-9,-443,77
-1,1797,2050,-253,0,-82,62
-1,1273,1323,-50,1,35,60
1,1521,1334,187,10,74,41
1,1621,1767,-146,3,141,57
-1,1072,1714,-642,-4,-329,67
1,1706,1811,-105,0,54,97
1,1387,1002,385,1,85,45
-1,1451,1634,-183,0,-16,86
-1,1316,1512,-196,-2,-60,72
1,1500,1542,-42,-6,-122,49
-1,1492,1480,12,4,-20,66
-1,2055,1792,263,0,58,78
0,1892,1943,-51,0,19,115
1,1546,1517,29,-7,-80,47
1,1745,1600,145,-1,69,113
1,1484,1527,-43,0,130,105
1,1637,1753,-116,2,92,75
-1,1812,2033,-221,-2,96,118
1,1563,1621,-58,2,237,121
-1,1562,1381,181,-1,-76,66
1,1690,1734,-44,0,33,97
1,1500,1500,0,-1,41,53
1,1653,1788,-135,6,170,59
1,1477,1547,-70,3,112,65
-1,1328,1526,-198,-3,74,138
-1,1903,1940,-37,-2,-128,68
1,2039,1806,233,0,70,61
1,1742,1776,-34,0,16,70
1,1394,1289,105,-1,139,135
-1,1800,1777,23,1,1,74
0,1801,2045,-244,-3,87,107
-1,1555,1457,98,-2,-89,42
-1,1308,1533,-225,-1,171,90
-1,1461,1489,-28,-1,-51,53
1,1507,1541,-34,8,112,41
1,1969,1957,12,2,99,49
1,1744,1805,-61,0,45,125
1,1833,1408,425,2,151,59
-1,1500,1639,-139,-4,-38,44
-1,1279,1595,-316,-8,-485,82
1,1574,1350,224,9,193,45
1,2037,1809,228,-4,-187,69
-1,1304,1637,-333,-2,-105,64
-1,1545,1530,15,5,139,52
-1,1764,1754,10,1,40,68
1,1925,1881,44,-1,-123,119
1,1707,1649,58,4,181,73
-1,1816,1579,237,-4,-136,80
1,1573,1522,51,-5,-194,69
1,1541,1512,29,-9,-368,55
-1,1326,1398,-72,2,9,40
-1,1302,1518,-216,0,72,70
1,1508,1247,261,13,652,63
1,1942,1894,48,1,46,57
1,1654,1543,111,7,322,69
-1,1526,1500,26,-4,-9,40
1,1406,1835,-429,-1,2,81
1,1608,1629,-21,1,45,49
1,1583,1069,514,12,408,49
1,1702,1616,86,5,186,65
1,1646,1536,110,0,-86,91
-1,1594,1366,228,1,26,52
-1,1523,2117,-594,-2,-91,54
-1,1364,1546,-182,0,19,54
-1,1295,1538,-243,-5,-132,68
1,1500,1487,13,0,-28,53
-1,1561,1385,176,-14,-959,112
1,1547,1579,-32,3,136,47
1,1266,1599,-333,-1,75,61
-1,1765,1752,13,1,-90,102
1,1486,1325,161,0,182,87
1,1584,1068,516,0,17,47
1,1522,1289,233,2,54,47
-1,1543,2118,-575,-2,-89,50
-1,1478,1535,-57,1,-26,54
-1,1445,1790,-345,-1,-147,72
-1,1544,1402,142,-2,-535,154
1,1601,1305,296,9,323,55
-1,1390,1487,-97,-2,-307,74
-1,1426,1260,166,-3,-426,70
-1,1463,1546,-83,2,49,52
-1,1551,1643,-92,0,-5,56
1,1641,1435,206,-4,421,103
1,1648,1765,-117,-5,10,67
1,1838,1393,445,4,191,89
1,2069,1701,368,2,433,85
-1,1412,1422,-10,0,-226,90
1,1689,1500,189,2,55,55
1,1865,1905,-40,0,-25,111
1,1970,1467,503,-3,28,73
-1,1616,1456,160,3,-71,62
-1,1391,1840,-449,-1,-136,76
1,1397,1495,-98,-2,-5,57
-1,1674,1521,153,-1,-21,54
1,1808,1674,134,0,-40,71
1,1670,1623,47,0,49,107
-1,1363,1466,-103,-2,-324,98
1,1842,1389,453,0,114,73
1,1670,1799,-129,-14,-145,67
-1,1597,1593,4,1,116,82
1,1380,1202,178,4,137,53
1,1619,1707,-88,1,16,55
-1,1387,1844,-457,-6,-172,59
1,1500,1017,483,13,349,51
1,1743,1672,71,0,1,45
-1,1829,2070,-241,0,-80,62
1,1404,1431,-27,6,103,61
0,1474,1470,4,0,-57,103
1,1465,1492,-27,1,533,111
-1,1490,1316,174,0,-278,144
-1,1500,1892,-392,-2,-140,140
1,1458,1364,94,-3,-69,73
-1,1430,1600,-170,1,-184,84
-1,1213,1479,-266,0,-2,44
1,2075,1824,251,1,77,81
1,1480,1696,-216,-1,10,83
-1,1194,1386,-192,-8,-1299,166
-1,1535,1673,-138,0,14,46
1,1779,1850,-71,0,107,63
1,1819,1678,141,3,82,51
1,2075,1677,398,-1,97,87
-1,1574,1536,38,-7,-151,48
1,1364,1468,-104,0,-71,85
1,1679,1430,249,5,138,90
1,2177,1846,331,1,231,119
-1,1479,1641,-162,-1,-158,64
-1,1546,1675,-129,-1,-475,94
1,1354,1549,-195,0,9,71
-1,1723,1924,-201,-3,-118,74
1,1761,1790,-29,2,79,63
1,1827,1671,156,0,105,101
-1,1441,1745,-304,-3,-47,50
1,1208,1366,-158,0,-14,140
-1,1379,1683,-304,-5,-119,42
1,1683,1379,304,2,24,55
1,1606,1479,127,-1,348,97
-1,1446,1456,-10,-2,-3,44
-1,1416,1467,-51,1,38,120
1,1644,1796,-152,3,68,97
-1,1327,1371,-44,-3,-206,95
-1,1780,1828,-48,1,3,72
-1,2081,1842,239,3,28,46
1,1749,1438,311,1,-75,88
1,1557,1531,26,-3,353,189
-1,1842,2081,-239,-1,-131,64
-1,1517,1647,-130,5,68,52
1,2086,1863,223,0,649,111
-1,1594,1720,-126,-1,-22,56
1,1562,1522,40,3,133,85
0,1658,1613,45,2,107,73
1,1857,2092,-235,-4,-29,51
1,2034,1687,347,-3,94,63
-1,1603,1735,-132,0,-255,94
-1,1194,1496,-302,-2,-18,52
1,2071,1878,193,3,232,89
-1,1378,1357,21,-2,-48,50
0,1458,1381,77,4,-59,143
-1,1437,1387,50,0,-23,84
-1,1871,2078,-207,0,-542,163
1,1115,0,1115,5,529,89
-1,1877,1944,-67,-2,-123,62
-1,1615,1657,-42,0,-8,68
1,1451,1614,-163,-1,422,95
1,2038,1873,165,-3,21,81
-1,1322,1753,-431,-1,-94,74
1,1566,1509,57,0,12,41
1,1757,1894,-137,0,39,67
1,1480,1406,74,4,126,41
-1,1277,1571,-294,-1,-367,103
-1,1384,1447,-63,-2,-199,78
1,1667,1605,62,2,308,85
-1,1461,1239,222,1,46,52
1,1617,1680,-63,-5,-10,117
-1,1666,1661,5,-4,-136,46
1,1646,1616,30,0,-1,61
0,1397,1492,-95,0,-53,169
1,1731,1684,47,-2,-58,97
1,1226,1463,-237,3,182,72
-1,1696,1654,42,0,-26,56
-1,1596,1676,-80,-1,-115,98
1,1472,1374,98,-2,47,109
1,1301,1321,-20,-6,-33,41
1,1616,1494,122,0,-30,47
1,2190,1953,237,0,11,59
1,1668,1661,7,3,18,47
-1,1660,1755,-95,-3,-105,60
1,1575,1472,103,1,303,143
1,1632,1679,-47,-5,-3,81
1,1655,1331,324,7,73,41
1,1246,1317,-71,3,111,59
1,1913,1742,171,0,75,63
1,1424,1321,103,5,384,74
-1,1510,1491,19,2,-671,138
1,1684,1587,97,1,17,109
-1,1511,2209,-698,0,-50,64
-1,1736,1919,-183,1,-30,100
1,2045,1663,382,0,94,93
1,1465,1366,99,0,299,101
-1,1487,1624,-137,1,-155,130
-1,1764,1652,112,-1,-222,112
1,1925,1730,195,0,216,99
1,1694,1518,176,1,30,47
-1,1654,1689,-35,5,-1,40
0,1724,1794,-70,0,-29,73
-1,1320,1478,-158,-5,-212,76
1,1647,1623,24,-9,50,85
-1,1711,1644,67,3,304,128
1,1791,1726,65,11,140,43
-1,1655,1759,-104,-4,-65,48
1,1658,1261,397,-2,-30,53
-1,1480,1498,-18,1,-95,88
-1,1500,1304,196,-3,-51,46
-1,1717,1801,-84,0,-3,56
-1,1247,1432,-185,-6,-538,77
1,1683,1945,-262,-2,25,57
-1,1579,1523,56,0,103,110
1,1952,1485,467,1,431,113
-1,1767,1647,120,-4,-261,68
1,1773,1872,-99,0,0,43
-1,1270,2003,-733,-3,-91,54
1,1392,1499,-107,6,527,113
-1,1263,1421,-158,-2,-187,56
-1,1748,1591,157,-6,-36,54
1,1666,1266,400,2,150,53
1,1811,1373,438,1,47,67
-1,1811,1865,-54,1,41,56
-1,1358,1428,-70,-2,-142,94
1,1742,1423,319,0,112,75
1,1922,1613,309,-2,-28,41
1,1657,1701,-44,0,7,63
-1,1546,1470,76,-2,-14,54
-1,1876,1813,63,-1,-194,68
1,1486,1465,21,4,563,161
1,1569,1281,288,1,746,163
1,1567,1464,103,-1,10,83
1,1828,1861,-33,1,150,81
-1,1699,1432,267,1,223,94
-1,1808,1826,-18,-6,-118,60
1,1481,1406,75,-5,-112,45
-1,1662,1752,-90,0,-14,88
1,1669,1529,140,1,121,135
-1,1508,1562,-54,5,221,58
1,1930,1948,-18,-2,185,99
1,1256,1469,-213,2,9,47
1,1788,1740,48,1,102,65
0,2209,1749,460,0,-5,106
1,1575,1632,-57,4,71,45
-1,1683,1874,-191,-1,-33,54
1,1445,1173,272,-2,237,81
1,1836,1797,39,-1,-31,49
0,1483,1558,-75,2,-100,179
-1,1318,1371,-53,0,6,48
-1,1397,1492,-95,3,42,56
-1,1454,1644,-190,0,-153,74
1,1349,1556,-207,0,675,117
1,1847,1947,-100,0,-143,93
1,1523,1516,7,-4,45,63
1,1644,1838,-194,-2,-47,67
1,1731,1798,-67,-3,136,81
1,1863,1705,158,0,109,87
-1,1931,1790,141,-1,0,60
1,1936,1860,76,-1,3,63
1,1308,1591,-283,2,273,79
-1,1880,1678,202,2,-51,70
-1,1486,1455,31,0,10,158
1,1699,1870,-171,0,234,89
0,1945,1947,-2,0,49,96
1,1368,1398,-30,1,28,44
-1,1853,1715,138,1,-409,128
-1,1640,1562,78,-9,-105,43
-1,1560,1618,-58,0,11,48
1,1637,1496,141,0,143,89
-1,1731,1836,-105,0,6,72
-1,1255,1312,-57,-8,-186,75
1,1938,1841,97,0,51,53
1,1325,1213,112,3,28,41
1,1353,1199,154,-2,35,51
-1,1515,1670,-155,-4,-176,74
-1,1723,2110,-387,-1,-65,66
-1,1708,1845,-137,-1,-491,86
1,1785,1744,41,-2,-4,79
1,1539,1150,389,16,366,43
-1,1362,1504,-142,3,41,40
-1,1660,1761,-101,0,14,60
1,1945,1481,464,4,106,53
-1,1758,1818,-60,0,147,88
1,1821,1661,160,3,177,61
-1,1366,1606,-240,-2,-193,80
1,1859,1694,165,1,756,165
-1,1070,1492,-422,-3,-176,64
0,1542,1410,132,3,54,45
-1,1137,1399,-262,1,-21,60
1,1828,1749,79,0,36,113
1,1688,1866,-178,2,299,121
-1,1947,1946,1,1,-396,108
1,1833,1479,354,2,90,55
-1,1277,1344,-67,-1,-2,62
-1,1382,1412,-30,-1,-175,82
-1,1303,1486,-183,-6,-67,54
1,1849,1704,145,0,60,67
-1,1299,1346,-47,-7,-3,40
-1,1740,1836,-96,1,11,96
1,1839,1713,126,10,1259,127
1,1420,1265,155,0,3,53
1,1933,1835,98,1,40,87
-1,1102,1650,-548,-2,4,70
-1,1500,1897,-397,0,-57,83
-1,1706,1847,-141,-1,-47,80
1,1489,1645,-156,-4,-2,81
1,1780,1817,-37,-3,-50,67
-1,1534,1365,169,-9,-146,56
-1,1844,1731,113,-3,171,126
1,1498,1429,69,1,621,105
-1,1652,1643,9,0,-11,64
1,1500,1516,-16,0,5,49
-1,1692,1861,-169,0,-372,98
1,1769,1448,321,3,186,81
-1,1762,1521,241,0,-10,56
-1,1414,1490,-76,-4,-152,108
1,1867,1686,181,13,650,67
1,1652,1764,-112,0,9,47
-1,1530,2093,-563,-3,-260,76
1,1426,1344,82,1,135,103
-1,1500,1093,407,1,34,52
-1,1746,1830,-84,0,48,120
0,1680,1874,-194,-6,-301,133
1,1551,1493,58,7,152,47
-1,1099,1407,-308,-10,-645,76
0,1868,1686,182,0,-58,129
1,1772,1661,111,-1,-59,65
-1,1512,1634,-122,1,22,48
-1,1297,1492,-195,-2,-73,54
-1,1353,1352,1,2,16,44
-1,1838,1738,100,0,12,110
-1,1636,1548,88,0,-27,100
-1,1639,1583,56,-4,-164,132
1,1362,1444,-82,2,73,63
1,1691,1862,-171,0,352,161
-1,1529,1329,200,-6,-164,64
1,1606,1661,-55,1,23,53
-1,1246,1562,-316,-4,-193,55
-1,1555,1500,55,-6,-128,58
-1,1896,1951,-55,-1,-77,83
-1,1959,1726,233,0,-30,88
-1,1120,1487,-367,-2,-81,60
-1,1366,1341,25,-2,-705,116
1,1291,1497,-206,3,1651,183
-1,1545,1445,100,0,523,88
1,1422,1360,62,2,28,45
-1,1828,1778,50,-1,-73,56
1,1617,1565,52,0,93,67
1,1360,1512,-152,3,113,71
1,1442,1388,54,-3,53,124
1,1430,1500,-70,15,170,41
1,1435,1410,25,0,183,135
1,1807,1824,-17,0,2,51
-1,1795,1764,31,0,-134,106
-1,1596,1587,9,0,8,86
0,1971,1809,162,0,-13,107
-1,1500,1352,148,-10,-47,40
1,1221,1354,-133,-1,-9,53
-1,1794,1806,-12,-1,268,144
-1,1334,1413,-79,0,-28,68
1,1813,1440,373,4,205,71
1,1460,1531,-71,0,27,75
1,1647,1505,142,6,263,81
1,1900,1680,220,2,451,119
1,1966,1586,380,4,102,57
1,1496,1388,108,-1,39,81
1,1660,1571,89,-1,-40,56
1,1815,1556,259,1,23,73
-1,1276,1116,160,-5,-33,46
1,1341,1355,-14,-5,185,135
1,1829,1686,143,0,200,79
-1,1380,1679,-299,1,-63,64
1,1929,2188,-259,7,299,69
-1,1968,1511,457,-8,-1,40
-1,1578,1685,-107,-4,-154,56
1,1626,1628,-2,3,236,100
-1,1752,1872,-120,0,-39,88
-1,1422,1495,-73,-4,26,80
1,2165,1946,219,0,-83,77
-1,1246,1392,-146,-3,-96,56
1,1563,1669,-106,5,288,69
-1,1733,1820,-87,0,-106,74
1,1679,1598,81,2,43,57
-1,1350,1335,15,0,-53,50
1,1746,1635,111,0,102,79
-1,1384,1289,95,-14,-811,74
-1,1434,1676,-242,-1,-33,72
1,1579,1558,21,0,3,63
1,1695,1510,185,3,195,67
1,1345,1557,-212,0,-56,83
-1,1378,1281,97,-4,27,48
-1,1704,1957,-253,0,-29,84
-1,1855,1821,34,-3,-74,50
-1,1726,1945,-219,-2,-114,70
0,1356,1224,132,2,444,117
1,1553,1566,-13,0,0,45
1,1721,2028,-307,0,61,53
1,1739,1675,64,0,38,101
-1,1387,1500,-113,1,21,50
-1,1541,1691,-150,-1,-38,70
-1,1416,1657,-241,-1,-156,66
1,1524,1726,-202,3,37,49
-1,1879,1942,-63,-1,-83,64
1,2168,1860,308,-3,57,73
1,1721,1507,214,7,122,75
-1,1343,1539,-196,-7,-138,58
-1,1390,1366,24,-10,-195,52
-1,1951,1872,79,0,-31,48
1,1951,1870,81,0,-19,61
1,1581,1333,248,1,54,67
1,1803,1620,183,4,64,49
-1,1442,1373,69,3,133,66
1,1271,1256,15,1,-34,57
-1,1681,1430,251,-7,-97,106
-1,1420,1724,-304,-2,-26,76
-1,1564,1590,-26,0,-609,128
1,1889,1593,296,2,37,65
-1,1571,1690,-119,-1,-177,82
1,1662,1412,250,3,272,97
-1,1622,1337,285,0,9,52
-1,1020,1380,-360,3,-49,62
1,1937,1615,322,0,-5,51
-1,1587,1749,-162,1,-28,58
-1,1504,1743,-239,0,2,42
-1,1862,1959,-97,-2,-27,50
-1,1548,1637,-89,-2,-458,90
-1,1502,1726,-224,-1,-42,54
-1,1603,1455,148,4,107,154
-1,1274,1381,-107,-6,-514,82
1,1718,1921,-203,0,369,125
-1,1542,1627,-85,2,-51,106
1,1459,1377,82,-3,112,79
-1,1245,1283,-38,-7,-206,64
1,1707,1568,139,-6,-119,113
-1,1570,1694,-124,-1,6,96
1,1610,1833,-223,0,137,79
1,1967,1854,113,3,28,45
1,1940,1401,539,4,699,105
1,1727,1417,310,0,43,93
1,1500,1539,-39,0,218,71
1,1741,1666,75,0,405,125
-1,2036,1805,231,-3,-251,132
1,1809,1497,312,1,-43,71
-1,1856,1887,-31,2,84,74
-1,1358,1601,-243,-1,-263,112
1,1907,1846,61,2,168,79
-1,1235,1411,-176,-5,-272,83
-1,1846,1974,-128,0,-14,46
1,1735,1422,313,9,214,53
1,1622,1477,145,1,707,97
-1,1588,1498,90,-1,-90,92
-1,1657,1751,-94,-3,-212,82
0,1368,1467,-99,-1,-111,82
1,1739,1836,-97,0,91,109
-1,1981,1839,142,0,16,82
1,2000,1948,52,13,405,51
-1,1948,2000,-52,0,-4,52
-1,1587,1572,15,-3,-20,42
1,2011,1932,79,-3,47,71
1,1594,1107,487,4,327,65
-1,1563,1273,290,0,-33,122
1,1584,1575,9,1,14,73
-1,1493,1813,-320,-3,-205,80
-1,1415,1393,22,-4,-268,102
-1,1678,1739,-61,-1,-19,40
-1,1822,1918,-96,-1,-94,74
0,1695,1715,-20,0,547,230
0,1654,1725,-71,0,-20,114
-1,1669,1749,-80,-3,-234,74
-1,1534,1721,-187,-4,-146,56
-1,1563,1928,-365,2,46,48
1,2020,1792,228,0,-2,57
1,1339,1022,317,-1,169,71
-1,1854,1913,-59,0,-41,94
-1,1691,1972,-281,-1,-83,98
-1,1569,1702,-133,-12,-550,68
-1,1918,2030,-112,-5,-326,67
-1,1565,1595,-30,2,2,70
1,1758,1660,98,-1,66,75
-1,1629,1942,-313,1,-153,78
1,1311,1014,297,4,438,79
1,1343,1371,-28,-1,55,73
-1,1822,1660,162,0,-123,100
1,1709,1562,147,9,352,67
1,1791,1782,9,0,107,123
0,1561,1439,122,0,-59,143
1,1760,1605,155,0,48,56
1,1448,1448,0,9,421,75
0,1247,1500,-253,-5,-583,84
-1,1598,1767,-169,0,-17,98
-1,1653,1787,-134,-8,-555,112
1,1545,1531,14,-1,-32,71
1,1529,1467,62,2,89,51
-1,1573,1467,106,-1,-282,168
1,2038,1795,243,0,19,51
1,1766,1646,120,0,467,131
1,1772,1931,-159,0,-1,45
0,1774,1592,182,-3,129,146
1,1480,1383,97,0,34,99
1,1660,1649,11,0,-40,102
-1,1621,1624,-3,-3,-60,52
-1,1499,1816,-317,0,-152,120
-1,1222,1332,-110,-12,-416,58
-1,1657,1555,102,-2,-151,87
1,1697,1639,58,0,-13,103
1,1692,1312,380,0,2,53
1,1555,1520,35,3,47,41
1,1639,1703,-64,2,20,41
1,1629,1630,-1,1,98,63
1,1561,1631,-70,-1,29,151
-1,1538,1513,25,-1,-11,66
1,1523,1385,138,-1,-61,47
1,1341,1214,127,0,4,73
0,1510,1565,-55,2,8,79
-1,1694,1623,71,7,190,90
1,1569,1644,-75,2,60,59
-1,1496,1756,-260,0,-207,116
0,1578,1517,61,0,-122,201
1,1500,1916,-416,0,50,51
1,1641,1510,131,2,71,123
1,1389,1618,-229,5,241,99
1,1564,1512,52,2,28,46
1,1746,1413,333,7,69,45
1,1343,1357,-14,1,146,81
-1,1370,1708,-338,0,-123,134
1,1767,1278,489,3,900,147
1,1651,1790,-139,-1,505,119
1,1671,1650,21,0,20,53
1,1622,1659,-37,1,118,131
-1,1207,1220,-13,-6,-323,94
-1,1398,1401,-3,-5,-146,61
1,2080,1764,316,0,20,95
-1,1639,1681,-42,-6,-382,100
-1,1696,1692,4,0,-81,92
1,2147,1989,158,-3,24,69
-1,1451,1466,-15,0,82,108
-1,1304,1442,-138,0,-22,86
-1,1525,1886,-361,-1,-43,64
-1,1624,1720,-96,0,-19,60
1,1595,1465,130,-3,-50,47
1,1977,1484,493,1,80,59
-1,1232,1519,-287,0,-11,62
1,1195,1371,-176,5,123,49
-1,1568,1534,34,-1,-683,112
1,1574,1676,-102,2,-40,40
1,2043,1979,64,-1,-5,43
-1,1658,1774,-116,-2,-153,54
-1,1423,1429,-6,-1,-35,95
1,1653,1412,241,3,93,67
1,1782,1962,-180,4,225,65
-1,1962,1697,265,1,31,60
1,1491,1404,87,5,142,45
-1,1337,1691,-354,1,47,90
1,1766,1572,194,1,52,51
1,1892,1757,135,4,161,63
1,1933,1798,135,0,-7,87
1,1685,1661,24,0,105,165
1,1773,1478,295,-4,204,77
1,1730,1242,488,7,213,51
-1,1408,1658,-250,-5,-489,80
1,2084,1761,323,0,-14,61
-1,1355,1817,-462,0,-41,88
1,1631,1711,-80,0,-122,75
1,1833,1806,27,8,338,67
1,1941,1727,214,3,117,61
1,1957,1784,173,0,-9,51
-1,1589,1902,-313,-1,-54,88
-1,1401,1695,-294,3,128,114
1,1796,1844,-48,4,81,43
-1,1218,1314,-96,-5,-325,86
-1,1778,1967,-189,2,215,104
1,1505,1500,5,0,10,59
1,1522,1525,-3,0,26,71
1,1831,1808,23,1,279,69
-1,1587,1553,34,-5,-89,50
1,1803,1889,-86,-1,-95,95
1,1628,1981,-353,-4,-43,113
1,1976,1772,204,4,90,57
-1,1758,1735,23,2,25,54
1,1798,1842,-44,-3,-145,121
-1,1525,1470,55,-2,-37,74
1,1947,1734,213,0,94,79
1,1767,1984,-217,2,29,57
-1,1606,1362,244,0,27,130
1,1574,1762,-188,4,121,53
0,1829,1810,19,0,-141,191
1,1818,1497,321,0,25,45
1,1958,1784,174,-1,-134,85
1,1457,1105,352,13,419,61
-1,1554,1556,-2,-4,-786,126
1,1820,1945,-125,1,48,61
1,1696,1644,52,0,106,73
1,1667,1600,67,-2,4,77
-1,1279,1720,-441,-22,-907,86
1,1811,1828,-17,1,126,107
-1,1566,1773,-207,-1,-551,154
-1,1644,1666,-22,-3,-109,56
-1,1083,1390,-307,1,11,62
1,1778,1967,-189,0,361,149
-1,1694,1517,177,-2,37,42
1,1816,1822,-6,5,136,57
1,1747,1746,1,-8,-695,109
-1,1384,1667,-283,-1,-338,80
-1,1295,1342,-47,7,983,98
-1,1942,1795,147,-1,-160,68
-1,1811,1828,-17,-2,-23,56
-1,1533,1677,-144,-1,-64,120
-1,1811,1920,-109,-8,-196,62
-1,1508,1500,8,-3,-42,52
1,1931,1803,128,0,1,65
1,1839,2110,-271,2,48,69
1,1635,1707,-72,-1,-109,87
1,1101,1460,-359,-8,-235,67
1,1591,1496,95,0,543,147
-1,1745,1941,-196,-1,-307,130
-1,1249,1408,-159,-6,-288,58
-1,1695,1651,44,0,-132,110
-1,2092,1852,240,1,78,88
1,1953,1693,260,5,108,49
-1,1677,1630,47,-2,-105,58
1,1684,1526,158,0,46,94
1,1418,1276,142,4,409,85
0,1758,1791,-33,1,-283,181
-1,1588,1703,-115,-5,-482,98
1,1599,1256,343,-1,36,69
-1,1751,1709,42,-4,-138,58
1,1723,1900,-177,0,11,47
-1,1870,2068,-198,-1,-29,50
-1,1347,1424,-77,2,-792,120
-1,1555,1531,24,-2,-165,64
-1,1689,1957,-268,0,-19,90
1,1447,1378,69,0,191,95
-1,1906,1950,-44,0,-35,74
1,1648,1573,75,-1,39,63
1,2076,1865,211,-1,-45,45
-1,1865,2076,-211,0,-207,92
1,1242,1602,-360,0,18,53
-1,1381,1345,36,-1,-1085,126
0,1664,2099,-435,0,-53,115
1,1279,1338,-59,0,-30,109
1,1740,1490,250,-1,38,49
-1,1439,1131,308,-7,-571,100
-1,1388,1630,-242,-1,-155,74
1,1538,1415,123,1,22,49
-1,1654,1514,140,-9,-102,40
1,1854,2089,-235,1,103,81
-1,1554,1531,23,-9,-264,52
1,1583,1331,252,-1,80,79
-1,1747,1851,-104,0,-14,52
1,2066,1872,194,1,63,79
-1,1573,1559,14,3,148,93
1,1543,1543,0,1,46,55
-1,1468,1617,-149,-2,-128,66
1,1580,1576,4,1,90,65
1,1788,1759,29,0,50,95
1,1313,1588,-275,1,14,45
-1,1212,1292,-80,0,-719,158
-1,1867,2073,-206,2,-26,84
1,1498,1497,1,-1,19,85
-1,1691,1951,-260,0,13,66
-1,1529,1977,-448,-4,-145,84
-1,1668,1459,209,0,-455,106
-1,1549,1500,49,0,-62,104
1,1763,1694,69,1,23,81
1,1570,1385,185,5,273,67
-1,1856,2086,-230,-7,-371,78
1,1447,1471,-24,1,-3,51
-1,1481,1732,-251,-2,28,58
1,2006,1692,314,0,41,71
1,2092,1851,241,1,216,115
-1,1664,1859,-195,-2,-24,44
-1,1779,1561,218,3,78,56
1,1383,1357,26,-2,-61,49
1,1591,1393,198,-1,138,69
-1,1368,1485,-117,-3,-332,82
1,1836,1604,232,0,6,57
-1,1846,2098,-252,0,3,60
1,1623,1623,0,0,-9,57
1,1620,1543,77,1,-25,115
-1,1576,1541,35,1,-407,134
1,1671,1203,468,3,277,83
1,1647,1600,47,-1,-179,77
-1,1736,1843,-107,-4,-513,110
1,1650,1574,76,-1,-13,57
-1,1581,1592,-11,1,-18,90
1,1624,1461,163,1,130,76
-1,1397,1354,43,0,-175,96
0,1347,1425,-78,2,17,111
1,1871,1730,141,0,27,73
-1,1524,1612,-88,-1,-229,106
1,1773,1627,146,2,2,45
-1,1562,1268,294,-4,-136,66
1,2103,1824,279,1,1,59
1,1729,1816,-87,-6,523,149
0,1554,1563,-9,1,-195,126
1,2020,1951,69,-2,9,41
-1,1639,1841,-202,0,-41,98
-1,1599,1688,-89,-1,-22,40
-1,1659,1565,94,-3,-398,86
-1,1476,1532,-56,-2,-34,44
1,1597,1488,109,1,64,81
1,1939,2029,-90,0,-54,67
-1,1202,1673,-471,-1,-115,70
-1,1394,1347,47,-3,-391,88
1,1605,1509,96,-4,-49,63
1,1563,1594,-31,-1,-70,75
1,1854,1620,234,0,0,53
1,1827,1598,229,0,175,99
1,1697,1587,110,0,136,97
-1,1485,1475,10,1,88,70
-1,1479,1500,-21,-5,-100,44
-1,1957,2192,-235,0,-104,116
-1,1605,1633,-28,1,-35,66
1,1575,1267,308,0,-26,67
-1,1578,1489,89,-4,-186,58
-1,1514,1535,-21,-1,-62,66
1,2198,1951,247,1,34,51
1,1867,1671,196,0,83,66
-1,1460,1612,-152,0,24,68
1,1481,1554,-73,-4,-235,111
1,1861,1014,847,20,624,51
1,1945,2204,-259,-1,-8,57
1,1715,1349,366,5,29,41
-1,1578,1573,5,0,-5,60
-1,1579,1534,45,0,-300,124
1,1631,1269,362,3,107,49
0,1426,1271,155,0,137,183
-1,1730,1847,-117,0,-203,116
1,1884,1800,84,0,17,49
-1,1471,1543,-72,-3,21,84
-1,1395,1495,-100,6,158,54
-1,1544,1779,-235,1,-48,76
1,1474,1266,208,2,482,87
-1,1822,1925,-103,-1,-10,44
1,1590,1659,-69,0,98,59
-1,1329,1756,-427,-6,-227,112
1,1861,1633,228,3,55,51
-1,1381,1534,-153,-6,-244,59
1,1833,1665,168,6,236,90
1,1956,1685,271,0,96,83
-1,1159,1665,-506,-6,-551,82
-1,1594,1748,-154,0,-47,60
-1,1584,1566,18,-3,-4,68
-1,1965,2089,-124,1,216,110
1,1566,1201,365,0,198,65
-1,1719,1723,-4,1,41,65
-1,1491,1566,-75,1,89,114
1,1676,1873,-197,0,-19,61
-1,1619,1644,-25,0,-35,126
-1,1817,1789,28,-1,-38,50
1,1719,1560,159,1,43,45
1,1921,1638,283,-1,63,115
1,1892,1771,121,6,199,63
-1,2097,1958,139,-1,-570,120
-1,1758,1792,-34,-1,-121,77
-1,1569,1164,405,2,124,70
-1,1541,1628,-87,-1,35,56
1,1579,1572,7,1,76,91
-1,1545,1505,40,3,-5,68
-1,1973,2081,-108,0,98,102
1,1546,1690,-144,0,7,51
-1,1618,1486,132,7,120,98
-1,1241,1549,-308,-20,-343,42
-1,1681,1960,-279,-1,-22,54
1,1387,1434,-47,9,438,73
1,1985,1971,14,3,61,51
1,2154,1968,186,-2,142,95
1,2089,1965,124,10,94,41
-1,1301,1502,-201,-2,-9,40
-1,1749,1717,32,0,-11,74
1,1552,1229,323,6,61,41
-1,1392,1508,-116,-2,-194,109
-1,1958,2097,-139,1,42,118
1,1868,1609,259,4,134,59
-1,1049,1427,-378,-4,-211,58
1,1801,1805,-4,0,4,59
-1,1420,1472,-52,-1,-32,48
1,1561,1591,-30,0,21,57
1,1490,1240,250,6,1080,129
1,1961,1859,102,5,92,51
1,1533,1492,41,4,198,145
1,2104,1951,153,0,25,67
1,1500,1326,174,-3,29,55
1,1483,1570,-87,0,2,57
-1,1556,1483,73,2,307,136
-1,1851,1971,-120,0,-31,66
1,2010,1658,352,0,2,87
1,1407,1540,-133,10,271,59
-1,1806,1805,1,1,25,52
1,1637,1500,137,4,71,46
1,1602,1825,-223,-2,14,44
-1,1482,1409,73,3,84,82
-1,1996,1961,35,-2,-71,148
1,1980,1844,136,7,327,75
-1,1541,1463,78,0,-140,122
1,1841,1532,309,0,136,105
1,1933,1703,230,5,134,51
1,1874,1500,374,0,-16,55
-1,1837,1988,-151,-2,-519,140
1,1914,1710,204,1,-37,41
-1,1337,1527,-190,-13,-401,64
1,1855,1734,121,-2,-25,49
1,1424,1468,-44,1,51,79
1,1578,1573,5,4,187,67
-1,1682,1473,209,-4,-668,152
-1,1623,2161,-538,0,-12,70
-1,1696,1676,20,-1,-25,48
1,1996,1830,166,0,-9,113
1,1475,1513,-38,2,39,55
1,1585,1500,85,-6,-43,60
1,1652,1525,127,-2,-70,67
-1,1374,1563,-189,-6,-89,50
-1,1479,1536,-57,0,115,82
1,1727,1863,-136,-1,39,81
1,1452,1500,-48,10,56,41
-1,1488,1501,-13,1,24,52
1,1589,1716,-127,0,109,81
1,1805,1620,185,-1,85,103
-1,1519,1552,-33,0,-85,96
1,1556,1496,60,-2,28,61
1,1396,1156,240,8,833,95
1,1549,1268,281,0,18,48
1,1500,1563,-63,1,25,47
1,1824,1762,62,3,126,101
1,1342,1438,-96,5,474,109
-1,1695,1939,-244,-4,-58,46
1,1538,1469,69,8,282,51
1,1864,1873,-9,-1,-60,67
1,1687,1684,3,-2,90,68
1,1553,1422,131,7,392,73
-1,1753,1833,-80,-6,-50,44
-1,1500,1889,-389,-1,-275,84
1,2062,1716,346,0,-14,49
-1,1842,1744,98,-2,1,40
1,1514,1546,-32,1,-9,59
1,1520,1460,60,-1,-73,95
1,1744,1842,-98,0,-13,59
1,1709,1159,550,11,500,63
1,1828,1758,70,0,201,131
1,1825,1613,212,0,5,65
0,1569,1500,69,-9,-277,80
1,1487,1565,-78,0,-22,81
1,1749,1837,-88,1,542,125
1,1973,1984,-11,0,55,109
1,1605,1256,349,1,70,93
1,1455,1435,20,1,44,53
-1,1706,1831,-125,2,-126,112
1,1566,1260,306,0,6,45
-1,1511,1414,97,0,-6,68
1,1801,1523,278,11,194,45
1,1200,1399,-199,-3,-64,69
1,1673,1076,597,1,63,65
1,1839,1697,142,3,93,81
-1,1253,1570,-317,2,74,64
1,1500,1353,147,3,240,91
-1,1627,1612,15,0,-76,82
-1,1345,1717,-372,-4,-80,42
-1,1519,1805,-286,-4,-501,112
1,1348,1221,127,-3,-14,63
1,1661,1525,136,1,20,43
0,1608,1531,77,0,1,135
-1,1528,1575,-47,0,-19,118
0,1384,1319,65,5,553,83
-1,1472,1570,-98,3,19,86
1,1242,1266,-24,2,142,67
1,1399,1494,-95,2,197,63
-1,1423,1881,-458,-2,-81,78
1,1808,1585,223,8,241,73
1,1615,1594,21,3,152,48
1,1150,1401,-251,0,-13,45
1,1575,1818,-243,0,238,69
1,1849,1531,318,-1,5,67
-1,1580,1813,-233,-3,-411,72
-1,1478,1414,64,1,-12,74
1,1516,1919,-403,-2,-42,57
1,1551,1388,163,2,139,67
0,2073,1968,105,0,22,84
-1,1639,1695,-56,-6,-809,128
-1,1370,1343,27,0,-46,56
-1,1668,1629,39,-4,-355,116
-1,1389,1461,-72,0,-75,90
-1,1470,1416,54,3,110,56
0,2067,1896,171,1,71,132
1,1538,1565,-27,0,35,61
-1,1331,1479,-148,-3,-654,126
-1,1626,1649,-23,0,7,76
1,1598,1893,-295,-1,-44,73
1,1293,1345,-52,-3,-142,111
-1,1444,1427,17,-1,-23,64
1,1436,1343,93,-5,-352,83
1,1518,1517,1,-1,171,91
-1,1656,1569,87,1,-157,86
-1,1720,1701,19,-2,-65,58
-1,1459,1446,13,-1,-239,84
-1,1541,1444,97,-3,-281,78
-1,1539,1692,-153,0,-7,44
-1,1679,1460,219,-1,-339,76
-1,1653,1854,-201,0,-92,84
1,1597,1500,97,7,269,49
-1,1774,1710,64,0,-220,124
-1,1782,1557,225,2,-129,84
1,1717,1480,237,0,-1,49
1,1389,1082,307,4,945,153
1,1854,2064,-210,-3,-30,43
1,1650,1461,189,5,789,117
1,1640,1532,108,3,141,79
0,1780,1698,82,-1,-36,59
-1,1400,1448,-48,3,146,76
-1,1586,1486,100,1,-24,70
1,1256,1410,-154,6,240,69
1,1814,1475,339,10,139,42
-1,1458,1500,-42,-2,-171,104
1,1524,1277,247,6,105,41
-1,1204,1016,188,4,128,60
-1,1936,1812,124,-1,-14,46
-1,1307,1333,-26,2,1,52
-1,1708,1724,-16,-4,-263,124
-1,1286,1212,74,5,-100,100
1,1676,1648,28,0,33,47
1,1981,1624,357,2,56,75
1,1649,1524,125,0,-16,121
0,1647,1659,-12,0,165,124
-1,1472,1852,-380,-2,1,52
-1,1551,2042,-491,-4,-233,82
0,1817,1795,22,-5,-91,111
1,1252,1271,-19,-2,54,53
-1,1686,1933,-247,0,14,70
1,1530,1470,60,-1,52,49
1,1466,1612,-146,1,13,59
1,1860,1583,277,1,38,45
1,1645,1643,2,1,-26,67
1,1447,1381,66,1,64,76
-1,1765,1584,181,0,-69,76
-1,1296,1343,-47,-2,-196,106
1,1453,1444,9,0,285,67
1,1839,1500,339,3,77,47
1,1494,1604,-110,-2,33,103
1,1702,1777,-75,-1,90,123
0,1273,1324,-51,2,-259,164
-1,1579,1865,-286,-4,-116,64
1,1371,1085,286,15,340,49
1,1938,1682,256,1,7,57
1,1685,1500,185,3,275,107
-1,1257,1265,-8,-2,-76,70
1,1451,1543,-92,0,-31,45
-1,1563,1607,-44,-3,-256,73
1,1854,1523,331,0,91,97
0,1698,1830,-132,0,-45,97
-1,1553,1253,300,0,-37,40
-1,1842,1910,-68,2,29,94
-1,1933,1500,433,-4,-55,50
1,1695,1514,181,1,67,55
-1,1668,1659,9,0,-107,92
1,1753,1683,70,1,11,47
-1,1288,1357,-69,0,-37,48
-1,1656,1592,64,-7,-198,78
-1,1816,1586,230,1,5,62
-1,1482,1564,-82,1,17,68
1,1460,1540,-80,0,17,61
-1,1508,1433,75,-4,-67,48
1,1985,1789,196,3,70,57
-1,1869,1575,294,0,-281,84
-1,1689,1730,-41,0,-6,52
1,1920,1824,96,-1,158,93
-1,1527,1432,95,-1,-67,76
0,1456,1562,-106,-1,-131,137
-1,1407,1529,-122,-2,-13,46
1,1869,2123,-254,0,-18,81
1,1762,1674,88,2,62,69
0,1574,1500,74,0,-8,45
-1,1285,1517,-232,5,430,150
1,1857,1422,435,1,317,89
-1,1389,1651,-262,-10,-269,58
1,1864,1826,38,-1,-3,61
1,1482,1404,78,10,233,43
1,1991,1670,321,0,145,62
0,1500,1658,-158,-2,99,95
1,1655,1546,109,1,14,41
-1,1609,1643,-34,-3,17,98
-1,1770,1657,113,1,-19,56
-1,1594,1847,-253,-10,-59,97
1,1777,1522,255,0,536,145
1,2028,2096,-68,0,-7,41
-1,2096,2028,68,-4,-77,58
1,1397,1690,-293,0,63,121
0,1494,1447,47,-2,69,96
-1,1390,1299,91,-3,-43,47
0,1512,1131,381,-2,-189,89
1,1700,1477,223,1,32,85
-1,1475,1740,-265,-9,-412,65
1,2046,2076,-30,-1,-63,43
1,1887,1671,216,-1,110,87
1,1721,1609,112,-2,-145,95
-1,1518,1786,-268,1,-227,100
1,1915,1602,313,2,152,75
1,1525,1458,67,8,444,88
0,1617,1714,-97,-2,-179,119
1,1473,1454,19,-5,-185,67
1,1397,1481,-84,2,21,47
-1,1794,1513,281,1,-217,96
-1,1307,1500,-193,-10,-5,92
1,1859,1671,188,3,91,75
-1,1657,1538,119,-11,-188,48
0,1751,1684,67,-3,-233,94
-1,1655,1736,-81,3,107,48
0,2100,1995,105,1,47,69
1,1798,1536,262,1,165,79
1,1595,1580,15,0,-8,65
1,1611,1647,-36,0,-1,47
1,1852,1589,263,8,88,47
1,1701,1592,109,-1,123,119
0,1702,1810,-108,-1,5,97
1,1351,1241,110,1,14,48
-1,1647,1418,229,0,106,130
1,1686,1749,-63,3,181,77
1,1760,1500,260,2,-49,61
0,1585,1857,-272,3,247,131
-1,1640,1744,-104,-4,-284,80
-1,1675,1476,199,0,-2,70
-1,1468,1567,-99,-2,-446,92
1,1734,1469,265,-4,-230,93
-1,1185,1323,-138,-1,-193,60
1,1483,1730,-247,6,192,62
-1,1998,2097,-99,-2,-92,60
-1,1610,1506,104,0,76,74
1,1326,1475,-149,-5,-241,75
1,1655,1500,155,0,-23,85
-1,1322,1423,-101,-4,-227,81
-1,1459,1632,-173,0,-364,118
-1,1535,1224,311,1,10,50
-1,1764,1877,-113,-5,-133,56
-1,1548,1894,-346,0,-3,46
1,1631,1076,555,3,102,93
1,2044,2062,-18,2,76,53
1,1803,1452,351,0,0,53
1,1929,1773,156,1,17,53
-1,1501,1583,-82,-4,-294,94
-1,2047,2059,-12,-4,-27,144
1,1430,1565,-135,7,476,77
1,1472,1533,-61,-3,-35,61
1,1752,1629,123,-1,89,79
1,1849,1593,256,-2,111,101
-1,1705,1708,-3,-1,-251,92
-1,1685,1621,64,0,2,102
0,1465,1738,-273,-1,376,124
-1,1936,1766,170,0,1,50
1,1897,2105,-208,0,-78,119
1,1609,1548,61,1,1031,163
1,1695,1500,195,0,129,69
1,1756,1561,195,-1,1,53
0,2033,1974,59,0,21,141
-1,1332,1434,-102,0,18,92
1,1301,1456,-155,0,181,87
-1,1858,1584,274,-4,-202,82
-1,1544,1843,-299,-2,-24,96
1,1773,1667,106,0,27,57
-1,1920,1521,399,-7,-260,60
1,1976,2031,-55,1,18,59
1,1584,1733,-149,0,-14,83
1,1520,1564,-44,1,10,83
1,2015,1988,27,1,340,119
-1,1659,1781,-122,0,-5,86
0,1709,1620,89,-1,-120,104
-1,1759,1618,141,0,-5,60
1,1341,1418,-77,0,22,51
-1,1519,1438,81,0,-11,54
1,2088,1915,173,3,125,63
-1,1493,1667,-174,-1,-188,80
-1,1438,1472,-34,-2,-911,128
1,1355,1267,88,4,27,41
1,1762,1758,4,5,462,95
1,1579,1600,-21,1,46,54
1,1473,1243,230,-7,-181,75
1,1522,1651,-129,1,177,97
1,1712,1574,138,3,103,63
-1,1464,1425,39,-4,-288,78
-1,1540,1719,-179,0,-3,42
-1,1908,2094,-186,-1,-4,42
-1,1318,1438,-120,-3,-221,83
-1,1639,1818,-179,1,12,46
-1,1122,1404,-282,-6,-339,76
-1,1354,1410,-56,-2,-256,102
1,1633,1377,256,3,123,66
-1,1773,1609,164,-1,-203,122
1,1740,1821,-81,1,121,77
1,1673,1639,34,-1,13,59
-1,1567,1719,-152,-4,-173,58
1,1553,1575,-22,0,775,125
-1,1856,1797,59,-1,-241,90
-1,1701,1624,77,-1,-55,92
1,1542,1431,111,-4,84,57
1,1730,1684,46,4,86,45
-1,1478,1526,-48,-1,-4,74
1,1892,1678,214,4,224,81
1,1856,1337,519,15,299,45
1,1537,1538,-1,-3,104,53
1,1280,1227,53,2,113,61
-1,1507,1385,122,-1,39,120
1,1626,1684,-58,2,38,73
1,1788,1545,243,6,176,63
-1,1532,1464,68,3,261,74
1,1626,1522,104,-2,-31,77
-1,1592,1558,34,-3,-111,70
-1,1618,1232,386,-6,-367,104
-1,1540,1693,-153,-1,-10,44
-1,1136,1365,-229,-4,-117,52
1,1834,1809,25,1,18,47
-1,1474,1536,-62,1,30,54
-1,1959,1793,166,1,58,68
-1,1390,1534,-144,-4,-23,62
1,1623,1504,119,-2,-55,67
1,1665,1652,13,0,87,103
-1,1374,1386,-12,-5,-79,48
-1,1453,1439,14,-5,-541,122
1,1275,1303,-28,1,155,89
1,1556,1726,-170,3,136,57
-1,1874,1888,-14,-9,-415,130
1,1811,1935,-124,3,399,113
-1,1797,1845,-48,-14,-46,40
1,1290,1424,-134,2,38,48
-1,1699,1532,167,-1,-185,130
-1,1364,1428,-64,-2,-18,46
1,1487,1604,-117,0,-11,55
1,1496,1633,-137,-8,220,113
1,1372,1465,-93,11,352,48
1,1695,1674,21,0,49,53
-1,1382,1535,-153,-7,-489,68
1,1827,1914,-87,5,560,89
1,1500,1500,0,-1,-58,77
0,1309,1234,75,-8,-1052,215
-1,1874,1856,18,0,-324,86
1,1580,1442,138,1,271,107
-1,1741,1639,102,-8,-51,78
-1,1402,1803,-401,-1,-274,82
-1,1532,1643,-111,-1,-37,106
1,1855,1786,69,0,101,111
1,1618,1653,-35,-2,-169,83
1,1379,1571,-192,7,225,53
0,1677,1495,182,-3,-247,128
1,1614,1513,101,-3,101,87
1,1759,1864,-105,-1,122,61
-1,1666,1337,329,-4,-306,80
-1,1522,1842,-320,0,33,74
-1,1306,1238,68,1,-301,86
1,1657,1180,477,0,-2,57
1,1623,1632,-9,1,258,111
1,1477,1519,-42,2,182,99
1,1632,1518,114,-1,73,81
-1,1105,1370,-265,-2,-339,120
1,1742,1707,35,-1,1,41
-1,1501,1636,-135,-1,-5,46
1,1927,1860,67,1,131,86
-1,1491,1396,95,1,-204,100
-1,1520,2102,-582,-2,-237,88
1,1595,1521,74,8,732,73
0,1849,1774,75,-1,-198,79
1,1806,1399,407,2,103,71
1,1598,1724,-126,2,56,53
1,1245,1196,49,8,285,57
-1,1568,1419,149,-2,-15,120
-1,1425,1542,-117,1,1,40
1,1691,1550,141,2,707,135
1,1725,1545,180,-3,117,73
-1,1899,1598,301,-6,-106,44
1,1757,1769,-12,0,0,73
1,1292,1434,-142,1,99,59
-1,1492,1420,72,1,14,46
-1,1631,1776,-145,1,0,50
-1,1514,1634,-120,-8,-34,40
-1,1587,1423,164,-3,-35,42
0,1746,1705,41,-2,-267,116
1,1475,1420,55,2,134,77
1,1432,1385,47,-3,-162,71
-1,1360,1543,-183,-2,-110,82
1,1637,1262,375,1,434,77
-1,1532,1435,97,-3,-159,80
1,1652,1524,128,3,91,49
-1,1485,1327,158,-6,-60,98
-1,1543,1755,-212,-7,-361,114
-1,1810,1393,417,2,26,40
1,1493,1416,77,1,13,45
-1,1502,1734,-232,-1,-29,48
-1,1769,1821,-52,3,-43,98
1,1547,1775,-228,6,446,109
-1,1439,1452,-13,-2,-124,57
1,1788,1784,4,5,62,43
1,1500,1423,77,3,29,47
-1,1308,1519,-211,-7,-52,42
1,1539,1732,-193,2,74,53
1,1641,1506,135,-3,-90,53
1,1500,1344,156,6,100,45
1,1517,1662,-145,0,58,127
1,1525,1392,133,2,78,111
1,1413,1641,-228,0,46,62
1,1507,1489,18,4,302,85
1,1795,1648,147,-9,-145,125
1,1449,1295,154,1,757,141
1,1653,1624,29,0,-53,89
-1,1586,1464,122,-1,-131,58
-1,1550,1824,-274,1,-551,110
1,1772,1800,-28,1,135,107
-1,1232,1753,-521,-4,-227,76
1,1508,1563,-55,-1,78,113
1,1449,1518,-69,-1,57,99
-1,1302,1524,-222,-9,-134,41
-1,1910,2050,-140,1,-25,82
0,1612,1500,112,0,82,112
1,1502,1475,27,1,3,41
-1,1542,1660,-118,-1,6,62
-1,1435,1552,-117,0,-655,124
-1,1507,2103,-596,-1,-20,48
-1,1613,1691,-78,0,-174,104
-1,1606,1837,-231,0,-1,56
1,1476,1842,-366,0,62,89
-1,1739,1540,199,2,-519,144
-1,1614,1740,-126,0,-19,62
-1,1497,1529,-32,-6,-314,74
1,1355,1253,102,-9,-228,63
1,2104,1506,598,0,-3,43
-1,1297,1432,-135,-4,-243,62
-1,1865,1757,108,0,7,64
-1,1428,1470,-42,5,-67,68
-1,1505,2105,-600,1,4,42
1,1672,1837,-165,0,500,147
1,1680,1672,8,2,110,77
1,1383,1254,129,10,165,71
1,1552,1556,-4,2,27,47
-1,1512,1542,-30,0,-8,52
-1,1479,1517,-38,-1,-311,120
1,1777,1894,-117,1,14,89
1,1770,1792,-22,2,243,79
1,1919,1787,132,0,27,89
1,1464,1710,-246,4,79,44
1,1505,1462,43,7,258,63
1,1670,1482,188,2,321,98
0,1556,1785,-229,-1,-221,113
1,1638,1306,332,2,32,47
-1,1406,1453,-47,5,184,50
-1,1741,1782,-41,-2,52,102
1,1748,1606,142,4,126,57
-1,1487,1667,-180,0,-71,59
-1,1451,1525,-74,-4,-124,60
0,1460,1442,18,-2,-84,96
1,1497,1732,-235,2,331,121
1,1633,1515,118,2,92,72
1,1707,1745,-38,0,17,57
1,1743,1535,208,3,608,119
-1,1605,1469,136,-4,-118,62
1,1724,1697,27,0,104,75
-1,1517,1429,88,-12,-460,60
1,1694,1779,-85,0,8,55
1,1926,1919,7,0,195,133
1,1640,1691,-51,0,82,72
-1,1560,1455,105,0,73,70
1,1483,1317,166,2,188,81
1,1668,1533,135,-1,-35,77
-1,1504,1532,-28,0,-44,61
1,1325,1276,49,9,187,45
1,1868,1874,-6,-7,-254,65
-1,1764,1587,177,-1,-30,41
-1,1599,1755,-156,-1,-77,116
-1,1618,1501,117,0,-95,76
1,1640,1413,227,6,88,43
-1,1707,1747,-40,-2,-225,112
-1,1481,1677,-196,-2,19,46
1,1778,1412,366,4,97,93
1,1494,1591,-97,3,82,55
-1,1392,1439,-47,13,407,70
1,1500,1562,-62,4,94,59
-1,1500,1479,21,1,-474,80
-1,1874,1950,-76,-2,-105,82
1,1527,1469,58,0,42,135
-1,1813,1588,225,0,-215,82
1,1995,1790,205,0,-7,69
1,1666,1379,287,9,372,61
1,1679,1652,27,-3,47,58
-1,1289,1460,-171,-1,-68,58
-1,1234,1454,-220,0,9,44
1,1642,1459,183,-1,-47,49
1,1960,1862,98,1,-23,63
1,1787,1603,184,2,-12,40
1,1515,1658,-143,5,108,43
-1,1476,1547,-71,-4,-104,58
1,1683,1342,341,0,54,79
-1,1717,1750,-33,-2,2,44
1,1393,1455,-62,-2,-27,49
-1,1314,1441,-127,-3,-112,50
1,1688,1822,-134,14,450,60
0,1322,1376,-54,3,406,112
1,1862,1639,223,-1,15,53
-1,1542,1519,23,0,-22,60
1,1781,1409,372,5,400,89
1,1528,1708,-180,-2,-76,51
1,1597,1804,-207,3,60,53
0,1294,1266,28,-9,-279,138
1,1372,1490,-118,1,37,43
1,1698,1808,-110,3,78,53
1,1796,1936,-140,-1,52,115
1,1468,1514,-46,-2,-117,107
-1,1703,1806,-103,-1,-12,121
-1,1315,1415,-100,-3,-262,73
-1,1108,1689,-581,-2,-166,68
1,1711,1736,-25,0,31,69
-1,1791,1852,-61,0,-6,108
-1,1622,1748,-126,5,50,42
-1,1470,1743,-273,-6,-212,61
1,1409,1505,-96,2,265,79
1,1521,1530,-9,-1,121,105
-1,1642,1642,0,1,34,46
-1,1607,1634,-27,0,-5,42
-1,1732,1707,25,2,104,68
1,1782,1762,20,0,393,123
1,1494,1566,-72,0,5,55
1,1752,1571,181,-1,-55,61
-1,1474,1398,76,1,22,76
-1,1464,1375,89,1,45,76
1,1789,1727,62,4,406,107
1,1524,1500,24,2,457,93
-1,1306,1243,63,0,-88,56
1,1380,1402,-22,5,126,61
1,1519,1670,-151,1,148,83
-1,1377,1452,-75,2,-61,74
1,1810,1758,52,0,18,51
1,1693,1606,87,-3,959,141
1,1459,1417,42,4,988,111
1,1721,1786,-65,1,26,41
1,1688,1500,188,0,154,91
-1,1591,1307,284,3,83,58
1,1633,1769,-136,0,204,73
-1,1653,1536,117,0,56,120
-1,1500,1320,180,-2,-300,70
-1,1387,1596,-209,3,-229,160
1,1754,1714,40,0,20,67
-1,1507,1477,30,0,8,72
-1,1775,1641,134,1,92,122
-1,1750,1818,-68,0,-38,66
1,1645,1675,-30,-1,-28,77
0,1370,1473,-103,0,491,148
1,1390,1450,-60,0,279,125
-1,1553,1638,-85,0,37,98
-1,1734,1891,-157,-1,-164,86
-1,1864,2079,-215,0,-367,120
1,1744,1548,196,2,28,41
1,1668,1622,46,-5,-303,79
1,1846,1683,163,-2,-133,69
1,1440,1466,-26,-10,-390,87
1,1532,1488,44,0,1,73
1,1647,1543,104,0,264,67
1,1695,1177,518,1,73,65
1,1294,1289,5,3,670,113
1,1641,1383,258,0,583,115
-1,1677,1853,-176,-3,209,78
1,1692,1320,372,2,124,49
1,1535,1655,-120,-3,-8,67
1,2085,1857,228,3,397,151
1,1811,1864,-53,2,179,103
-1,1845,1758,87,0,-166,136
1,1702,1747,-45,-2,95,83
-1,1334,1395,-61,0,-222,80
1,1710,1576,134,6,89,43
1,1535,1272,263,3,138,41
1,1754,1662,92,-9,7,63
1,1959,1671,288,1,56,55
0,1438,1403,35,4,639,113
1,1542,1648,-106,1,48,85
1,1860,2091,-231,2,88,75
1,1544,1530,14,0,32,63
1,2070,1902,168,2,57,51
-1,1495,1330,165,1,32,54
1,1691,1556,135,6,839,101
1,1851,1735,116,1,143,131
1,1548,1500,48,3,148,53
1,1302,1228,74,0,27,55
1,1407,1267,140,7,31,49
1,1663,1657,6,7,418,99
-1,1705,1823,-118,-5,-300,104
1,2070,1879,191,0,67,85
-1,1533,1557,-24,0,-59,46
-1,1557,1643,-86,0,-15,80
1,1762,1751,11,-1,3,49
0,1220,1333,-113,-2,281,153
-1,1631,1764,-133,-2,-117,66
1,2072,1633,439,0,403,93
1,1379,1457,-78,1,113,65
1,1518,1267,251,0,39,67
-1,1873,2077,-204,-1,-258,56
-1,1655,1548,107,-4,-322,78
1,1487,1735,-248,-2,0,75
1,1727,1703,24,0,146,135
-1,1847,1820,27,1,-108,84
-1,1967,2079,-112,0,-210,118
1,1696,1708,-12,0,-5,55
1,1811,1720,91,0,52,67
1,2083,1867,216,4,230,81
-1,1404,1437,-33,1,-390,94
1,2074,1632,442,0,229,63
0,1785,1731,54,0,3,103
-1,1835,1819,16,-12,-92,42
-1,1396,1440,-44,-10,-398,80
-1,1407,1453,-46,-11,-459,64
-1,1626,1469,157,0,234,136
1,1788,1928,-140,-1,-3,43
-1,1469,1373,96,-6,-357,66
1,1831,1630,201,1,101,65
-1,1861,2089,-228,0,6,50
1,2077,1860,217,2,102,55
1,1500,1447,53,7,447,71
1,1555,1743,-188,-1,-1,55
-1,1806,1543,263,-2,-48,52
1,1762,1699,63,2,266,79
-1,1854,2083,-229,-8,-289,130
-1,1667,1737,-70,0,-73,78
1,2095,1856,239,0,8,61
1,1718,1697,21,-1,59,73
-1,1405,1481,-76,-11,-614,66
1,1500,1488,12,-3,-35,69
1,1727,1624,103,1,105,59
-1,1728,1500,228,-3,-159,62
1,1896,1725,171,-3,37,81
1,1695,1421,274,-1,76,103
1,1378,1646,-268,9,269,67
-1,2090,1960,130,0,-51,72
1,1590,1500,90,-1,144,65
1,1479,1509,-30,2,183,75
-1,1615,1687,-72,-6,-68,74
-1,1553,1329,224,-5,-462,100
1,1892,1947,-55,-2,38,81
1,1792,1594,198,0,-98,85
-1,1611,1364,247,-2,-75,62
1,1433,1457,-24,-1,262,75
1,1703,1546,157,-1,-3,41
1,2160,1971,189,1,64,65
1,1584,1097,487,1,144,87
1,1965,2166,-201,-1,-1,41
-1,1564,1736,-172,-2,-136,79
1,1785,1478,307,1,157,78
-1,1698,2012,-314,0,-106,92
-1,1500,1389,111,4,43,64
-1,1347,1587,-240,-2,-67,60
-1,1523,1542,-19,1,-91,126
1,1695,1591,104,-3,-11,60
-1,1410,1321,89,5,27,80
-1,2148,1982,166,-2,-101,118
1,1427,1483,-56,-4,-248,73
1,1496,1539,-43,1,154,83
1,1600,1481,119,1,194,91
1,1461,1764,-303,0,29,69
1,1324,1399,-75,1,102,71
1,1391,1392,-1,-2,-86,59
1,1703,1527,176,1,36,61
1,1385,1349,36,2,51,71
1,1961,1585,376,0,-25,49
0,1692,1720,-28,-3,31,83
1,1689,1914,-225,0,1,119
1,1473,1608,-135,-1,121,83
1,1500,1618,-118,5,280,73
-1,1612,1601,11,0,-2,58
-1,1381,1599,-218,1,-108,70
1,2064,1950,114,0,-3,59
-1,1352,1461,-109,-8,-196,56
1,1577,1062,515,4,47,61
1,1799,1588,211,0,2,43
-1,1846,1794,52,0,71,122
1,1512,1809,-297,-1,3,61
-1,1713,1583,130,-2,-7,74
-1,1692,1821,-129,-2,-50,54
1,1743,1509,234,0,16,45
1,1475,1519,-44,-1,87,121
-1,1319,1608,-289,-4,-271,100
1,1828,1726,102,0,-70,85
-1,1940,2072,-132,0,-19,54
-1,1710,1553,157,-1,-103,110
-1,1376,1790,-414,1,32,42
-1,1623,1525,98,2,48,52
-1,1598,1697,-99,-5,-110,52
1,1693,1738,-45,-1,139,123
-1,1539,1408,131,-2,-527,120
1,1356,1386,-30,-1,228,85
1,1805,1583,222,1,-18,83
-1,1836,1717,119,-1,-185,94
1,1694,1535,159,0,50,122
1,1738,1749,-11,3,193,79
-1,1592,1589,3,-6,-62,44
1,1890,1898,-8,-1,10,115
1,1677,1782,-105,1,349,117
0,2022,2035,-13,0,162,200
-1,1920,1807,113,0,-56,84
0,1945,2068,-123,-1,-199,140
-1,1470,1439,31,5,265,84
1,1322,1276,46,6,469,65
-1,1922,1437,485,1,38,58
0,1591,1543,48,-2,-59,123
1,1901,1629,272,2,34,61
1,1504,1498,6,0,84,67
1,1531,1472,59,-4,-81,47
1,1442,1469,-27,1,-66,83
-1,1545,1589,-44,-4,-12,40
1,1504,1579,-75,5,97,47
1,2168,1822,346,2,123,67
-1,1096,1365,-269,0,-532,100
1,1741,1593,148,3,495,85
-1,1657,1403,254,-1,-2,52
-1,1608,1744,-136,-1,-185,86
-1,1599,1584,15,-2,30,60
1,1558,1625,-67,-1,-66,71
0,2131,1931,200,0,44,116
1,1819,2007,-188,0,8,63
-1,1738,1813,-75,0,7,46
-1,1604,1661,-57,-1,-20,96
-1,1585,1748,-163,0,-51,60
1,1526,1895,-369,1,8,71
1,1629,1485,144,-1,-37,61
1,1985,1835,150,2,180,73
1,1700,1565,135,0,-18,71
-1,1449,1454,-5,0,9,82
1,1755,1579,176,1,267,161
-1,1578,1811,-233,-1,-18,52
1,1568,1521,47,8,55,42
-1,1828,1994,-166,-4,-443,102
-1,1582,1496,86,0,17,64
-1,1408,1389,19,0,-1,52
1,1424,1479,-55,9,129,45
1,1595,1588,7,0,-219,103
1,1905,1671,234,3,167,69
-1,1421,1517,-96,0,9,48
-1,2002,1822,180,3,147,70
-1,1358,1381,-23,-1,-287,120
-1,1382,1612,-230,-1,-29,86
-1,1573,1762,-189,-3,-88,78
-1,1431,1504,-73,0,21,58
1,1518,1574,-56,-4,-63,53
-1,1412,1526,-114,0,-619,96
1,1729,1515,214,-2,187,101
-1,1573,1811,-238,-2,-177,98
1,1708,1707,1,0,56,87
-1,1938,2125,-187,0,-51,94
1,1558,1621,-63,4,51,47
-1,1838,1981,-143,-1,-30,70
-1,1609,1610,-1,1,-19,52
1,1768,1567,201,0,-30,47
1,1826,1871,-45,-1,-20,93
-1,1506,1421,85,1,-93,62
-1,1825,1998,-173,-9,-176,56
1,1561,1774,-213,7,272,61
1,1577,1606,-29,-3,-262,99
1,1515,1418,97,2,42,47
-1,1404,1476,-72,0,-127,68
1,1510,1569,-59,4,80,47
0,1817,1637,180,0,23,161
1,1682,1761,-79,0,-17,65
1,2005,1819,186,0,115,73
-1,1696,1721,-25,1,-31,80
1,1608,1571,37,-2,-105,67
-1,1707,1598,109,0,-74,64
-1,1991,2048,-57,-1,-47,48
-1,1406,1526,-120,0,1,56
1,1546,1535,11,2,244,85
-1,1362,1470,-108,6,129,84
-1,1814,2012,-198,0,-35,50
1,2058,1981,77,1,67,55
1,1662,1487,175,2,396,115
-1,2131,1931,200,0,100,126
-1,1721,1533,188,0,-39,63
1,1666,1317,349,-4,272,63
1,2019,1808,211,-1,7,45
1,1579,1375,204,3,117,47
-1,1594,1589,5,0,-104,112
1,1556,1523,33,4,416,87
1,1369,1090,279,1,688,141
1,1443,1262,181,-1,20,79
1,1534,1511,23,4,364,91
1,1857,1246,611,2,202,59
1,1477,1426,51,-6,-227,73
-1,1579,1606,-27,0,-179,104
1,1395,1332,63,1,24,45
1,1733,1557,176,2,246,61
-1,1734,1592,142,-1,-65,82
1,2022,1599,423,-2,-5,43
1,1570,1412,158,1,17,61
0,2040,2054,-14,-1,48,108
-1,1376,1521,-145,-1,79,81
-1,1597,2025,-428,-5,-456,78
-1,1406,1577,-171,0,-184,76
-1,1737,1843,-106,1,44,116
-1,1797,1460,337,-12,-309,52
1,1574,1477,97,-1,67,62
-1,1616,1568,48,-10,-123,60
-1,2054,2040,14,0,26,78
-1,1499,1545,-46,0,-29,42
-1,1321,1595,-274,-7,-363,70
-1,1599,1773,-174,-3,-242,82
1,1695,1793,-98,1,327,120
-1,1544,1670,-126,-1,-311,66
-1,1513,1566,-53,2,-220,110
1,1910,1510,400,-1,73,67
0,1581,1604,-23,0,20,82
1,2053,2042,11,2,46,69
1,1555,1488,67,-3,38,57
1,1599,1317,282,-1,105,69
-1,1673,1669,4,-4,-122,52
1,1408,1712,-304,4,292,65
1,1600,1362,238,-1,-18,45
-1,1318,1547,-229,0,-25,50
-1,1825,1703,122,-3,-31,40
1,1711,1550,161,1,-6,49
-1,1603,1582,21,-2,-36,60
-1,1486,1796,-310,-5,-594,81
-1,1858,1998,-140,-1,-146,106
1,1952,1924,28,4,78,47
1,2016,1739,277,-1,-40,61
-1,1312,1603,-291,-3,-110,61
-1,1478,2066,-588,0,-25,48
1,1594,1591,3,2,86,53
0,1576,1485,91,-2,-299,182
1,1662,1403,259,0,-125,117
1,1718,1530,188,2,94,49
-1,2067,1477,590,-1,-95,52
1,1616,1512,104,1,15,53
1,1607,1308,299,1,218,103
-1,1405,1377,28,-3,-122,52
-1,1401,1449,-48,0,37,62
-1,1608,1677,-69,-5,-44,76
-1,1435,1486,-51,-4,-193,62
-1,1914,1965,-51,-1,-49,96
-1,1464,1590,-126,-2,-86,52
1,1523,1432,91,0,74,93
1,1718,1594,124,1,296,81
-1,1716,1696,20,0,-45,82
-1,1448,1639,-191,-3,85,102
-1,1267,2041,-774,-2,-199,98
1,1563,1729,-166,0,28,70
-1,1584,1803,-219,1,22,64
1,1605,1565,40,0,9,57
1,1508,1500,8,1,189,99
-1,1346,1407,-61,2,69,78
1,1586,1504,82,1,136,60
-1,1850,1575,275,0,-16,90
1,1304,1611,-307,0,85,75
0,2042,1808,234,0,146,86
-1,1695,1597,98,-1,-98,58
1,2005,1851,154,-2,54,49
-1,1686,1599,87,0,-173,144
1,1950,1486,464,0,97,133
1,1811,1621,190,0,528,119
-1,1735,2020,-285,-2,-75,64
-1,1587,1487,100,1,-205,109
1,1572,1438,134,1,25,75
-1,1814,2034,-220,0,-156,74
1,1531,1578,-47,2,44,59
1,1590,1326,264,1,210,62
-1,1342,1401,-59,-3,-190,70
-1,1084,1373,-289,1,-562,96
1,1725,1712,13,0,-27,87
1,1721,1287,434,5,252,69
-1,1503,1955,-452,-2,-276,70
1,1579,1496,83,0,49,100
-1,2040,1809,231,1,-170,140
1,1828,1271,557,1,57,65
-1,1658,1517,141,-1,-317,144
-1,2050,1587,463,-6,-528,84
1,1960,1501,459,0,165,67
-1,1321,1595,-274,-4,-130,70
0,1611,1551,60,0,20,88
1,1724,1487,237,1,109,79
-1,1389,1496,-107,-1,2,48
-1,1865,1896,-31,1,285,112
-1,1499,1964,-465,-1,10,60
1,1499,1425,74,1,249,83
-1,1501,1572,-71,0,7,58
-1,1906,1854,52,-1,-278,86
-1,1499,1440,59,-12,-205,48
1,1968,1497,471,-3,-13,89
-1,1299,1549,-250,-5,-191,60
-1,1290,1329,-39,0,-160,74
-1,1269,1829,-560,-4,-270,75
-1,1613,1329,284,-3,-129,60
0,1627,1676,-49,-1,-77,58
-1,1867,1893,-26,-3,-89,46
1,1396,1249,147,0,22,61
-1,1495,1973,-478,-9,-486,76
-1,1733,1821,-88,2,48,78
1,1700,1602,98,-1,71,75
1,1597,1442,155,-4,-120,53
1,1904,1857,47,0,-126,89
1,1377,1079,298,0,500,85
1,1976,1493,483,0,-5,97
1,1581,1492,89,0,166,66
-1,1717,1621,96,-2,-26,50
-1,1847,1914,-67,2,123,76
1,1828,1435,393,4,320,87
-1,1294,1731,-437,-1,-92,56
-1,1491,1980,-489,6,197,104
1,1965,1483,482,-1,38,45
-1,1634,1646,-12,-3,-90,66
-1,1588,1558,30,-1,-43,58
1,1830,1500,330,7,561,81
-1,1923,1838,85,0,-92,78
-1,1588,1705,-117,-2,-269,118
1,1729,1490,239,0,29,105
1,1984,1489,495,1,31,75
-1,1602,1481,121,0,-79,80
1,1500,1537,-37,3,247,89
1,1966,1766,200,0,-17,69
1,1674,1629,45,-2,123,79
1,1500,1458,42,0,145,75
-1,1166,1583,-417,-4,-313,58
1,1852,1909,-57,3,98,51
-1,1488,1987,-499,1,5,64
-1,1594,1709,-115,-1,-36,52
1,1896,1865,31,5,126,53
1,1583,1571,12,0,55,59
1,1686,1578,108,3,488,93
1,1991,1486,505,0,48,63
1,1087,1242,-155,10,984,81
-1,1818,1500,318,-1,-164,96
1,1519,1516,3,0,23,61
1,1629,1472,157,3,75,53
1,1465,1500,-35,-1,27,61
-1,1854,1906,-52,0,-110,80
1,1775,1777,-2,-1,3,55
-1,1834,1923,-89,3,741,130
1,1403,1278,125,0,22,43
-1,1074,1381,-307,-10,-649,80
-1,1156,1305,-149,-4,-223,70
1,1687,1670,17,3,309,83
1,1656,1427,229,6,202,55
1,1997,1482,515,3,98,55
-1,1424,1559,-135,-9,-652,70
-1,1916,1845,71,0,-81,76
-1,1285,1416,-131,-1,-32,54
-1,1481,2000,-519,0,32,70
-1,1416,1566,-150,-6,-676,82
-1,1565,1725,-160,-2,196,100
-1,1655,1836,-181,1,154,110
-1,1590,1484,106,0,-46,66
1,1858,1902,-44,3,493,93
1,1717,1401,316,3,76,49
-1,1659,1698,-39,-1,-6,68
1,2003,1479,524,0,131,119
-1,1857,2134,-277,-1,-8,84
1,1890,1870,20,-1,39,51
1,1409,1397,12,1,81,59
-1,1485,1734,-249,0,-22,86
1,1540,1432,108,0,180,71
-1,1785,1808,-23,-5,-102,54
-1,1478,2006,-528,-3,-181,74
-1,1860,1900,-40,-1,-68,68
1,1500,1423,77,1,49,85
1,2139,1853,286,2,540,115
1,1226,1103,123,3,501,97
1,1534,1398,136,1,71,68
1,1720,1387,333,0,211,82
1,1821,1671,150,1,23,51
1,1967,1751,216,6,536,129
1,1723,1245,478,1,107,65
1,1511,1747,-236,-1,146,79
-1,1423,2019,-596,-3,-142,62
1,1417,1420,-3,1,53,61
-1,1474,2012,-538,-1,-84,70
1,1731,1558,173,7,207,55
1,1573,1420,153,2,83,63
-1,1277,1450,-173,-2,-18,48
1,1385,1069,316,15,472,59
-1,2021,1910,111,2,57,48
-1,1579,1654,-75,-1,-233,112
1,1593,1684,-91,0,-35,63
1,1245,1266,-21,-3,-161,59
-1,1437,1828,-391,-9,-121,44
-1,2015,1473,542,0,-85,112
-1,1675,2011,-336,-1,-34,62
1,1564,1430,134,-5,-70,49
1,1924,2003,-79,-2,-65,59
1,1640,1436,204,1,43,41
-1,1614,1489,125,2,-2,52
0,0,936,-936,-12,-480,67
1,1498,1575,-77,-1,-74,67
-1,1482,1520,-38,-12,-199,52
1,1552,1737,-185,1,155,83
0,1301,1410,-109,0,-27,88
1,1422,1571,-149,-12,-215,57
1,1987,1937,50,2,124,69
-1,1094,1217,-123,-23,-307,40
1,1830,1434,396,3,573,121
-1,1503,1960,-457,0,-120,82
1,1658,1470,188,-1,65,55
-1,1582,1587,-5,0,-188,107
1,1555,1439,116,0,675,141
-1,1702,1649,53,0,-95,92
1,1803,1593,210,0,108,71
-1,1723,1709,14,0,-45,78
1,1454,1541,-87,-1,-62,63
1,1983,1941,42,3,58,49
1,1964,1500,464,0,127,69
1,1336,1445,-109,-5,-36,41
-1,1271,2062,-791,-4,-137,62
1,1705,1355,350,6,222,49
0,1991,1859,132,0,67,162
1,1313,1428,-115,3,334,85
-1,2014,2169,-155,0,-56,68
-1,1064,1389,-325,-3,-2177,196
0,1979,1944,35,1,6,163
1,1562,1511,51,2,263,86
0,1266,1227,39,1,381,119
1,1721,1569,152,-1,-27,45
-1,1498,1968,-470,-2,-117,58
-1,1530,1532,-2,0,-106,86
1,1520,1504,16,0,108,65
-1,1715,1626,89,-4,-103,110
-1,1828,1500,328,-3,245,136
1,1565,1618,-53,1,108,59
1,1315,1383,-68,-8,-376,81
1,1989,1935,54,1,35,69
1,1500,1348,152,-3,6,53
1,1396,1588,-192,1,101,71
-1,1228,1597,-369,1,27,58
-1,1659,1632,27,-3,-169,72
-1,1828,1775,53,1,-21,74
-1,1787,2063,-276,0,-66,100
-1,1450,1642,-192,-1,-29,50
0,2007,1833,174,0,55,100
-1,1409,2000,-591,-2,-58,54
1,1069,1407,-338,-2,-76,57
1,1527,1496,31,1,214,80
0,1647,1752,-105,0,19,108
-1,1502,1571,-69,-1,20,74
1,2000,1408,592,2,183,69
1,1159,1500,-341,-4,-217,63
1,1681,1572,109,8,225,51
1,1639,1701,-62,0,19,49
-1,1553,1605,-52,-1,43,42
0,1362,1312,50,-9,-791,103
-1,1407,1972,-565,0,-38,50
-1,1780,1733,47,-2,-140,56
1,1649,1500,149,4,310,77
0,1613,1533,80,4,489,91
1,1974,1406,568,4,372,65
1,1591,1239,352,0,74,57
-1,1974,1812,162,-1,-475,170
1,2008,1797,211,5,215,59
1,1825,1862,-37,2,121,67
1,1877,1441,436,1,224,93
1,1559,1423,136,0,1,63
1,1614,1544,70,-1,-28,47
-1,1443,1627,-184,0,9,61
1,1503,1410,93,8,572,69
1,1607,1613,-6,0,10,67
1,1530,1638,-108,1,60,55
-1,1488,1616,-128,-7,-62,40
1,1746,1729,17,3,151,71
1,1839,1928,-89,-1,-24,47
-1,2002,1912,90,-3,-44,68
1,1600,1202,398,3,492,91
1,1333,1416,-83,4,48,47
1,1850,1836,14,4,110,57
1,1082,1175,-93,8,234,57
-1,1533,1562,-29,-3,-128,82
1,1535,1623,-88,4,60,43
1,1363,1388,-25,-7,-67,55
-1,1413,1559,-146,-4,-56,42
1,1674,1579,95,-5,146,103
-1,1642,1575,67,0,23,56
1,1913,1856,57,0,40,77
1,1390,1365,25,4,204,59
-1,1735,1795,-60,-1,-39,60
-1,1553,1720,-167,0,-219,78
1,1615,1570,45,0,19,107
1,1481,1500,-19,0,-62,53
1,1632,1366,266,-1,-2,81
1,1392,1060,332,0,305,89
-1,1270,1535,-265,-3,-36,60
-1,1412,1344,68,2,60,48
-1,1737,1426,311,-1,-71,88
-1,1826,1861,-35,-4,52,96
-1,1526,1369,157,0,0,40
1,1846,1914,-68,-4,-291,113
-1,1405,1973,-568,-23,-174,41
-1,1489,1829,-340,-17,-331,60
-1,1362,1637,-275,-1,-54,54
-1,1573,1523,50,-1,-51,60
1,1386,1414,-28,1,39,47
1,1500,1350,150,-7,150,77
1,1473,1199,274,5,240,71
-1,1481,1437,44,-1,-155,90
1,1810,1508,302,3,35,49
1,1625,1719,-94,0,-5,41
1,1726,1721,5,0,-25,71
-1,1571,1682,-111,0,-91,106
-1,1539,1880,-341,0,-195,118
-1,1266,1580,-314,-2,-72,68
1,1845,1923,-78,-3,-72,129
-1,1654,1749,-95,-4,-41,42
1,1550,1214,336,7,341,67
1,1734,1652,82,1,78,79
1,1641,1605,36,0,-10,113
1,1248,1162,86,5,334,67
-1,1538,1593,-55,-2,-186,72
1,1486,1387,99,1,79,53
-1,1902,1780,122,-4,-66,56
-1,1731,1601,130,0,-373,94
-1,1389,1639,-250,-4,-167,64
1,1576,1385,191,7,147,48
1,1592,1708,-116,-1,33,77
-1,1400,1579,-179,-1,-13,94
1,1510,1500,10,7,330,67
-1,1384,1643,-259,-1,-1019,142
1,1536,1560,-24,6,215,57
1,1719,1546,173,3,72,59
1,1810,1629,181,-1,67,79
-1,1885,2067,-182,0,7,46
-1,1573,1449,124,-1,-479,124
1,1495,1583,-88,0,110,87
-1,1379,1647,-268,-4,-99,92
1,1583,1316,267,0,72,77
0,1593,1651,-58,-1,-144,123
1,1977,1769,208,0,64,75
-1,1262,1416,-154,4,64,76
1,1912,1817,95,0,2,69
1,1597,1372,225,1,116,89
-1,1532,1364,168,-4,-897,108
-1,1652,1580,72,-2,-38,74
1,1500,1290,210,6,479,69
-1,1543,1643,-100,0,-187,122
1,2150,1881,269,1,99,85
-1,1861,1871,-10,0,-19,88
-1,1708,1869,-161,-3,-104,48
1,1332,1132,200,-6,-192,63
1,1361,1257,104,-1,157,95
-1,1183,1500,-317,-6,-142,70
-1,1783,1808,-25,-2,-39,50
-1,2074,1876,198,-2,-71,76
1,1842,1886,-44,-1,-110,111
-1,1561,1851,-290,0,-18,84
-1,1971,1909,62,1,57,94
1,1553,1425,128,1,-7,41
1,1649,1595,54,3,75,65
1,1559,1536,23,3,170,75
1,1387,1369,18,0,23,65
0,1871,1816,55,-5,-1747,174
1,1596,1450,146,1,278,119
-1,1281,1253,28,0,-33,58
1,1399,1358,41,-4,101,69
1,1505,1500,5,0,547,135
1,1329,1586,-257,0,43,67
1,1889,1624,265,0,96,71
1,1814,1773,41,-2,58,75
-1,1493,1596,-103,-1,4,94
1,1266,1424,-158,-3,21,63
1,1612,1587,25,-1,68,69
-1,1379,1697,-318,-1,-157,78
-1,2098,1846,252,-2,-350,92
-1,1586,1542,44,-1,-24,60
1,1680,1701,-21,0,90,79
-1,1048,1433,-385,-4,-112,46
1,1418,1328,90,-1,-23,41
-1,1520,1481,39,0,-1,52
-1,1500,1461,39,-6,-404,82
-1,1472,1261,211,0,0,56
-1,1767,1372,395,0,-56,114
1,2074,1603,471,-3,-31,69
-1,1440,1331,109,3,-152,62
-1,1618,1408,210,0,-702,98
1,1656,1705,-49,2,161,79
-1,1485,1675,-190,-13,-1425,122
1,1647,1454,193,3,257,83
-1,1601,2076,-475,0,-112,70
1,2078,1600,478,6,246,65
1,1426,1320,106,6,226,61
-1,1720,1479,241,-1,-563,124
1,1751,1500,251,10,1136,87
1,1666,1456,210,-2,-35,61
-1,1317,1253,64,-9,-311,60
-1,1377,1528,-151,-1,50,62
1,1905,1739,166,1,54,97
1,1455,1519,-64,2,544,123
1,1692,1669,23,0,-4,47
1,1507,1494,13,6,103,53
1,1185,0,1185,-3,-160,73
1,1633,1299,334,1,335,97
-1,1707,2080,-373,0,-88,114
1,1846,1653,193,-3,-61,97
1,1547,1637,-90,0,-2,45
1,1800,1598,202,-2,-72,75
1,1601,1427,174,0,79,83
1,1833,1693,140,0,21,127
1,1436,1653,-217,-2,35,85
1,1598,1496,102,11,182,48
-1,1393,1416,-23,-12,-166,42
1,2084,1705,379,2,89,67
1,1554,1045,509,9,383,53
-1,1736,1689,47,0,-34,78
-1,1577,1627,-50,1,52,86
1,1529,1653,-124,-2,109,65
1,1450,1435,15,8,255,53
1,1889,1744,145,0,13,51
0,1616,1855,-239,-2,-57,100
1,1488,1474,14,9,316,56
1,1783,1701,82,-1,473,133
1,1733,1912,-179,-1,-48,59
-1,1853,1940,-87,-5,100,118
-1,1447,1500,-53,7,183,44
0,1755,1748,7,0,-147,153
1,1518,1453,65,3,62,61
1,1896,1912,-16,0,88,115
1,1434,1353,81,1,546,83
1,1854,1600,254,4,352,91
1,1434,1488,-54,0,-6,67
1,1841,1444,397,0,60,81
1,1691,1791,-100,-1,-17,51
-1,1534,1520,14,-2,-312,84
-1,1376,1700,-324,2,11,42
1,1636,1487,149,0,47,49
-1,1613,1637,-24,-2,-38,48
1,1560,1556,4,1,152,55
-1,1598,1731,-133,0,-52,82
1,1742,1594,148,-3,438,127
0,1701,1722,-21,-5,-414,90
1,1908,1703,205,1,87,83
1,1672,1523,149,1,206,67
1,1702,1505,197,-6,-345,93
-1,1468,1250,218,-1,-28,48
1,2087,1590,497,-1,254,103
1,1883,1926,-43,0,3,49
1,1442,1844,-402,2,139,69
1,1511,1500,11,1,45,40
-1,1755,1842,-87,0,-253,120
-1,1676,1589,87,-4,-178,114
1,1371,1258,113,1,64,55
-1,1468,1643,-175,-4,-288,88
-1,1461,2089,-628,-2,-202,62
0,1679,1516,163,2,276,155
1,1498,1708,-210,-4,-65,51
-1,1323,1448,-125,-4,-33,40
1,1527,1519,8,5,204,64
1,1648,1697,-49,2,30,41
1,1526,1460,66,2,699,107
-1,0,1185,-1185,-14,-276,46
1,1543,1537,6,23,859,57
1,1425,1461,-36,-7,-211,55
1,1640,1567,73,9,157,43
1,1212,1500,-288,7,188,43
1,1913,1864,49,0,7,79
1,1465,1519,-54,-1,63,99
-1,1604,1678,-74,1,-517,112
1,1761,1607,154,5,664,99
1,1690,1518,172,2,143,65
1,1722,1702,20,1,23,53
-1,1662,1557,105,-1,-246,98
1,1914,1895,19,-1,27,45
-1,1410,1446,-36,1,209,116
-1,1564,1450,114,-1,-32,42
-1,1523,1746,-223,-2,-460,122
-1,1447,1415,32,-1,14,56
1,1623,1621,2,-3,92,105
-1,1893,1863,30,0,-158,78
-1,1594,1662,-68,0,-60,58
-1,1684,1660,24,0,-180,126
1,1551,1298,253,3,28,49
1,1649,1453,196,4,251,73
-1,1435,1387,48,-7,-590,94
1,1922,1771,151,0,95,107
-1,1564,1527,37,0,3,44
1,1378,1221,157,2,116,55
-1,1748,1504,244,1,34,52
-1,1506,1537,-31,0,-4,54
1,1554,1530,24,-3,-193,95
1,1827,1768,59,3,156,59
-1,1464,1496,-32,1,18,42
1,1327,1541,-214,4,794,103
1,1751,1692,59,-3,152,85
-1,1575,1595,-20,2,115,62
1,1934,1875,59,0,18,63
1,1700,1674,26,-2,-171,89
1,1317,1078,239,1,348,107
1,1641,1345,296,-2,-62,57
1,1506,1479,27,1,617,147
1,1523,1445,78,1,474,113
1,1866,1549,317,6,252,53
1,1671,1500,171,-3,-10,49
-1,1522,1730,-208,-7,-486,84
1,1659,1455,204,0,145,77
-1,1328,1209,119,-1,-27,44
-1,1456,1400,56,3,-156,84
-1,1860,1591,269,-1,-138,80
-1,1683,1761,-78,-3,-533,120
1,1870,1538,332,-2,299,129
1,1736,1517,219,0,80,79
-1,1929,1791,138,0,8,100
-1,1537,1454,83,-6,-73,45
1,1547,1500,47,6,33,42
1,1865,1634,231,3,36,45
1,1774,1712,62,3,103,53
1,1682,1275,407,-1,416,87
1,1449,1665,-216,0,-6,71
-1,1449,1437,12,-3,-131,134
1,1734,1504,230,3,124,57
1,1422,1024,398,3,83,59
0,1439,1516,-77,0,285,77
1,1794,1270,524,-4,-136,57
1,1645,1601,44,0,3,79
-1,1256,1237,19,12,730,88
0,1839,1701,138,-2,-124,70
1,1914,1806,108,0,32,83
1,1866,1737,129,0,67,45
1,1554,1519,35,5,30,43
-1,1564,1675,-111,-3,-75,52
-1,1511,1741,-230,0,-252,110
-1,1477,1795,-318,-5,-431,134
-1,1586,1771,-185,-3,-66,50
1,1413,1500,-87,8,640,75
1,1566,1465,101,6,92,45
-1,1494,1651,-157,-1,-184,104
-1,1492,1423,69,6,180,54
-1,1514,1441,73,1,-189,98
-1,1294,1353,-59,-8,-143,82
1,1799,1473,326,4,52,43
1,1799,1684,115,-1,-52,107
1,1569,1563,6,-5,-37,153
1,1777,1580,197,1,15,43
-1,1385,1420,-35,1,-493,84
1,1500,1384,116,-2,257,85
-1,1825,1949,-124,0,-102,90
1,1488,1022,466,12,432,65
1,1390,1291,99,3,50,45
1,1706,1500,206,3,71,75
1,1720,1333,387,0,318,119
1,1564,1547,17,0,77,75
1,1835,1574,261,0,-56,109
1,1499,1742,-243,0,11,83
1,1682,1783,-101,-1,-67,69
-1,1399,1247,152,-1,-788,92
-1,1030,1500,-470,0,-365,92
1,1874,1307,567,7,132,45
1,1746,1728,18,-1,-92,69
-1,1567,1788,-221,-3,48,112
1,1551,1522,29,0,22,60
1,1510,1322,188,9,175,45
-1,1633,1598,35,0,-752,156
1,1845,1802,43,0,-23,43
1,1500,1586,-86,-4,-28,71
0,1711,1521,190,0,-34,99
1,1431,1506,-75,-1,71,69
-1,1791,1854,-63,0,-143,112
1,1775,1676,99,1,249,155
-1,1550,1531,19,1,16,122
1,1562,1794,-232,0,256,79
1,1428,1199,229,13,355,51
1,1752,1488,264,2,332,91
-1,1316,1516,-200,2,87,70
-1,1756,1704,52,-2,-142,58
-1,1500,1759,-259,-2,-141,116
1,1781,1588,193,1,120,59
-1,1846,1595,251,1,-15,59
1,1500,1341,159,1,66,61
1,1570,1003,567,13,628,67
1,1426,1400,26,0,117,113
1,1723,1603,120,1,43,55
-1,1155,1433,-278,-4,-193,56
-1,1492,1445,47,-1,-371,150
1,1376,1289,87,14,1389,107
-1,1793,1578,215,0,-489,98
1,1505,1037,468,5,426,77
-1,1783,1667,116,-3,24,78
1,1526,1581,-55,-3,-43,47
1,1409,1276,133,20,273,41
-1,1775,1580,195,0,-167,114
1,1577,1723,-146,6,1147,111
-1,1594,1774,-180,-1,-59,60
1,1655,1319,336,4,149,55
1,1574,1456,118,1,-96,59
1,1687,1776,-89,-1,10,67
-1,1839,1641,198,-1,-22,58
1,1781,1588,193,0,-47,53
-1,1749,1467,282,-4,-161,54
1,1500,1487,13,2,340,123
1,1695,1522,173,-4,44,71
-1,1500,1583,-83,-4,-711,92
1,1583,1787,-204,-3,471,117
1,1683,1701,-18,0,-17,113
1,1527,1570,-43,2,82,59
1,1522,1034,488,3,875,91
-1,1768,1599,169,-1,-230,90
-1,1701,1658,43,0,143,154
-1,1957,1770,187,0,-3,60
-1,1503,1549,-46,-7,-107,50
1,1864,1934,-70,-3,22,51
1,1687,1646,41,-3,-48,61
-1,1686,1590,96,-5,-93,54
1,1437,1330,107,-3,11,61
1,1655,1694,-39,1,44,91
1,1615,1750,-135,0,17,51
-1,1317,1552,-235,-3,-284,84
-1,1557,1541,16,-1,191,92
-1,1706,1678,28,0,-38,76
1,1435,1216,219,2,40,41
-1,1567,1878,-311,0,-24,52
-1,1734,1630,104,-4,-209,66
-1,1500,1345,155,-1,-69,82
-1,1614,1479,135,0,-11,76
1,1733,1442,291,-3,-5,57
-1,1567,1493,74,2,68,67
1,1690,1694,-4,-3,-84,69
-1,1644,1718,-74,0,29,90
-1,1416,1764,-348,1,16,62
-1,1032,1573,-541,-15,-689,62
1,1790,1870,-80,3,55,45
1,1682,1701,-19,0,515,143
1,1730,1245,485,0,146,83
0,1444,1515,-71,3,-97,132
-1,1737,2088,-351,-2,-400,102
-1,1554,1546,8,-4,-111,52
1,1824,1700,124,0,-134,113
-1,1583,1630,-47,-5,-549,98
-1,1329,1620,-291,-2,-18,46
1,1767,1403,364,3,107,65
1,2091,1734,357,-1,170,87
1,1172,1429,-257,-1,-143,63
-1,1581,1653,-72,-2,-65,52
-1,1559,1644,-85,-1,-530,70
-1,1990,1841,149,0,11,66
-1,2001,1526,475,-8,-452,104
-1,1690,1694,-4,-1,-243,78
1,1440,1196,244,1,165,63
-1,1881,1670,211,5,54,124
-1,1737,1527,210,-5,-210,86
1,2156,1731,425,1,170,71
-1,1856,1803,53,-1,-55,58
-1,1706,1679,27,-5,-299,78
1,1530,1568,-38,0,-3,73
-1,1448,1576,-128,-1,-61,56
1,1648,1216,432,7,213,59
-1,1475,1821,-346,-6,-308,62
-1,1500,1584,-84,-1,-31,52
-1,1729,2158,-429,-2,-213,76
-1,1691,1693,-2,1,-109,120
1,1325,1270,55,1,93,91
-1,1818,1604,214,-5,-277,136
-1,1813,1893,-80,-3,-32,64
1,1571,1386,185,3,92,55
-1,1833,1547,286,1,-209,162
1,1449,1359,90,3,241,75
-1,1727,2095,-368,0,-48,60
-1,1357,1855,-498,-2,-158,72
-1,1523,1586,-63,-3,-435,108
1,1639,1574,65,2,459,99
-1,1543,1555,-12,2,50,50
1,1705,1680,25,-1,162,145
-1,1512,1446,66,-10,-162,88
1,2098,1857,241,-2,87,101
1,1769,1624,145,0,12,57
1,1528,1389,139,-2,-63,41
1,1589,1172,417,4,212,51
1,2103,1853,250,-1,19,113
-1,1604,1382,222,-1,-53,92
1,1606,1590,16,0,126,115
1,1732,1404,328,0,59,63
-1,1523,1508,15,-2,-125,74
-1,1717,1249,468,0,9,54
1,1733,1747,-14,-1,-32,47
-1,1857,1355,502,3,179,76
1,1670,1715,-45,-3,-37,41
-1,1544,1577,-33,-3,-126,64
1,1763,1687,76,-7,243,175
1,1410,1195,215,19,347,41
-1,1392,1390,2,0,-6,68
-1,1477,1500,-23,-2,-491,74
-1,1465,1437,28,-7,-160,52
-1,1705,1639,66,-4,-35,40
1,1810,1864,-54,2,647,181
1,1758,1626,132,0,124,95
1,1968,1777,191,0,96,63
1,1404,1500,-96,-1,46,85
-1,1433,1803,-370,0,-25,82
-1,1702,1682,20,-8,-237,64
1,1465,1202,263,-2,20,58
-1,1402,1682,-280,-2,-7,40
-1,1613,1691,-78,0,-421,88
-1,1672,1748,-76,0,-40,78
-1,1735,1745,-10,-7,31,40
1,1487,1622,-135,-1,438,99
-1,1589,1824,-235,-4,-181,68
-1,1387,1771,-384,0,-5,62
1,1935,1797,138,1,81,63
1,1974,1948,26,-1,0,43
1,1565,1648,-83,-4,-10,63
1,1456,1465,-9,-1,-18,47
-1,1459,1567,-108,-7,-178,72
-1,1380,1815,-435,-7,-360,70
-1,1587,1534,53,-3,-107,68
-1,1416,1636,-220,0,5,40
1,1652,1692,-40,9,661,76
1,1500,1344,156,18,314,43
-1,1546,1633,-87,-1,-3,56
1,1644,1608,36,-5,-133,49
1,1691,1537,154,1,34,45
-1,1589,1628,-39,0,-517,98
-1,1457,1554,-97,-2,-254,78
1,1445,1168,277,1,67,103
-1,1385,1484,-99,-4,-83,48
-1,1798,1851,-53,1,13,52
-1,1773,1788,-15,0,-105,57
1,1478,1454,24,-4,-63,63
1,1819,1377,442,2,46,48
1,1573,1500,73,1,92,85
-1,1515,1699,-184,2,-225,128
1,1872,1796,76,0,-45,59
-1,1952,1985,-33,0,158,92
1,1518,1458,60,-1,-28,67
1,1790,1780,10,-2,-193,89
-1,1357,1735,-378,-4,-147,68
-1,1367,1705,-338,-8,-158,50
1,1537,1421,116,3,-11,41
1,1528,1462,66,-4,0,41
1,1651,1504,147,-3,-18,49
0,1554,1473,81,-3,-9,106
1,1974,1860,114,0,-119,81
-1,1708,1364,344,1,3,104
1,1635,1578,57,0,442,145
-1,1762,1584,178,0,-205,82
0,1605,1699,-94,0,102,113
-1,1375,1822,-447,-1,-32,50
1,1680,1665,15,0,231,133
1,1500,1538,-38,-4,-158,49
-1,1492,1573,-81,0,-11,76
1,1444,1490,-46,-3,-116,65
1,1655,1765,-110,0,-61,103
1,1453,1567,-114,-2,422,129
1,1436,1618,-182,6,101,43
0,1459,1536,-77,-7,217,118
1,1402,1588,-186,-6,38,69
-1,1757,1828,-71,-4,-86,52
1,1691,1788,-97,2,107,67
-1,1568,1688,-120,-3,-451,104
-1,1853,1981,-128,-3,-112,58
1,1744,1600,144,2,169,71
0,1451,1401,50,-4,-295,133
1,1354,1759,-405,-12,453,125
1,1413,1614,-201,1,45,55
1,2001,1802,199,0,116,87
1,1988,1846,142,1,36,63
-1,1475,1456,19,-1,60,88
1,1842,1696,146,0,-30,59
1,1940,1799,141,0,4,55
1,1484,1585,-101,-2,252,107
1,1801,1388,413,-2,-32,45
1,1420,1230,190,0,128,79
0,1410,1500,-90,-3,-383,110
1,2111,1751,360,2,63,69
1,1510,1306,204,16,678,59
1,1555,1631,-76,-3,-6,49
1,1582,1534,48,4,172,61
0,1433,1469,-36,-6,-293,130
1,1706,1497,209,2,70,67
1,1682,1385,297,-2,-38,51
-1,1500,1617,-117,-2,-20,43
-1,1660,1820,-160,0,13,64
-1,1839,1995,-156,-1,-67,116
-1,1556,1331,225,5,156,68
-1,1362,1646,-284,-1,-141,82
1,1803,1381,422,0,19,51
1,1439,1410,29,0,44,47
-1,1792,1947,-155,0,-283,130
0,1670,1751,-81,-2,-131,92
-1,1433,1123,310,6,198,74
-1,1543,1815,-272,-5,-380,72
1,1473,1418,55,-2,-96,97
-1,1592,1524,68,0,-16,64
-1,1187,1697,-510,-3,-82,44
-1,1401,1504,-103,0,-40,78
1,1426,1431,-5,-2,-30,43
-1,1569,1644,-75,0,-54,92
1,1787,1379,408,1,36,83
1,1519,1541,-22,3,90,67
-1,1485,1557,-72,-1,-373,106
-1,1492,1474,18,2,-138,58
1,1743,1651,92,0,6,61
-1,1581,1562,19,-1,-300,83
1,1826,1516,310,0,141,101
-1,1547,1618,-71,-6,-434,76
1,1671,1358,313,1,147,73
1,1650,1474,176,7,229,63
1,1832,1749,83,0,28,91
-1,1826,1939,-113,1,18,42
1,1359,1537,-178,-1,-7,43
1,1292,1527,-235,4,157,87
-1,1686,1591,95,0,48,86
-1,1450,1538,-88,1,-217,115
-1,1748,1672,76,1,88,96
1,1686,1409,277,1,183,77
-1,1469,1678,-209,-4,-125,54
-1,1530,1699,-169,-5,-178,62
1,1652,1560,92,1,635,121
1,1805,1818,-13,-3,49,121
0,1821,1703,118,-1,-25,150
-1,1739,1841,-102,-3,-72,52
-1,1449,1538,-89,-1,-63,74
1,1746,1512,234,-1,18,61
1,1684,1579,105,3,221,87
-1,1830,1849,-19,-1,-315,74
0,1556,1566,-10,0,-651,125
1,1476,1353,123,-1,-25,62
1,1954,1786,168,0,-6,53
-1,1604,1731,-127,1,161,128
1,1706,1524,182,2,264,111
1,1656,1302,354,6,449,85
1,1374,1527,-153,6,-24,41
-1,1623,1591,32,-1,60,72
1,1546,1441,105,1,49,49
-1,1412,1595,-183,1,-17,60
-1,1709,1562,147,1,-732,136
1,1468,1434,34,0,438,121
1,1692,1572,120,0,-103,75
-1,1559,1374,185,-3,-102,44
1,1581,1534,47,1,42,50
-1,1780,1779,1,0,-120,90
1,1817,1751,66,-2,78,113
-1,1508,1665,-157,0,-8,62
1,1532,1337,195,7,86,47
1,1711,1723,-12,0,11,59
1,1437,1419,18,-1,14,49
-1,1806,1672,134,1,-101,118
-1,1433,1412,21,-3,-191,94
-1,1330,1568,-238,4,25,44
1,1685,1735,-50,0,4,131
1,1510,1398,112,12,885,73
1,1758,1739,19,3,39,49
0,1527,1468,59,3,688,116
1,1497,1497,0,7,230,66
-1,1552,1662,-110,-1,-92,98
-1,1762,1713,49,-1,-50,54
1,1355,1538,-183,8,148,51
1,1700,1564,136,0,10,61
1,1633,1669,-36,1,3,85
-1,1714,1778,-64,-2,-209,102
-1,1436,1569,-133,-1,-181,118
-1,1485,1756,-271,-4,-68,46
-1,1816,1551,265,0,-140,78
1,1638,1467,171,-2,-58,79
0,1463,1515,-52,-2,23,113
-1,1557,1707,-150,0,-49,68
-1,1329,1541,-212,6,-251,88
1,1659,1544,115,-6,315,89
-1,1500,1727,-227,-9,-191,52
0,1828,1865,-37,-5,-24,131
1,1742,1771,-29,5,66,53
-1,1809,1808,1,0,-223,144
-1,1318,1495,-177,-10,-135,50
-1,1690,1661,29,-1,150,96
1,1726,1726,0,-1,56,103
1,1603,1610,-7,1,-2,53
1,1848,1569,279,0,155,71
1,1409,1500,-91,4,-3,40
0,1558,1508,50,-1,-32,47
-1,1608,1833,-225,-2,-148,68
-1,1467,1421,46,2,-47,124
-1,1552,1760,-208,0,-1,56
-1,1483,2015,-532,-12,-655,73
1,1477,1295,182,-1,234,99
-1,1600,1718,-118,-1,-138,90
-1,1611,1829,-218,-4,-264,99
-1,1435,1646,-211,0,-18,56
1,1614,1497,117,-1,57,105
1,1367,1598,-231,2,58,49
1,1548,1639,-91,2,32,81
-1,1606,1834,-228,0,-333,136
1,1342,1331,11,6,218,51
-1,1563,1711,-148,-1,-129,90
1,1391,1149,242,3,945,253
1,1652,1428,224,0,-12,65
1,1476,1252,224,1,25,51
-1,1627,1818,-191,-1,-74,58
-1,1449,1737,-288,1,12,54
-1,1608,1500,108,2,-108,80
1,1464,1512,-48,-5,-63,69
-1,1412,1257,155,2,20,54
-1,1514,1761,-247,0,-579,100
1,1590,1038,552,6,233,51
0,1814,1865,-51,5,316,104
-1,1002,1352,-350,-6,-98,46
1,1737,1598,139,14,752,71
1,1649,1424,225,-4,483,125
-1,1374,1402,-28,-6,-593,112
-1,1289,1435,-146,2,-102,74
-1,1421,1568,-147,0,-4,44
1,1592,1725,-133,-4,-56,55
1,1720,1236,484,3,135,51
-1,1499,1477,22,0,-35,62
1,1607,1727,-120,0,105,89
-1,1355,1585,-230,-1,-284,128
1,1575,1412,163,0,3,69
1,1622,1713,-91,4,106,60
1,1231,1722,-491,0,104,73
0,1501,1196,305,-2,-43,151
1,1445,1528,-83,6,331,85
1,1713,1532,181,3,61,40
1,1386,1398,-12,8,356,63
-1,1718,1811,-93,-3,14,46
-1,1650,1700,-50,-2,-89,62
1,1495,1387,108,9,739,95
0,1439,1249,190,1,155,78
1,1617,1562,55,1,183,82
1,1746,1742,4,-1,16,55
1,1540,1485,55,0,163,105
1,1640,1696,-56,-1,12,63
-1,1964,1839,125,0,54,72
1,1766,1509,257,-6,416,111
-1,1301,1976,-675,0,-403,176
-1,1653,1683,-30,-2,-417,104
-1,1683,1653,30,2,13,40
-1,1503,1378,125,0,-25,82
1,1712,1816,-104,2,499,165
1,1707,1806,-99,0,15,69
1,2015,2001,14,-1,-158,109
-1,1854,2179,-325,-8,-106,48
-1,1412,1496,-84,-6,-222,64
-1,1815,1820,-5,0,61,64
-1,1515,1646,-131,0,-68,70
1,1035,1470,-435,-3,5,55
-1,1488,1226,262,0,-129,70
-1,1665,1723,-58,-5,-617,106
-1,1848,2186,-338,0,-131,108
1,1824,1933,-109,3,69,51
-1,1563,1132,431,2,34,56
1,1393,1178,215,0,69,135
1,1500,1618,-118,0,47,61
1,1645,1514,131,-3,130,85
1,1493,1646,-153,0,225,110
1,1653,1508,145,8,841,103
1,1660,1394,266,-1,7,91
1,1630,1528,102,3,18,46
-1,1256,1470,-214,-1,-25,68
-1,1664,1532,132,-2,-123,40
1,1845,1388,457,-3,-76,57
0,1725,1791,-66,-1,-160,129
1,1732,1548,184,0,3,63
1,1704,1777,-73,1,40,59
1,1738,1649,89,6,529,87
1,1590,1605,-15,1,83,75
-1,1664,1498,166,-5,1,42
1,1477,1610,-133,1,49,75
-1,1640,1746,-106,-1,-97,74
1,1764,1718,46,0,16,51
1,1947,1934,13,-2,-38,45
-1,1633,1670,-37,-6,-108,40
-1,1526,1846,-320,0,129,66
-1,1508,1649,-141,-1,-33,52
1,1361,1386,-25,0,-18,89
0,1680,1623,57,-1,-33,162
-1,1805,1749,56,-2,-23,50
1,1442,1602,-160,-2,289,79
1,1613,1602,11,2,360,107
1,1754,1624,130,11,416,44
1,1632,1524,108,0,256,67
-1,1500,1744,-244,0,29,88
-1,1802,2190,-388,-6,-247,72
-1,1500,1132,368,-1,-78,40
1,1605,1646,-41,1,245,99
1,1594,1372,222,2,88,57
1,1761,1617,144,-4,-203,59
1,1485,1294,191,13,199,45
1,1707,1504,203,0,116,71
1,1492,1595,-103,0,1,59
1,1768,1611,157,5,136,41
-1,1839,1923,-84,0,-16,46
-1,1799,2087,-288,0,-407,92
0,2008,1666,342,1,15,66
-1,1774,1604,170,-12,-1163,132
-1,1167,1398,-231,-2,-19,58
1,1789,1727,62,0,185,113
-1,1365,1599,-234,-1,-18,82
-1,1501,1504,-3,1,20,50
0,1608,1553,55,1,52,90
1,1634,1426,208,3,155,55
-1,1516,1644,-128,0,-197,86
-1,1655,1584,71,0,-83,88
-1,1553,1353,200,-3,-350,91
-1,2091,1693,398,0,117,176
-1,1758,1620,138,-6,-879,86
-1,1675,1997,-322,0,-347,152
-1,1500,1504,-4,-18,-941,72
0,1287,1507,-220,0,269,131
1,1743,1635,108,9,325,71
-1,1604,1359,245,1,74,78
1,1822,1940,-118,3,255,81
1,1751,1627,124,6,859,109
1,1514,1476,38,-3,43,55
1,1641,1291,350,-7,-517,77
-1,1293,1360,-67,3,280,72
1,1758,1620,138,0,467,95
-1,1534,1484,50,0,-175,78
-1,1506,1571,-65,-4,-195,66
-1,2071,1850,221,-2,1,48
1,1565,1505,60,3,72,55
1,1765,1613,152,5,385,79
-1,1543,1622,-79,0,62,82
-1,1868,2051,-183,-3,-770,110
1,1585,1382,203,0,98,73
1,1435,1373,62,5,185,55
-1,1801,1654,147,4,225,80
1,2058,1862,196,0,5,51
-1,1856,2064,-208,-2,-795,140
-1,1772,1607,165,-1,-1,52
-1,1502,1466,36,1,-44,85
1,1512,1327,185,7,585,73
-1,1756,1623,133,0,-414,154
-1,1631,1794,-163,-1,-24,56
-1,1845,2076,-231,1,42,62
-1,1718,1800,-82,0,-19,74
1,1575,1601,-26,-3,135,81
1,1597,1369,228,2,42,57
-1,1642,1487,155,-1,-53,48
-1,1734,1782,-48,-1,-95,72
-1,1741,1638,103,-7,-268,64
1,1222,1495,-273,1,35,53
1,1349,1528,-179,-3,-37,75
-1,1524,1458,66,3,108,96
1,1727,1652,75,4,785,99
-1,1624,1653,-29,-2,-72,44
1,1371,1267,104,-3,10,67
-1,1781,2110,-329,2,32,60
-1,1363,1364,-1,0,-1,46
1,1549,1398,151,-2,-49,47
1,1719,1521,198,-1,-5,73
1,1773,1604,169,1,37,49
1,1607,1671,-64,1,160,73
1,1813,1751,62,8,381,77
-1,1800,1624,176,-2,-37,84
-1,1536,1563,-27,7,5,60
-1,1450,1545,-95,0,6,50
1,1500,1504,-4,2,51,51
1,2114,1302,812,3,119,50
-1,1400,1350,50,-11,-407,62
1,1482,1286,196,0,-24,61
-1,1736,1643,93,-2,-1525,212
1,1935,1639,296,5,56,41
-1,1150,1303,-153,-3,-73,46
1,1722,1657,65,4,205,119
-1,1561,1344,217,2,399,134
1,1554,1437,117,-3,12,55
1,1519,1310,209,13,416,61
1,1301,1636,-335,0,3,45
-1,1490,1431,59,-9,-365,68
-1,2115,1940,175,-1,-65,98
1,1642,1784,-142,0,12,59
1,1420,1463,-43,2,326,65
-1,1500,1730,-230,-6,-237,68
1,2001,1785,216,1,52,79
0,1553,1656,-103,0,-101,119
-1,1627,2018,-391,-1,-240,112
1,1496,1308,188,0,-13,49
1,1803,1139,664,5,644,97
1,1383,1423,-40,5,257,61
-1,1344,1447,-103,5,470,80
-1,1497,1647,-150,0,-44,90
-1,1768,1660,108,1,-29,72
1,1959,1335,624,5,181,97
-1,1738,1608,130,-7,-70,44
-1,1010,1448,-438,-10,-388,54
1,1500,1540,-40,-6,-211,95
-1,1510,1746,-236,-1,-79,64
1,1822,1655,167,0,46,57
-1,1455,1334,121,6,-169,126
1,1473,1468,5,3,228,65
1,1614,1364,250,1,19,107
-1,1739,1741,-2,0,86,94
1,1724,1624,100,-1,118,51
-1,1517,1307,210,0,-555,104
-1,1338,1477,-139,0,4,50
-1,1561,1664,-103,1,-32,70
1,1653,1731,-78,5,128,57
0,1676,1754,-78,0,-64,100
1,1721,1434,287,1,85,51
-1,1334,1960,-626,-2,-3,44
-1,1556,1357,199,-6,-129,44
1,1726,1480,246,1,89,81
1,1317,1138,179,12,460,59
-1,1690,1709,-19,-1,-20,52
-1,1380,1439,-59,0,39,74
-1,1477,1446,31,-1,-44,53
-1,1727,1657,70,0,-18,98
-1,1324,1463,-139,-5,-43,40
-1,1556,1501,55,-5,-30,64
1,1369,1371,-2,3,5,47
1,1642,1677,-35,-1,54,52
1,1466,1487,-21,-1,-62,89
1,1248,1488,-240,2,155,55
1,1500,1919,-419,1,65,55
-1,1302,1483,-181,2,69,42
1,1504,1838,-334,0,456,77
1,1715,1670,45,9,938,119
1,1809,1244,565,-5,17,58
1,1314,1472,-158,-4,537,87
-1,1724,1661,63,0,-675,86
1,1490,1476,14,0,108,73
1,1472,1314,158,-6,-371,97
-1,1417,1574,-157,1,6,50
0,1673,1711,-38,-1,-266,124
-1,1544,2022,-478,4,103,58
-1,1654,1731,-77,-1,-207,88
1,1653,1524,129,2,90,65
1,1465,1503,-38,1,141,123
-1,1360,1380,-20,1,35,66
-1,1388,1448,-60,-1,-816,130
1,1944,1598,346,-4,-15,95
1,1654,1718,-64,5,284,89
1,1737,1522,215,-9,3,51
-1,1129,1818,-689,-6,-408,68
-1,1677,1648,29,2,87,72
-1,1489,1484,5,-5,-351,114
-1,1548,1369,179,0,-399,90
-1,1324,1464,-140,0,57,50
1,1468,1500,-32,6,528,77
-1,1478,1543,-65,-2,-2,40
-1,1710,1674,36,-10,-683,120
1,1615,1618,-3,0,226,92
0,1514,1495,19,1,47,61
1,1712,1618,94,-3,17,129
1,1672,1553,119,1,66,51
-1,1419,1678,-259,1,60,80
-1,1335,2081,-746,0,-105,62
1,1511,1341,170,1,19,43
1,2024,1837,187,0,5,53
1,1709,1676,33,8,368,67
1,1819,1925,-106,1,-28,69
1,1984,1751,233,0,-7,43
-1,1501,1371,130,0,-4,74
1,1605,1627,-22,0,131,145
1,1739,1645,94,6,192,50
-1,1718,1666,52,0,-191,82
-1,1645,1595,50,0,-435,148
-1,1683,1415,268,1,-15,44
-1,1564,1534,30,5,127,54
-1,1317,1350,-33,-1,-22,44
1,1432,1709,-277,7,168,55
1,2111,1751,360,0,93,117
-1,1581,1451,130,-1,-61,118
-1,1706,1678,28,3,66,52
1,1535,1553,-18,1,41,69
-1,1308,1476,-168,-20,-321,40
-1,1434,1663,-229,0,50,94
1,1396,1167,229,12,558,69
1,1545,1230,315,1,264,111
1,1391,1349,42,-2,-44,118
-1,2034,2044,-10,-2,-81,72
-1,1234,1823,-589,0,-15,52
-1,1695,1690,5,-4,-133,94
0,1680,1704,-24,0,57,143
1,1496,1376,120,7,289,63
-1,1636,1956,-320,1,18,44
-1,1780,1710,70,-3,-57,88
-1,1671,1528,143,0,-201,138
1,1495,1478,17,1,99,109
-1,1873,1834,39,3,-63,78
-1,1477,1490,-13,4,51,66
1,1380,1337,43,3,288,73
-1,1668,1429,239,0,-51,52
-1,1007,1403,-396,-17,-368,53
1,2114,2093,21,0,1,83
1,1960,1633,327,2,37,53
-1,1433,1414,19,-1,-54,48
-1,1910,2153,-243,4,120,90
1,1687,1545,142,4,208,65
-1,2059,1746,313,-6,-102,42
1,1449,1648,-199,2,182,75
-1,1406,1415,-9,1,-86,68
1,1693,1538,155,0,-1,59
-1,1233,1346,-113,-5,-151,52
1,2079,2125,-46,0,259,111
1,1517,1383,134,0,-7,43
1,1660,1660,0,-2,286,147
-1,1211,1389,-178,0,185,72
1,1359,1289,70,0,94,57
1,1511,1361,150,6,131,43
-1,1747,2016,-269,-1,-56,68
1,1700,1531,169,0,417,87
1,1660,1444,216,0,32,59
1,1588,1619,-31,-2,84,83
-1,1416,1682,-266,-1,-2,46
-1,1489,1708,-219,-1,-23,46
1,1224,1127,97,0,399,103
1,1227,1551,-324,4,90,45
-1,1457,1359,98,0,216,112
1,1798,1916,-118,0,67,131
-1,1161,1401,-240,-1,-337,98
-1,2158,2055,103,0,-4,52
0,1559,1652,-93,1,157,73
1,1481,1501,-20,4,293,85
-1,1004,1524,-520,-6,-401,82
1,1706,1524,182,1,416,89
-1,1508,1638,-130,-1,-64,74
1,1350,1456,-106,6,546,127
1,1713,1728,-15,0,-101,157
-1,1816,1753,63,0,-246,142
-1,1534,1505,29,-3,-31,46
1,1452,1551,-99,6,162,63
1,1420,1454,-34,2,256,65
1,1711,1526,185,4,195,83
-1,1306,1293,13,7,176,48
-1,1721,1633,88,0,-15,94
1,1767,1746,21,1,16,47
-1,1702,1760,-58,-1,-67,67
1,1541,1368,173,-1,4,63
-1,1349,1747,-398,-3,-283,90
-1,1717,1538,179,1,54,60
-1,1279,1489,-210,-3,-84,54
-1,1636,1627,9,0,96,60
1,2143,1920,223,-2,35,57
1,1645,1618,27,0,12,79
1,1666,1753,-87,1,131,81
1,1526,1402,124,0,153,77
-1,1701,1570,131,1,-423,122
-1,1501,1656,-155,-3,-130,62
-1,1438,1521,-83,2,24,104
1,1615,1818,-203,-6,-568,97
1,1354,1440,-86,-4,-125,71
0,1686,1585,101,-9,-783,175
1,1831,1725,106,0,17,47
1,1649,1564,85,0,2,73
1,1424,1648,-224,-2,-109,69
-1,1915,2148,-233,-2,-94,78
0,1801,1632,169,1,37,92
-1,1662,1495,167,-9,-187,54
-1,1246,1310,-64,-2,-20,42
-1,1706,1543,163,-5,-472,74
1,1816,1758,58,-4,20,45
1,1527,1500,27,1,67,63
-1,1478,1347,131,0,131,118
1,1796,1949,-153,-1,246,97
1,1436,1296,140,-1,37,51
-1,1406,1154,252,6,98,44
1,1906,1731,175,0,102,97
-1,1372,1397,-25,-4,-207,58
1,1381,1319,62,4,105,65
1,1706,1565,141,4,160,65
1,1593,1494,99,-2,104,99
1,1510,1646,-136,0,330,93
-1,1646,1613,33,-6,-925,138
1,1699,1817,-118,2,57,107
1,1444,1465,-21,0,148,85
-1,1762,1366,396,1,46,70
-1,1558,1713,-155,-9,-647,89
1,1645,1672,-27,4,243,81
1,1697,1524,173,-3,-125,65
1,1719,1552,167,-4,-144,69
1,1669,1427,242,-6,-73,67
-1,1911,1879,32,3,94,72
-1,1697,1831,-134,-7,-314,84
-1,1738,1680,58,-8,-475,79
1,1819,1503,316,4,144,51
1,1812,1715,97,-1,-61,83
-1,1518,1704,-186,3,268,96
1,1594,1457,137,-1,114,73
-1,1427,1305,122,-6,-999,126
-1,1681,1500,181,-1,-40,62
1,1732,1548,184,6,395,83
1,1687,1500,187,3,35,46
-1,1632,1525,107,-1,-197,74
1,1820,1802,18,0,23,81
-1,1309,1346,-37,-2,-119,68
-1,1737,1542,195,3,-201,94
-1,1404,1566,-162,-4,-181,78
-1,1710,1512,198,-2,-427,126
1,1721,1630,91,0,-66,69
-1,1430,1500,-70,-1,-81,68
-1,1369,2008,-639,-7,-109,47
1,1659,1472,187,-2,-37,45
-1,1521,1566,-45,5,-121,84
1,1694,1724,-30,1,57,77
-1,1500,1661,-161,-1,-103,76
-1,1787,2017,-230,0,-46,70
1,1541,1064,477,3,98,45
-1,1539,1618,-79,1,30,60
-1,1453,1455,-2,-2,-218,82
0,1689,1623,66,-7,7,107
-1,1451,1272,179,-1,-52,68
1,1504,1248,256,4,404,89
-1,1383,1729,-346,6,-370,116
-1,1500,1580,-80,0,-137,116
1,1505,1274,231,1,30,43
-1,1500,1595,-95,-1,-50,54
1,1370,1329,41,3,250,99
-1,1365,1750,-385,-14,-91,42
1,1977,1595,382,3,107,59
-1,1500,1488,12,-7,-145,42
-1,1580,1511,69,1,11,86
1,1740,1581,159,4,63,43
-1,1695,1424,271,-1,-69,86
1,1464,1369,95,-1,-67,67
1,1083,1289,-206,0,-80,81
1,1638,1179,459,1,531,103
-1,1673,1723,-50,-7,-80,52
-1,1711,1706,5,-1,-174,102
-1,1285,1785,-500,-4,-287,74
-1,1503,1799,-296,0,35,56
1,1483,1370,113,0,427,187
1,1440,1471,-31,2,283,129
0,1521,1729,-208,-3,167,219
1,1600,1531,69,0,42,101
-1,1860,1761,99,0,-13,48
1,1422,1362,60,0,31,54
1,1836,1737,99,0,10,79
-1,1360,1587,-227,-8,-56,72
-1,1466,1305,161,-6,-103,40
1,1686,1575,111,-2,-62,73
-1,1273,1521,-248,1,34,48
-1,1509,1500,9,-2,-44,60
0,1807,1791,16,1,14,82
1,1663,1747,-84,0,-32,79
-1,1768,1514,254,-10,-93,42
1,1853,1593,260,1,2,57
-1,1308,1278,30,-8,-930,106
1,1792,1806,-14,2,161,63
1,1621,1451,170,1,298,103
-1,1525,1722,-197,0,-35,66
-1,1380,1636,-256,-1,-19,56
-1,1794,1803,-9,-1,-134,118
1,1528,1295,233,2,22,41
-1,1572,1610,-38,0,20,74
1,1789,1659,130,0,-3,75
0,1760,1844,-84,0,-25,90
1,1775,1383,392,3,62,43
1,1533,1632,-99,5,223,60
-1,1783,1814,-31,-2,298,130
1,1423,1562,-139,2,218,87
-1,1504,1545,-41,1,-28,60
1,1269,1158,111,3,83,49
1,1192,1386,-194,3,94,67
-1,1782,2025,-243,0,27,58
-1,1542,1521,21,-2,-15,60
-1,1680,1689,-9,1,5,72
-1,1772,1824,-52,-5,-36,64
1,1730,1620,110,1,45,79
-1,1960,1831,129,-1,-166,76
1,1415,1578,-163,1,208,91
1,1501,1556,-55,4,317,95
1,1841,1763,78,0,-8,51
1,1730,1519,211,-5,-24,61
1,1443,1598,-155,2,45,43
-1,1431,1215,216,-5,127,100
1,1834,1763,71,0,119,127
-1,1732,1677,55,0,-32,52
1,1845,1942,-97,3,74,55
1,1533,1693,-160,-10,-58,49
1,1639,1416,223,1,37,62
-1,1754,1842,-88,-4,-508,92
-1,1290,1315,-25,-1,-523,128
1,1889,2009,-120,0,-68,61
-1,1754,1850,-96,0,-35,70
-1,1623,1720,-97,-2,-24,44
-1,1378,1777,-399,-1,-32,64
-1,1666,1555,111,-4,-82,58
-1,1400,1446,-46,-1,-126,56
-1,1508,1378,130,-4,-50,46
-1,1941,2172,-231,0,-4,68
-1,1473,1680,-207,0,-259,104
-1,1143,1256,-113,-4,-78,43
-1,1622,1887,-265,0,-14,74
1,1584,1504,80,11,341,53
0,1879,1744,135,0,-243,111
-1,1828,1720,108,0,-37,78
0,2178,1937,241,0,89,117
-1,1480,1607,-127,0,19,56
-1,1275,1361,-86,0,-87,88
1,1504,1693,-189,0,-5,145
1,1590,1689,-99,-2,-34,81
1,1875,1558,317,2,64,57
-1,1371,1503,-132,-3,-93,46
-1,1499,1619,-120,0,-9,72
1,1664,1493,171,1,201,95
1,1529,1393,136,-2,59,49
-1,2017,1667,350,0,-193,136
1,1799,1814,-15,1,-31,117
1,1327,1158,169,3,125,55
1,1375,1614,-239,2,70,49
-1,1507,1742,-235,-3,-58,84
1,2070,1878,192,-1,120,89
1,1564,1570,-6,3,465,106
-1,1326,1484,-158,7,410,80
1,1810,1721,89,5,27,41
1,1481,1908,-427,-3,28,54
-1,1802,1739,63,0,-16,126
-1,1561,1549,12,-2,-29,60
-1,1556,1500,56,-1,-53,58
-1,1487,1671,-184,1,8,56
1,1810,2076,-266,0,20,57
1,1673,1604,69,5,113,53
1,1497,1685,-188,-1,171,81
1,1148,1333,-185,8,462,74
-1,1522,1547,-25,1,-791,142
-1,1873,1919,-46,0,-6,44
1,1675,1472,203,1,17,53
1,1505,1641,-136,10,455,59
-1,1926,1941,-15,-2,-97,68
1,1810,1500,310,0,155,125
1,1660,1422,238,4,229,80
-1,2012,1683,329,-1,-143,82
-1,1707,1678,29,0,-56,64
1,1317,1175,142,8,621,101
-1,1595,1683,-88,-5,-400,90
-1,1680,1561,119,0,-59,62
-1,1288,1407,-119,-9,-531,86
-1,1695,1690,5,-2,-270,70
1,1483,1584,-101,9,752,109
-1,1684,1702,-18,4,158,74
1,1952,1915,37,0,-16,63
1,1472,1438,34,6,146,53
-1,1677,1426,251,0,-195,86
-1,1767,2112,-345,0,-189,112
-1,1575,1665,-90,0,-117,106
-1,1164,1324,-160,3,-92,42
-1,1836,1885,-49,0,-15,58
-1,1673,1752,-79,-7,-114,50
1,1519,1390,129,-1,-51,59
1,1705,1529,176,5,170,56
-1,1599,1863,-264,4,273,68
0,1668,1514,154,-4,-150,160
-1,1627,1891,-264,-3,-149,68
1,1330,1154,176,3,135,51
1,1706,1520,186,1,26,64
-1,1508,1484,24,0,-126,80
-1,1686,1944,-258,0,-93,76
1,1267,1266,1,6,292,79
1,1513,1441,72,1,30,55
0,1679,1747,-68,0,-38,152
-1,1552,1657,-105,-5,-185,98
1,1408,1495,-87,3,181,105
1,1685,1662,23,-2,185,111
-1,1828,1867,-39,-2,-404,96
-1,1567,1541,26,1,-76,74
-1,1681,1512,169,-1,-613,140
-1,1145,1336,-191,0,-24,68
1,1681,1745,-64,-1,-20,43
-1,1731,1666,65,0,-207,134
1,1685,1462,223,2,39,51
1,1497,1570,-73,0,-15,47
1,1329,1357,-28,-1,-36,50
-1,1267,1616,-349,-4,-83,40
1,1877,1818,59,-3,7,85
1,1858,1552,306,1,84,52
-1,1528,1500,28,-7,-829,104
-1,1694,1718,-24,0,-5,52
1,1342,1136,206,9,317,59
1,1820,1680,140,1,105,69
1,1453,1596,-143,1,139,73
-1,1729,1683,46,-1,-7,40
1,2116,1949,167,0,2,53
1,1914,1809,105,0,92,77
-1,1558,1666,-108,-1,132,93
-1,1129,1347,-218,-2,-50,44
1,1672,1827,-155,0,3,41
-1,1696,1716,-20,-7,-655,122
-1,2080,2124,-44,-1,-211,140
-1,1355,1363,-8,2,75,50
1,1959,1895,64,-1,-207,81
-1,1732,1918,-186,-1,-378,124
-1,1422,1273,149,-4,-378,82
-1,1685,1727,-42,0,32,58
-1,1352,1121,231,-9,-86,80
-1,1689,1922,-233,-9,-32,132
-1,1288,1515,-227,-2,-91,52
-1,1515,1543,-28,-11,-355,60
1,1596,1628,-32,0,-51,73
-1,1689,1674,15,0,-3,47
-1,1511,1481,30,0,3,68
1,1764,1587,177,3,463,95
1,1622,1473,149,1,47,61
1,1467,1478,-11,12,340,55
-1,1283,1482,-199,-11,-204,52
1,1500,1684,-184,0,16,85
-1,1491,1452,39,-1,-96,57
1,1910,1686,224,1,137,129
-1,1146,1335,-189,0,48,52
-1,1253,1295,-42,-6,-951,96
-1,1504,1676,-172,-1,-92,66
1,1685,1554,131,1,17,85
-1,1481,1429,52,-9,-353,60
-1,2084,2056,28,-1,-15,68
0,1669,1757,-88,-5,-307,152
-1,1339,1384,-45,-3,-665,140
-1,1748,1886,-138,-5,-6,68
-1,1362,1673,-311,-2,-64,58
-1,2060,1928,132,0,-203,130
1,1552,1473,79,1,39,43
0,1942,1770,172,-3,5,72
1,1692,1612,80,0,-8,103
1,1340,1138,202,-3,-49,75
-1,1587,1557,30,0,20,86
1,1673,1500,173,0,3,53
1,1553,1493,60,4,148,51
-1,1537,1683,-146,2,100,62
-1,1573,1712,-139,-9,-237,52
0,1944,2044,-100,1,-51,114
1,1682,1462,220,12,50,41
-1,1353,1677,-324,-4,-236,80
1,1474,1581,-107,0,58,69
1,1277,1323,-46,2,121,53
1,1690,1736,-46,-5,-89,183
-1,1741,1527,214,0,19,56
-1,1419,1478,-59,-7,-669,114
1,1546,1392,154,0,64,67
-1,2041,1948,93,-1,-63,48
0,1688,1671,17,0,-10,117
-1,1374,1285,89,-7,-541,114
1,2070,1680,390,2,70,61
1,1801,1437,364,2,144,53
0,1645,1712,-67,3,113,89
0,1719,1565,154,2,-361,150
1,2072,1678,394,4,347,73
1,1329,1154,175,0,13,55
1,1702,1724,-22,1,62,57
-1,1434,1804,-370,-1,-19,50
-1,1328,1988,-660,-1,-48,54
1,1567,1488,79,0,6,69
-1,1712,1675,37,-7,-53,58
1,1500,1394,106,-4,8,47
-1,1713,1723,-10,-9,-638,82
-1,1341,1349,-8,1,38,56
1,1806,1432,374,11,326,55
1,1814,1468,346,1,26,57
-1,1608,1406,202,0,34,84
1,1780,1553,227,1,-29,87
1,1963,1700,263,1,105,109
1,2075,1703,372,1,460,115
1,1507,1413,94,11,600,77
-1,1146,1335,-189,1,-308,106
-1,1809,1689,120,1,-24,60
1,1500,1256,244,-8,-280,55
1,1371,1289,82,2,264,87
0,1700,1494,206,0,428,89
-1,1990,1987,3,-6,-22,44
-1,1465,1817,-352,0,3,42
-1,1499,1695,-196,4,154,46
1,1603,1561,42,0,19,55
0,1967,1705,262,1,66,85
1,1480,1575,-95,2,925,103
-1,1877,1950,-73,0,0,114
1,1473,1192,281,1,208,123
-1,1700,1688,12,0,-485,136
1,1500,1630,-130,1,47,63
1,1970,1568,402,10,613,67
1,1404,1516,-112,0,433,107
1,1973,1570,403,2,43,71
1,1341,1139,202,-2,-57,81
-1,1412,1529,-117,1,20,58
1,1319,1241,78,1,146,73
1,1820,1462,358,0,37,47
-1,1487,1377,110,-7,-382,76
-1,1421,1494,-73,-3,-119,62
-1,1689,1712,-23,-10,-745,76
1,1330,1361,-31,5,58,43
-1,1918,2142,-224,0,33,64
-1,1552,1612,-60,-1,-67,78
-1,1237,1461,-224,-6,49,102
1,1885,1776,109,0,96,99
-1,1647,1573,74,0,8,52
-1,1406,1500,-94,2,-44,122
-1,1661,1602,59,1,16,58
1,1306,1360,-54,0,-93,87
1,1497,1363,134,0,-23,89
-1,2007,1957,50,-1,23,42
-1,1325,1749,-424,-4,-326,92
-1,1595,1724,-129,-1,-4,56
-1,1570,1715,-145,1,-231,100
-1,1131,1346,-215,0,-91,92
1,1405,1380,25,2,198,99
1,1627,1685,-58,5,775,129
-1,1407,1562,-155,1,-5,104
-1,1732,1587,145,-1,-294,92
1,1504,1750,-246,0,-53,115
-1,1672,1640,32,-2,-244,94
1,1894,1347,547,0,16,43
1,1343,1422,-79,0,39,53
1,2078,1700,378,0,33,45
-1,1658,1637,21,-1,-45,78
-1,1477,1488,-11,0,-12,40
-1,1724,1662,62,2,84,56
-1,1729,1572,157,0,-455,136
-1,1318,1414,-96,0,-238,126
0,1652,1660,-8,-3,-4,134
-1,1632,1619,13,0,89,96
1,1522,1697,-175,1,595,107
1,1732,1715,17,0,27,95
1,1500,1281,219,0,12,53
0,1593,1565,28,-1,172,105
1,1895,1500,395,-3,-52,45
1,1475,1585,-110,5,501,117
-1,1726,2148,-422,0,-201,74
1,1660,1653,7,1,891,113
-1,1370,1417,-47,-3,29,148
1,2081,1580,501,0,6,49
-1,1492,1442,50,0,1,44
-1,1704,1743,-39,0,-30,112
-1,1257,1581,-324,1,58,80
1,1719,1681,38,0,843,185
1,1647,1597,50,0,86,59
1,1462,1271,191,2,274,77
1,1642,1670,-28,1,767,163
1,1538,1500,38,0,6,61
-1,1411,1411,0,-8,-449,64
1,1468,1231,237,1,107,69
-1,1408,1500,-92,1,30,58
1,1689,1610,79,0,-42,81
1,1507,1579,-72,3,129,65
-1,1895,1587,308,0,3,68
1,1898,1454,444,-2,-79,79
-1,1656,1548,108,-3,-465,130
-1,1529,1381,148,-2,-19,46
-1,1730,1671,59,0,-12,96
1,1342,1545,-203,2,166,75
-1,1659,1654,5,-8,-609,180
0,1336,1309,27,0,49,112
1,1648,1467,181,9,255,51
-1,1595,1509,86,0,-36,154
1,1254,1335,-81,-4,-45,55
0,1638,1545,93,-1,123,120
1,1676,1350,326,0,12,45
1,1290,1456,-166,10,230,47
-1,1742,1894,-152,-1,-24,44
1,1400,1510,-110,0,22,57
1,1427,1360,67,-1,158,63
-1,1350,1521,-171,-1,-641,114
-1,1399,1407,-8,2,-4,46
1,1648,1654,-6,0,173,58
1,1477,1608,-131,4,117,123
-1,1661,1617,44,1,40,69
-1,1517,1900,-383,-4,-270,64
1,1654,1589,65,0,-9,81
-1,1422,1392,30,-10,-462,74
-1,1665,1684,-19,0,-8,60
-1,1642,1563,79,2,-90,62
-1,1461,1429,32,-6,-561,102
-1,1222,1537,-315,-5,-397,102
-1,1532,1500,32,0,-199,122
-1,1500,1514,-14,-3,-421,154
1,1734,1900,-166,1,172,117
-1,1901,1895,6,1,60,70
-1,1993,1611,382,0,-114,64
1,1786,1767,19,0,75,73
-1,1716,1523,193,0,2,66
-1,1643,1659,-16,-4,-526,116
-1,1853,2045,-192,0,11,86
1,1122,0,1122,12,377,43
1,1525,1629,-104,2,346,95
-1,1465,1498,-33,-6,-38,56
1,1868,1940,-72,-3,7,55
1,1712,1607,105,0,211,93
-1,1750,1842,-92,0,-81,70
-1,1524,1494,30,2,-1129,176
-1,1489,2095,-606,0,2,58
-1,1057,1691,-634,-3,-65,48
-1,1761,1802,-41,1,207,124
-1,1851,1742,109,-2,-122,66
-1,1610,1702,-92,0,-258,136
-1,1551,1626,-75,-4,-191,58
-1,1410,1546,-136,-1,-234,76
-1,1757,1836,-79,-1,-269,96
-1,1666,1884,-218,-3,-9,62
1,1654,1802,-148,1,1,65
1,1470,1265,205,-2,-130,75
-1,1540,1545,-5,2,-87,100
0,1993,1699,294,1,167,126
1,1511,1492,19,11,45,40
1,1947,1663,284,2,15,51
1,1420,1555,-135,-3,47,57
-1,1531,1511,20,-3,-75,62
1,2095,1488,607,0,10,49
1,1960,1734,226,6,14,41
-1,1343,1265,78,-6,-50,42
-1,1744,1827,-83,-11,-185,46
1,1616,1467,149,3,283,97
1,1698,1503,195,2,161,99
-1,1522,1692,-170,1,50,84
1,1842,2055,-213,0,61,133
-1,1634,1676,-42,-1,-109,73
-1,1343,1241,102,-1,-4,50
1,1577,1724,-147,0,9,77
-1,1670,1704,-34,0,-215,152
-1,1106,1519,-413,-1,-45,58
-1,1498,1313,185,-3,-261,86
1,1463,1419,44,-4,104,101
1,1904,1659,245,-1,287,107
-1,1491,1508,-17,0,10,54
1,1518,1352,166,-1,4,59
1,1563,1403,160,5,178,51
1,1329,1047,282,3,454,107
-1,1443,1646,-203,-8,-127,42
1,1845,1543,302,0,19,61
1,1558,1487,71,-3,-417,135
-1,1560,1629,-69,0,16,48
1,1715,1660,55,0,215,119
1,1721,1539,182,0,67,67
1,1698,1640,58,1,50,69
1,1302,1377,-75,-3,-10,71
-1,1529,1315,214,-1,-981,148
-1,1516,1525,-9,-3,-331,89
1,1280,1330,-50,1,-32,77
1,2026,1713,313,0,12,85
1,1651,1725,-74,-4,-79,75
-1,1563,1474,89,-1,53,84
1,1396,1578,-182,5,22,67
1,1500,1288,212,1,29,49
1,1662,1584,78,-5,-215,71
-1,1388,1345,43,-6,-109,50
1,1708,1593,115,-1,79,125
1,1670,1576,94,-1,-16,51
-1,1519,1414,105,-3,-160,76
1,1909,1896,13,0,-1,101
-1,1710,1664,46,0,-11,82
1,1536,1544,-8,9,163,42
-1,1769,1614,155,0,-82,94
1,1676,1697,-21,0,43,69
-1,1548,1571,-23,-9,-307,78
1,1497,1638,-141,-2,183,83
1,1856,1728,128,0,61,75
-1,1412,1533,-121,2,21,136
-1,1660,1568,92,-1,-57,62
1,1836,1871,-35,-1,53,61
-1,1931,1692,239,0,-237,120
1,1685,1687,-2,1,275,111
1,1648,1429,219,2,507,109
-1,1511,1470,41,1,-271,106
1,1685,1336,349,2,275,83
1,1358,1333,25,-2,-76,61
-1,1541,1413,128,-3,130,124
1,1537,1583,-46,-1,-24,45
-1,1771,1651,120,1,18,58
-1,1480,1510,-30,-3,-116,68
-1,1676,1696,-20,-2,-129,136
0,1423,1653,-230,-1,-228,192
1,1603,1448,155,1,42,57
0,1786,1907,-121,0,4,87
1,1707,1666,41,0,8,89
1,1585,1715,-130,0,10,74
1,2088,1849,239,0,52,59
-1,1545,1582,-37,0,-12,62
1,1849,2088,-239,0,11,49
1,1646,1430,216,6,412,81
1,1657,1717,-60,0,24,105
1,1632,1784,-152,-3,-364,111
-1,1921,1735,186,0,49,70
-1,1562,1947,-385,-2,-141,60
1,1520,1499,21,1,189,77
1,1550,1374,176,1,21,41
-1,1735,1491,244,-1,-292,86
-1,1405,1420,-15,-5,-389,104
1,1428,1510,-82,-2,-75,97
-1,1365,1610,-245,0,-85,84
-1,1720,1480,240,2,-76,84
1,1936,1749,187,0,-93,85
1,1690,1281,409,0,-37,69
0,1500,1474,26,-6,-673,88
0,1368,1556,-188,-2,-75,138
1,1597,1902,-305,2,261,89
1,1949,1559,390,1,199,122
1,1610,1375,235,9,238,49
1,1507,1651,-144,1,35,71
-1,1369,1639,-270,-5,-383,68
-1,1693,1500,193,-4,-151,72
-1,1467,1492,-25,-2,-167,80
-1,1550,1557,-7,0,-113,92
1,1661,1669,-8,-3,461,177
1,1489,1350,139,-2,21,55
1,1700,1600,100,3,255,109
-1,1828,1717,111,0,-30,40
1,1118,1328,-210,3,82,51
1,1142,0,1142,3,35,139
1,1903,1666,237,-1,-9,117
-1,1640,1654,-14,-2,-164,109
1,1951,1756,195,1,21,45
-1,1495,1533,-38,4,99,54
1,1426,1236,190,-1,-56,61
-1,2150,1857,293,-1,-34,52
-1,1506,1501,5,0,-401,168
0,1579,1621,-42,0,-47,127
-1,1535,1441,94,0,-8,50
1,1423,1473,-50,0,-2,45
-1,1678,1418,260,-1,-125,73
1,1482,1442,40,3,78,47
-1,1373,1579,-206,-1,-150,136
-1,1359,1261,98,-5,-371,78
-1,1715,1659,56,3,-81,104
1,1701,1500,201,5,28,49
-1,1500,1595,-95,-11,-251,84
1,1553,1699,-146,0,-98,49
1,1646,1680,-34,1,25,53
1,1540,1365,175,0,75,95
-1,1375,1241,134,1,-29,62
-1,1652,1363,289,-7,-104,58
1,1492,1383,109,3,742,105
-1,1814,1858,-44,-2,-8,66
-1,1874,1982,-108,-2,-17,50
1,1294,1227,67,-2,-46,85
0,1650,1256,394,0,0,101
-1,1771,1696,75,2,2,80
0,1432,1501,-69,-1,75,97
1,1311,1140,171,6,238,49
-1,1355,1555,-200,-2,-304,86
1,1476,1488,-12,0,297,97
-1,1528,1572,-44,0,16,64
1,1743,1500,243,0,593,133
1,1256,1681,-425,3,163,97
1,1620,1580,40,0,-74,107
1,2048,1799,249,0,9,65
-1,1865,1884,-19,0,-226,128
1,1443,1376,67,3,154,74
-1,1630,1665,-35,0,-156,84
1,1954,1948,6,-1,-2,67
1,1717,1372,345,-4,-69,73
-1,1483,1588,-105,-2,-85,52
1,1505,1435,70,14,328,47
1,1750,1661,89,0,35,65
0,1592,1708,-116,0,34,96
1,1944,1725,219,0,20,61
-1,1643,1426,217,-1,-27,56
-1,1567,2075,-508,0,13,61
1,1132,1317,-185,2,186,69
1,1748,1348,400,-2,9,61
-1,1448,1305,143,-1,-211,106
1,1661,1478,183,0,47,47
1,1497,1434,63,0,393,133
-1,1785,1937,-152,0,69,78
-1,1681,1675,6,1,-180,82
-1,1662,1798,-136,-7,-98,84
1,1730,1631,99,-7,-188,143
1,1464,1332,132,-2,-3,55
-1,1759,1895,-136,0,-2,86
-1,1620,1700,-80,-4,-40,42
-1,1503,1393,110,-2,-92,80
1,1770,1487,283,0,0,53
-1,1592,1853,-261,-2,-258,88
-1,1844,2065,-221,0,-17,50
-1,1367,1537,-170,-6,-126,56
-1,1625,1664,-39,0,-10,54
-1,1301,1153,148,-6,-33,54
1,2071,1839,232,0,-4,73
1,2038,1943,95,3,117,53
1,1305,1144,161,-1,102,89
1,1466,1217,249,0,23,109
-1,1912,1857,55,0,1,46
1,1441,1388,53,2,125,69
-1,1589,1929,-340,-1,-276,78
-1,1325,1664,-339,-5,-392,76
-1,1625,1693,-68,0,-229,72
-1,1450,1460,-10,1,-7,56
1,1416,1483,-67,0,79,109
1,1708,1558,150,3,57,53
-1,1571,1604,-33,-1,61,60
-1,1455,1644,-189,0,-39,102
-1,1773,1676,97,-1,-17,52
-1,1555,1613,-58,-1,-46,60
1,1505,1561,-56,0,608,101
-1,1551,1715,-164,6,122,100
-1,1961,1789,172,0,-15,58
-1,1215,1414,-199,-7,-108,52
-1,1436,1364,72,-6,-336,102
1,1702,1616,86,0,29,69
1,1372,1458,-86,10,548,73
-1,1761,1651,110,-1,-70,66
-1,1691,1758,-67,-1,-420,108
-1,1807,1883,-76,-3,-129,94
-1,1462,1393,69,0,-30,58
1,1602,1508,94,12,466,58
1,1678,2148,-470,-2,-28,61
-1,1343,1585,-242,-6,-173,60
-1,1344,1400,-56,-3,-394,80
-1,1513,1576,-63,-2,-19,50
1,1767,1681,86,5,183,65
-1,1351,1627,-276,2,-13,94
1,1607,1795,-188,6,439,95
-1,1552,1625,-73,-1,-369,108
-1,1472,1435,37,-9,-500,156
-1,1425,1744,-319,0,-194,104
1,1977,2002,-25,10,296,51
-1,1306,1607,-301,0,-51,82
1,1775,1466,309,0,40,71
-1,1622,1546,76,-1,-117,166
1,1556,1518,38,-1,44,71
1,1848,1501,347,1,48,49
1,1650,1449,201,2,30,49
1,1806,1945,-139,1,42,73
-1,1776,1650,126,0,-57,100
-1,1652,1897,-245,-2,-149,84
-1,1452,1335,117,-2,86,110
-1,1678,1492,186,-2,22,72
1,1668,1322,346,5,135,63
1,1767,1624,143,1,83,57
-1,1892,1799,93,3,91,68
1,1470,1429,41,4,96,47
-1,1761,1548,213,-1,-247,128
1,1611,1568,43,6,313,69
-1,1699,1711,-12,-3,-78,56
0,1915,1993,-78,0,-1,120
-1,1555,1505,50,-1,39,54
1,1617,1778,-161,0,-4,87
-1,1637,1762,-125,-2,-21,86
1,1255,1191,64,-2,-77,55
-1,1657,1800,-143,0,-6,54
1,1515,1310,205,-1,10,57
-1,1661,1721,-60,-1,179,88
1,1902,1648,254,0,152,85
1,1426,1428,-2,-2,39,96
0,1432,1535,-103,-3,-19,95
-1,1607,1801,-194,-2,-84,70
-1,1349,1338,11,-1,-63,74
1,1462,992,470,7,135,45
1,1865,1852,13,-3,18,55
1,1610,1460,150,7,143,47
1,1654,1275,379,8,80,43
1,1747,1644,103,-1,10,65
1,1808,1878,-70,1,104,95
-1,1613,1723,-110,-2,-46,60
0,1626,1754,-128,-3,152,123
-1,1492,1627,-135,6,-93,70
0,1351,1362,-11,-3,303,142
-1,1863,1869,-6,0,-52,74
-1,1297,1406,-109,-3,-193,68
1,1492,1656,-164,1,141,97
-1,1778,1508,270,-4,-218,58
1,1553,1615,-62,5,367,101
1,1565,1740,-175,2,157,85
-1,1862,1619,243,3,-27,68
-1,1517,1482,35,-11,-550,76
1,1633,988,645,4,208,53
1,1640,1509,131,-3,-133,73
-1,1386,1484,-98,-4,-235,66
-1,1636,1844,-208,-1,-39,44
-1,1423,1796,-373,-1,22,94
1,1724,1500,224,18,364,41
1,1731,1838,-107,-3,-61,53
-1,1611,1589,22,1,70,114
-1,1650,1881,-231,-6,-245,74
1,1517,1421,96,1,84,109
1,1501,1647,-146,7,388,59
1,1335,1380,-45,-1,-11,63
-1,1453,1515,-62,-3,-53,52
1,1634,1485,149,-9,132,95
1,1567,1537,30,0,-134,109
1,1652,1820,-168,-5,-89,45
-1,1746,1791,-45,0,-224,146
-1,1631,1517,114,-7,-214,52
-1,1865,1822,43,-1,-23,70
-1,1520,1560,-40,0,4,56
1,1500,1449,51,1,14,49
-1,1655,1760,-105,-1,-47,90
-1,1513,1478,35,-8,-207,60
-1,1532,1616,-84,-1,-23,58
1,1646,1822,-176,-1,2,91
1,1753,1545,208,-3,29,49
1,1817,1601,216,0,-13,49
-1,1325,1500,-175,-4,-138,50
-1,1556,1562,-6,-4,-58,56
1,1721,1582,139,0,310,137
1,1546,1558,-12,4,329,75
-1,1570,1349,221,3,75,52
-1,1360,1414,-54,-20,-392,44
1,1907,1737,170,0,49,65
1,1537,1610,-73,0,-10,47
1,1880,1852,28,0,17,43
-1,1796,1800,-4,0,-88,84
1,1288,1260,28,-6,-382,81
1,1596,1551,45,-1,-120,81
1,1770,1763,7,2,116,83
-1,1755,1718,37,1,-67,66
-1,1803,1736,67,0,-29,98
1,1586,1421,165,-1,-45,45
-1,1378,1598,-220,-1,-359,110
1,1662,1736,-74,1,104,68
1,1541,1606,-65,-3,11,51
-1,1526,1430,96,-5,-150,64
1,1638,1462,176,0,55,117
1,1587,1202,385,11,26,41
1,1671,1373,298,15,1425,93
1,1705,1734,-29,1,28,49
1,1350,1334,16,3,167,56
-1,1959,1805,154,-1,-75,116
1,1730,1545,185,0,543,101
-1,1549,1481,68,7,263,52
-1,1592,1554,38,1,-14,102
1,1319,1235,84,0,-8,61
1,1702,1561,141,3,229,108
-1,1436,1768,-332,-7,-318,68
-1,1495,1605,-110,-1,-195,78
-1,1618,1554,64,0,-17,44
1,1525,1412,113,6,127,49
1,1914,1567,347,1,-122,93
-1,1799,1817,-18,-1,-50,76
-1,1187,1451,-264,-7,-916,100
1,1640,1780,-140,1,21,63
0,1723,1675,48,-3,2,123
1,1891,1819,72,0,-138,99
-1,1333,1736,-403,-18,-685,48
-1,1593,1644,-51,0,-55,82
-1,1750,1578,172,0,-29,60
-1,1575,1729,-154,0,-23,64
-1,1631,1768,-137,2,31,48
1,1602,1566,36,0,-43,103
1,1799,1558,241,2,58,51
1,1821,1943,-122,0,92,103
-1,1364,1441,-77,-1,57,62
1,1564,1414,150,1,299,123
1,1932,1512,420,-5,-79,51
-1,1485,1491,-6,-6,-126,56
1,1775,1624,151,1,155,85
1,1570,1554,16,1,194,91
1,1613,1830,-217,2,110,99
-1,1935,1365,570,0,-11,46
-1,1617,1782,-165,0,20,100
-1,1713,1687,26,1,-16,72
1,1788,1789,-1,0,2,55
-1,1437,1143,294,0,31,52
0,1689,1805,-116,-1,44,137
1,1389,1135,254,-5,-35,51
-1,1364,1545,-181,2,49,68
1,1595,1378,217,-3,18,43
0,1771,1891,-120,-3,20,87
-1,1444,1655,-211,-2,-47,56
-1,1677,1721,-44,-5,-278,73
1,1739,1310,429,5,238,45
-1,1512,1875,-363,-5,-70,48
1,2013,1842,171,2,59,65
1,1401,1909,-508,-8,91,69
1,1788,1611,177,4,155,69
-1,1184,1564,-380,-1,49,70
-1,1590,1500,90,-4,-512,100
-1,1320,1786,-466,0,-4,52
-1,1373,1601,-228,-1,-11,46
1,1884,1437,447,0,15,61
-1,1688,1700,-12,0,6,42
-1,1502,1564,-62,0,-156,72
1,1464,1433,31,-1,18,57
1,1543,1580,-37,-1,-75,111
1,1537,1553,-16,0,51,109
1,1314,1484,-170,-9,0,61
1,1809,1129,680,5,206,53
-1,1393,1660,-267,0,-95,86
-1,1432,1673,-241,-2,-119,64
1,1634,1532,102,8,145,45
1,1467,1422,45,-1,-1399,160
1,1565,1567,-2,0,412,117
-1,1677,1733,-56,-2,-41,54
1,1368,1602,-234,0,183,99
-1,1656,1730,-74,1,9,54
1,1709,1406,303,3,125,145
-1,1750,1269,481,-2,-16,41
1,1722,1553,169,1,867,187
-1,1886,2019,-133,0,-6,48
-1,1417,1441,-24,0,-14,92
-1,1888,2026,-138,0,36,66
1,1759,1668,91,2,98,53
-1,1667,1737,-70,0,-33,52
-1,1701,1497,204,1,-22,66
1,1579,1422,157,2,101,43
1,1574,1408,166,6,96,41
-1,1693,1746,-53,-1,-73,78
1,2132,2026,106,0,21,59
-1,1500,1414,86,-9,-200,56
1,1750,1849,-99,0,425,141
-1,1443,1500,-57,-3,-170,66
-1,1836,1833,3,0,-4,50
1,1747,1749,-2,0,10,57
1,1556,1442,114,-4,-12,53
-1,1331,1466,-135,-2,-127,70
1,1658,1710,-52,0,18,65
1,1706,1788,-82,1,85,51
1,1659,1611,48,2,397,87
1,1546,1531,15,1,39,71
1,1630,1327,303,-1,-36,75
-1,1568,1657,-89,0,-42,68
-1,1684,1500,184,0,-22,102
1,1606,1220,386,6,305,57
-1,1483,1367,116,-2,-99,62
-1,1665,1778,-113,0,-5,72
-1,1702,1653,49,0,-69,102
-1,1799,1810,-11,-7,-448,80
1,1506,1467,39,5,349,87
1,1725,1580,145,-1,82,132
-1,1721,1772,-51,1,53,76
-1,1524,1615,-91,-1,-23,58
1,1520,1557,-37,6,312,73
1,1498,1846,-348,-1,-115,85
1,1626,1487,139,2,186,98
1,1500,1358,142,10,378,55
-1,1697,1671,26,2,59,66
1,1687,1804,-117,0,47,113
0,1501,1406,95,-3,133,111
-1,1210,1649,-439,-14,-862,72
-1,1399,1775,-376,2,198,66
-1,1725,1647,78,0,40,64
1,1545,1533,12,0,535,121
1,1424,1386,38,0,68,57
1,1436,1459,-23,3,949,165
-1,1347,1552,-205,-2,-576,123
-1,1634,1927,-293,-5,-285,116
1,1789,1783,6,0,22,57
-1,1357,1393,-36,-5,-174,57
1,1500,1536,-36,8,91,41
-1,1739,1665,74,0,9,64
1,1665,1351,314,1,39,49
-1,1768,1600,168,-2,119,98
-1,1581,1583,-2,-4,-77,70
1,1182,1352,-170,-6,-153,53
-1,1999,1771,228,-4,-147,80
-1,1543,1534,9,0,-167,124
-1,1664,1791,-127,-1,-270,80
-1,1770,1630,140,0,-49,114
-1,1731,1760,-29,-4,-99,55
1,1674,1370,304,1,2,71
1,1654,1322,332,-7,43,63
-1,1807,2161,-354,-3,40,94
-1,1931,1824,107,-2,59,82
-1,1777,1500,277,-1,-29,54
-1,1342,1630,-288,-1,-114,72
0,1236,1157,79,9,1548,122
-1,1409,1498,-89,-5,-242,74
-1,1743,1721,22,-1,-68,74
1,2165,1804,361,2,85,75
-1,1529,1576,-47,-3,-46,42
1,1560,1741,-181,-1,-9,53
1,1651,1421,230,3,63,59
1,1308,1352,-44,7,218,51
1,1662,1524,138,0,45,59
0,1752,1616,136,2,233,99
1,1455,1452,3,0,241,183
1,1677,1595,82,1,34,87
1,1801,2167,-366,2,73,61
-1,1411,1455,-44,-5,-47,80
-1,1750,1712,38,-1,-26,46
-1,1673,1317,356,0,-111,106
-1,1346,1337,9,-5,3,68
1,2145,1825,320,2,-76,79
-1,1546,1336,210,-8,-204,46
0,1416,1656,-240,0,11,101
1,1342,1372,-30,-2,-76,51
1,1793,1726,67,-3,0,71
-1,1539,1512,27,-10,-811,78
1,1790,1982,-192,-1,-7,63
1,1755,1840,-85,-1,-26,61
-1,1821,2148,-327,-3,-955,108
1,1416,1403,13,9,453,75
-1,1732,1730,2,2,82,70
-1,1572,1916,-344,-1,-231,120
1,1723,1687,36,0,260,69
-1,1591,1638,-47,-1,-78,56
-1,1673,1992,-319,4,132,74
-1,1588,1522,66,-4,-222,78
-1,1575,1608,-33,0,7,68
-1,1533,1742,-209,2,102,64
1,1536,1614,-78,-1,82,97
-1,1589,1565,24,-5,-371,66
0,1751,1789,-38,0,46,88
1,1763,1745,18,0,68,75
-1,1182,1359,-177,-12,-474,64
1,1749,1500,249,3,223,97
-1,1625,1706,-81,0,-84,86
1,1486,1424,62,0,86,97
-1,1297,1512,-215,0,-37,69
1,1634,1519,115,0,-11,79
-1,1952,2045,-93,-1,-71,60
1,1494,1585,-91,1,101,53
0,1867,1732,135,1,198,158
1,1311,1098,213,0,60,73
-1,1382,1436,-54,-1,-60,64
-1,1787,1727,60,1,-567,192
1,1316,1247,69,6,893,93
-1,1677,1733,-56,0,-89,110
1,1582,1297,285,0,165,79
-1,1734,1772,-38,-7,-329,80
-1,1497,1706,-209,-3,-207,60
1,1521,1417,104,-1,225,85
-1,1549,1756,-207,0,-208,82
-1,1858,1836,22,0,38,56
1,1568,1435,133,1,130,67
1,1564,1585,-21,8,310,61
-1,1581,1743,-162,-1,-166,116
1,1550,1759,-209,-1,-91,77
1,1748,1528,220,-2,-57,45
1,1618,1772,-154,-2,-27,43
-1,1731,1720,11,0,6,44
1,1846,1848,-2,4,273,75
1,1810,1518,292,3,237,103
1,2062,1936,126,0,-2,51
1,1727,1665,62,0,-2,53
-1,1533,1507,26,-3,-37,126
1,1540,1575,-35,1,10,43
-1,1630,1591,39,-1,-9,56
1,1782,1725,57,2,39,43
-1,1576,1400,176,1,81,68
-1,1773,1743,30,0,7,62
-1,1298,1841,-543,-2,-615,78
1,1528,1184,344,2,104,61
-1,1740,1668,72,1,-50,90
1,1725,1351,374,6,78,41
-1,1374,1577,-203,-6,-127,60
-1,1500,1534,-34,-4,-565,106
-1,1631,1756,-125,-1,-87,86
1,1317,1365,-48,1,190,79
-1,1592,1596,-4,-1,30,59
-1,1428,1489,-61,-5,-204,62
-1,1670,2039,-369,-2,-234,102
-1,1510,1596,-86,0,-180,96
1,1836,1857,-21,0,26,67
1,1563,1521,42,2,347,79
1,1512,1275,237,3,281,72
-1,1516,1595,-79,1,200,90
-1,1563,1557,6,-1,-192,116
-1,1715,1790,-75,0,-19,84
1,1841,1963,-122,3,74,55
1,1708,1513,195,5,86,47
-1,1577,1741,-164,0,-62,118
-1,1236,1326,-90,-11,-72,42
-1,1476,1322,154,4,80,58
-1,1560,1656,-96,0,-1,52
1,1736,1665,71,-2,128,75
-1,1377,1149,228,-3,-293,92
0,1659,1756,-97,1,99,128
-1,1337,1727,-390,0,-11,90
1,1930,1688,242,6,154,49
-1,1413,1424,-11,-2,-33,42
1,1331,1500,-169,5,131,53
1,1495,1359,136,0,84,63
-1,1531,1400,131,-4,-94,58
-1,1553,1573,-20,1,29,144
-1,1597,1753,-156,-1,-44,82
1,1716,1825,-109,0,117,63
1,1790,1389,401,2,318,81
-1,1935,1684,251,-7,-276,70
1,1560,1503,57,0,-6,57
1,1604,1508,96,1,66,47
1,1842,1331,511,6,162,53
1,1919,1532,387,4,388,93
-1,1349,1500,-151,-5,-391,78
-1,1410,1513,-103,-4,-63,70
1,1877,1863,14,2,220,107
-1,1518,1492,26,1,71,54
1,1751,2007,-256,0,148,97
1,1616,1186,430,2,32,43
1,1547,1278,269,8,353,63
1,1448,1516,-68,-2,66,87
1,1342,1502,-160,1,66,59
-1,1719,1822,-103,0,-23,70
1,1845,1681,164,1,170,111
-1,2132,2069,63,-3,-17,52
1,1655,1745,-90,0,50,59
-1,1640,1582,58,-3,-9,54
-1,1149,1349,-200,0,19,62
-1,1586,1715,-129,-2,-133,56
1,1853,1753,100,1,26,83
1,1821,1572,249,0,-15,53
1,1844,1394,450,1,32,51
0,1319,1400,-81,-4,-649,120
1,1500,1543,-43,0,8,49
0,1583,1678,-95,0,-4,64
1,1593,1567,26,0,43,89
-1,1240,1551,-311,-6,-292,100
-1,1516,1396,120,-2,-99,55
1,2083,2118,-35,-1,-55,53
1,1760,1707,53,0,128,67
1,1730,1324,406,0,45,57
-1,1848,1949,-101,0,56,70
-1,1638,1578,60,-1,-99,69
-1,1675,1852,-177,0,-92,106
-1,1503,1487,16,-1,-53,44
-1,1423,1178,245,-3,-296,76
-1,1666,1586,80,-1,-14,48
1,1854,1730,124,4,12,43
1,1470,1154,316,2,138,65
1,1471,1504,-33,-2,17,53
0,1649,1670,-21,1,211,153
-1,1561,1274,287,5,90,52
1,1509,1618,-109,3,705,145
0,1500,1845,-345,0,-2973,176
1,1512,1602,-90,0,37,93
1,1407,1486,-79,1,39,55
0,1771,1744,27,0,80,92
0,2106,2096,10,0,9,73
1,1465,1524,-59,0,-14,69
1,1502,1426,76,6,308,69
1,1858,1669,189,-2,-43,59
1,1729,1689,40,0,142,97
1,1468,1497,-29,2,280,81
-1,1841,1893,-52,0,-484,98
-1,1599,1653,-54,0,30,68
1,1282,1847,-565,1,29,53
1,1492,1791,-299,0,102,149
-1,1529,1511,18,-2,-63,50
-1,1763,1861,-98,1,-20,74
1,1711,1604,107,5,122,47
-1,1765,1689,76,0,90,94
-1,1397,1701,-304,-1,-87,56
1,1201,1280,-79,-4,-149,67
-1,1313,1732,-419,-2,-77,64
1,1321,1486,-165,0,363,147
1,1732,1718,14,-1,-22,47
-1,1663,1864,-201,0,-51,98
-1,1624,1618,6,0,-38,116
-1,1402,1523,-121,-7,-681,82
1,1555,1212,343,4,121,47
-1,1500,1539,-39,-6,-35,42
1,1922,1500,422,0,320,89
1,1354,1150,204,5,94,43
1,1591,1534,57,0,56,103
-1,1411,1300,111,-4,-35,40
-1,1624,1472,152,0,8,44
1,1527,1535,-8,2,856,115
1,1662,1590,72,1,274,127
1,1510,1319,191,2,55,67
-1,1541,1745,-204,0,87,88
1,1475,1581,-106,1,358,107
-1,1626,1500,126,0,-130,108
1,1511,1273,238,6,128,51
-1,1832,2085,-253,-3,-116,82
1,1491,1297,194,8,114,42
-1,1872,1575,297,0,-379,118
-1,1903,1831,72,-3,-18,42
0,1572,1596,-24,1,658,112
1,1719,1805,-86,1,85,69
-1,1191,1559,-368,-5,-99,86
-1,1869,1755,114,0,-78,74
1,1869,1658,211,4,77,46
1,1394,1371,23,-2,-86,133
-1,1725,1726,-1,-1,-144,66
-1,1525,1518,7,0,-76,70
1,1669,1649,20,-5,-59,71
-1,1335,1338,-3,0,-15,64
1,1314,1209,105,13,906,79
1,1568,1741,-173,1,134,57
1,1702,1752,-50,0,61,65
-1,1707,1442,265,-1,-184,90
1,1874,1415,459,4,261,83
-1,1516,1647,-131,0,-249,94
-1,1745,1671,74,-2,-553,136
1,1743,1644,99,-4,79,103
1,1285,1342,-57,0,175,71
1,2116,1855,261,-3,-102,51
-1,1615,1824,-209,-1,-184,100
1,1925,1533,392,0,128,53
1,1739,1704,35,2,66,47
1,1291,1225,66,8,83,151
-1,1497,1362,135,-4,-128,48
-1,1602,1543,59,-1,-135,110
-1,1529,1514,15,0,149,93
1,1616,1316,300,2,189,68
1,1546,1343,203,6,723,95
-1,1510,1442,68,-1,16,78
-1,1395,1403,-8,-6,6,40
1,1603,1750,-147,0,59,97
1,1337,1288,49,2,655,127
-1,1488,1567,-79,-2,-58,60
-1,1603,1853,-250,1,6,76
-1,1519,1497,22,-1,-2,52
-1,1383,1765,-382,-3,-185,74
1,1740,1714,26,1,57,55
1,1492,1297,195,5,201,79
1,1562,1524,38,0,12,53
1,1737,1831,-94,-1,69,77
-1,1523,1530,-7,-3,-310,108
1,1472,1473,-1,2,184,81
1,1576,1480,96,-2,-1,73
1,1598,1398,200,-4,-123,125
1,1448,1407,41,-3,138,109
-1,1511,1928,-417,0,-9,94
1,1578,1312,266,2,171,69
-1,1851,2121,-270,0,-23,90
1,1639,1456,183,15,837,77
1,1620,1410,210,2,-8,107
1,1714,1364,350,-1,45,75
1,1857,1599,258,0,13,53
1,1815,1935,-120,5,550,97
-1,1349,1410,-61,-9,-437,76
-1,1328,1518,-190,-3,-339,124
0,1550,1473,77,1,14,114
-1,1669,1684,-15,0,0,90
-1,1704,1750,-46,-2,-201,128
-1,1861,2089,-228,-4,-76,74
1,1515,1413,102,2,-100,59
-1,1627,1719,-92,2,111,60
-1,1595,1786,-191,-2,25,60
-1,1722,1584,138,2,-101,86
-1,1780,2092,-312,0,-18,56
-1,1717,1361,356,-4,37,40
-1,1710,1680,30,0,16,66
0,1473,1569,-96,3,441,115
-1,1735,1612,123,-4,0,52
1,1594,1472,122,3,106,57
1,1411,1407,4,8,187,55
1,2094,1856,238,-2,301,119
1,1859,1731,128,6,309,81
-1,1636,1646,-10,0,-10,58
1,1389,1412,-23,1,11,44
-1,1392,1604,-212,-6,-108,88
1,1671,1688,-17,0,4,63
1,1751,1736,15,3,68,49
-1,1321,1404,-83,-3,-158,62
1,1768,1378,390,5,266,71
1,1466,1357,109,-1,32,59
-1,1281,1552,-271,-4,-148,106
-1,1573,1707,-134,-2,-204,78
1,1346,1442,-96,0,336,107
1,1308,1144,164,2,143,69
-1,1582,1602,-20,1,-29,100
-1,1615,1658,-43,0,-152,74
-1,2125,2096,29,0,-37,98
1,1508,1390,118,-3,-9,115
-1,1625,1746,-121,-2,-36,118
-1,1695,1645,50,0,8,82
-1,1514,1691,-177,-7,-124,46
-1,1445,1508,-63,-2,-104,66
1,1213,1301,-88,0,260,99
1,1609,1387,222,5,105,55
0,1814,1751,63,2,219,104
-1,1612,1529,83,-3,-77,74
-1,1724,1867,-143,-2,-155,92
-1,1536,1413,123,1,7,60
-1,1312,1413,-101,-6,-91,44
1,1618,1561,57,-4,115,87
-1,1540,1467,73,1,-11,120
-1,1459,1830,-371,-1,-7,48
1,1716,1564,152,4,248,83
-1,1471,1432,39,0,-4,48
-1,1397,1340,57,0,-159,132
1,1467,1174,293,9,407,55
1,1705,1540,165,-1,66,131
-1,1554,1632,-78,-1,-571,142
-1,1428,1360,68,-2,-116,58
0,1382,1614,-232,-1,-151,113
-1,1688,1626,62,-3,-83,95
1,1583,1570,13,-1,5,43
1,1847,1845,2,0,92,97
1,1494,1559,-65,-1,98,77
-1,1303,1209,94,1,147,56
1,1571,1877,-306,8,220,55
-1,1873,1717,156,1,47,88
1,1520,1462,58,-1,-48,61
1,1382,1556,-174,3,100,53
-1,1500,1625,-125,-11,-1111,102
1,1600,1703,-103,1,151,61
1,1614,1605,9,-1,-3,79
-1,1401,1596,-195,-1,-67,51
-1,1476,1493,-17,-8,-64,44
1,1436,1453,-17,-4,-36,71
1,1470,1494,-24,-1,36,59
1,1618,1691,-73,0,34,75
-1,2112,2099,13,-3,-12,88
-1,1376,1471,-95,-13,-123,40
-1,1584,1712,-128,-5,-290,60
-1,1500,1435,65,0,-2,48
-1,1758,1969,-211,0,-13,42
-1,1771,1765,6,-1,-51,64
-1,1603,1634,-31,0,127,174
-1,1636,1635,1,0,-30,122
-1,1516,1367,149,1,-17,58
1,1525,1343,182,5,292,75
-1,1618,1669,-51,-3,-51,40
1,1434,1517,-83,0,65,107
-1,1603,1489,114,-9,-182,68
-1,1583,1859,-276,-5,-47,48
-1,1516,1468,48,-1,-102,74
0,1443,1311,132,5,317,69
-1,1343,1520,-177,-1,-56,83
-1,1704,1679,25,-3,-534,102
1,1825,1767,58,-5,481,97
1,1423,1495,-72,13,337,51
1,1878,1714,164,2,307,77
0,1649,1423,226,0,-11,123
1,1677,1587,90,0,-2,63
1,1660,1830,-170,0,113,65
1,1722,1708,14,0,19,47
1,1510,1425,85,2,54,51
-1,1494,1400,94,-6,33,40
-1,1547,1439,108,-4,-287,88
-1,1644,1769,-125,-8,-275,70
-1,1736,2020,-284,-1,-18,44
1,1919,1569,350,1,99,95
1,1848,1847,1,3,13,51
1,1384,1250,134,-1,-7,51
1,1809,1846,-37,5,335,149
-1,1792,1676,116,0,-66,78
-1,1442,1625,-183,-1,-61,81
1,1697,1732,-35,-1,-15,57
0,1575,1624,-49,1,162,114
-1,1432,1489,-57,-2,110,62
1,1836,1860,-24,-5,-138,53
0,1504,1515,-11,-3,-21,131
-1,1592,1678,-86,-2,-31,56
-1,1524,1532,-8,-1,-68,62
1,1504,1548,-44,4,18,41
1,1354,1360,-6,1,-18,81
1,1777,1361,416,17,303,49
1,1686,1332,354,-4,-43,43
1,1657,1657,0,2,375,121
-1,1669,1690,-21,0,-88,82
1,1776,1637,139,6,204,69
-1,1571,1494,77,2,297,94
1,1811,1336,475,3,121,57
1,1720,1709,11,1,175,85
1,1603,1526,77,3,348,85
1,1690,1759,-69,3,366,95
-1,1469,1555,-86,2,54,52
-1,1139,1408,-269,0,-273,92
-1,1531,1561,-30,0,-113,52
-1,1965,1808,157,-5,-61,44
1,1755,1663,92,-3,149,103
-1,1436,1523,-87,-4,-19,44
-1,1500,1337,163,-2,-40,42
1,1595,1548,47,1,49,43
-1,1441,1436,5,-4,-564,96
-1,1719,1692,27,-3,-548,104
-1,1332,1306,26,11,451,104
-1,1717,1645,72,0,-14,64
1,1687,1584,103,0,59,45
1,1707,1636,71,3,37,41
0,1382,1379,3,4,141,93
-1,1500,1613,-113,-6,-232,54
-1,1736,1922,-186,1,-120,68
-1,1521,1564,-43,-1,-55,56
-1,1329,1334,-5,-1,68,76
-1,1641,1830,-189,1,50,94
-1,1570,1640,-70,-2,-115,52
1,1491,1323,168,-5,-95,69
1,1715,1706,9,1,98,127
0,1834,1822,12,-8,-49,128
1,1699,1730,-31,-3,8,81
1,1560,1535,25,1,144,69
-1,1396,1192,204,0,60,86
-1,1519,1684,-165,-1,-23,47
1,1500,1336,164,7,329,51
-1,1688,1500,188,0,-96,92
-1,1337,1630,-293,-6,-656,86
1,1658,1415,243,3,138,65
1,1619,1549,70,6,357,85
1,1427,1503,-76,2,130,77
1,1457,1369,88,0,69,67
-1,1389,1692,-303,-2,-351,86
1,1847,1836,11,0,15,57
1,1732,1863,-131,0,87,107
-1,1498,1551,-53,-2,-51,46
-1,1532,1452,80,-6,-135,60
1,1825,1858,-33,-4,-96,47
-1,1514,1504,10,-9,-231,48
-1,1654,1604,50,0,-57,76
1,1415,1538,-123,1,-53,73
1,1558,1631,-73,0,117,89
-1,1622,1577,45,1,69,60
1,1532,1517,15,-1,-20,85
1,1609,1330,279,1,43,73
-1,1166,1430,-264,-9,-197,52
1,1506,1532,-26,-1,301,121
-1,1488,1529,-41,-3,-198,70
-1,1500,1837,-337,-1,-23,64
-1,1846,1930,-84,-6,-345,82
-1,1576,1711,-135,0,-37,104
-1,1643,1655,-12,-1,-335,106
1,1735,1619,116,0,102,65
1,1849,1930,-81,-2,-56,105
1,1707,1738,-31,3,92,57
-1,1500,1500,0,0,13,42
1,1938,1838,100,-1,-33,63
-1,1823,1834,-11,0,-78,93
1,1496,1160,336,4,79,43
-1,1351,1264,87,-8,-626,90
-1,1348,1578,-230,-5,-153,56
-1,1478,1544,-66,-2,-95,68
-1,1830,1946,-116,-1,-210,82
-1,1360,1465,-105,-3,310,92
1,1743,1610,133,-1,-18,51
-1,1725,1857,-132,-5,-3,110
-1,1765,1682,83,-2,-31,54
-1,1757,1927,-170,0,-2,66
-1,1633,1556,77,0,56,82
1,1316,1185,131,-2,-18,57
-1,1685,1663,22,-3,-246,100
1,1756,1628,128,1,35,47
-1,1435,1151,284,0,-27,66
1,1617,1501,116,-3,71,107
1,1129,1416,-287,0,71,45
1,1660,1358,302,2,63,53
1,1396,1382,14,1,25,43
-1,1953,1823,130,-1,23,86
1,1716,1749,-33,0,32,61
1,1704,1659,45,1,63,73
-1,1609,1610,-1,8,142,76
1,1553,1469,84,1,54,71
1,1596,1718,-122,5,75,45
1,1748,1750,-2,0,39,69
-1,1727,1719,8,-5,-36,86
1,1617,1571,46,-3,60,57
1,1782,1650,132,1,41,45
0,1917,2051,-134,-4,-338,127
-1,1208,1364,-156,-4,-425,144
1,1373,1009,364,6,128,43
-1,1837,1938,-101,-5,-19,42
1,1346,1411,-65,-5,-71,45
-1,1354,1630,-276,3,-77,54
1,1339,1313,26,12,1002,79
1,1567,1645,-78,1,40,99
0,1946,2152,-206,0,-418,109
1,1460,1562,-102,2,67,45
1,1739,1602,137,-1,-38,67
1,1777,1322,455,4,228,69
1,1623,1700,-77,1,59,141
1,1703,1611,92,-1,-15,49
-1,1800,1802,-2,-2,-95,54
1,1811,1885,-74,0,13,61
-1,1617,1640,-23,-2,-309,78
1,1697,1500,197,0,2,71
1,1421,1197,224,6,246,61
1,2145,1952,193,0,214,69
1,1547,1475,72,0,136,74
-1,1790,1570,220,2,216,84
0,1397,1152,245,5,262,118
1,1633,1759,-126,-2,-201,103
1,1514,1453,61,0,-3,53
-1,1286,1360,-74,0,-6,54
1,1946,2152,-206,-3,-19,67
-1,1524,1476,48,1,-272,122
1,1565,1732,-167,0,3,73
0,1561,1627,-66,1,31,97
-1,1524,1581,-57,0,-123,70
1,1734,1674,60,1,43,61
1,1441,1225,216,3,296,80
1,1695,1751,-56,1,216,107
1,1776,1577,199,3,173,69
-1,1603,1684,-81,-2,-41,82
1,1593,1352,241,-3,105,67
1,1466,1556,-90,-1,283,111
-1,1749,1848,-99,0,-15,88
1,1825,1921,-96,0,-47,101
0,2132,1963,169,-2,-183,103
-1,1525,1559,-34,0,-119,68
-1,1500,1548,-48,3,-300,77
1,1621,1101,520,4,591,111
-1,1429,1674,-245,-1,-42,68
-1,1744,1730,14,0,-41,56
1,1864,1744,120,0,-56,83
-1,1320,1234,86,1,-47,108
-1,1293,1479,-186,5,121,160
1,1466,1371,95,7,624,103
-1,1778,1716,62,-8,-136,49
1,1968,2126,-158,-3,-82,77
-1,1500,1824,-324,-4,-140,62
1,1542,1480,62,0,318,97
1,1782,1572,210,-1,95,71
-1,1494,1633,-139,0,-58,74
-1,1950,2047,-97,-3,43,74
-1,1664,1632,32,-9,-48,44
1,2108,1983,125,1,367,111
-1,1779,1595,184,-3,-151,60
-1,1490,1645,-155,-1,-134,54
1,1369,1277,92,2,-5,49
1,1637,1679,-42,3,331,71
1,1769,1625,144,1,33,107
0,1221,1348,-127,-3,-255,85
1,1514,1560,-46,1,-45,59
-1,1500,1411,89,-25,-459,42
1,1837,1730,107,0,5,67
1,1659,1526,133,2,-133,79
1,1625,1563,62,4,77,45
1,1839,1569,270,-5,36,75
1,1764,1840,-76,0,39,121
1,1489,1574,-85,0,-223,101
-1,1501,1622,-121,2,5,50
1,1746,1872,-126,1,460,105
-1,1976,2116,-140,-1,-164,98
1,1598,1554,44,2,89,75
-1,1737,1737,0,1,-32,110
1,1582,1711,-129,0,153,89
1,1378,1305,73,4,184,80
-1,1304,1422,-118,-3,-137,66
1,1512,1649,-137,-1,17,53
-1,1378,1506,-128,4,93,54
1,2124,1969,155,0,69,91
1,1872,1565,307,0,196,75
1,1824,1278,546,4,218,65
-1,1609,1636,-27,-4,-69,48
-1,1421,1453,-32,1,-17,54
1,1554,1634,-80,0,10,45
1,1917,1860,57,1,294,87
-1,1160,1390,-230,-2,-44,50
-1,1720,1845,-125,1,18,50
1,1630,1494,136,-1,18,45
-1,1612,1672,-60,1,-107,56
-1,1761,1857,-96,-2,-70,74
0,1650,1565,85,0,-8,71
-1,1942,1828,114,-10,-30,40
1,1626,1500,126,3,56,47
0,1568,1398,170,-6,-83,69
-1,1963,2132,-169,-4,-43,44
1,1787,1818,-31,0,127,69
1,1557,1652,-95,0,9,77
-1,1598,1722,-124,0,-108,100
1,1826,1779,47,-1,-75,81
-1,1878,1845,33,1,48,70
-1,1390,1406,-16,2,75,94
1,1338,1218,120,-2,12,83
-1,2120,1957,163,-5,-795,122
-1,1182,1523,-341,-3,-151,58
-1,1704,1500,204,-12,-662,86
-1,1154,1157,-3,0,-25,62
1,1543,1487,56,-3,-10,43
-1,1621,1568,53,-3,-193,78
-1,1099,1622,-523,-20,-607,58
1,1706,1600,106,1,32,43
1,1769,1836,-67,1,38,55
0,1972,2100,-128,1,132,128
-1,1269,1218,51,-4,-98,50
1,1415,1492,-77,2,83,59
-1,1851,1926,-75,-6,-206,96
1,1750,1647,103,0,-15,85
1,1296,1366,-70,1,-132,77
-1,1597,1698,-101,-2,80,102
1,1475,1373,102,10,103,41
1,1170,1134,36,-2,36,63
1,1453,1353,100,10,36,41
-1,1527,1647,-120,0,-82,90
-1,1609,1637,-28,-12,-290,46
-1,1592,1752,-160,1,52,76
-1,1264,1826,-562,-13,-380,48
1,1752,1693,59,-1,-87,89
-1,1651,1856,-205,-3,-46,64
1,1759,1469,290,1,725,133
1,1928,1822,106,-3,-51,71
1,1643,1446,197,-1,-19,57
-1,1844,1783,61,3,256,120
-1,1442,1411,31,-6,-210,140
1,1410,1546,-136,6,421,97
1,1782,1788,-6,0,32,87
1,1550,1500,50,13,595,59
1,1580,1608,-28,0,13,167
1,1935,1842,93,0,30,55
-1,1395,1566,-171,-7,-276,68
-1,1762,2018,-256,-3,-139,76
-1,1680,1491,189,0,-63,78
-1,1713,1727,-14,-1,-130,100
-1,1834,2120,-286,-4,-151,84
1,1834,1943,-109,-2,-118,81
1,1192,1102,90,5,100,41
-1,1466,1552,-86,-11,-491,62
1,1683,1857,-174,4,96,93
-1,1523,1479,44,3,95,68
-1,1648,1602,46,-6,-181,108
-1,1784,1585,199,-7,-343,60
1,1865,1590,275,-7,24,67
-1,1096,1624,-528,-5,-451,66
-1,1856,1814,42,-2,3,54
1,1543,1608,-65,0,134,83
-1,1558,1840,-282,-1,-26,48
1,1509,1545,-36,-6,27,107
-1,1256,1468,-212,-2,-81,59
1,1880,1487,393,4,230,79
-1,1272,1427,-155,-7,-334,78
1,1541,1612,-71,1,213,117
-1,1377,1633,-256,-2,-28,40
-1,1088,1365,-277,-10,-202,45
1,1862,1646,216,1,48,118
-1,1351,1345,6,-3,-232,68
1,1531,1303,228,-1,29,57
-1,1595,1634,-39,-1,66,82
-1,1798,1935,-137,-1,-42,82
-1,1481,1492,-11,-4,-141,56
1,1370,1082,288,6,152,51
-1,1929,1848,81,-1,-29,60
-1,2028,1853,175,-4,-30,56
-1,1130,1124,6,-4,-113,66
1,1398,1388,10,8,338,61
0,1434,1530,-96,8,290,90
1,1634,1749,-115,-2,-17,63
0,1838,1827,11,0,7,72
-1,1265,1615,-350,-5,-630,84
-1,1560,1789,-229,-5,-145,58
-1,1870,2012,-142,-5,-2,40
1,1572,1431,141,5,564,81
1,1831,1589,242,3,75,43
1,1625,1095,530,12,556,67
-1,1802,1654,148,3,101,80
1,1987,1500,487,5,283,75
1,1699,1796,-97,-1,18,69
-1,1942,1827,115,1,79,80
1,1644,1314,330,-2,-60,73
1,1837,1861,-24,0,9,47
1,1838,2019,-181,1,-156,99
-1,1402,1491,-89,-2,-92,62
-1,1536,1533,3,5,88,42
-1,1110,1500,-390,3,150,54
-1,1869,1598,271,0,-683,204
-1,1461,1555,-94,2,-94,99
-1,1428,1476,-48,-2,92,60
1,1585,1836,-251,0,-8,69
1,1735,1649,86,-2,72,81
1,1789,1709,80,-1,-44,51
-1,1343,1602,-259,-7,-235,56
-1,1602,1714,-112,-5,-135,60
0,1674,1544,130,0,-14,157
1,1648,1736,-88,-2,-158,97
-1,1320,1473,-153,0,-507,128
1,1850,1854,-4,1,19,117
1,1552,1441,111,11,397,43
1,1551,1719,-168,-4,-60,47
1,1595,1557,38,0,-5,65
0,2070,2124,-54,0,-68,93
1,1105,1500,-395,18,806,59
-1,1238,1290,-52,-2,-60,64
-1,1093,1626,-533,-13,-655,64
1,1424,1579,-155,1,4,53
-1,1842,1738,104,-2,-91,76
-1,1703,1794,-91,-3,-58,50
1,1782,1712,70,3,132,59
1,1763,1635,128,-1,42,47
1,1438,1589,-151,1,145,101
-1,1429,1451,-22,-2,-241,124
-1,1367,1423,-56,-1,-89,102
-1,1667,1708,-41,-2,-1109,194
1,1525,1417,108,-2,-56,61
-1,1041,1125,-84,-4,-489,98
-1,1503,1506,-3,2,-55,122
1,1742,1765,-23,0,-15,81
-1,1662,1565,97,-3,-75,74
1,1507,1593,-86,-2,-53,67
-1,1490,1322,168,-5,-211,73
-1,1646,1640,6,0,-6,56
-1,1561,1801,-240,-3,-50,60
1,1742,1539,203,-1,24,49
-1,1757,1967,-210,0,-91,100
1,1627,1518,109,3,186,87
1,1614,1770,-156,-1,230,111
1,1704,1791,-87,0,35,67
-1,1604,1695,-91,-1,-383,116
1,1628,1092,536,4,277,58
1,1581,1452,129,1,91,53
-1,1493,1468,25,2,-213,120
1,1136,924,212,12,491,51
-1,1359,1666,-307,-3,-470,100
1,1534,1585,-51,2,98,57
-1,1789,1828,-39,-10,-325,62
-1,1789,1560,229,0,-63,78
1,1718,1650,68,1,82,56
1,1464,1460,4,2,14,43
-1,1456,1500,-44,0,33,66
-1,869,1144,-275,-31,-559,44
-1,1648,1715,-67,0,350,162
1,1729,1695,34,-2,-64,51
-1,1652,1634,18,-1,-68,52
1,1588,1574,14,1,203,135
1,1388,1500,-112,4,233,57
-1,1165,1302,-137,2,37,64
-1,1635,1727,-92,-9,-239,60
1,1150,834,316,10,1215,79
-1,1338,1830,-492,7,196,50
-1,1598,1748,-150,0,-81,98
-1,1752,1916,-164,1,47,54
-1,1570,1510,60,-3,1,70
0,1777,1717,60,-1,28,47
1,1735,1621,114,-3,65,81
-1,1435,1669,-234,0,36,74
1,1844,1242,602,4,153,57
1,1646,1640,6,1,1,57
1,1509,1337,172,3,44,42
-1,1431,1547,-116,-1,-22,56
0,1500,1590,-90,-2,95,128
0,1425,1596,-171,3,151,99
0,1540,1500,40,-1,-119,118
1,1500,1668,-168,7,664,85
1,1639,1472,167,0,109,69
-1,1635,1454,181,0,-22,58
1,1922,1746,176,3,106,61
1,1465,1464,1,0,53,63
1,1491,1682,-191,9,427,69
1,1828,1593,235,3,118,46
1,1160,789,371,13,455,51
1,1798,1555,243,4,139,55
1,1703,1596,107,2,201,83
-1,1349,1463,-114,0,-13,68
1,1510,1423,87,5,69,47
-1,1525,1620,-95,1,34,58
1,1719,1775,-56,1,-1,101
1,1786,1918,-132,0,11,71
1,1472,1754,-282,6,154,67
1,1630,1619,11,6,404,75
-1,1861,2056,-195,-1,-43,62
-1,1449,1550,-101,5,254,98
1,1615,1590,25,1,-7,43
-1,1576,1685,-109,-1,-118,66
-1,1598,1340,258,-2,-142,84
1,2009,1593,416,1,31,74
-1,1568,1568,0,0,2,60
-1,1629,1657,-28,0,-13,56
1,1555,1425,130,5,188,51
-1,1505,1637,-132,-1,-42,66
1,1671,1742,-71,1,48,71
1,1331,1515,-184,-1,43,67
1,1631,1638,-7,0,-14,116
1,1608,1524,84,-3,-110,55
-1,1850,2067,-217,-1,-102,72
-1,1341,1710,-369,-1,-215,114
-1,1579,1653,-74,-3,-145,50
1,1755,1525,230,3,333,79
-1,1928,1866,62,-7,-227,78
1,1427,1674,-247,0,64,67
-1,1722,1500,222,-3,-163,128
1,1667,1619,48,0,409,126
1,1672,1570,102,-6,44,41
-1,1440,1828,-388,-1,-132,96
1,1777,1599,178,1,101,79
-1,2072,1845,227,-2,-11,54
-1,1478,1481,-3,-3,-377,129
-1,1668,1722,-54,0,-5,52
1,1575,1904,-329,1,236,103
1,1879,1915,-36,0,36,101
1,1337,1437,-100,-6,-175,57
0,1740,1800,-60,0,-322,145
-1,1666,1531,135,-3,-96,84
-1,1563,1605,-42,1,-85,78
-1,1457,1562,-105,-2,-236,132
1,1722,1508,214,-2,-23,43
-1,1547,1795,-248,1,-97,84
1,1655,1692,-37,0,63,71
-1,1752,1973,-221,-3,-299,100
-1,1537,1451,86,-2,-61,50
1,1729,1642,87,-2,12,77
1,1515,1554,-39,1,46,73
-1,1458,1560,-102,-6,-198,74
-1,1735,1645,90,0,5,46
-1,1410,1354,56,-3,-38,50
-1,1341,1505,-164,7,284,60
1,2102,1757,345,-1,63,69
-1,1520,1760,-240,-4,-196,70
-1,1340,1378,-38,-4,-181,66
-1,1578,1619,-41,1,44,78
-1,1539,1723,-184,0,1,62
-1,1831,2105,-274,-10,-53,40
1,1903,2054,-151,0,32,113
1,1827,1551,276,0,95,97
1,1616,1574,42,-1,2,73
-1,1637,1445,192,3,99,62
-1,1755,2110,-355,-1,-95,88
-1,1386,1595,-209,0,-193,72
1,1617,1729,-112,2,58,45
1,1649,1574,75,5,281,63
1,1185,1187,-2,0,0,53
-1,1327,1596,-269,-2,-479,126
-1,1534,1512,22,-1,-72,62
1,1803,1346,457,6,310,69
-1,1537,1675,-138,0,-62,60
-1,1497,1388,109,-9,-228,60
1,1925,1804,121,0,175,109
1,1441,1541,-100,0,42,91
1,1893,1922,-29,0,30,85
1,1591,1578,13,0,28,89
1,1440,1425,15,-1,-8,53
1,2135,2056,79,0,-2,67
-1,1621,1743,-122,1,1,98
1,1942,1774,168,2,39,43
1,1792,1612,180,1,23,49
0,1817,1770,47,-1,-93,132
1,1494,1375,119,4,81,47
1,1230,1402,-172,5,126,45
1,1385,1249,136,-1,207,81
0,1781,1741,40,-5,23,98
-1,1371,1634,-263,0,-440,101
-1,1737,1653,84,0,-19,82
-1,1700,1580,120,-1,-56,54
1,1688,1512,176,0,31,55
1,1536,1673,-137,0,342,119
1,1555,1431,124,2,132,61
-1,1948,1767,181,0,4,124
-1,1272,1513,-241,-1,-104,58
1,1473,1448,25,-3,-1,47
1,1432,1441,-9,0,-17,47
-1,1673,1833,-160,-6,-338,96
-1,1597,1673,-76,-6,-76,50
-1,1641,1609,32,-3,-106,74
1,1241,1393,-152,0,-10,51
-1,1593,1599,-6,0,-401,92
-1,1826,1807,19,-12,-158,56
-1,1611,1582,29,3,71,70
-1,1631,1515,116,-4,-163,68
-1,1643,1469,174,-2,-15,58
1,1904,1901,3,1,114,75
-1,1529,1780,-251,3,163,96
1,1452,1368,84,7,445,81
1,1377,1259,118,0,88,73
-1,1797,1932,-135,-2,-30,64
-1,1330,1551,-221,-7,-145,40
1,1690,1634,56,2,45,99
-1,1682,1589,93,-6,-241,74
1,1455,1394,61,1,132,71
-1,1770,1500,270,-2,32,91
1,1667,1604,63,0,17,61
1,1466,1524,-58,0,13,51
-1,1661,1583,78,7,196,74
1,1932,1784,148,0,18,55
-1,1309,1401,-92,5,291,80
1,1718,1628,90,1,17,47
-1,1444,1356,88,4,-83,112
1,2047,1742,305,3,92,58
-1,1676,1800,-124,-3,-183,88
-1,1556,1325,231,-1,-32,68
-1,1434,1483,-49,-10,-383,60
0,1939,1790,149,3,371,98
1,1380,1500,-120,5,285,89
-1,1116,1530,-414,-3,-139,48
1,1485,1438,47,4,140,43
-1,1938,1883,55,2,14,54
-1,1815,1563,252,0,-328,130
0,1541,1742,-201,0,53,102
1,1577,1594,-17,4,254,75
1,1599,1423,176,2,145,63
-1,1595,1595,0,-4,-103,93
-1,1628,1837,-209,0,7,42
1,1603,1692,-89,4,72,63
1,1669,1620,49,6,377,79
1,1860,1757,103,0,-13,48
-1,1257,1450,-193,-8,-21,40
1,1721,1530,191,-3,-26,109
1,1521,1249,272,15,274,47
1,1926,1456,470,0,66,98
1,1679,1759,-80,2,97,45
-1,1584,1582,2,-3,-31,52
-1,1510,1412,98,-1,-847,116
1,1606,1545,61,0,48,101
1,1768,1588,180,1,212,101
-1,1388,1577,-189,-15,-596,82
-1,1664,1401,263,1,-185,84
1,1611,1461,150,7,243,65
1,1691,1530,161,-2,-59,43
1,1542,1564,-22,0,60,69
-1,1255,1390,-135,-1,-283,96
-1,1232,1733,-501,-13,-157,40
1,1642,1582,60,-3,53,49
-1,1941,1929,12,-3,63,64
1,1503,1579,-76,8,278,59
1,1998,1921,77,2,94,71
1,1787,1809,-22,0,-191,129
-1,1616,1659,-43,0,0,78
1,1700,1577,123,0,44,105
-1,1211,1473,-262,-7,-191,46
1,1458,1510,-52,0,49,78
-1,1456,1517,-61,-4,32,60
-1,1928,1960,-32,-1,-26,138
-1,1605,1672,-67,0,-83,60
1,1524,1342,182,0,-5,49
1,1698,1767,-69,1,567,123
-1,1627,1675,-48,0,-102,70
1,1660,1572,88,1,63,63
1,1628,1649,-21,8,518,73
1,1920,1622,298,-2,11,45
-1,1565,1517,48,12,869,104
-1,1479,1625,-146,0,-10,48
-1,1885,2050,-165,-3,-151,102
-1,1573,1677,-104,-7,-363,62
1,1906,1772,134,-9,16,109
-1,1344,1618,-274,-8,-214,76
1,1487,1735,-248,3,294,89
-1,1843,2005,-162,-3,-14,56
-1,1616,1564,52,-2,-150,132
0,1695,1500,195,-2,-90,111
1,1794,1247,547,1,20,49
-1,1445,1478,-33,1,-282,90
1,1583,1382,201,0,413,123
-1,1711,2020,-309,0,-32,102
-1,1479,1595,-116,-1,-14,40
-1,1669,1712,-43,0,-131,172
1,1712,1428,284,-3,-114,47
-1,1583,1608,-25,-2,-149,60
1,1618,1538,80,1,68,71
1,1719,1668,51,3,91,99
-1,1282,1443,-161,-10,-220,58
-1,1918,1727,191,-1,-3,106
-1,1177,1564,-387,-17,-352,52
1,1716,1505,211,-2,1,49
1,1591,1587,4,1,158,73
-1,1729,1771,-42,-3,-42,58
-1,1925,1788,137,0,-164,126
1,1768,1681,87,0,1,83
-1,1726,1618,108,0,-39,62
-1,1755,1799,-44,-1,-160,84
1,1500,1722,-222,0,163,89
-1,1602,1656,-54,0,-157,68
-1,1616,1716,-100,-1,-691,164
-1,1755,1917,-162,-1,-625,126
-1,1774,1764,10,-6,-212,72
-1,1716,1927,-211,-6,-37,66
1,1566,1175,391,-2,193,111
-1,1557,1517,40,0,-285,92
-1,1189,1887,-698,0,-20,58
-1,1688,1762,-74,0,3,96
-1,1640,1779,-139,0,-136,120
-1,1901,2106,-205,0,-57,78
1,1299,1477,-178,0,40,56
-1,1753,1711,42,0,-271,82
-1,1560,1416,144,-2,-36,44
1,1538,1419,119,-1,150,65
-1,1231,1796,-565,-3,-30,46
-1,1652,2012,-360,-5,-243,57
-1,1276,1478,-202,-1,-87,86
1,1523,1221,302,12,193,45
-1,1212,1391,-179,-1,-339,156
-1,1535,1520,15,-8,-244,98
-1,1435,1569,-134,-6,-296,70
1,1463,1637,-174,0,73,117
-1,1202,1181,21,-14,-1156,98
1,1763,1492,271,1,-61,119
1,1622,1572,50,0,65,69
1,1494,1377,117,-2,-36,49
1,1724,1699,25,-5,-104,55
-1,1781,1719,62,-1,-89,146
-1,1700,1622,78,-1,-107,62
1,1626,1442,184,1,130,65
1,1408,1529,-121,0,337,117
-1,1741,1603,138,-11,-350,76
-1,1579,1612,-33,-13,-723,64
1,1736,1712,24,-1,-109,109
1,1621,1357,264,-3,-110,73
1,1500,1465,35,0,35,79
1,1776,1659,117,2,92,91
-1,1494,1810,-316,-4,-94,58
1,1440,1570,-130,1,79,67
-1,1722,1675,47,1,-182,114
1,1577,1825,-248,0,33,59
-1,1723,1751,-28,0,-162,118
-1,1912,2007,-95,-1,-134,102
1,1933,1703,230,2,145,57
1,1734,1659,75,7,230,49
-1,1367,1243,124,-6,-112,50
1,1659,1260,399,-2,371,121
-1,1352,1219,133,1,-29,94
-1,1603,1736,-133,-1,6,46
-1,1797,2102,-305,-1,-246,116
-1,1554,1634,-80,-1,5,80
-1,1712,1663,49,-1,-46,56
1,1428,1576,-148,2,128,51
-1,1711,1468,243,2,76,112
1,1384,1171,213,-6,-571,79
-1,1530,1527,3,-3,-228,64
1,1598,1726,-128,1,100,79
-1,1322,1686,-364,-4,-171,56
-1,1419,1788,-369,-10,-245,47
-1,1861,1938,-77,-1,-97,70
-1,1652,1784,-132,0,-167,72
1,1563,1603,-40,-1,-11,77
-1,1922,1825,97,-1,-187,84
-1,1487,1434,53,-3,-368,74
1,1947,1852,95,-1,487,121
-1,1443,1560,-117,-2,-88,70
1,1807,1836,-29,8,265,51
-1,1292,1303,-11,0,-90,76
-1,1820,1819,1,0,0,40
-1,1331,1568,-237,-3,-178,60
-1,1515,1438,77,-6,-286,108
-1,1454,1319,135,1,-408,116
-1,1527,1743,-216,0,-5,62
1,1115,0,1115,0,6,40
-1,1843,1955,-112,-2,-350,90
1,1830,1805,25,11,396,55
1,1400,1406,-6,-1,77,105
-1,1744,1796,-52,-1,-114,82
1,1840,1792,48,5,191,57
1,1905,1776,129,0,16,78
-1,1258,1352,-94,-3,1,46
1,1617,1705,-88,0,4,55
1,1963,1835,128,0,132,105
-1,1363,1628,-265,-5,-300,86
-1,1596,1443,153,-3,-5,54
1,1721,1838,-117,2,111,62
0,1858,1768,90,9,388,164
-1,1398,1457,-59,-6,-94,48
1,1687,1798,-111,1,298,147
-1,1604,1424,180,1,136,66
-1,1627,1793,-166,-2,-17,42
-1,1452,1383,69,1,59,54
1,1962,1575,387,4,110,55
-1,1828,1970,-142,-1,-297,100
1,1424,1247,177,9,435,63
1,1711,1807,-96,-1,-59,71
1,1268,1162,106,8,84,45
1,2105,1793,312,0,5,81
1,1446,1474,-28,0,110,87
0,1888,1879,9,-4,38,121
-1,1381,1807,-426,-7,-303,58
1,1772,1855,-83,-4,33,47
-1,1592,1788,-196,-5,-222,60
1,1633,1641,-8,3,63,49
1,1661,1250,411,1,24,57
-1,1436,1580,-144,-11,-512,96
-1,1637,1820,-183,-4,-90,56
1,1400,1621,-221,-2,-35,49
1,1804,1905,-101,0,237,145
-1,1842,1788,54,0,-252,108
1,1949,1757,192,0,15,51
1,1573,1320,253,8,271,53
-1,1442,1587,-145,-6,-180,88
-1,1625,1658,-33,-1,-159,152
1,1827,1630,197,0,87,67
-1,1767,1519,248,-7,-32,52
-1,1646,1792,-146,0,40,68
-1,1478,1585,-107,-1,-131,81
1,1580,1370,210,9,180,49
1,1455,1332,123,-1,-14,41
-1,1809,1824,-15,-2,14,78
1,1607,1548,59,0,195,77
-1,1803,1830,-27,-1,-222,82
1,1725,1628,97,-3,-107,65
1,1395,1456,-61,2,699,147
-1,1315,1677,-362,-4,-174,72
1,1699,1646,53,-1,15,112
1,1582,1332,250,1,465,119
1,1914,1215,699,7,164,51
-1,1710,1646,64,0,-373,125
-1,1843,1954,-111,-1,-111,93
-1,1618,1281,337,0,-40,66
1,1307,1500,-193,5,140,43
-1,1030,1387,-357,-2,-879,132
1,1464,1501,-37,0,74,123
-1,1645,1752,-107,-3,-203,82
1,1840,1791,49,-1,120,131
-1,1484,1397,87,-7,-102,44
-1,1310,1577,-267,0,-133,98
0,1638,1799,-161,-3,-62,127
1,1202,1319,-117,-1,21,53
1,1586,1594,-8,-1,68,73
-1,1606,1868,-262,-3,-166,66
-1,1748,1799,-51,-9,-99,76
1,1780,1849,-69,-3,-34,47
1,1436,1545,-109,5,58,47
1,1573,1971,-398,7,331,79
-1,1462,1664,-202,-3,-450,96
1,1500,1867,-367,1,23,115
-1,1719,1634,85,-4,3,58
-1,1914,1835,79,0,-32,70
1,1962,1836,126,0,99,81
1,1633,1813,-180,0,59,113
1,1429,1581,-152,0,-1,45
-1,1809,1824,-15,0,-17,50
1,1721,1702,19,0,1,119
1,1594,1661,-67,0,54,109
-1,1673,1760,-87,0,-7,56
-1,1789,2108,-319,0,-55,64
1,1730,1500,230,16,979,77
-1,1306,1377,-71,-10,-279,54
0,1648,1705,-57,-2,193,98
0,1702,1870,-168,0,-177,166
1,1442,1411,31,2,609,89
1,1500,1500,0,10,86,43
1,1725,1619,106,3,395,133
1,1751,1382,369,4,187,55
1,1533,1543,-10,0,180,143
-1,1884,1951,-67,-1,33,90
-1,1213,1398,-185,-1,-170,64
-1,1901,2033,-132,-1,-105,96
-1,1508,1863,-355,0,-15,92
1,1605,1325,280,0,9,63
1,2119,1283,836,5,116,43
0,1585,1681,-96,0,-587,178
-1,1853,2084,-231,0,0,84
1,1662,1529,133,17,366,45
1,1662,1467,195,0,156,107
-1,1448,1739,-291,-6,-310,86
-1,1360,1386,-26,-9,-822,102
-1,1278,1610,-332,0,-96,52
1,1758,1343,415,5,112,55
1,1865,1725,140,-3,-112,127
-1,1619,1681,-62,0,2,66
-1,1430,1355,75,6,908,106
1,1558,1583,-25,0,150,77
-1,1649,1604,45,0,-57,62
-1,1241,1362,-121,-7,-381,80
1,1496,1532,-36,3,46,59
-1,1541,1632,-91,4,441,102
1,1782,1339,443,-8,-136,57
1,1526,1283,243,-12,-481,69
1,1578,1287,291,3,429,101
-1,1739,1848,-109,-4,-215,66
1,1729,1532,197,0,119,75
1,1800,1336,464,7,247,65
1,1499,1687,-188,1,165,77
-1,1455,1495,-40,5,108,42
1,1289,1409,-120,3,646,103
-1,1718,1872,-154,-3,-151,64
1,1492,1593,-101,-1,-102,137
-1,1759,1793,-34,-2,-12,72
1,1723,1601,122,3,33,51
-1,1764,1754,10,-3,-56,62
1,1271,1381,-110,2,183,67
-1,1649,1577,72,-5,-14,42
-1,1507,1575,-68,-7,-363,70
-1,1815,1576,239,0,-119,118
-1,1531,2120,-589,-2,-120,92
1,1740,1662,78,2,45,45
1,1812,1571,241,1,-17,63
-1,1437,1544,-107,0,-20,60
-1,1581,1803,-222,-3,-54,58
1,1426,1327,99,7,930,105
-1,1879,1712,167,-6,-703,88
-1,1570,1505,65,0,-5,78
1,1669,1499,170,9,1309,131
1,1730,1573,157,0,61,99
-1,1589,1678,-89,-1,-60,70
1,1856,1642,214,-3,-111,65
1,1636,1347,289,1,344,117
1,1410,1466,-56,-2,105,99
1,1866,1980,-114,0,-9,55
-1,1453,1586,-133,0,9,52
-1,1631,1687,-56,-4,-635,90
-1,1934,1871,63,0,-88,80
1,1711,1493,218,9,994,113
-1,1229,1499,-270,-12,-1070,144
-1,1608,1650,-42,-1,-97,82
-1,1724,1793,-69,0,-32,50
-1,1508,1454,54,-3,-211,84
1,1668,1487,181,1,487,89
1,1960,1875,85,0,30,65
1,1803,1749,54,0,89,105
1,1741,1613,128,-1,430,85
-1,1647,1480,167,0,12,98
1,1393,1314,79,0,433,119
1,1369,1403,-34,-4,-166,73
1,1475,1485,-10,1,77,57
1,1488,1419,69,-9,26,71
1,1452,1342,110,-1,-77,89
-1,1468,1429,39,-8,-177,46
-1,1965,1853,112,-6,-18,44
0,1429,1421,8,0,413,127
-1,1446,1637,-191,-1,-22,44
1,1717,1752,-35,0,-15,47
-1,1283,1582,-299,-4,-129,48
-1,1579,1475,104,-3,-370,98
1,1551,1736,-185,0,-231,105
-1,1931,1874,57,-3,-83,58
-1,1779,1606,173,0,-57,100
-1,1526,1582,-56,-1,-40,48
1,1660,1597,63,-4,377,123
-1,1749,1420,329,-1,-12,42
-1,1446,1423,23,-13,-656,66
1,1774,1596,178,-3,440,115
-1,1412,1479,-67,-7,-75,46
1,1417,1322,95,-11,-184,57
-1,1382,1596,-214,1,-141,114
1,1674,1313,361,0,288,131
1,1497,1481,16,-1,44,91
-1,1222,1518,-296,-3,-170,66
1,1705,1500,205,5,202,89
1,1768,1632,136,7,155,55
-1,1867,1968,-101,0,4,46
-1,1376,1622,-246,0,-111,112
-1,1557,1642,-85,-5,-467,118
1,1707,1500,207,-4,-104,87
1,1740,1753,-13,0,28,77
1,1887,1951,-64,0,24,63
-1,1729,1610,119,0,4,64
-1,1328,1397,-69,2,18,48
1,1596,1670,-74,0,2,49
-1,1564,1696,-132,1,-98,118
1,1572,1482,90,1,27,55
-1,1653,1497,156,4,246,68
-1,1309,1312,-3,-3,-75,42
-1,1172,1285,-113,-2,-125,70
1,1781,1590,191,1,86,65
1,1300,1402,-102,-3,-119,59
-1,1554,1669,-115,0,-527,94
-1,1231,1524,-293,1,-279,148
-1,1487,1715,-228,0,-57,59
1,1521,1217,304,5,301,57
1,1767,1751,16,-6,-173,75
1,1269,1337,-68,11,297,43
1,1595,1543,52,0,-34,73
-1,990,1424,-434,-16,-381,54
1,1278,1081,197,-3,918,143
-1,1334,1813,-479,-2,26,68
0,1715,1642,73,-3,10,137
-1,1583,1751,-168,-4,-854,106
-1,1924,1804,120,1,-2,62
-1,1728,1804,-76,1,-15,62
-1,1360,1378,-18,0,-403,166
1,1442,1425,17,1,48,109
-1,1807,1713,94,2,76,106
-1,978,1426,-448,-17,-1095,82
1,1627,1584,43,4,46,51
-1,1787,1727,60,0,36,68
-1,1376,1546,-170,0,-60,62
-1,1773,1533,240,1,-52,88
1,1295,1496,-201,-2,-50,59
1,1881,1701,180,2,111,63
-1,1640,1578,62,0,-129,86
-1,1440,1953,-513,0,-56,72
1,1743,1625,118,9,357,83
1,1722,1467,255,0,333,125
-1,1469,1556,-87,-15,-554,64
-1,1482,1686,-204,-4,-93,74
1,1323,1411,-88,-1,-79,79
1,1677,1549,128,0,100,91
0,1905,1873,32,0,2,88
-1,1531,1500,31,0,-13,44
-1,1368,1512,-144,2,110,64
0,1754,1552,202,-4,-29,132
-1,1677,1441,236,2,102,64
-1,1279,1500,-221,0,-231,69
0,1740,1793,-53,-3,-482,121
-1,1767,1968,-201,-1,-63,58
-1,1556,1480,76,0,58,92
0,1919,2112,-193,-1,30,152
1,1528,1206,322,2,302,67
-1,1600,1667,-67,0,-7,78
1,1765,1314,451,-3,154,99
-1,1887,1910,-23,0,-92,70
1,1652,1741,-89,5,227,59
-1,1435,1432,3,3,-6,64
-1,1820,1776,44,-3,-17,46
-1,1613,1773,-160,-9,-182,52
1,1910,1939,-29,0,72,97
1,1449,1552,-103,-1,-75,85
-1,1691,1726,-35,2,-21,44
0,1684,1597,87,-2,242,108
1,1508,1482,26,-1,52,41
-1,1655,1661,-6,-1,-295,130
-1,968,1528,-560,-3,-66,58
1,1795,1463,332,-5,-175,131
-1,1666,1791,-125,0,-2,58
1,1370,1442,-72,0,2,61
1,1644,1591,53,-3,25,115
1,1302,1153,149,-2,-20,49
1,1747,1744,3,5,349,71
-1,1580,1659,-79,-1,-124,98
-1,1920,1876,44,-2,-129,86
1,1664,1672,-8,0,-35,83
1,1549,1347,202,0,10,65
-1,1658,1399,259,-5,6,40
1,1457,1802,-345,7,497,85
1,1762,1976,-214,2,48,65
-1,1317,1565,-248,-4,-77,54
-1,1783,1741,42,1,0,43
1,1718,1379,339,2,129,57
-1,1201,1531,-330,-8,-285,60
-1,1759,1799,-40,0,-455,180
-1,1388,1324,64,-3,-286,108
-1,1691,1476,215,-4,-96,60
1,1693,1659,34,0,-2,79
-1,1333,1724,-391,0,19,74
1,2071,1681,390,3,63,53
-1,1541,1503,38,0,-187,78
1,1558,1495,63,7,357,67
-1,1336,1875,-539,-1,-21,58
1,1639,1565,74,-3,102,87
-1,1927,1921,6,-5,-12,88
1,1712,1716,-4,4,139,55
-1,1716,1618,98,5,565,104
-1,1453,1414,39,-5,-891,128
1,1953,1779,174,-1,66,67
-1,1443,1424,19,2,103,90
1,1627,1632,-5,4,543,109
-1,1338,1330,8,-1,-181,104
-1,1907,2074,-167,-2,-182,70
1,1534,1197,337,4,651,155
-1,1685,1749,-64,-2,-104,70
-1,1284,1310,-26,-10,-219,56
1,1563,1438,125,4,221,75
-1,1881,1809,72,0,-40,70
1,1679,1764,-85,2,176,77
1,1370,1749,-379,0,216,129
-1,1874,1901,-27,2,75,64
-1,2122,2037,85,0,-395,140
-1,1364,1375,-11,-8,-216,50
1,1753,1765,-12,0,15,67
-1,1528,1512,16,-7,-217,104
-1,1739,1430,309,-1,-118,67
1,1498,1348,150,1,-7,75
1,1574,1494,80,3,136,67
-1,1567,1661,-94,-2,-171,90
-1,1312,1472,-160,3,35,62
-1,1696,1946,-250,0,-84,92
1,1758,1666,92,6,188,65
1,1631,1379,252,9,476,67
-1,1690,1523,167,-1,-149,108
-1,1455,1706,-251,0,-59,56
-1,1660,1740,-80,-2,-161,62
1,1421,1592,-171,3,260,85
1,1529,1731,-202,-5,-82,81
1,1822,1811,11,1,102,107
-1,1610,1780,-170,-2,-309,74
1,1334,1494,-160,3,108,59
1,1889,1715,174,2,35,75
-1,1767,2102,-335,0,25,82
1,1253,1326,-73,-1,-1,55
1,1751,1629,122,-5,-72,89
1,1522,1429,93,1,151,95
1,1691,1649,42,3,65,47
1,1713,1449,264,-8,-347,87
-1,1273,1720,-447,0,-90,94
-1,1932,1916,16,0,-16,56
-1,1758,1751,7,-3,-26,52
-1,1722,1580,142,-7,-115,50
1,1350,1421,-71,-2,-75,55
1,1581,1573,8,6,133,41
1,1762,1832,-70,-3,22,69
-1,1143,1571,-428,-2,-798,86
-1,1351,1392,-41,1,-62,74
1,1523,1571,-48,4,249,75
1,1716,1641,75,-2,-18,41
1,1676,1386,290,-3,7,73
1,1709,1895,-186,3,17,41
-1,1605,1706,-101,0,-671,110
1,1471,1478,-7,-3,7,63
1,1864,1961,-97,0,3,55
-1,1444,1720,-276,1,44,68
-1,1401,1598,-197,-4,-469,112
1,1471,1622,-151,-3,-134,56
-1,1404,1607,-203,1,45,42
1,1819,1815,4,-5,103,65
1,1878,1725,153,0,113,83
-1,1425,1530,-105,2,69,66
1,1657,1444,213,6,223,71
-1,1500,1665,-165,-10,-189,48
-1,1684,1951,-267,1,3,56
-1,1727,1439,288,-4,-458,98
1,1906,1576,330,11,101,43
1,1370,1427,-57,0,-23,73
-1,1436,1536,-100,-1,-125,104
-1,1749,1700,49,4,166,50
-1,1776,1830,-54,-6,-135,56
1,1321,1384,-63,20,424,43
1,1405,1364,41,6,296,79
-1,1719,1885,-166,-1,-176,114
1,1564,1536,28,1,23,49
1,2112,1842,270,0,157,103
1,1558,1546,12,0,4,53
-1,1639,1404,235,-1,-27,48
-1,1632,1500,132,0,-106,86
0,1887,1679,208,-8,-452,131
1,1637,1276,361,-1,-104,85
-1,1955,1928,27,-6,-343,102
1,1271,1370,-99,-3,59,72
1,1463,1697,-234,5,493,89
-1,1905,1917,-12,-7,-333,92
1,1839,1745,94,-1,41,79
1,1751,1737,14,-2,-117,95
1,1486,1605,-119,-9,-112,41
1,1525,1565,-40,1,82,55
-1,1636,1726,-90,0,-27,50
-1,1542,1526,16,-2,-139,69
1,1763,1815,-52,-2,218,123
-1,1901,2143,-242,-1,-430,116
1,1892,1712,180,-1,115,85
-1,1669,1486,183,-3,-892,130
-1,1439,1604,-165,1,40,82
-1,1456,1610,-154,-1,-427,82
1,1350,1508,-158,3,59,45
-1,1532,1382,150,-1,-26,50
1,1497,1415,82,0,404,107
-1,1823,1746,77,0,-59,120
-1,1291,1639,-348,-2,-95,82
1,1381,1512,-131,3,195,59
1,1733,1858,-125,-5,7,91
1,1539,1399,140,-1,210,73
1,1931,1493,438,4,40,41
1,1597,1356,241,0,223,101
-1,2111,2101,10,0,-31,54
1,1758,1531,227,1,152,67
-1,1291,1535,-244,0,6,52
1,1858,1825,33,0,43,83
-1,1718,1577,141,-7,-134,46
1,1465,1421,44,4,214,87
1,1749,1812,-63,3,116,81
1,1602,1277,325,2,293,99
1,1625,1445,180,1,135,91
1,1526,1337,189,4,340,92
1,1937,2090,-153,2,13,43
-1,1530,1477,53,3,43,42
1,1590,1697,-107,1,75,57
-1,1509,1463,46,0,207,98
1,1293,1339,-46,1,99,65
-1,1490,1396,94,-3,-102,48
1,1631,1533,98,5,101,45
1,1592,1704,-112,1,77,55
-1,1315,1482,-167,0,-11,62
1,1753,1701,52,0,27,57
-1,1721,1663,58,8,21,118
-1,1406,1506,-100,0,132,174
1,1632,1377,255,8,156,50
-1,1526,1679,-153,-3,-78,72
1,1466,1384,82,0,101,85
1,1481,1479,2,1,89,77
1,1677,1543,134,1,7,65
-1,1286,1288,-2,-2,-32,52
1,1868,1815,53,1,68,57
1,1450,1642,-192,4,201,59
-1,1063,1617,-554,-4,-34,42
1,1605,1494,111,1,1,41
-1,1437,1649,-212,0,17,64
1,1517,1463,54,0,24,43
1,1491,1449,42,10,340,105
1,1606,1711,-105,1,269,73
1,1470,1410,60,-2,44,61
-1,1471,1493,-22,-2,-40,52
-1,1592,1653,-61,1,53,78
-1,1322,1387,-65,-8,-131,46
-1,1696,1622,74,0,-274,102
1,1544,1323,221,-2,40,51
-1,1690,1606,84,-7,-292,60
-1,1571,1534,37,-3,-377,122
-1,1636,1761,-125,6,128,54
1,1277,1286,-9,0,-541,143
1,1389,1599,-210,-9,-172,41
1,1639,1572,67,-1,-5,47
-1,1607,1352,255,-1,-47,84
-1,1398,1494,-96,8,219,54
1,1877,1805,72,0,22,65
-1,1698,1779,-81,-6,-100,53
1,1636,1683,-47,1,88,51
0,1349,1473,-124,1,11,58
1,1631,1475,156,5,501,97
1,1326,1306,20,9,198,47
-1,1274,1482,-208,-1,-100,78
-1,1438,1879,-441,-3,-10,42
-1,1508,1335,173,-2,-33,48
1,1848,1865,-17,2,46,48
1,1762,1787,-25,-4,14,41
-1,1439,1487,-48,-4,-403,80
1,1488,1401,87,-1,-13,141
1,1685,1516,169,2,209,81
1,1789,1689,100,0,-5,67
0,1670,1650,20,-1,-323,90
-1,1298,1625,-327,-3,-238,76
1,1605,1488,117,2,58,51
-1,1527,1572,-45,-2,-47,48
-1,1619,1675,-56,0,9,78
1,1514,1398,116,3,142,71
-1,1483,1407,76,-1,73,68
-1,1763,1885,-122,-2,-99,56
1,1605,1683,-78,-1,-50,71
-1,1373,1616,-243,-1,-51,64
-1,1774,2026,-252,-1,-9,53
-1,1650,1669,-19,-9,-22,96
-1,1768,1724,44,0,12,72
-1,1629,1725,-96,-4,-245,104
1,1475,1296,179,1,169,92
-1,1508,1662,-154,-5,-92,48
-1,1680,1798,-118,-3,-46,64
-1,2109,2112,-3,-2,-191,76
1,1881,1593,288,1,130,65
1,1492,1580,-88,1,25,55
-1,1680,1639,41,-16,-456,54
1,1360,1283,77,6,290,74
1,1613,1648,-35,1,90,95
1,1475,1294,181,-5,-42,71
1,1391,1521,-130,0,-38,113
1,1644,1391,253,3,555,132
-1,1269,1300,-31,-1,-5,128
1,1488,1428,60,4,134,49
-1,1667,1916,-249,-2,-144,80
1,1756,1796,-40,0,-13,83
-1,1430,1500,-70,-2,-16,50
-1,1549,1321,228,-2,-163,56
-1,1467,1353,114,-1,-21,40
1,1475,1545,-70,0,14,45
1,1756,1742,14,-1,-7,81
1,1507,1691,-184,2,341,77
1,1396,1367,29,1,40,43
-1,1522,1434,88,6,135,52
0,1684,1610,74,-2,-132,72
1,1313,1454,-141,2,125,118
1,1854,1861,-7,1,27,113
1,1952,1833,119,-2,26,67
1,1421,1464,-43,-5,-17,49
1,1641,1690,-49,-4,27,45
-1,1638,1662,-24,0,20,84
1,1604,1663,-59,0,156,89
-1,1424,1643,-219,-4,-19,62
1,1620,1601,19,-3,41,111
1,1903,1617,286,4,231,71
1,1885,1382,503,1,370,79
-1,1574,1547,27,0,-272,98
1,1590,1456,134,0,42,48
-1,1576,1583,-7,0,17,60
0,1419,1497,-78,0,-66,116
1,1468,1143,325,3,83,43
-1,1959,2099,-140,-1,-62,64
-1,2123,2097,26,-3,-73,58
-1,1685,1419,266,-1,-103,80
-1,1753,1776,-23,-1,-3,44
-1,1774,1784,-10,-2,-467,96
1,1392,1496,-104,0,207,99
-1,1672,1627,45,-5,-96,95
1,1532,1698,-166,4,95,66
1,1747,1360,387,-3,-42,47
0,1602,1232,370,0,-5,78
-1,1589,1670,-81,0,5,56
1,1731,1766,-35,0,184,99
0,1892,1826,66,0,49,164
-1,1602,1676,-74,-1,-43,54
-1,1368,1443,-75,1,96,40
1,1512,1488,24,8,91,51
-1,1290,1654,-364,-1,-13,58
1,1632,1699,-67,2,36,45
-1,1508,1371,137,4,43,64
1,1728,1453,275,2,104,63
-1,1494,1523,-29,-4,-142,90
1,1680,1778,-98,4,69,43
-1,1953,2106,-153,-1,-71,66
-1,1419,1703,-284,-6,-133,59
1,2110,2111,-1,0,-3,87
-1,1808,1527,281,-1,-22,72
1,1682,1525,157,-2,-165,69
-1,1619,1733,-114,-9,-585,87
1,1130,1251,-121,-2,-35,55
-1,1434,1552,-118,0,135,96
-1,1559,1562,-3,2,113,112
1,1448,1543,-95,-2,686,99
-1,1292,1631,-339,2,-24,80
1,1727,1618,109,-2,35,47
1,1908,1668,240,0,7,87
-1,1584,1347,237,-3,28,48
-1,1274,1359,-85,2,-207,140
1,1510,1586,-76,1,36,44
-1,1172,1671,-499,0,7,50
-1,1258,1116,142,0,-219,124
1,1580,1538,42,-3,121,73
-1,1887,1795,92,1,183,198
1,1921,1766,155,-5,-177,95
-1,1482,1612,-130,0,17,62
1,1770,1684,86,0,30,61
1,1494,1421,73,-1,271,95
0,1457,1359,98,0,-18,50
-1,1631,1701,-70,-2,-687,134
1,1752,1424,328,-1,-33,47
1,1591,1500,91,4,296,83
1,1550,1636,-86,0,-32,131
1,1588,1548,40,0,-9,41
-1,1791,1759,32,1,-53,98
1,1593,1764,-171,-2,-82,81
1,1717,1666,51,0,210,123
1,1828,1890,-62,4,244,75
1,1679,1580,99,1,65,63
-1,1364,1597,-233,-6,-143,54
1,1440,1525,-85,0,361,133
1,1593,1476,117,2,71,45
1,1481,1361,120,-1,-49,63
-1,1771,1756,15,0,-238,100
1,1768,1597,171,3,305,81
-1,1485,1511,-26,0,7,41
1,1446,1334,112,3,70,65
1,1728,1602,126,0,-17,57
1,1645,1600,45,2,62,45
1,1433,1440,-7,-4,180,91
-1,1535,1557,-22,1,-108,72
1,1580,1683,-103,0,112,177
1,1660,1673,-13,-4,-95,53
-1,1481,1470,11,4,104,58
-1,1663,1913,-250,-2,-213,98
1,1787,1759,28,6,306,53
1,1878,1840,38,0,20,141
-1,1407,1475,-68,0,14,46
1,1949,1610,339,-2,8,61
1,1748,1570,178,0,-1,41
1,1619,1442,177,0,160,95
-1,1523,1729,-206,0,-266,98
1,1750,1662,88,1,-5,57
1,1749,1601,148,20,647,53
1,1522,1369,153,1,96,71
-1,1194,1474,-280,-8,-195,48
-1,1591,1812,-221,-1,-200,74
1,1370,1844,-474,-2,-26,47
1,1920,1687,233,-5,6,73
-1,1594,1756,-162,2,186,80
0,1444,1376,68,-3,-47,113
-1,1241,1785,-544,-10,-140,42
1,1721,1655,66,-4,22,57
1,1685,1621,64,7,322,75
1,1928,1849,79,3,140,67
1,1611,1500,111,1,142,53
-1,1722,1671,51,0,42,90
-1,1368,1265,103,-2,-320,104
-1,1386,1472,-86,-8,-171,56
-1,1574,1806,-232,-5,-86,58
1,1762,1588,174,-2,272,95
-1,1623,1660,-37,1,-1,54
1,1870,1809,61,1,104,91
1,1412,1503,-91,3,310,101
1,2113,2100,13,0,10,43
1,1371,1465,-94,-2,-46,45
-1,1507,1303,204,-1,-3,48
-1,1786,1523,263,-3,7,85
-1,1288,1625,-337,-4,-108,62
-1,1598,1536,62,3,29,64
-1,1493,1517,-24,0,9,60
1,1355,1581,-226,0,-5,47
-1,1398,1484,-86,-11,-84,42
-1,1839,2120,-281,-1,-61,80
1,1240,1225,15,-1,209,83
-1,1924,1843,81,-1,35,116
-1,1359,1498,-139,-12,-227,53
-1,1515,1652,-137,-12,-445,60
1,1831,1887,-56,0,25,85
1,1754,1682,72,0,63,54
1,1856,2125,-269,6,68,45
1,1565,1413,152,-3,26,71
1,1819,1493,326,1,389,119
1,1564,1468,96,-1,37,61
-1,1220,1504,-284,-7,-170,52
1,1631,1684,-53,0,77,63
-1,1560,1581,-21,-7,-54,40
-1,1448,1385,63,-1,207,80
1,1638,1758,-120,-1,75,61
1,1133,1500,-367,-2,-97,69
-1,1392,1571,-179,-1,127,90
-1,1324,1453,-129,0,4,44
1,1865,1754,111,0,61,105
0,1492,1389,103,9,386,111
-1,1218,1671,-453,-1,-591,100
1,1519,1352,167,9,187,61
-1,1937,1876,61,0,-13,60
1,1275,1487,-212,-2,34,55
-1,1483,1460,23,-6,-33,70
1,1373,1439,-66,4,278,59
1,1577,1375,202,9,139,45
-1,1605,1285,320,-2,-29,46
0,1536,1529,7,0,-115,142
1,1415,1442,-27,1,-2,41
1,1735,1583,152,6,265,76
-1,1800,1881,-81,0,-22,82
-1,1628,1657,-29,0,0,46
-1,1360,1583,-223,1,21,40
1,1439,1476,-37,-1,-11,93
1,1592,1550,42,3,119,51
-1,1252,1308,-56,0,12,52
-1,1460,1572,-112,-7,-98,46
1,1673,1645,28,-4,14,69
-1,1875,1843,32,0,-20,102
1,1427,1429,-2,1,452,83
1,1992,1835,157,0,543,95
1,1325,1315,10,5,241,57
-1,1753,1436,317,0,-204,114
1,1823,1339,484,0,203,133
1,1762,1686,76,0,-2,43
-1,1399,1432,-33,0,-31,100
1,1062,1151,-89,10,550,69
1,1508,1327,181,4,82,47
1,1475,1643,-168,2,362,109
1,1660,1424,236,0,33,61
-1,1739,1755,-16,-3,-174,172
1,1598,1619,-21,-2,-29,45
-1,1212,1654,-442,0,-160,86
1,1540,1601,-61,0,31,43
-1,1806,1791,15,-1,-53,88
-1,1471,1392,79,-6,-196,60
-1,1666,1769,-103,-9,-294,56
-1,1303,1354,-51,-2,-138,88
-1,1998,2102,-104,-4,-155,78
-1,1361,1462,-101,-1,-437,106
1,1617,1667,-50,0,122,85
-1,1531,1891,-360,-1,-62,56
-1,1669,1512,157,0,66,62
1,1641,1257,384,6,218,59
-1,1438,1418,20,-11,-256,68
-1,1595,1449,146,-3,-115,89
1,1916,1429,487,0,171,75
1,2112,1991,121,3,120,67
-1,1746,1873,-127,1,22,50
1,1464,1451,13,0,103,77
-1,1256,1536,-280,-4,-322,98
1,1362,1588,-226,0,-48,91
-1,1984,2121,-137,0,-40,98
0,1771,1802,-31,0,-91,145
-1,1231,1395,-164,-8,-337,69
1,1198,1264,-66,-2,-27,99
-1,1427,1430,-3,-6,-141,56
-1,1492,1489,3,-2,-31,64
1,1457,1406,51,5,94,45
1,1444,1388,56,-2,-31,53
1,1338,1375,-37,3,114,59
1,1666,1285,381,-1,-103,81
1,2129,1977,152,0,7,71
-1,1855,1864,-9,0,-27,98
1,1644,1825,-181,-2,-14,55
1,1584,1351,233,8,296,55
1,1370,1489,-119,4,69,43
-1,1781,1843,-62,0,-3,48
1,1362,1353,9,-3,-20,73
1,1409,1514,-105,6,1031,113
1,1501,1500,1,1,74,97
1,1460,1066,394,1,150,88
-1,1754,1881,-127,-2,-275,158
1,1441,1416,25,3,93,65
1,1732,1683,49,4,250,73
-1,1880,1739,141,-4,-133,62
1,1396,1113,283,0,30,55
-1,1669,1861,-192,-1,-63,72
-1,1514,1894,-380,-1,-9,49
-1,1340,1373,-33,0,351,78
-1,1675,1827,-152,-1,-329,72
1,1803,1614,189,0,245,81
-1,1915,1874,41,-1,-62,76
-1,1713,1653,60,0,-18,80
1,1529,1478,51,0,96,67
1,2137,1827,310,-2,-82,59
-1,1280,1291,-11,-5,-249,64
-1,1379,1483,-104,-5,-137,58
-1,1630,1561,69,-1,-151,84
-1,1630,1403,227,-3,-19,64
1,1251,1465,-214,0,1,53
-1,1553,1662,-109,1,64,116
1,1643,1819,-176,-2,48,49
-1,1608,1777,-169,2,81,70
1,1327,1145,182,3,152,63
0,1885,1834,51,-1,-80,110
-1,1107,1400,-293,-3,-34,64
1,1406,1452,-46,-2,74,59
-1,1705,1581,124,0,1,46
-1,1743,1888,-145,-11,-70,58
1,1747,1897,-150,2,192,115
1,1270,1540,-270,3,52,42
-1,1754,1865,-111,-1,-57,48
-1,1254,1401,-147,0,-40,70
-1,1664,1980,-316,0,-90,80
1,1917,2159,-242,1,13,85
1,1735,1681,54,0,-66,103
1,1208,1292,-84,-8,-197,76
1,1410,1353,57,-4,232,107
-1,1467,1555,-88,2,55,56
-1,1025,0,1025,0,-36,54
-1,1443,1520,-77,-2,-379,152
-1,1608,1577,31,-2,-98,60
1,1530,1500,30,-2,-33,51
-1,1290,1362,-72,-7,-210,58
-1,1315,1532,-217,0,-172,66
-1,1371,1404,-33,-2,-106,70
1,1439,1418,21,1,52,41
1,1660,1382,278,0,237,69
-1,1397,1461,-64,-2,-48,48
1,1461,1397,64,-4,-106,45
1,1692,1447,245,1,74,65
-1,1730,1895,-165,-4,-245,66
0,1500,1553,-53,1,17,164
1,1617,1060,557,7,431,85
0,1477,1380,97,1,53,100
1,1307,1463,-156,14,502,57
-1,1542,1681,-139,-2,-21,42
-1,1685,1691,-6,0,-8,68
1,1905,1923,-18,3,202,71
-1,1408,1450,-42,0,-117,69
1,1325,1290,35,0,6,71
-1,1730,1811,-81,0,39,98
-1,1458,1564,-106,2,123,94
1,1445,1301,144,6,75,42
-1,1735,1498,237,0,-125,48
1,1280,1433,-153,-5,-38,47
-1,1878,1477,401,-2,-485,132
-1,1551,1766,-215,1,-31,48
-1,1696,1823,-127,-9,-366,70
1,1414,1361,53,3,166,77
1,1622,1660,-38,-1,87,63
-1,1548,1663,-115,-11,-59,40
1,1374,1432,-58,0,62,69
1,1716,1902,-186,0,49,87
1,1334,1445,-111,-1,-38,61
1,1522,1498,24,-1,-33,51
1,1523,1193,330,0,26,47
1,1858,1296,562,10,320,51
1,1916,1579,337,1,25,49
-1,1537,1625,-88,0,-266,100
1,1569,1378,191,0,63,97
-1,1452,1885,-433,-6,-216,92
-1,1578,1198,380,1,-2,42
1,1675,1576,99,2,154,73
1,1202,1472,-270,-4,-74,77
1,1450,1420,30,2,31,45
-1,1756,1474,282,-1,30,78
1,1392,1349,43,-2,-115,61
1,1822,1721,101,-1,-132,129
1,1537,1528,9,1,197,85
-1,1522,1464,58,0,-12,54
-1,1246,1408,-162,-4,-61,56
-1,1762,1864,-102,0,101,74
0,1788,1553,235,-2,130,238
1,1925,1700,225,6,98,43
1,1698,1540,158,0,35,115
1,1700,1925,-225,-2,85,53
-1,1338,1424,-86,0,-9,58
1,1660,1351,309,2,-33,123
-1,1460,1699,-239,-1,-35,66
1,1704,1646,58,0,-54,83
-1,1629,1455,174,1,45,48
1,1479,992,487,3,76,45
1,1633,1482,151,8,675,85
-1,1885,1774,111,-1,26,106
1,1811,1737,74,0,-14,61
1,1907,1717,190,1,126,85
1,1989,1725,264,0,28,61
1,1605,1455,150,-3,265,101
-1,1706,1918,-212,-1,-57,72
-1,1531,1548,-17,-3,133,78
-1,1543,1620,-77,0,44,106
1,1613,1765,-152,0,61,71
-1,1513,1402,111,0,-3,52
1,1883,1714,169,0,150,95
-1,1709,1832,-123,-3,89,92
0,1496,1665,-169,-4,-61,120
-1,1557,1697,-140,0,-3,99
-1,1683,1645,38,1,26,70
1,1858,1714,144,-1,-311,91
1,1797,1637,160,-1,-160,85
-1,1315,1531,-216,-11,-90,42
-1,1396,1525,-129,-2,-223,82
-1,1530,1535,-5,-2,-305,98
-1,1492,1545,-53,-8,-387,74
1,1525,1394,131,9,166,49
-1,1456,1500,-44,5,160,66
1,1896,2111,-215,0,-16,71
1,1526,1291,235,1,101,68
-1,1416,1498,-82,-1,49,50
1,1749,1628,121,0,104,56
-1,1609,1992,-383,0,-12,46
-1,1309,1371,-62,2,28,61
-1,1490,1539,-49,-1,-585,112
1,1825,1580,245,-3,132,91
1,1721,1993,-272,-3,281,135
-1,1634,1600,34,0,-229,86
-1,1575,1722,-147,0,-93,90
-1,1348,1663,-315,-1,-106,88
1,1389,1521,-132,0,-25,65
1,1729,1821,-92,-2,141,115
1,1450,1300,150,0,33,53
1,1075,1190,-115,0,15,41
1,1929,1567,362,1,40,53
0,1448,1464,-16,-1,0,88
-1,1757,1630,127,-2,-84,50
-1,1621,1590,31,-3,-93,84
-1,1686,1631,55,1,-39,52
-1,1404,1787,-383,-5,-529,105
-1,1636,1507,129,-4,29,96
-1,1407,1533,-126,-17,-59,40
1,1743,1654,89,4,837,85
-1,1642,1681,-39,-2,-47,48
-1,1612,1704,-92,0,-103,100
1,1932,1604,328,0,63,75
1,1536,1738,-202,-3,-74,83
-1,1746,1848,-102,1,81,112
1,1671,1720,-49,0,35,83
0,1594,1609,-15,5,68,126
1,1615,1281,334,-2,155,95
-1,1601,1935,-334,-3,-338,92
1,1972,1739,233,3,41,42
-1,1438,1507,-69,2,-32,58
1,1729,1733,-4,0,134,71
-1,1633,1646,-13,-3,-92,56
-1,1645,1741,-96,-1,-40,48
-1,1723,1960,-237,-3,-83,40
1,1999,1606,393,9,121,43
-1,1500,1627,-127,-6,-18,46
-1,1461,1479,-18,2,216,86
1,1455,1291,164,-1,2,47
1,1460,1032,428,2,240,75
1,1534,1411,123,6,209,58
1,1750,1575,175,2,325,95
1,1684,1734,-50,0,-99,77
1,1403,1239,164,3,199,64
1,1550,1492,58,2,102,63
1,1466,1508,-42,0,66,127
1,1591,1483,108,0,103,65
1,1329,1275,54,3,154,75
-1,1750,1637,113,1,82,76
1,1641,1550,91,-1,-27,65
-1,1609,1977,-368,1,14,42
-1,1687,1721,-34,0,-179,86
-1,1615,1736,-121,-14,-572,76
-1,1746,1638,108,-2,-184,120
-1,1510,1454,56,0,-13,56
0,1323,1484,-161,-5,-65,153
-1,1550,1747,-197,-2,-91,60
1,1914,1803,111,3,58,43
1,1733,1623,110,-3,-2,42
1,1733,1783,-50,0,42,105
-1,1602,1523,79,0,23,64
1,1391,1339,52,0,7,47
1,1719,1312,407,2,24,51
-1,1974,2069,-95,1,-145,114
-1,1439,1650,-211,0,-528,126
1,1699,1574,125,-2,26,55
1,1419,1396,23,1,241,117
-1,1732,2089,-357,-1,-50,70
1,1560,1603,-43,3,407,101
-1,1555,1682,-127,-1,-268,82
-1,1508,1680,-172,-2,-18,48
-1,1492,1448,44,-1,-19,52
1,1824,1243,581,4,146,51
-1,1707,2031,-324,4,-4,40
-1,1389,1276,113,1,47,58
1,1516,1489,27,6,395,129
-1,1716,1505,211,0,-152,66
-1,2100,2092,8,0,-27,86
1,1329,1224,105,9,88,41
1,1502,1643,-141,11,1189,93
1,1906,1697,209,0,20,59
-1,1717,1796,-79,1,14,58
1,1680,1687,-7,1,39,51
1,1729,1635,94,5,300,97
1,1533,1467,66,0,246,77
-1,1552,1572,-20,-2,-341,90
-1,1460,1480,-20,-4,-466,84
-1,2106,2087,19,-3,-102,92
-1,1878,2035,-157,0,-3,72
1,1694,1799,-105,4,59,47
1,1490,1614,-124,-1,405,157
-1,1310,1519,-209,1,-311,91
-1,1374,1476,-102,-6,-129,46
-1,1699,1451,248,-3,-211,78
-1,1603,1534,69,-8,-181,47
-1,1721,1574,147,2,-433,110
-1,1966,1770,196,0,-17,64
1,1453,1404,49,-2,437,171
-1,1942,1804,138,0,-38,116
1,2100,2092,8,5,131,59
1,1742,1246,496,3,144,72
-1,1291,1553,-262,1,-16,53
-1,1211,1323,-112,6,529,163
-1,1912,1631,281,-3,-250,72
1,1826,1219,607,4,208,59
1,1871,1921,-50,-5,-333,85
-1,1233,1486,-253,2,106,64
1,1711,1433,278,0,299,115
1,1712,1829,-117,4,321,73
-1,1430,1337,93,1,52,81
1,1443,1660,-217,-3,-166,79
-1,1696,2079,-383,-1,-213,84
-1,1829,1486,343,0,-16,45
-1,2080,1826,254,0,-38,89
1,1506,1460,46,-1,54,73
1,1705,1666,39,3,57,47
-1,1892,1848,44,2,-78,104
1,1475,1327,148,4,123,53
1,1743,1525,218,-1,9,43
-1,1787,1950,-163,0,-5,104
-1,1558,1704,-146,0,-57,64
-1,1685,2085,-400,-1,-18,66
1,1451,1421,30,-1,-56,55
1,1771,1562,209,1,30,51
-1,1353,1346,7,0,-85,62
-1,1819,1926,-107,-2,-170,90
-1,1522,1414,108,-4,-106,60
1,1492,1615,-123,6,269,67
-1,1879,1682,197,0,-57,106
1,1500,1547,-47,5,97,43
1,2087,1680,407,-1,1,57
1,1909,1748,161,0,20,81
1,1458,1543,-85,0,176,109
-1,1784,1705,79,-1,-47,68
1,1829,1200,629,6,116,49
0,1706,1641,65,-7,-85,54
1,1590,1628,-38,0,14,55
-1,1745,1753,-8,0,-114,136
-1,1366,1750,-384,-5,-93,40
1,1629,1019,610,10,460,59
1,1879,2090,-211,-5,-80,65
-1,1884,2062,-178,-1,-43,48
-1,1657,1717,-60,0,-829,184
-1,1582,1753,-171,-3,-10,42
-1,1675,2051,-376,-2,-187,110
-1,1018,1630,-612,-4,-50,42
-1,1590,1722,-132,3,80,114
1,1713,1781,-68,-1,69,83
1,1492,1302,190,4,94,43
-1,1386,1508,-122,-6,-50,46
1,1652,1535,117,-4,-104,57
1,1858,1872,-14,0,-16,61
-1,2069,1897,172,-5,-18,112
0,1514,1527,-13,-1,-371,129
-1,1017,1630,-613,-3,-385,72
1,1700,1500,200,-1,-69,77
-1,1463,1810,-347,-5,-27,50
1,1468,1169,299,0,38,45
1,1521,1119,402,8,279,69
0,1686,1753,-67,-1,53,106
1,1862,1811,51,0,-7,47
-1,1192,1830,-638,-7,-201,50
1,1528,1660,-132,0,50,49
1,1776,1951,-175,0,102,81
1,1875,2066,-191,0,20,99
-1,1478,1591,-113,1,-22,51
1,1549,1499,50,0,253,119
-1,1464,1283,181,-3,-151,62
-1,1630,1718,-88,0,-11,54
1,1712,1364,348,1,80,97
-1,1582,1631,-49,-3,-78,58
-1,1344,1954,-610,-3,-52,48
1,1708,1714,-6,1,94,59
1,1695,1770,-75,0,-18,75
-1,1106,1523,-417,-5,-159,53
1,1526,1608,-82,0,73,89
0,1699,1651,48,0,173,128
-1,1532,1545,-13,-2,-18,43
1,1602,1522,80,4,343,106
-1,1817,1976,-159,-5,-141,56
1,1645,1542,103,2,33,47
-1,1151,1471,-320,-4,-14,42
1,1768,1728,40,0,70,71
1,1529,1471,58,0,105,104
-1,1693,1890,-197,-9,-77,40
1,1740,1616,124,0,6,79
1,2025,1894,131,1,32,65
1,1638,1556,82,1,312,124
-1,1407,1474,-67,0,50,88
-1,1490,1472,18,0,17,41
-1,1703,1720,-17,-4,-34,106
-1,1178,1832,-654,-16,-372,52
1,1356,1558,-202,-2,-184,77
1,1915,1956,-41,0,96,113
1,1382,1286,96,-1,-42,43
1,1823,1514,309,3,106,45
1,1492,1469,23,1,110,101
-1,1641,1654,-13,0,-17,80
1,1450,1200,250,3,144,57
-1,1535,1653,-118,-2,-40,72
-1,1609,1750,-141,-3,-68,50
1,1586,1174,412,1,145,85
-1,1470,1549,-79,-5,-277,76
-1,1717,1777,-60,0,-373,150
-1,1500,1760,-260,-4,-565,90
-1,1311,1559,-248,-2,-299,72
1,1914,1811,103,6,173,51
1,1876,1654,222,0,182,123
-1,1478,1483,-5,0,122,42
1,1390,1444,-54,-3,-44,73
-1,1761,1705,56,0,-59,80
1,1675,1389,286,2,187,67
-1,1487,1559,-72,-4,-56,44
-1,1195,1395,-200,0,-130,77
1,1833,1172,661,16,509,57
1,1616,1751,-135,2,153,87
-1,1305,1416,-111,-6,-50,42
1,1922,1686,236,0,170,95
1,1456,1618,-162,-6,5,56
-1,1380,1683,-303,-4,5,42
1,1588,1416,172,0,-5,57
-1,1688,1648,40,0,-56,70
0,1593,1572,21,0,-543,157
1,1664,1569,95,1,4,99
-1,1727,1622,105,-1,-99,64
-1,1476,1229,247,-1,3,50
-1,1749,1469,280,2,45,66
1,1500,1385,115,0,242,79
1,1896,1689,207,0,64,71
-1,1709,1275,434,1,0,112
1,1458,1502,-44,3,27,41
1,1404,1594,-190,-2,-73,73
1,1707,1199,508,9,704,79
-1,1226,1496,-270,-1,-42,56
1,1601,1473,128,3,53,41
1,1739,1743,-4,4,83,59
-1,1719,1749,-30,0,45,74
-1,1582,1504,78,-4,-158,58
1,1730,1458,272,2,314,113
-1,1166,1834,-668,-12,-401,58
1,1468,1684,-216,3,235,99
-1,1602,1616,-14,0,-148,104
-1,1334,1703,-369,-12,-753,86
-1,1730,1775,-45,0,-56,82
1,1315,1401,-86,-1,-29,45
1,1679,1902,-223,2,629,125
1,1627,1187,440,1,149,55
0,1465,1609,-144,4,13,153
1,1462,1538,-76,1,178,131
1,1461,1428,33,4,467,123
-1,1403,1483,-80,-2,-324,70
-1,1756,1510,246,0,-106,74
-1,1887,2032,-145,0,-32,62
1,1509,1437,72,2,326,93
-1,1739,1800,-61,0,-50,60
-1,1709,1750,-41,1,-299,134
-1,1591,1593,-2,0,-413,134
-1,1485,1372,113,0,-26,66
1,1835,1161,674,-5,89,63
1,1884,1711,173,0,14,91
-1,1153,1480,-327,-6,-131,49
-1,1738,1741,-3,-1,-471,82
-1,1759,1708,51,0,-11,100
-1,1927,1780,147,0,3,60
-1,1567,1398,169,2,-129,96
-1,1599,1811,-212,-7,155,84
-1,1420,1535,-115,-5,-50,84
1,1655,1538,117,3,209,63
0,1571,1537,34,1,73,102
1,1734,1633,101,0,31,69
1,1485,1474,11,2,32,47
-1,1861,2071,-210,1,138,120
-1,1496,1592,-96,1,26,56
-1,1621,1765,-144,-4,-62,44
1,1890,1933,-43,0,32,59
1,1672,1676,-4,2,127,61
1,1803,1751,52,1,16,53
-1,1374,1481,-107,-7,-289,60
-1,1819,1867,-48,-1,-139,70
1,1636,1713,-77,0,48,61
-1,1722,1737,-15,-1,-84,78
1,1686,1560,126,1,52,51
-1,1375,1555,-180,0,-349,100
-1,1812,1742,70,-1,8,72
-1,1155,1835,-680,-20,-475,48
-1,1375,1601,-226,-7,-16,44
1,1698,1605,93,-1,225,169
0,1738,1610,128,0,2,67
-1,1298,1686,-388,-4,-281,76
1,1495,1453,42,3,81,51
-1,1847,1903,-56,0,-5,68
1,1612,1367,245,0,-7,51
0,1755,1800,-45,4,455,143
-1,998,1629,-631,-11,-248,51
1,1836,1150,686,11,483,67
1,1609,1551,58,1,585,141
-1,1331,1175,156,-7,-187,60
1,1345,1379,-34,1,253,69
1,1468,1301,167,0,92,85
-1,1574,1788,-214,0,-54,104
1,1730,1880,-150,3,58,42
-1,1341,1258,83,-2,39,54
-1,1795,1866,-71,0,-94,76
-1,1576,1807,-231,-1,-94,122
1,1472,1454,18,-4,467,125
-1,1552,1693,-141,0,-48,44
1,1573,1600,-27,-1,11,49
1,1837,1756,81,-1,36,55
-1,1417,1476,-59,-6,-340,70
-1,1721,1746,-25,0,-136,92
1,1883,1518,365,5,286,71
1,1513,1595,-82,4,155,49
1,1564,1520,44,1,141,99
1,1624,1743,-119,1,107,111
-1,1772,1615,157,-4,-294,136
1,1569,1484,85,3,157,71
1,2006,1651,355,-2,16,81
1,2078,1856,222,0,31,117
-1,1554,1585,-31,-1,74,158
-1,1852,2084,-232,-2,66,100
-1,1343,1476,-133,0,-449,164
-1,1575,1613,-38,3,-227,94
1,1859,1381,478,7,122,49
0,1367,1357,10,2,133,99
1,1672,1676,-4,2,111,75
-1,1395,1536,-141,-2,-738,134
1,1471,1453,18,1,231,61
1,1688,1318,370,0,22,51
1,1720,1793,-73,3,117,77
-1,1756,1711,45,-4,-34,52
1,1562,1786,-224,-1,-111,101
-1,1328,1322,6,0,-179,108
-1,1487,1414,73,-5,-138,57
-1,1472,1541,-69,-2,-58,64
1,1838,1141,697,4,165,47
0,1486,1408,78,1,79,118
1,1690,1818,-128,-1,-51,71
-1,1566,1492,74,0,-56,54
1,1649,1618,31,-4,-90,71
-1,1379,1861,-482,-4,-75,56
-1,1589,1555,34,-1,-91,91
-1,1464,1464,0,1,77,64
-1,1588,1615,-27,-5,-6,40
1,2091,1847,244,3,108,73
-1,1875,1724,151,1,-49,102
-1,1315,1265,50,7,90,56
-1,1704,1734,-30,0,6,44
-1,1547,1579,-32,-1,7,94
-1,1678,1633,45,0,-24,72
-1,1514,1886,-372,-1,-46,85
-1,1564,1743,-179,-5,-158,54
1,1283,1185,98,2,19,51
1,1887,1834,53,0,158,87
1,1553,1568,-15,-1,-139,73
-1,1322,1382,-60,-6,-390,70
-1,1254,1832,-578,-4,-96,58
1,1889,1421,468,1,61,59
1,1014,1228,-214,7,89,49
-1,1962,1584,378,0,-325,242
1,1734,1549,185,2,112,74
1,1845,1536,309,0,54,65
0,1971,1741,230,0,55,105
-1,1570,1416,154,-1,76,92
-1,1803,1788,15,0,-18,76
-1,1331,1510,-179,-3,-303,122
1,1600,1588,12,0,-8,57
1,1895,1811,84,-2,-266,105
-1,1588,1580,8,1,-38,83
1,1610,1551,59,8,149,43
1,1419,1500,-81,0,-3,79
-1,1901,2061,-160,0,-36,100
1,1899,2061,-162,0,39,149
-1,1428,1539,-111,7,-93,122
-1,1414,1505,-91,0,172,82
0,1553,1448,105,0,81,109
-1,1644,1546,98,-1,-9,40
1,1847,1579,268,-1,-25,59
-1,1210,1338,-128,-1,-9,45
-1,1451,1550,-99,-1,-14,56
0,1609,1539,70,-1,-65,98
-1,1377,1363,14,0,-21,76
1,1733,1310,423,8,372,73
-1,1501,1467,34,-5,-113,46
0,1641,1656,-15,-1,-385,259
1,1247,1517,-270,0,40,57
1,1572,1332,240,0,0,67
1,1263,1500,-237,7,459,81
-1,2069,1895,174,0,27,66
-1,1458,1543,-85,-2,-47,48
-1,1488,1339,149,-2,15,148
-1,1577,1611,-34,-2,-138,76
-1,1543,1660,-117,-4,-258,66
-1,1560,1628,-68,0,-313,89
-1,1449,1552,-103,-7,-58,42
1,1576,1282,294,0,11,41
1,1723,1854,-131,0,-66,95
1,2004,1497,507,-7,21,85
-1,1229,1597,-368,1,79,52
1,1345,1194,151,1,119,61
-1,1373,1358,15,0,-335,88
-1,1456,1545,-89,-10,-122,44
-1,1911,2050,-139,-1,-104,90
0,1682,1630,52,0,80,119
-1,1545,1456,89,-1,36,72
1,1607,1500,107,5,183,69
-1,1501,1857,-356,-1,-24,44
1,1941,1677,264,1,178,93
-1,1577,1555,22,-2,-125,106
1,1540,1460,80,4,1173,129
0,1572,1405,167,-5,-412,144
-1,1547,1420,127,-2,-313,82
-1,1913,2009,-96,1,15,54
1,2172,1998,174,-2,230,111
-1,1500,1344,156,1,23,66
1,1500,1367,133,-1,25,53
1,2162,2005,157,1,27,89
-1,1565,1365,200,0,80,66
1,1929,1347,582,0,487,133
1,1774,1500,274,0,-6,61
1,1911,1567,344,0,-10,43
-1,1616,1595,21,-3,-220,86
1,2179,1990,189,-4,20,55
-1,1607,1554,53,-10,-58,96
-1,1582,1722,-140,-2,-35,46
-1,1348,1727,-379,-3,-76,56
1,1592,1624,-32,-3,-99,121
-1,1371,1478,-107,-7,-283,54
-1,1897,2066,-169,0,-206,102
1,1636,1193,443,0,65,83
1,1528,1180,348,0,55,61
-1,1923,1539,384,-1,-25,52
-1,1984,2185,-201,-1,-143,82
-1,1318,1473,-155,-1,-43,66
-1,1580,1507,73,0,1,46
1,1548,1642,-94,0,-2,55
1,1735,1672,63,3,97,75
-1,1778,1977,-199,0,-90,144
1,1642,1710,-68,1,199,71
1,1662,1678,-16,0,-13,62
-1,1600,1550,50,-5,-432,102
1,1906,1804,102,-1,4,47
1,1834,1346,488,6,98,41
-1,1566,1823,-257,-4,-249,124
-1,1607,1557,50,-2,-191,96
0,1717,1813,-96,3,71,120
1,1593,1177,416,1,31,45
1,1829,1802,27,1,23,43
1,1563,1344,219,5,350,69
-1,1827,1562,265,-4,-714,98
1,1918,1631,287,3,123,79
0,1567,1482,85,-3,-44,48
1,1798,1881,-83,1,22,79
1,1380,1175,205,0,238,71
1,1685,1371,314,1,194,63
1,1500,1500,0,1,404,91
-1,1594,1984,-390,0,-8,98
-1,1500,1570,-70,-9,-348,62
-1,1581,1809,-228,2,131,76
-1,1582,1501,81,0,-39,74
-1,1627,1827,-200,0,20,68
-1,1531,1980,-449,5,-178,102
-1,1674,1793,-119,0,-123,92
-1,1658,1676,-18,3,28,50
1,1986,1592,394,3,393,79
-1,1435,1275,160,2,39,46
1,1814,1576,238,4,444,86
-1,1183,1413,-230,-7,-683,74
1,1707,1522,185,2,129,79
-1,1438,1945,-507,-1,-200,114
-1,1569,1939,-370,-2,-107,62
1,1851,1748,103,-4,-48,65
-1,1700,1670,30,0,-61,62
-1,1589,1989,-400,-5,-115,68
-1,1571,1819,-248,-5,-164,70
1,1391,1352,39,6,350,69
-1,1410,1638,-228,-12,-170,40
-1,1515,1713,-198,-9,-513,86
-1,1599,1848,-249,3,101,66
1,1567,1368,199,-9,-287,95
-1,1181,1393,-212,2,-128,122
-1,1621,1338,283,0,44,62
1,1720,1681,39,0,-12,89
1,1605,1554,51,3,146,67
-1,1572,1566,6,-1,-74,98
1,1683,1730,-47,0,0,91
1,1823,1566,257,0,-8,71
-1,1643,1405,238,-2,-108,86
1,1482,1470,12,1,27,41
1,1688,1564,124,6,235,55
-1,1791,1864,-73,0,14,60
-1,1873,1545,328,1,128,98
1,1718,1509,209,-1,17,81
-1,1562,1827,-265,1,107,92
1,1662,1406,256,1,71,97
-1,1426,1486,-60,0,6,60
1,1740,1860,-120,1,24,43
-1,1422,1424,-2,-4,-51,40
-1,1267,1364,-97,-2,-81,56
1,1889,1546,343,-1,36,71
-1,1910,1853,57,0,-71,108
1,1811,1800,11,-3,-40,71
1,1697,1648,49,-3,3,47
1,1724,1303,421,5,108,51
1,1655,1731,-76,0,39,70
0,1579,1500,79,0,-35,115
1,1582,1520,62,0,12,79
1,1627,1665,-38,0,78,169
-1,1696,1853,-157,-5,-110,66
1,1681,1688,-7,1,54,79
1,1772,1425,347,-3,-33,77
1,1605,1566,39,-1,-17,81
-1,1746,1601,145,1,-54,64
1,1562,1454,108,-9,-247,105
-1,1807,1754,53,0,-125,110
-1,1730,1455,275,3,60,92
1,1494,1203,291,2,113,75
-1,1689,1726,-37,0,-167,124
1,1612,1666,-54,-1,-28,83
1,1982,1529,453,3,119,58
-1,1178,1418,-240,-19,-654,53
-1,1423,1624,-201,-4,-161,80
1,1682,1495,187,6,198,55
-1,1507,1592,-85,-5,-253,66
1,1447,1570,-123,1,106,87
1,1470,1946,-476,1,-6,57
-1,1300,1421,-121,-1,1,42
1,1779,1713,66,2,10,101
1,1555,1461,94,-1,-35,81
1,1435,1405,30,-3,64,93
-1,1278,1460,-182,-2,-26,50
1,1611,1497,114,0,69,65
-1,1754,1671,83,0,109,84
-1,1199,1585,-386,5,215,78
-1,1475,1370,105,0,21,64
-1,1563,1991,-428,-1,-626,86
1,1575,1511,64,4,123,58
-1,1864,1480,384,0,-9,84
0,1695,1928,-233,1,261,141
1,1517,1630,-113,2,210,93
-1,1573,1716,-143,0,-71,74
-1,1498,1729,-231,3,92,66
-1,1796,1994,-198,-1,-60,46
1,1495,1677,-182,2,351,85
-1,1073,1453,-380,-9,-126,60
-1,1704,1789,-85,-2,-300,136
-1,1747,1964,-217,0,-335,144
-1,1580,1800,-220,-4,-2,42
-1,1176,1423,-247,0,-233,78
-1,1565,1527,38,0,-58,96
-1,1694,2055,-361,0,-164,118
1,2000,1790,210,-1,275,139
1,1805,1575,230,2,397,71
-1,1822,1877,-55,-4,-268,88
1,1714,1500,214,12,977,117
0,1922,1767,155,0,-8,87
1,1570,1810,-240,-1,-37,65
-1,1256,1500,-244,0,-124,68
0,1784,2007,-223,0,132,111
1,1685,1741,-56,-1,-188,105
1,1436,1511,-75,2,75,63
1,1711,1479,232,1,88,61
-1,1289,1361,-72,0,13,42
-1,1669,1801,-132,0,6,68
1,1792,1588,204,2,3,65
1,1402,1194,208,12,583,69
1,1841,1734,107,0,-4,95
1,1820,1790,30,2,-115,63
-1,1539,1578,-39,1,-8,52
-1,1999,1791,208,-3,-569,138
-1,1491,1625,-134,-3,-84,48
-1,1582,1798,-216,-1,-37,74
1,1496,1450,46,1,319,125
-1,1853,1785,68,-9,-178,74
1,1618,1601,17,2,101,61
1,1809,1979,-170,0,169,121
0,1803,1577,226,2,41,134
1,1888,1733,155,-2,13,51
-1,1654,1739,-85,-1,-51,76
-1,1405,1719,-314,-11,-639,76
-1,1736,1423,313,-1,-31,69
1,1960,1825,135,-1,-130,113
1,1577,1267,310,7,702,93
-1,1584,1796,-212,-2,-73,100
-1,1440,1507,-67,-3,-450,98
-1,1898,1579,319,-3,-47,44
-1,1428,1579,-151,0,0,84
1,1448,1333,115,10,607,95
-1,1729,1697,32,1,14,50
1,1554,1664,-110,1,9,47
-1,1637,2087,-450,-1,-33,48
-1,1772,1917,-145,-3,-194,82
1,1689,1548,141,-4,-40,61
1,1695,1639,56,1,203,99
1,1818,1968,-150,0,85,65
1,1713,1722,-9,0,139,109
1,1516,1459,57,-2,24,73
1,1368,1169,199,0,249,81
1,1691,1500,191,1,414,173
1,1517,1431,86,14,501,55
1,1309,1565,-256,9,541,85
-1,1500,1641,-141,-6,-142,46
1,1950,1834,116,0,-16,75
-1,1552,1626,-74,0,-33,82
1,1685,1726,-41,-2,-206,69
1,1921,1712,209,2,127,83
1,1712,1831,-119,1,43,89
-1,1826,1959,-133,0,15,54
-1,1600,1598,2,0,40,54
1,1709,1717,-8,2,35,49
-1,1722,1654,68,-1,-17,48
0,1346,1547,-201,2,681,179
1,1942,2001,-59,-2,-21,47
1,1554,1500,54,9,357,65
1,1771,1636,135,1,124,103
1,1967,1819,148,-2,-45,55
-1,1693,1578,115,-2,-20,86
-1,1416,1389,27,-1,-338,116
-1,1629,2089,-460,0,-89,90
-1,1925,1765,160,-5,-274,98
-1,1812,1975,-163,-2,-50,40
1,1545,1535,10,4,149,61
-1,1661,1633,28,3,64,64
-1,1954,1580,374,0,75,118
0,1714,1697,17,1,351,145
-1,1568,1713,-145,0,-42,70
1,1593,1679,-86,1,-93,75
-1,1464,1295,169,-1,-127,64
-1,1580,1474,106,-4,-200,124
-1,1517,1850,-333,0,-51,96
1,1836,1542,294,1,55,63
-1,1860,1589,271,1,37,104
-1,1982,1805,177,0,-686,136
1,1548,1587,-39,-1,-129,119
1,1696,1707,-11,0,-7,75
-1,1708,1620,88,2,42,54
-1,1666,1607,59,-2,-157,90
-1,1748,1646,102,1,-38,74
1,1919,2058,-139,-1,81,149
-1,1338,1823,-485,3,-149,104
-1,1449,1528,-79,-1,-126,102
-1,1523,1556,-33,0,-56,60
0,1822,1963,-141,0,-189,119
-1,1500,1875,-375,-4,-36,66
1,1621,1654,-33,-3,65,71
1,1500,1512,-12,1,-4,75
1,1959,1826,133,0,42,53
-1,1304,1638,-334,-2,-82,80
0,1549,1415,134,2,62,89
-1,1642,1633,9,0,104,76
1,2091,1628,463,1,178,113
1,1698,1714,-16,-1,-32,59
-1,1944,1731,213,0,-97,74
1,1819,1967,-148,-9,343,131
1,1681,1504,177,0,239,111
-1,1644,1631,13,0,1,52
1,1317,1493,-176,2,46,51
0,1643,1832,-189,1,419,136
0,1713,1842,-129,-1,-45,121
1,1528,1554,-26,1,25,47
0,1829,1969,-140,0,-30,144
1,1582,1457,125,1,272,119
-1,1300,1578,-278,7,84,60
1,1597,1458,139,0,-53,95
1,1456,1297,159,2,180,59
-1,1328,1593,-265,3,-207,86
-1,1659,1697,-38,-2,-48,68
1,1404,1139,265,2,222,73
-1,1489,1487,2,-3,-250,98
1,1742,1844,-102,-4,-126,71
1,1941,1430,511,-2,44,51
-1,1650,1827,-177,1,66,64
-1,1847,1898,-51,0,-189,114
-1,1553,1852,-299,-8,-421,66
-1,1703,1735,-32,-4,-213,80
-1,1290,1502,-212,-2,-109,60
-1,1510,1413,97,0,-23,142
1,1663,1530,133,-6,-176,71
0,1634,1581,53,-1,-51,109
1,1692,1575,117,2,47,49
1,1542,1552,-10,8,11,41
1,1768,1665,103,-2,-45,57
-1,1143,1115,28,-3,-104,54
1,1553,1624,-71,6,102,45
-1,1685,1502,183,0,112,120
1,1965,1833,132,-1,7,129
1,1669,1456,213,6,401,83
1,1643,1833,-190,1,509,113
1,1140,1129,11,-4,-76,43
1,1534,1284,250,0,12,59
1,1648,1607,41,10,438,75
-1,1593,1680,-87,-2,-85,58
1,1570,1471,99,3,299,103
-1,1748,1687,61,-1,-94,76
1,1116,1162,-46,3,-61,45
-1,1746,1693,53,0,-24,82
-1,1410,1312,98,-1,-18,44
1,1852,1838,14,0,439,165
-1,1341,1332,9,1,-14,66
1,1446,1409,37,1,37,55
1,1586,1603,-17,0,35,51
-1,1459,1519,-60,-1,-56,52
1,1982,1573,409,-7,-94,43
1,1485,1026,459,13,395,55
1,1610,1567,43,-2,45,127
-1,1893,1592,301,-4,-243,74
1,1768,1879,-111,-6,-194,79
-1,1279,1558,-279,-8,-328,70
1,1507,1478,29,0,200,141
-1,1536,1746,-210,0,-123,78
1,1584,1231,353,0,372,97
-1,1662,1794,-132,-5,51,76
1,1706,1781,-75,0,-30,111
1,1652,1700,-48,2,429,107
1,1602,1324,278,13,465,59
1,1512,1463,49,0,37,63
1,1411,1351,60,7,618,91
-1,1614,1658,-44,-4,-147,60
1,1381,1609,-228,-6,-80,55
-1,1536,1666,-130,-9,-140,54
1,1657,1776,-119,-10,-11,95
-1,1654,1458,196,-8,139,114
1,1625,1543,82,8,430,77
-1,1337,1719,-382,0,-126,86
-1,1858,1826,32,-2,-174,90
-1,1600,1800,-200,0,-40,74
1,1719,1802,-83,0,-20,67
-1,1634,1500,134,1,-46,78
1,1443,1522,-79,0,54,61
1,1323,1501,-178,5,373,87
-1,1542,1577,-35,-7,-68,50
1,1578,1274,304,-1,12,59
-1,1457,1429,28,-4,-287,114
1,1500,1360,140,19,1398,87
1,1887,1326,561,2,92,51
1,1745,1818,-73,1,57,75
1,1691,1549,142,1,325,97
-1,1673,1528,145,-1,-12,44
1,1508,1470,38,1,18,79
1,1578,1608,-30,2,163,79
1,1717,1896,-179,-1,5,87
-1,1444,1489,-45,-1,-929,134
-1,1689,1695,-6,-1,-85,79
1,1632,1739,-107,-4,10,83
-1,1735,1828,-93,0,9,48
1,1369,1385,-16,6,841,121
1,1678,1664,14,-1,20,49
1,1544,1657,-113,9,275,56
-1,1595,1584,11,0,11,58
1,1342,1461,-119,2,88,57
-1,1732,1787,-55,2,44,88
-1,1838,1846,-8,0,-126,110
-1,1733,1614,119,-10,-44,42
-1,1500,1465,35,4,96,56
1,1865,1782,83,0,65,64
1,1505,1475,30,-1,-24,81
-1,1464,1211,253,0,417,112
0,1278,1379,-101,-3,295,115
-1,1689,1653,36,-5,-45,58
-1,1584,1650,-66,-3,-331,99
0,1534,1633,-99,-3,-54,88
1,1674,1594,80,-4,-30,59
1,1679,1761,-82,0,8,99
-1,1463,1532,-69,6,128,122
-1,1587,1658,-71,-8,-139,62
-1,1667,1716,-49,-1,-142,84
-1,1871,1844,27,0,-25,132
-1,1038,1630,-592,-10,-101,40
1,1888,1321,567,6,86,43
-1,1665,1677,-12,0,-121,90
-1,1501,1471,30,0,-17,53
-1,1558,1682,-124,1,77,136
-1,1500,1620,-120,-1,-45,46
-1,1501,1500,1,1,74,68
1,1732,1552,180,-2,-34,45
-1,1524,1441,83,-1,-85,68
1,1435,1620,-185,-4,-233,103
-1,1596,1583,13,0,-10,54
1,1857,1827,30,0,21,73
1,1856,1742,114,2,147,85
-1,1472,1573,-101,0,-26,72
-1,1748,1699,49,0,-5,80
-1,1630,1527,103,1,-16,50
-1,1687,1655,32,-2,-146,108
-1,1689,1530,159,0,-65,94
1,1464,1511,-47,3,710,105
-1,1317,1602,-285,-4,-118,62
-1,1336,1503,-167,0,-169,66
0,1726,1715,11,1,-68,127
1,1749,1814,-65,-2,-55,57
-1,1500,1347,153,-5,-39,60
1,1541,1615,-74,1,23,49
1,1585,1674,-89,1,192,73
1,1401,1500,-99,7,621,65
1,1611,1627,-16,2,265,93
1,1626,1301,325,7,302,61
1,1757,1977,-220,-1,148,133
1,1592,1503,89,-2,18,45
-1,1235,1393,-158,-5,-259,60
-1,1283,1605,-322,-2,-32,50
-1,1667,1675,-8,-2,5,56
-1,1484,1670,-186,-5,-236,74
1,1695,1700,-5,0,147,77
-1,1675,1603,72,0,-57,62
1,1530,1381,149,-5,146,83
1,2015,1871,144,0,159,71
1,1865,1711,154,1,31,47
-1,1409,1738,-329,-11,-521,64
-1,1520,1422,98,0,-397,142
1,1661,1628,33,0,-95,71
1,1457,1189,268,0,-8,91
1,1418,1208,210,4,64,55
-1,1399,1420,-21,1,57,51
1,1273,1418,-145,1,63,45
1,1733,1668,65,1,54,98
-1,1595,1617,-22,0,-11,60
-1,1268,1410,-142,-4,-57,48
1,1774,1677,97,-1,454,133
0,1574,1640,-66,-3,-98,71
1,1606,1310,296,3,358,75
1,1611,1649,-38,0,-35,77
0,1600,1232,368,-3,135,121
-1,1411,1500,-89,0,-20,64
-1,1279,1680,-401,0,-3,46
1,1771,1813,-42,-2,-45,65
1,1263,1478,-215,1,386,119
-1,1599,1671,-72,2,374,84
-1,1225,1307,-82,0,-475,114
1,1723,1497,226,0,82,67
1,1609,1683,-74,5,422,83
1,1403,1277,126,-1,-38,73
1,1424,1373,51,-2,354,105
-1,1582,1476,106,-7,-56,46
1,2148,1767,381,1,7,41
1,1584,1406,178,3,574,113
1,1705,1873,-168,0,4,51
1,1622,1636,-14,0,96,83
0,1611,1554,57,-5,41,127
1,1223,1190,33,-4,1,59
-1,1412,1665,-253,2,-144,94
-1,1680,1575,105,0,0,56
-1,1491,1728,-237,-2,-49,66
-1,1368,1393,-25,-9,-96,52
-1,1498,1475,23,0,-211,96
1,1406,1448,-42,0,11,63
1,1464,1671,-207,3,595,135
1,1705,1564,141,2,81,59
1,1760,1710,50,-1,561,123
1,1774,1778,-4,1,3,87
1,1631,1268,363,0,3,51
-1,1348,1677,-329,-3,-4,40
1,1864,2022,-158,-1,-23,67
1,1611,1666,-55,2,73,75
-1,1739,1800,-61,-3,-51,62
1,1511,1407,104,15,740,81
1,1433,1363,70,1,294,115
1,1611,1266,345,-2,-59,51
-1,1769,1700,69,-1,-45,54
-1,1671,1634,37,-1,-334,118
1,1892,1707,185,-5,-131,53
1,1246,1484,-238,-2,160,67
-1,1424,1520,-96,-8,-215,54
-1,1816,1838,-22,1,-541,124
-1,1488,1389,99,-8,-77,40
-1,1397,1265,132,-8,-333,70
1,1105,1239,-134,-3,522,117
0,1431,1599,-168,1,16,76
1,1854,1720,134,-1,-62,67
-1,1378,1646,-268,-2,-179,78
-1,1813,1864,-51,5,-217,106
-1,1655,1576,79,0,-99,72
1,1402,1638,-236,-3,-276,93
1,1623,1712,-89,0,38,79
-1,1594,1354,240,0,-24,56
-1,1096,1746,-650,-4,-341,82
1,1578,1402,176,-1,46,98
-1,1403,1483,-80,0,14,66
1,1466,1305,161,3,135,53
-1,1639,1283,356,0,-146,78
-1,1556,1607,-51,1,24,40
-1,1372,1666,-294,-6,-248,66
-1,1654,1840,-186,0,-46,66
-1,1810,1855,-45,-1,-183,80
1,1541,1500,41,1,84,51
1,1461,1282,179,4,102,45
1,1650,1306,344,6,366,85
1,1451,1685,-234,1,142,80
1,936,0,936,21,525,53
1,1590,1376,214,2,153,81
1,1269,1537,-268,-4,-168,49
1,1847,1648,199,1,-84,107
-1,1275,1467,-192,-1,-131,88
1,1601,1557,44,0,-6,51
1,1500,1536,-36,-1,73,95
-1,1364,1439,-75,-3,-80,54
0,1713,1863,-150,-3,-17,107
1,1428,1303,125,-5,153,87
-1,1416,1548,-132,-10,-306,71
-1,1628,1626,2,1,25,72
1,1580,1596,-16,0,16,47
1,1522,1148,374,0,58,63
-1,1722,1800,-78,0,-579,110
0,1147,1233,-86,-2,-489,219
0,1636,1697,-61,1,41,123
1,1642,1853,-211,0,251,117
-1,1664,1628,36,1,-320,100
-1,1358,1741,-383,-4,-9,42
1,1702,1613,89,0,235,101
-1,1295,1525,-230,-2,-95,64
1,1909,1539,370,3,116,81
1,1472,1438,34,-2,-79,67
-1,1648,1617,31,0,12,68
1,1834,1660,174,1,-115,147
1,1857,1718,139,0,-4,53
-1,1623,1701,-78,1,17,44
-1,1714,1818,-104,0,-324,84
-1,1488,1611,-123,-1,-22,74
1,1603,1710,-107,-4,36,74
1,1575,1289,286,-1,57,67
-1,1367,1595,-228,-9,-209,50
1,1677,1573,104,2,43,55
1,1595,1295,300,-1,-17,45
-1,1682,1716,-34,-2,-9,42
1,1269,1456,-187,-1,336,119
1,1696,1621,75,4,350,89
-1,1878,1797,81,1,-17,46
-1,1653,1841,-188,0,-85,66
1,1500,1435,65,4,129,53
1,1482,1528,-46,1,-11,41
1,1600,1094,506,-2,-185,109
-1,1711,1865,-154,0,-56,84
-1,1607,1885,-278,0,-219,94
-1,1848,1748,100,-1,-11,94
1,1867,1825,42,-1,41,165
-1,1673,1560,113,-5,-281,74
1,1395,1285,110,-10,-290,63
-1,1572,1849,-277,-1,-85,71
1,1687,1570,117,0,148,99
-1,1357,1637,-280,-3,-220,98
0,1565,1685,-120,-4,-519,103
1,1847,1648,199,0,113,81
1,1691,1627,64,1,207,97
-1,1415,1428,-13,-3,-163,72
1,1578,1889,-311,0,490,85
-1,1341,1435,-94,-5,-116,44
-1,1433,1669,-236,-7,-602,92
-1,1629,1625,4,1,48,56
-1,1528,1694,-166,-1,-227,64
1,1515,1495,20,2,15,41
1,1872,1707,165,-1,-77,47
-1,1585,1645,-60,-4,-465,86
1,1229,1107,122,-2,292,77
1,1529,1351,178,6,146,43
1,1671,1878,-207,3,563,97
1,1616,1700,-84,-1,-93,123
1,1697,1458,239,-1,65,127
1,1641,1353,288,-1,-1,59
1,1815,1848,-33,0,88,73
-1,1682,1569,113,0,12,50
-1,1672,1912,-240,0,-9,96
-1,1500,1659,-159,-8,-225,52
1,1710,1332,378,-3,-32,41
-1,1203,1668,-465,-1,-232,82
-1,1568,1628,-60,0,-31,48
1,1870,1723,147,-1,-25,53
1,1546,1486,60,1,141,66
1,1667,1566,101,0,13,71
1,1745,1577,168,2,111,70
-1,1439,1540,-101,-4,-58,46
-1,1695,1877,-182,1,13,50
-1,1717,1962,-245,0,3,46
1,1275,1383,-108,1,327,73
-1,1883,1673,210,-3,-607,154
-1,1188,1444,-256,-4,-291,94
1,1816,1877,-61,2,29,47
1,1637,1557,80,3,90,55
1,1278,1092,186,9,247,51
-1,1439,1441,-2,-2,-161,64
-1,1584,1667,-83,-7,-70,50
1,1477,1556,-79,-1,45,45
1,1967,1288,679,2,96,55
1,1765,1523,242,4,259,63
1,1677,1202,475,-4,-52,69
-1,1806,1984,-178,-1,-108,94
-1,1811,1714,97,-1,-59,60
1,1307,1563,-256,6,204,63
-1,1599,1445,154,1,-38,84
-1,1783,1798,-15,-1,-180,88
-1,1732,1866,-134,2,30,46
1,1427,1351,76,0,-12,57
1,1864,1828,36,1,113,81
1,1541,1720,-179,2,149,89
1,1991,1799,192,0,108,113
1,1874,1710,164,-3,-112,51
-1,1329,1439,-110,2,-13,96
-1,1429,1434,-5,0,93,96
-1,1602,1572,30,0,-8,82
-1,1917,1618,299,0,-157,138
1,1676,1575,101,-2,-58,49
1,1968,1692,276,7,101,41
1,1183,1287,-104,-8,-258,51
1,1691,1880,-189,-2,313,185
-1,1747,1552,195,0,-12,120
1,1785,1763,22,1,99,69
-1,1440,1420,20,6,297,46
-1,1674,1725,-51,-1,-41,60
1,1330,1257,73,-2,-444,115
1,1541,1490,51,1,189,89
1,1206,1430,-224,1,564,113
-1,1449,1668,-219,-1,-16,52
-1,1296,1374,-78,-1,2,54
1,1444,1201,243,-1,-46,49
-1,1702,1669,33,0,-137,88
-1,1972,1273,699,-1,29,42
1,1681,1708,-27,-5,-141,107
-1,1737,1864,-127,1,31,48
1,1496,1680,-184,5,239,74
-1,1352,1725,-373,-3,-25,48
-1,1512,1289,223,-3,-41,43
1,1673,1443,230,2,60,46
1,1406,1500,-94,-4,-113,55
-1,1632,2082,-450,-3,-377,94
-1,1683,1947,-264,-5,-16,42
-1,1567,1684,-117,-1,-39,58
-1,1871,1718,153,-1,166,66
-1,1819,1874,-55,1,-12,94
-1,1776,2055,-279,-2,-201,74
-1,1757,1856,-99,-3,-37,72
1,1772,1609,163,0,167,75
-1,1436,1707,-271,-16,-184,40
1,1642,1630,12,-9,-310,83
-1,1481,1551,-70,-1,-109,60
-1,1262,1411,-149,-2,-62,44
1,1484,1398,86,-4,0,47
1,1582,1363,219,-3,39,63
1,1722,1871,-149,0,702,103
-1,1659,1458,201,-1,-84,52
-1,1300,1930,-630,7,191,60
1,1460,1340,120,0,6,63
1,1899,1930,-31,1,30,45
1,1873,1822,51,0,21,81
-1,1610,1500,110,-11,-120,44
-1,1691,1560,131,-4,-15,43
-1,1618,1665,-47,-3,-176,80
-1,1430,1396,34,-2,40,90
1,1610,1737,-127,0,9,43
1,1432,1262,170,1,321,109
1,1296,1421,-125,4,33,51
-1,1810,1743,67,1,-11,56
1,1856,1754,102,0,210,99
1,1686,1607,79,8,340,75
1,1426,1693,-267,-5,-189,77
-1,1565,1734,-169,-5,-441,98
-1,1345,1525,-180,-6,-49,42
-1,1692,1557,135,-2,72,80
-1,1883,1810,73,-1,-50,102
1,1446,1418,28,9,657,87
1,1930,1299,631,3,147,53
-1,1722,1626,96,-1,-3,42
-1,1941,1919,22,1,-44,96
1,1383,1281,102,0,2,41
-1,1500,1522,-22,-1,-3,50
1,1646,1569,77,4,133,55
1,1914,1463,451,2,36,49
0,1665,1649,16,0,21,107
1,1718,1588,130,0,-1,55
1,1251,1300,-49,-1,-21,73
1,1641,1701,-60,2,35,49
-1,1361,1418,-57,-3,-154,82
-1,1299,1931,-632,-4,-91,62
-1,1587,1563,24,0,-117,88
1,1307,1347,-40,6,108,45
-1,1409,1447,-38,-8,-260,68
1,1439,1357,82,2,49,133
1,1488,1383,105,-1,9,73
-1,1727,1758,-31,0,-12,98
-1,1680,1695,-15,0,-7,56
1,2059,1797,262,0,32,81
0,1984,1835,149,0,-136,112
-1,1756,1796,-40,4,188,124
-1,1803,1882,-79,0,-7,70
1,1655,1707,-52,0,-8,93
-1,1319,1480,-161,-1,-195,107
1,1932,1298,634,1,37,55
-1,1822,1870,-48,0,-234,106
-1,1500,1795,-295,-1,-203,102
1,1916,1320,596,2,155,58
-1,1613,1825,-212,0,-12,40
-1,1407,1835,-428,-7,-715,96
-1,1869,1761,108,-4,-238,70
1,1465,1347,118,1,-101,121
1,1548,1511,37,0,-3,63
1,1716,1523,193,-3,-71,73
1,1577,1597,-20,2,-2,41
1,1789,1960,-171,3,172,75
1,1930,1871,59,0,-30,107
1,1682,1492,190,0,21,49
-1,1244,1619,-375,-6,-224,52
-1,1489,1286,203,-2,-183,78
-1,1297,1933,-636,-8,-84,44
1,1584,1537,47,3,433,89
-1,1649,1664,-15,2,33,92
1,1256,1320,-64,12,811,111
-1,1307,1917,-610,-4,-124,48
-1,1793,2064,-271,-3,-81,52
1,1860,1929,-69,-1,93,81
1,1934,1296,638,6,113,45
-1,1604,1457,147,-3,-85,174
1,1642,1727,-85,-1,18,71
-1,1879,1813,66,0,-166,108
-1,1575,1282,293,-2,34,54
-1,1775,1781,-6,-1,-379,136
0,1805,1943,-138,-2,-117,120
-1,1295,1934,-639,-3,-3,42
1,1669,1640,29,2,52,53
-1,1239,1621,-382,-7,-247,54
-1,1406,1405,1,0,44,74
1,1495,1558,-63,3,307,103
-1,1710,1657,53,0,0,152
-1,1746,1698,48,-1,-41,58
1,1794,1945,-151,-5,0,78
1,1539,1446,93,-3,-4,41
1,1939,1809,130,3,134,53
1,2047,1891,156,-3,-42,101
-1,1861,1939,-78,-1,-33,48
1,1608,1528,80,-3,-25,49
-1,1446,1304,142,-2,-340,108
1,1542,1738,-196,3,240,65
-1,1612,1917,-305,0,-107,70
-1,1548,1935,-387,0,7,60
1,1313,1263,50,0,27,43
1,1531,1638,-107,0,48,58
1,1555,1449,106,2,224,83
-1,1802,1946,-144,-1,-84,112
-1,1630,1680,-50,0,-26,114
-1,1424,1466,-42,-1,-167,80
-1,1441,1688,-247,-2,-33,46
-1,1234,1616,-382,-4,-192,104
1,1472,1586,-114,-2,33,59
1,1826,1866,-40,4,222,75
-1,1452,1624,-172,0,-159,112
1,1592,1390,202,2,13,43
1,1587,1387,200,1,394,78
-1,1862,1787,75,-2,-199,62
1,1939,1545,394,1,8,49
1,1587,1228,359,-1,38,69
-1,1758,1947,-189,-3,-142,71
-1,1547,1462,85,0,18,76
1,1862,1763,99,-1,73,79
1,1563,1619,-56,2,9,69
1,1789,1787,2,-1,-43,67
-1,1616,1344,272,1,-82,62
-1,1305,1335,-30,-3,-86,76
-1,1885,2081,-196,0,23,88
-1,1523,1596,-73,-3,9,60
-1,1723,1552,171,0,-2,46
-1,1671,1604,67,1,55,84
1,1565,1607,-42,0,-108,61
-1,1769,1538,231,-1,-22,56
1,1713,1390,323,2,68,47
-1,1386,1519,-133,-14,-533,86
-1,1394,1222,172,-3,-238,74
1,1496,1409,87,4,165,73
-1,1807,1852,-45,0,-251,86
-1,1397,1419,-22,0,-2,40
1,2066,1921,145,-2,-14,57
1,1566,1562,4,-1,-23,61
-1,1421,1578,-157,-5,-293,76
-1,1575,1500,75,-10,-97,56
-1,1594,1577,17,0,1,68
-1,1421,1530,-109,-5,-126,58
1,1976,1705,271,3,88,69
1,1712,1375,337,5,298,59
1,1760,1740,20,4,306,61
-1,1294,1266,28,5,309,74
1,1511,1304,207,11,235,45
-1,1521,1521,0,-1,-92,58
-1,1476,1510,-34,1,-280,95
-1,1385,1324,61,-4,-154,50
1,1556,1583,-27,4,219,77
1,1724,1765,-41,-4,-151,69
-1,1427,1376,51,-1,-328,90
1,1829,1615,214,0,-34,67
-1,1717,1345,372,-5,-216,82
-1,1441,1453,-12,-2,-58,42
1,1594,1578,16,0,19,57
1,2116,1862,254,0,187,97
1,1724,1681,43,1,126,55
-1,1691,1576,115,-5,-91,72
-1,1599,1614,-15,-1,-29,76
-1,1791,1832,-41,1,35,68
1,1405,1174,231,3,123,53
-1,1762,1769,-7,-1,-129,74
-1,1475,1575,-100,-5,-387,96
1,2121,1567,554,-1,78,63
-1,1672,1735,-63,-9,-355,50
1,1605,1551,54,-5,-32,65
-1,1850,1858,-8,-4,-69,74
-1,1697,1738,-41,0,-12,66
-1,1343,1372,-29,-3,-58,42
-1,1450,1550,-100,1,9,40
1,1526,1376,150,0,-135,61
-1,1480,1514,-34,1,-67,72
1,1745,1663,82,1,105,77
1,1532,1614,-82,2,245,83
1,1590,1573,17,-9,-362,67
1,1754,1601,153,-1,-34,53
1,1835,1529,306,1,206,83
0,1690,1537,153,-1,-118,112
-1,1869,1838,31,0,-157,108
1,1981,1736,245,0,569,171
1,1524,1391,133,-1,-58,61
1,1655,1754,-99,1,90,89
-1,1523,1539,-16,5,124,56
1,1695,1518,177,3,265,73
-1,1160,1633,-473,-4,-545,124
-1,1336,1716,-380,-12,-627,82
-1,1678,1633,45,-5,-297,66
0,1585,1516,69,4,675,121
-1,1383,1328,55,4,45,56
0,1875,1779,96,-1,-33,115
1,1564,1714,-150,-1,-15,53
-1,1566,1690,-124,0,-26,54
-1,1500,1424,76,-4,-121,58
1,1525,1500,25,7,503,85
1,1739,1669,70,-4,438,87
1,1415,1389,26,-1,44,89
-1,1851,1857,-6,1,96,76
1,1478,1566,-88,2,269,109
1,1413,1344,69,1,256,76
-1,1351,1698,-347,-11,-636,82
-1,1660,1749,-89,-10,-247,54
1,1843,1781,62,0,-5,53
-1,1398,1558,-160,0,489,166
-1,1758,1652,106,0,10,56
1,1421,1672,-251,1,490,117
1,1868,1581,287,0,23,63
1,1757,1614,143,-2,-126,83
-1,1780,1751,29,7,102,54
-1,1591,1677,-86,-4,-337,124
-1,1666,1742,-76,-13,-347,64
1,1454,1507,-53,1,-8,63
-1,1490,1701,-211,-1,-23,44
-1,1367,1534,-167,-6,-314,59
1,1558,1815,-257,0,-76,69
-1,1346,1370,-24,-4,-79,50
-1,1752,1658,94,-3,-187,112
1,1623,1529,94,0,-5,51
-1,1577,1872,-295,-1,-31,60
-1,1364,1702,-338,0,14,88
-1,1701,1732,-31,0,-32,74
-1,2074,1914,160,0,-221,98
1,1625,1589,36,-1,56,105
-1,1366,1322,44,-10,-1154,102
1,1671,1568,103,3,255,103
-1,1194,1612,-418,-2,-84,64
1,1836,1484,352,-1,-25,61
-1,1508,1763,-255,-1,-238,108
1,1798,1706,92,-8,73,55
-1,1671,1737,-66,-6,-272,62
1,1583,1433,150,3,136,67
1,1720,1309,411,15,287,41
1,1687,1760,-73,0,65,109
-1,1772,1853,-81,0,-101,70
-1,1425,1520,-95,0,-55,84
1,1922,1692,230,-5,0,115
-1,1746,1662,84,0,101,100
1,1879,1569,310,1,67,61
-1,1698,1806,-108,0,-47,76
1,1667,1708,-41,0,62,85
-1,1481,1840,-359,1,805,106
1,1380,1332,48,0,-8,93
-1,1818,1665,153,-1,-233,110
-1,1619,1645,-26,0,-75,92
-1,1675,1732,-57,-9,-1035,108
-1,1813,1883,-70,-1,-21,54
-1,1566,1690,-124,-1,-36,72
1,1756,1290,466,1,31,49
1,1505,1399,106,-2,-87,65
-1,1674,1656,18,-5,-204,104
1,1492,1552,-60,-1,-16,63
1,1804,1838,-34,1,21,111
1,1742,1666,76,3,372,97
1,1464,1500,-36,0,-6,41
-1,1402,1202,200,3,160,62
1,1366,1705,-339,-3,-194,128
1,1697,1558,139,5,529,133
-1,1521,1503,18,-3,52,48
-1,1926,1906,20,1,-76,102
-1,1298,1491,-193,-5,-134,56
1,1500,1472,28,-4,-57,95
0,1747,1863,-116,0,-145,159
1,1843,1478,365,0,9,49
-1,1577,1481,96,-8,-906,100
1,1550,1704,-154,-1,36,77
1,1428,1713,-285,-1,-29,69
-1,1066,1467,-401,-8,-366,54
1,1820,1653,167,0,165,101
1,1540,1391,149,2,81,47
0,1417,1649,-232,-2,101,122
-1,1688,1567,121,3,243,104
-1,1763,1759,4,0,-18,60
-1,1654,1749,-95,-1,-14,46
1,1767,1503,264,6,396,139
-1,1759,1650,109,0,-98,122
-1,1726,1554,172,1,52,66
1,1680,1722,-42,0,162,157
-1,1794,1444,350,0,-12,68
1,1615,1465,150,0,-56,63
-1,1700,1561,139,-4,-203,76
-1,1339,1352,-13,0,-5,48
-1,1579,1635,-56,0,-23,84
-1,1283,1760,-477,0,-20,52
1,1505,1489,16,1,-55,57
1,1915,1918,-3,0,93,115
1,1697,1686,11,-1,-17,51
1,1410,1500,-90,-1,67,57
-1,1664,1745,-81,-6,-928,114
1,1497,1255,242,1,179,81
-1,1515,1586,-71,-1,70,72
-1,1216,1576,-360,-9,-172,42
1,1458,1628,-170,5,675,119
1,1753,1656,97,0,283,85
-1,1647,1827,-180,-3,-35,48
1,1475,1423,52,-4,-51,63
1,1337,1532,-195,-3,-548,121
1,1384,1547,-163,5,106,47
1,1673,1847,-174,-1,-102,83
1,1627,1423,204,-1,97,93
-1,1536,1467,69,-1,-10,46
1,1353,1500,-147,0,87,56
-1,1523,1655,-132,0,15,48
1,1926,1907,19,0,-5,69
1,1590,1602,-12,1,7,51
-1,1761,1648,113,-2,-34,50
-1,1673,1750,-77,1,349,128
-1,1691,1859,-168,0,-10,60
1,1387,1118,269,2,72,59
-1,1647,1834,-187,0,-1,45
-1,1662,1769,-107,2,141,78
0,1570,1706,-136,-1,114,128
-1,1597,1690,-93,0,-59,98
1,1777,1654,123,-2,152,103
-1,1224,1501,-277,-1,9,68
1,1522,1311,211,-2,109,69
1,1897,1539,358,1,-14,49
1,1623,1540,83,0,-10,75
1,1364,1325,39,2,177,77
1,1176,1608,-432,-1,-140,105
-1,1500,1867,-367,-2,-523,120
-1,1647,1784,-137,-6,-691,84
-1,1418,1644,-226,-8,-270,66
-1,1741,1675,66,-1,-96,106
1,1679,1478,201,0,73,87
-1,1591,1793,-202,3,17,106
-1,1753,1701,52,0,-132,118
1,1693,1645,48,0,61,71
-1,1791,1641,150,7,203,54
-1,1538,1601,-63,1,-40,70
-1,1420,1698,-278,-3,-49,52
-1,1582,1521,61,-7,-85,44
1,1930,1866,64,0,5,45
1,1530,1401,129,1,25,45
-1,1391,1374,17,7,188,56
1,1133,1541,-408,8,67,44
-1,1515,1511,4,-2,-54,62
-1,1536,1899,-363,3,111,70
1,1569,1500,69,5,861,107
-1,1655,1776,-121,-3,-78,64
1,1702,1324,378,-6,-182,85
-1,1307,1476,-169,-3,-99,56
-1,1635,1779,-144,-3,-98,78
1,1783,1648,135,11,606,79
-1,1559,1417,142,-9,-168,40
-1,1759,1652,107,-4,-152,58
-1,1421,1490,-69,-1,-9,62
-1,1608,1645,-37,2,88,56
-1,1420,1588,-168,0,30,106
-1,1708,1856,-148,-2,-70,92
-1,1280,1704,-424,0,-420,154
-1,1181,1478,-297,-1,-226,95
1,1820,1784,36,0,-1,75
1,1285,1438,-153,-10,-457,59
-1,1641,1790,-149,-4,-439,106
-1,1468,1772,-304,5,-47,82
-1,1201,1359,-158,0,-221,66
1,1803,1609,194,-1,84,91
-1,1720,1575,145,2,19,104
1,1902,1533,369,1,73,55
1,1740,1527,213,0,-20,59
-1,1797,1635,162,3,-43,112
-1,1684,1745,-61,-1,2,44
-1,1635,1602,33,0,6,42
-1,1781,1391,390,-5,-393,84
1,1797,1655,142,1,66,69
-1,1416,1090,326,1,-2,44
1,1519,1174,345,1,25,59
1,1413,1659,-246,-1,-2,45
1,1841,1708,133,-1,3,41
-1,1706,1532,174,0,-88,108
1,1400,1402,-2,2,109,54
-1,1650,1781,-131,3,94,152
1,1568,1655,-87,-3,19,127
-1,1281,1410,-129,0,-676,92
-1,1635,1619,16,-1,-112,78
0,1686,1598,88,-1,43,138
-1,1531,1904,-373,-7,-158,50
1,1607,1430,177,2,168,63
1,1831,1685,146,0,-138,81
1,1735,1489,246,4,336,85
-1,1788,1643,145,12,1028,154
1,1688,1729,-41,0,-8,61
-1,1608,1669,-61,-3,-176,72
1,1694,1628,66,0,24,73
1,1689,1304,385,6,965,107
-1,1418,1500,-82,-1,-99,76
1,1863,1701,162,0,12,63
-1,1519,1745,-226,-1,-4,48
-1,1700,1849,-149,-1,-28,52
1,1960,1774,186,3,351,145
1,1432,1366,66,0,662,133
-1,1380,1552,-172,5,146,52
-1,1430,1426,4,2,66,54
1,1610,1529,81,1,94,79
1,1672,1777,-105,2,142,56
1,2042,1898,144,0,9,47
0,1658,1773,-115,-3,17,132
-1,1786,1637,149,0,52,92
-1,1429,1594,-165,-10,-93,40
-1,1301,1692,-391,1,5,50
-1,1169,1522,-353,-9,-465,102
1,1515,1498,17,6,144,55
1,1550,1739,-189,1,-70,71
-1,1892,2050,-158,0,-17,82
-1,1695,1870,-175,0,-97,134
-1,1384,1301,83,-1,-104,68
1,1424,1511,-87,0,-8,59
1,1398,1339,59,1,228,65
-1,1826,1795,31,2,96,64
-1,1386,1369,17,1,38,48
1,1750,1641,109,1,55,67
0,1710,1710,0,0,6,70
1,1662,1697,-35,1,15,47
-1,1628,1784,-156,0,-148,108
-1,1422,1461,-39,-1,4,66
-1,1683,1674,9,0,-57,62
-1,1578,1639,-61,-5,-498,116
1,1555,1771,-216,-4,50,98
-1,1623,2108,-485,0,-9,82
1,1511,1529,-18,-3,-9,45
1,1756,1686,70,0,-19,66
-1,1491,1549,-58,-1,-327,108
-1,1808,1818,-10,-3,-64,54
1,1685,1621,64,-1,-51,75
-1,1277,1468,-191,-4,-535,96
-1,1424,1367,57,-1,-63,56
-1,1768,2110,-342,-2,-127,80
-1,1282,1399,-117,0,-31,64
-1,1584,1659,-75,-1,-313,124
-1,1501,1499,2,-3,-463,90
-1,1726,1500,226,-1,-3,70
1,2181,1988,193,0,41,77
-1,1531,1423,108,0,-170,82
1,1578,1491,87,-3,-34,53
-1,1255,1570,-315,-4,-57,46
-1,1693,1557,136,1,58,54
-1,2020,1900,120,0,-10,50
-1,1535,1595,-60,0,-47,56
1,1352,1580,-228,-2,-37,57
-1,1365,1367,-2,2,37,42
1,1764,1983,-219,-2,-118,71
-1,1367,1618,-251,-2,-105,72
-1,1567,1406,161,-1,-182,76
1,1868,1625,243,2,82,71
1,1376,1478,-102,0,331,87
1,1570,1539,31,1,133,61
-1,1251,1573,-322,-7,-64,40
-1,1674,1619,55,-5,1,40
-1,1288,1714,-426,3,83,66
0,1514,1402,112,0,-249,96
1,1923,1668,255,3,52,47
-1,1621,1872,-251,0,-24,74
1,1920,2006,-86,0,211,125
1,1556,1390,166,3,153,69
1,1713,1500,213,8,308,67
-1,1154,1502,-348,-5,-135,56
1,1568,1541,27,4,247,74
1,1500,1258,242,14,693,77
-1,1664,1927,-263,-1,-116,83
-1,1877,1616,261,-2,-1,98
1,1564,1598,-34,-1,-229,109
1,1555,1370,185,6,427,79
-1,1555,1582,-27,-2,-20,58
-1,1244,1344,-100,-1,15,68
1,1669,1575,94,1,297,139
-1,1635,1858,-223,0,-145,98
1,1517,1545,-28,0,148,99
1,1854,1942,-88,0,379,133
-1,1379,1402,-23,-6,-175,60
-1,1531,1578,-47,-1,-74,170
-1,1565,1677,-112,1,-40,88
-1,1881,1970,-89,0,1,95
1,1707,1573,134,1,39,63
1,1363,1400,-37,5,531,87
-1,1863,1630,233,-3,-28,74
-1,1721,1838,-117,1,8,54
0,1983,1881,102,0,170,110
1,1526,1587,-61,2,58,47
-1,1606,1529,77,-10,-1200,104
-1,1630,1596,34,-2,-531,144
-1,1582,1529,53,2,54,60
1,1716,1328,388,3,23,41
1,1818,1921,-103,1,40,57
1,1685,1557,128,3,49,45
-1,1648,1845,-197,0,15,98
1,1405,1719,-314,-2,-146,75
1,1349,1327,22,3,355,103
1,1534,1133,401,15,1080,77
-1,1366,1623,-257,3,-216,82
1,1500,1538,-38,1,50,87
1,1444,1399,45,-3,15,85
-1,1851,1642,209,-3,-66,48
1,1846,1713,133,-4,-64,69
-1,1325,1719,-394,1,62,64
-1,1549,1693,-144,-1,-96,116
1,1845,1833,12,1,329,85
1,1699,1582,117,1,265,77
1,1660,1833,-173,4,385,91
-1,1372,1598,-226,-4,-126,58
1,1529,1641,-112,-6,289,91
1,1822,1856,-34,-5,-171,141
-1,1956,1884,72,0,51,118
-1,1412,1368,44,-1,-394,126
-1,1396,1496,-100,-3,-99,58
1,1829,1307,522,2,83,122
-1,1278,1719,-441,1,-37,58
1,1289,1293,-4,-2,-48,53
1,1533,1767,-234,0,124,109
-1,1587,1531,56,-9,-282,72
-1,1843,1835,8,-3,-171,86
-1,1552,1559,-7,-3,-234,82
1,1702,1634,68,1,99,59
-1,1965,1781,184,1,57,44
1,1385,1462,-77,-1,-171,61
-1,1597,1926,-329,-2,15,70
1,1700,1541,159,1,-1,55
1,1221,1213,8,0,-1,49
-1,1846,1831,15,0,-451,130
-1,1573,1691,-118,0,-24,58
-1,1706,1854,-148,1,-29,46
1,1721,1322,399,4,335,83
1,1389,1454,-65,1,44,45
1,1527,1563,-36,2,108,69
-1,1388,1394,-6,1,15,48
1,1703,1676,27,-3,328,129
1,1283,1543,-260,-3,414,117
-1,1677,1551,126,-12,-633,84
1,1543,1574,-31,9,375,71
-1,1539,2171,-632,-5,-119,55
-1,1532,1579,-47,-5,-23,42
-1,1566,1760,-194,7,327,80
-1,1937,1700,237,-1,-259,132
1,1721,1707,14,-1,19,102
1,1843,1835,8,0,613,149
-1,1250,1112,138,-10,-536,78
1,1809,1546,263,2,325,123
-1,1907,1268,639,0,-91,98
1,1862,1700,162,3,50,53
1,1538,1534,4,0,25,55
1,1440,1403,37,1,49,61
1,1563,1555,8,-2,19,55
-1,1712,1567,145,0,-22,82
-1,1824,1855,-31,-9,-883,94
1,1522,1589,-67,-1,-24,67
-1,1319,1723,-404,-5,-51,40
1,1509,1378,131,-3,154,140
-1,1661,1594,67,0,-519,116
-1,1401,1509,-108,2,-113,62
1,1865,1814,51,2,141,76
0,1575,1561,14,-4,-691,204
1,1523,1550,-27,1,123,67
1,1544,1573,-29,0,-125,63
1,1460,1544,-84,-2,-104,61
1,1249,1330,-81,1,14,51
-1,1639,1751,-112,-2,-64,70
0,1331,1360,-29,-8,-887,108
-1,1389,1533,-144,-1,-307,70
-1,1694,1869,-175,-2,-33,84
1,1696,1804,-108,1,85,67
1,1575,1797,-222,-2,-31,41
-1,1608,1648,-40,-9,-1377,134
1,1726,1316,410,0,18,43
1,1703,1750,-47,-1,-138,87
-1,1696,1732,-36,0,-59,88
-1,1872,1843,29,-1,-72,74
1,1562,1556,6,-2,-17,67
-1,1523,1304,219,-4,99,116
1,1790,1711,79,1,415,111
1,1388,1364,24,0,80,81
1,1942,1992,-50,0,41,100
1,1523,1500,23,-1,-33,57
-1,1314,1728,-414,1,31,86
-1,1474,1501,-27,-1,-525,94
1,1794,1560,234,3,92,61
-1,1530,1626,-96,1,38,50
-1,1597,1929,-332,0,-5,62
-1,1813,1918,-105,0,68,108
-1,1702,1798,-96,2,-1,52
-1,1837,1843,-6,-1,-459,118
1,1885,1678,207,1,28,54
-1,1714,1791,-77,-1,-150,96
1,1433,1279,154,5,171,61
-1,1118,1726,-608,-6,-238,62
1,1594,1767,-173,0,100,71
1,1658,1594,64,0,221,113
1,1807,1694,113,1,360,93
-1,1559,1793,-234,0,-35,88
1,1545,1572,-27,1,811,203
-1,1500,1793,-293,-3,-65,48
1,1561,1574,-13,-2,82,71
-1,1731,1932,-201,0,8,62
-1,1577,1522,55,0,-91,156
1,1553,1441,112,3,343,61
1,1876,1688,188,0,79,73
1,1730,1416,314,6,541,91
-1,1382,1400,-18,-4,-553,86
-1,1831,1423,408,2,32,42
1,1738,1715,23,6,157,51
-1,1686,1814,-128,0,-116,122
1,1223,1339,-116,-19,-509,77
1,1458,1390,68,-2,-43,47
-1,1938,1683,255,0,346,120
1,1529,1742,-213,1,299,137
-1,1555,1799,-244,-1,-60,132
-1,1544,1500,44,-4,-125,44
-1,1821,1679,142,-1,-61,66
-1,1705,1748,-43,0,-112,66
-1,1563,1573,-10,-3,-851,186
-1,1531,1627,-96,2,96,84
1,1686,1697,-11,-3,1,57
1,1875,1866,9,0,405,147
1,1541,1448,93,4,111,52
1,1359,1392,-33,10,301,51
1,1530,1700,-170,4,77,43
-1,1531,1891,-360,-3,-9,44
1,1561,1557,4,-1,-30,41
1,1746,1611,135,-2,-109,93
-1,1694,1920,-226,0,-85,84
-1,1136,1113,23,2,-12,94
-1,1799,1673,126,-1,-401,108
1,1627,1438,189,0,110,61
-1,1444,1806,-362,-7,-316,70
-1,1382,1540,-158,4,-162,106
-1,1849,1885,-36,0,-221,140
-1,1412,1408,4,-3,-282,76
1,1546,1571,-25,0,213,95
-1,1500,1641,-141,0,-19,94
-1,1778,1926,-148,-1,-262,140
-1,1757,1695,62,-2,-7,64
-1,1439,1561,-122,0,-2,64
1,1476,1374,102,3,198,87
1,1282,1433,-151,6,459,99
0,1695,1671,24,-1,81,102
1,1439,1551,-112,-4,-217,87
1,1453,1394,59,-1,185,89
-1,1535,1548,-13,0,-47,122
1,1500,1736,-236,2,24,49
-1,1719,1930,-211,0,-84,106
0,1894,1725,169,0,-67,120
1,1627,1651,-24,0,-114,83
1,1925,1725,200,0,87,67
-1,1806,1737,69,0,-25,60
-1,1965,1875,90,-6,27,114
-1,1705,1430,275,0,16,66
1,1652,1116,536,13,523,57
-1,1580,1841,-261,-11,-180,100
1,1249,1217,32,-4,-115,127
1,1935,1714,221,0,-249,95
1,1697,1558,139,0,21,69
0,1420,1353,67,-5,35,140
-1,1366,1510,-144,-1,-31,68
1,1708,1745,-37,-1,-329,81
1,1688,1785,-97,0,283,107
1,1847,1575,272,-1,-69,79
-1,1501,1553,-52,-5,-215,92
1,1850,1454,396,-1,-46,56
1,1637,1378,259,7,450,67
1,1809,1442,367,0,-24,57
-1,1963,1809,154,0,-59,70
-1,1672,1694,-22,-8,-48,41
-1,1652,1617,35,-3,-5,40
1,1834,1584,250,0,59,81
-1,1373,1637,-264,0,5,74
1,1637,1267,370,10,282,45
-1,1569,1694,-125,-5,-237,62
1,1507,1656,-149,6,73,45
-1,1702,1477,225,0,-40,58
1,1581,1584,-3,0,565,111
-1,1549,1775,-226,-1,-159,124
1,1505,1655,-150,2,7,41
-1,1520,1517,3,-5,-229,86
1,1525,1399,126,-1,48,53
-1,1546,1690,-144,-8,-83,50
-1,1569,1618,-49,-1,-17,62
-1,1488,1452,36,-1,-19,42
1,1686,1455,231,4,145,131
-1,1551,1704,-153,-1,-180,96
-1,1733,1511,222,-2,-125,70
1,1641,1368,273,-2,-141,105
1,1703,1480,223,0,16,63
0,1593,1572,21,0,145,112
1,1804,1734,70,2,77,63
1,1435,1560,-125,8,315,71
-1,1495,1681,-186,0,-53,64
-1,1641,1462,179,0,-20,106
1,1904,1853,51,-3,-255,133
1,1532,1239,293,18,399,43
1,1520,1314,206,-3,-126,59
1,1464,1562,-98,-1,-60,81
1,1554,1459,95,-5,44,93
1,1871,1798,73,0,62,141
-1,1711,1545,166,0,-32,78
-1,1724,1643,81,-1,9,60
1,1688,1489,199,1,146,93
-1,1726,1824,-98,-1,-43,70
1,1572,1592,-20,0,157,79
1,1584,1632,-48,-5,-259,87
-1,1363,1645,-282,-1,-103,102
-1,1938,2078,-140,-1,-117,78
-1,1583,1600,-17,1,34,42
-1,1183,1577,-394,-1,-130,62
1,1535,1732,-197,-5,-80,51
-1,1198,1297,-99,2,23,44
-1,1948,1961,-13,0,-25,130
-1,1356,1392,-36,-9,-397,102
0,1636,1621,15,-2,-190,92
1,1580,1585,-5,-6,301,153
-1,1685,1523,162,0,29,64
1,1475,1708,-233,3,172,73
-1,1496,1442,54,1,1,74
-1,1585,1888,-303,-1,-16,44
-1,1618,1597,21,-2,-54,100
-1,1545,1611,-66,-1,-69,68
-1,1552,1560,-8,2,-7,70
1,1560,1365,195,2,340,91
1,1573,1592,-19,-4,-29,69
-1,1459,1444,15,-10,-298,48
-1,1303,1630,-327,-6,-40,42
1,1695,1308,387,-1,-1,40
-1,1305,1458,-153,2,78,64
-1,1634,1800,-166,-4,-116,58
1,1925,1892,33,-1,3,47
0,1593,1621,-28,1,618,106
-1,1569,1556,13,1,351,100
1,1538,1690,-152,1,58,53
1,1582,1644,-62,0,10,49
1,1622,1491,131,-7,-71,105
1,1821,1445,376,6,330,67
-1,1285,1541,-256,-3,-19,44
-1,1591,1859,-268,0,-35,60
1,1486,1364,122,-3,-54,55
-1,1487,1177,310,3,43,64
1,2093,1994,99,0,235,103
1,1771,1499,272,0,-4,49
1,1277,1538,-261,-2,-144,97
1,1552,1707,-155,1,84,47
-1,1586,1747,-161,3,-25,40
-1,1542,1563,-21,-1,-421,96
1,1745,1304,441,2,417,93
-1,1695,1985,-290,-7,-75,40
1,2031,1105,926,0,-27,49
-1,1736,1863,-127,-6,-161,60
-1,1513,1752,-239,-1,-220,100
-1,1722,1703,19,1,94,120
-1,1546,1281,265,-3,-334,82
1,1875,1500,375,17,395,43
1,1722,1527,195,1,122,69
0,1871,1729,142,2,361,141
-1,1549,1546,3,-7,-71,54
1,1500,1331,169,-3,64,69
1,1500,1406,94,1,44,51
-1,1753,1783,-30,0,-43,46
-1,1494,1283,211,3,99,52
1,1826,1497,329,0,45,75
1,1609,1705,-96,0,8,46
1,1780,1374,406,-2,0,43
1,1622,1871,-249,-5,57,61
1,1661,1836,-175,5,124,63
-1,1653,1620,33,-1,-25,66
-1,1562,1431,131,3,-4,40
-1,1500,1494,6,1,5,88
1,1937,1489,448,1,276,79
0,1464,1518,-54,0,389,166
1,1468,1370,98,6,385,81
1,1513,1467,46,1,299,151
1,1608,1361,247,-4,-24,45
1,1623,1690,-67,0,26,57
1,1538,1557,-19,-3,287,159
-1,1819,1679,140,-13,-75,41
-1,1180,1199,-19,-7,-129,52
-1,1778,1720,58,0,-17,49
1,1547,1302,245,2,33,41
0,1695,1804,-109,4,551,112
-1,1519,1529,-10,-11,-327,54
-1,1586,1363,223,1,17,48
-1,1219,1310,-91,-3,-183,122
1,2039,1743,296,-5,-289,93
-1,1369,1783,-414,-5,-179,76
-1,1615,1264,351,-1,46,58
-1,1401,1549,-148,-4,-256,66
0,1517,1465,52,-1,-286,133
1,1800,1699,101,-4,-174,99
1,1571,1459,112,1,6,65
1,1567,1504,63,0,45,77
1,1573,1500,73,1,11,43
1,1665,1552,113,0,-67,85
-1,1677,1636,41,-1,-50,66
-1,1631,1738,-107,-4,9,46
-1,1690,1808,-118,0,280,94
-1,1447,1547,-100,-1,-174,104
-1,1350,1569,-219,-1,37,136
1,1555,1393,162,9,278,63
-1,1472,1558,-86,0,-4,68
1,1467,1515,-48,2,139,135
1,1568,1500,68,-2,844,127
1,1447,1494,-47,3,107,108
-1,1816,1682,134,0,75,86
1,1463,1322,141,-1,-13,53
-1,1530,1939,-409,-10,-110,48
-1,1385,1562,-177,-4,-449,108
1,1468,1707,-239,0,143,102
-1,1698,1502,196,-1,-96,78
0,1732,1579,153,3,663,175
1,1644,1632,12,-1,71,89
0,1801,2193,-392,-1,-117,152
1,1738,1597,141,3,118,113
-1,1412,1698,-286,1,12,50
1,1327,1363,-36,6,189,55
0,1663,1404,259,-1,-99,106
1,1494,1397,97,0,-1,61
-1,1502,1480,22,-1,-229,122
1,1406,1062,344,0,-17,57
-1,1469,1245,224,0,2,62
1,1727,1583,144,7,179,45
1,1621,1650,-29,0,42,75
1,2182,1810,372,2,164,75
-1,1408,1702,-294,-3,-48,66
1,1734,1576,158,2,42,47
-1,1750,2102,-352,-3,-108,58
1,1377,1500,-123,-3,-128,81
-1,1941,1597,344,2,16,84
1,1592,1736,-144,2,211,81
-1,1741,1570,171,5,-40,100
-1,1833,1568,265,-2,-217,86
1,1475,1500,-25,2,109,49
-1,1371,1378,-7,0,-96,82
1,1634,1622,12,1,49,73
1,1739,1786,-47,0,-3,61
1,1790,1446,344,0,-113,117
-1,1390,1558,-168,0,38,102
1,1666,1566,100,0,21,57
-1,1625,1682,-57,4,-89,106
-1,1503,1706,-203,-2,-191,64
-1,1727,1840,-113,0,-54,124
1,1509,1199,310,-3,-61,49
-1,1725,1403,322,-1,-47,48
-1,1280,1319,-39,12,265,42
1,1457,1627,-170,-2,18,75
-1,1057,1419,-362,-14,-191,68
-1,1550,1534,16,-1,-115,76
-1,1351,1921,-570,0,-8,52
1,1390,1330,60,8,196,51
1,2105,1748,357,2,25,57
1,1712,1497,215,-2,1,49
-1,1399,1705,-306,0,-131,60
1,1591,1520,71,1,18,51
1,1691,1534,157,4,54,46
1,1671,1708,-37,1,15,45
1,1638,1158,480,5,183,47
-1,1486,1697,-211,-8,-118,50
1,1728,1733,-5,1,70,91
-1,1329,1270,59,-6,-409,86
-1,1411,1439,-28,0,-187,75
1,1708,1395,313,0,-27,67
1,1541,1626,-85,3,26,43
-1,1219,1674,-455,0,-28,76
1,1500,1482,18,0,-406,115
-1,1299,1400,-101,1,33,54
1,1627,1639,-12,-3,-2,81
-1,1739,1721,18,-10,-48,40
1,1467,1536,-69,-1,-4,53
1,1682,1660,22,0,8,51
-1,1383,1561,-178,0,-45,62
1,2109,1748,361,0,221,85
1,1698,1475,223,0,16,47
1,1198,1364,-166,-1,-8,47
-1,1727,1733,-6,-7,-143,48
1,1575,1481,94,0,27,53
-1,1599,1630,-31,-1,-139,66
-1,1832,2082,-250,0,-20,66
-1,1391,1712,-321,0,11,72
1,1431,1319,112,4,55,47
-1,1751,1792,-41,0,-23,60
1,1263,1441,-178,-12,734,131
-1,1716,1745,-29,-2,-117,106
-1,1430,1692,-262,0,-24,70
-1,1308,1560,-252,-1,-65,58
1,1715,1387,328,3,171,85
-1,1494,1664,-170,-3,-204,93
0,1827,1743,84,0,283,121
1,1737,1952,-215,0,-81,67
-1,1703,1576,127,-5,-517,132
-1,1742,1758,-16,-2,-366,104
-1,1706,1643,63,1,-228,94
1,1746,1150,596,1,17,75
-1,1807,2181,-374,0,9,102
-1,1383,1719,-336,-1,-113,70
-1,1608,1473,135,-3,-21,44
1,1439,1527,-88,0,-15,55
-1,1318,1393,-75,0,34,44
-1,1315,1353,-38,-3,-32,60
-1,1350,1500,-150,-6,-56,42
-1,1358,1460,-102,-2,-21,42
1,1479,1600,-121,0,61,49
1,1583,1473,110,-1,-67,51
0,1317,1226,91,2,43,96
1,1599,1284,315,-1,-22,63
0,1746,1805,-59,2,236,109
-1,1500,1918,-418,-7,-290,60
1,1652,1608,44,1,87,69
-1,1840,2184,-344,-3,-57,60
1,1627,1611,16,1,7,103
1,1706,1585,121,1,18,45
1,1722,1380,342,-4,-113,69
-1,1527,1642,-115,-5,-98,64
-1,1212,1482,-270,-4,-258,74
1,1402,1294,108,0,-53,83
1,1803,1748,55,1,46,55
1,1578,1713,-135,0,44,55
1,1488,1569,-81,-1,310,80
1,1413,1055,358,-1,-8,49
-1,1739,1813,-74,-3,-28,50
-1,1494,1500,-6,0,-110,112
-1,1305,1448,-143,1,-177,64
0,1611,1844,-233,0,91,137
1,1635,1529,106,-1,29,123
1,1621,1780,-159,0,100,83
1,1730,1742,-12,0,51,71
-1,1403,1364,39,-1,-51,60
-1,1731,1921,-190,0,-21,56
-1,1275,1411,-136,-1,-20,46
1,1426,1281,145,-2,89,49
-1,1513,1602,-89,-2,-59,64
1,2087,1725,362,-1,-106,113
-1,1796,1719,77,0,-289,138
1,1666,1470,196,0,21,79
1,1990,1542,448,6,154,57
-1,1706,1539,167,0,8,58
1,1633,1419,214,6,351,99
1,1462,1446,16,0,98,63
1,1487,1196,291,4,326,81
1,1419,1258,161,-2,-106,77
-1,1722,2090,-368,1,4,52
1,1235,1463,-228,-4,-614,99
-1,1558,1556,2,-1,-30,68
0,1385,1443,-58,1,666,132
-1,1729,1632,97,4,58,56
-1,1583,1638,-55,-2,39,84
-1,1928,1726,202,2,86,70
-1,1696,1717,-21,5,149,82
-1,1224,1247,-23,2,-211,82
-1,1469,1656,-187,-4,-194,60
1,1801,1593,208,-3,-41,61
-1,1554,1670,-116,1,-81,51
-1,1567,1575,-8,-6,-319,76
-1,1661,2053,-392,-1,5,46
-1,1685,1755,-70,-3,-128,70
-1,1344,1432,-88,0,-51,56
-1,1465,1862,-397,-1,-92,66
1,1537,1612,-75,0,108,93
1,1506,1504,2,-4,-158,89
1,1711,1995,-284,2,53,43
-1,1436,1546,-110,0,7,78
1,1500,1661,-161,1,9,47
1,1500,1342,158,17,545,57
-1,1856,1725,131,0,21,70
1,1742,1907,-165,0,58,85
-1,1687,1640,47,-5,-91,54
1,1865,1591,274,0,102,74
-1,1427,1689,-262,-2,-152,84
-1,1351,1676,-325,-3,-131,64
-1,1547,1573,-26,-2,-177,62
1,1491,1377,114,0,68,137
0,1822,1928,-106,-4,-86,121
-1,1679,1480,199,2,65,50
-1,1723,1668,55,-1,-96,84
-1,1303,1308,-5,6,-163,132
1,1963,1617,346,0,15,59
1,1634,1182,452,7,255,55
1,1639,1251,388,8,664,83
1,1648,1570,78,0,51,101
-1,1662,1764,-102,-3,-389,98
-1,1779,1869,-90,-3,-20,76
-1,1714,1643,71,-1,-99,98
1,1382,1450,-68,2,19,43
-1,1712,1702,10,-1,-191,132
1,1653,1168,485,3,107,65
1,1653,1674,-21,-4,-411,151
1,1541,1439,102,-3,19,63
1,1720,1516,204,3,65,41
1,1546,1526,20,7,300,59
0,1650,1588,62,-3,-69,80
-1,1597,1550,47,-1,8,138
-1,1583,1536,47,-8,-143,119
-1,1401,1432,-31,-4,-88,55
1,1654,1497,157,6,245,47
-1,1659,1741,-82,-1,6,46
1,1682,1421,261,2,63,49
-1,1771,1879,-108,-3,-86,58
-1,1432,1799,-367,-1,-301,84
0,1503,1591,-88,-1,308,93
1,1765,1621,144,5,143,53
-1,1493,1844,-351,-2,-125,68
-1,1510,1725,-215,-3,-152,70
1,1437,1396,41,1,498,91
1,1692,1899,-207,-2,149,105
0,1485,1319,166,-3,-581,143
1,1656,1336,320,3,337,95
1,1487,1448,39,1,100,85
0,1662,1462,200,3,147,120
1,1590,1648,-58,-1,-18,51
-1,1240,1642,-402,0,-26,50
1,1734,1781,-47,-1,215,73
1,1454,1416,38,2,196,109
1,1481,1654,-173,0,14,83
-1,1562,1888,-326,0,-28,78
1,1535,1423,112,4,24,43
-1,1557,1600,-43,0,-5,51
-1,1429,1562,-133,-4,-61,48
-1,1258,1646,-388,-8,-157,60
-1,1662,1664,-2,-2,48,52
1,2073,1934,139,1,2,43
1,1520,1532,-12,0,28,75
-1,1741,1562,179,0,101,92
-1,1650,1634,16,3,43,72
-1,1524,1912,-388,0,-43,66
-1,1449,1454,-5,-5,-467,86
-1,1988,1847,141,1,0,52
1,1345,1340,5,-1,-34,49
-1,1569,1421,148,5,109,44
1,1675,1651,24,-1,-72,145
-1,1672,1730,-58,-5,-53,48
-1,1801,1774,27,1,22,50
1,1649,1175,474,0,43,91
1,1559,1638,-79,-3,84,85
1,1530,1481,49,-1,89,75
-1,1681,1500,181,-2,-98,68
-1,1611,1630,-19,0,24,82
1,1538,1549,-11,1,24,53
-1,1373,1435,-62,-2,23,50
1,1668,1687,-19,-1,-17,63
-1,1708,1677,31,-1,-58,80
1,1680,1667,13,1,281,101
-1,1640,1621,19,0,4,52
-1,1573,1910,-337,-4,-99,70
-1,1622,1680,-58,-2,-90,64
-1,1334,1500,-166,-1,-289,92
1,1620,1245,375,1,71,59
1,1639,1724,-85,0,-43,97
-1,1848,1720,128,-3,-106,74
-1,1472,1535,-63,0,-554,120
1,1541,1530,11,-1,-11,45
1,1595,1624,-29,3,336,95
1,1754,1764,-10,0,50,93
1,1591,1471,120,-1,4,45
0,1762,1833,-71,1,-137,117
1,1771,1678,93,3,220,85
-1,1646,1628,18,0,-42,84
0,1454,1489,-35,-2,79,144
-1,1431,1533,-102,-1,-31,66
-1,1630,1728,-98,0,5,48
-1,1383,1613,-230,-2,-373,116
1,1761,1620,141,-10,-208,67
-1,1310,1388,-78,4,99,170
-1,1706,1898,-192,-3,-224,92
1,1286,1356,-70,12,174,44
1,1501,1458,43,3,11,61
-1,1569,1537,32,-4,-166,75
-1,1274,1549,-275,1,-287,140
-1,1768,1831,-63,-1,-48,68
1,2148,1897,251,-2,68,71
1,1230,1345,-115,-1,-10,41
-1,1540,1428,112,-1,-122,74
-1,1735,1881,-146,-3,-17,45
-1,1661,1797,-136,-2,-144,70
-1,1376,1374,2,-10,-463,72
1,1804,1506,298,-2,-49,47
1,1840,1745,95,0,-115,129
-1,1656,1454,202,-6,-123,42
-1,1690,1780,-90,-2,-24,64
-1,1354,1385,-31,0,-34,52
1,1903,1701,202,2,223,73
1,1640,1470,170,2,74,47
-1,1422,1421,1,-9,-243,62
-1,1561,1845,-284,0,-523,142
0,1487,1780,-293,0,-207,132
1,1736,1422,314,0,46,55
1,1300,1519,-219,-1,102,87
1,1623,1551,72,3,80,63
1,1727,1848,-121,5,328,73
-1,1490,1639,-149,-6,-200,68
1,1579,1646,-67,0,105,59
-1,1728,1657,71,0,-4,58
-1,1644,1615,29,-2,-61,90
-1,1696,1909,-213,0,-92,76
-1,1463,1646,-183,0,121,86
-1,1449,1511,-62,1,70,58
-1,1834,1759,75,-9,-304,114
1,1557,1786,-229,-3,19,129
1,1350,1254,96,1,32,51
-1,1888,1805,83,-6,-471,92
1,1623,1408,215,1,118,63
-1,1530,1612,-82,-1,-220,76
1,1878,1943,-65,0,25,57
-1,1914,1579,335,2,105,80
1,1541,1592,-51,0,184,109
-1,1787,1820,-33,-1,-71,72
1,1939,1788,151,0,17,95
1,1914,1690,224,1,34,53
-1,1780,1748,32,0,-1,44
-1,1729,1618,111,-6,-314,74
-1,1392,1889,-497,-4,-549,96
-1,1594,1555,39,-4,-115,82
-1,1674,1893,-219,-9,-55,40
1,1475,1195,280,3,58,49
1,1747,1685,62,6,352,79
0,1652,1456,196,-1,-346,113
-1,1639,1337,302,0,-37,56
-1,1830,1767,63,-1,-354,98
-1,1820,1875,-55,0,-58,66
-1,1446,1631,-185,-1,-85,74
1,1538,1490,48,2,207,109
-1,1685,1919,-234,0,-92,72
1,1558,1500,58,0,32,73
-1,1381,1417,-36,0,-84,94
1,1318,1140,178,9,761,165
1,1574,1689,-115,6,227,59
1,1568,1628,-60,0,57,69
-1,1403,1436,-33,-6,-28,40
-1,1318,1570,-252,0,-142,92
1,1483,1426,57,0,-36,73
1,1873,1659,214,-2,227,109
-1,1463,1646,-183,0,12,64
-1,1554,1535,19,-6,-76,42
-1,1660,1693,-33,4,-6,74
1,1815,1642,173,0,30,77
-1,1979,2054,-75,1,190,106
-1,1479,1500,-21,-2,-243,72
-1,1597,1704,-107,-5,-231,56
-1,1428,1478,-50,-5,-350,80
1,2043,1880,163,2,146,63
-1,1317,1584,-267,-9,-254,50
1,1713,1740,-27,1,93,71
-1,1475,1590,-115,-3,-29,42
1,1714,1583,131,0,4,43
-1,1652,1456,196,4,47,50
1,1817,1765,52,-9,-392,81
1,1657,1323,334,-1,-18,63
1,1761,1500,261,-4,-46,41
-1,1500,1510,-10,-1,-238,82
1,1952,1775,177,0,113,51
-1,1500,1719,-219,0,119,108
1,1969,1510,459,2,-8,43
-1,1675,1583,92,-5,-61,41
-1,1371,1628,-257,-2,-368,70
-1,1671,1755,-84,-1,-91,78
1,1520,1431,89,-1,-51,91
1,1892,1390,502,2,-27,47
1,1626,1598,28,1,44,51
-1,1635,1791,-156,-4,-89,52
-1,1557,1674,-117,-10,-479,74
1,1531,1369,162,-6,-137,57
1,1418,1300,118,-7,-239,59
1,1665,1472,193,4,145,49
1,1625,1401,224,8,343,59
1,1450,1580,-130,-2,5,71
1,1528,1209,319,1,46,49
-1,1654,1769,-115,-1,60,70
1,1701,1958,-257,0,-24,101
1,1640,1635,5,2,93,67
-1,1640,1487,153,-1,-94,82
-1,1753,1720,33,0,-57,54
1,1481,1539,-58,-4,-110,61
0,1803,1629,174,0,-1008,118
-1,1721,1576,145,-6,-308,68
-1,1558,1700,-142,-1,2,46
-1,1696,1705,-9,-2,-73,114
1,1907,1923,-16,-1,-13,47
1,1827,1664,163,0,-34,111
-1,1621,1542,79,-1,-459,104
-1,1607,1392,215,-4,-173,71
-1,999,1892,-893,-10,-425,58
1,1402,1576,-174,2,125,111
-1,1682,1632,50,7,46,44
-1,1634,1794,-160,-1,-97,66
-1,1373,1424,-51,-1,-497,112
1,1821,1500,321,-1,52,101
-1,1630,1500,130,1,25,60
-1,1192,1427,-235,-20,-530,42
0,1940,1720,220,0,44,106
1,1888,1777,111,2,285,89
1,1531,1538,-7,1,31,41
1,1978,1595,383,-5,47,125
1,1500,1460,40,-6,-232,59
1,1466,1623,-157,2,104,69
1,1895,1388,507,8,430,61
1,1346,1434,-88,-1,-1,65
1,1532,1432,100,-2,62,53
-1,1565,1537,28,-1,-48,52
1,1185,1205,-20,1,-1,65
1,1805,1627,178,5,116,59
1,1567,1662,-95,0,7,45
-1,2039,1787,252,0,-8,56
1,1724,1494,230,-7,-185,59
1,1367,1359,8,2,127,55
1,1500,1351,149,2,223,89
-1,1393,2154,-761,0,-138,60
-1,1696,1574,122,-5,-1,70
1,1889,1523,366,9,157,43
-1,1550,1681,-131,-7,-361,66
-1,1788,1706,82,1,-71,76
1,1495,1543,-48,0,-3,41
1,1555,1603,-48,-2,-19,43
1,1455,1214,241,0,-16,71
-1,1776,1813,-37,-1,-115,76
1,1621,1603,18,-5,-11,51
1,1682,1492,190,-3,-42,51
-1,1725,1742,-17,2,-155,122
-1,1657,1815,-158,0,-139,88
-1,1726,1934,-208,-11,-88,46
1,1670,1587,83,-1,5,61
-1,1607,1560,47,0,-85,64
1,1807,2016,-209,3,391,161
-1,1550,1553,-3,-1,-593,142
-1,1266,1508,-242,-1,19,80
1,1896,1823,73,0,-2,53
0,1540,1591,-51,-1,-262,101
-1,1465,1220,245,1,-15,66
1,1732,1563,169,9,145,57
1,1656,1400,256,1,24,93
-1,1688,1770,-82,-2,-167,68
0,1909,1920,-11,-2,-28,98
-1,1654,1651,3,-2,-307,94
1,1808,1330,478,7,80,49
1,1939,1721,218,-3,-48,47
-1,1898,2106,-208,0,-69,78
-1,1632,1669,-37,-3,-256,154
1,1621,1417,204,5,128,73
-1,1589,1669,-80,-1,-13,48
-1,1708,1651,57,0,-2,48
1,1762,1769,-7,-3,-89,61
1,1893,1393,500,1,60,81
-1,1517,1805,-288,-2,-133,68
1,1362,1429,-67,6,238,47
-1,1489,1570,-81,2,3,45
-1,1593,1573,20,0,-315,114
1,1551,1408,143,2,104,61
1,1189,1202,-13,15,394,47
1,1664,1696,-32,-1,75,53
1,1716,1944,-228,0,154,83
1,1422,1403,19,8,296,70
1,1814,1825,-11,0,7,77
-1,1378,1220,158,10,761,86
-1,1558,1602,-44,-3,-31,46
-1,1431,1424,7,-5,-104,64
-1,1386,1898,-512,-7,-139,48
-1,1180,1340,-160,-2,-145,75
1,1560,1399,161,-1,65,89
-1,1483,1739,-256,-1,-60,60
1,1985,1774,211,0,21,103
1,1574,1566,8,-4,-18,53
-1,1679,1621,58,1,59,100
1,1708,1325,383,9,236,49
-1,1758,1775,-17,-3,-162,74
1,1479,1720,-241,7,202,49
-1,1620,1521,99,-4,-357,76
1,1186,1204,-18,14,570,63
-1,1354,1575,-221,-1,-5,116
1,1674,1909,-235,2,93,76
1,1496,1278,218,7,107,49
0,1592,1283,309,-1,-36,167
-1,1894,1892,2,-4,-478,114
1,1809,1908,-99,-2,-20,46
-1,1459,1595,-136,0,-186,152
1,1377,1400,-23,3,153,43
-1,1779,1646,133,-1,-137,103
-1,1634,1666,-32,0,-114,106
-1,1485,1688,-203,-1,-5,40
-1,1538,1712,-174,1,-67,68
1,1564,1594,-30,7,433,77
-1,1763,1927,-164,0,-15,43
-1,998,1391,-393,-6,-446,66
-1,1611,1504,107,-5,4,58
-1,1894,2154,-260,-1,-85,94
-1,1495,1141,354,-3,-551,144
1,1468,1565,-97,0,-3,68
-1,1628,1543,85,-7,-427,88
1,1702,1546,156,5,131,59
-1,1390,1734,-344,0,-157,65
-1,1411,1626,-215,-5,-137,50
1,1349,1433,-84,-2,50,83
1,1593,1578,15,-10,-428,77
1,1743,1826,-83,0,2,51
-1,1761,1900,-139,-1,-58,70
-1,1902,1793,109,-2,-8,58
1,1675,1583,92,0,11,45
1,1568,1409,159,5,197,57
-1,1365,1480,-115,0,-17,62
-1,1650,1585,65,0,31,74
1,1465,1400,65,3,182,79
1,1892,1692,200,-2,43,63
1,1390,1567,-177,1,358,133
-1,1624,1595,29,-1,-148,82
1,1531,1441,90,-9,-438,101
1,1500,1310,190,11,152,43
1,1813,1737,76,1,256,101
1,1202,1153,49,-4,-731,99
-1,1502,1745,-243,-4,-103,44
-1,1312,1566,-254,-3,52,50
-1,1540,1709,-169,2,28,66
-1,1410,1676,-266,0,21,54
1,1991,1769,222,0,67,143
-1,1518,1597,-79,-8,-226,52
-1,1719,1532,187,0,60,74
-1,1558,1321,237,2,-737,148
1,1579,1461,118,6,142,47
1,1426,1300,126,9,207,47
1,1811,1758,53,-1,-21,43
0,1556,1613,-57,-1,-304,114
1,1764,1661,103,-1,159,71
-1,1485,1583,-98,-4,-76,46
-1,1642,1829,-187,-5,-117,50
1,1611,1612,-1,1,48,63
-1,1409,1579,-170,0,-100,99
1,1693,1655,38,0,135,81
1,1680,1406,274,1,30,47
-1,1888,1807,81,1,6,48
-1,1347,1678,-331,-1,-92,118
0,1687,1897,-210,1,104,74
1,1580,1150,430,5,102,47
-1,1811,1826,-15,1,52,69
1,1615,1431,184,-1,-55,63
1,1456,1310,146,2,127,54
-1,1601,1625,-24,0,-35,48
-1,1402,1684,-282,-9,-576,90
-1,962,1573,-611,-1,-12,48
-1,1478,1742,-264,-5,-184,65
1,1638,1417,221,6,55,43
-1,1517,1520,-3,-10,-253,50
0,1534,1715,-181,1,144,137
-1,1402,1575,-173,-2,-184,88
1,1822,1748,74,0,8,55
1,1634,1399,235,3,122,49
-1,1638,1591,47,0,24,78
1,1436,1266,170,-2,233,57
-1,1357,1494,-137,0,-2,40
-1,1893,1770,123,-2,-140,78
1,1604,1544,60,8,354,87
-1,1397,1292,105,-7,-590,84
-1,1406,1434,-28,-6,-297,56
1,1754,1557,197,6,67,46
-1,1764,1875,-111,1,26,44
1,1892,1733,159,4,543,115
-1,1843,1580,263,-1,-202,108
-1,1574,1683,-109,5,256,76
-1,1350,995,355,3,142,60
1,1259,1300,-41,-3,-105,56
-1,1215,1502,-287,-7,-267,54
-1,1604,1622,-18,0,-179,72
1,1751,1644,107,0,55,91
1,1806,1772,34,0,79,147
1,1891,1693,198,0,41,67
1,1506,1587,-81,-2,-67,67
-1,2051,1677,374,-1,-107,78
-1,1819,1688,131,0,-24,74
1,1549,1701,-152,0,-79,125
1,1552,1762,-210,3,325,103
-1,1711,1722,-11,-6,-328,72
-1,1474,1530,-56,-3,-109,72
1,1425,1622,-197,0,407,179
-1,1785,1878,-93,1,-16,54
-1,2105,1851,254,-1,-82,82
-1,1750,1722,28,-10,-319,64
-1,1403,1864,-461,-1,-95,59
1,1861,1943,-82,1,372,127
1,1535,1613,-78,2,41,59
1,1518,1568,-50,2,50,49
0,1645,1702,-57,2,-41,134
-1,1622,1396,226,0,-2,42
-1,1500,1444,56,-11,-218,40
1,1633,1568,65,-1,-31,85
1,1790,1699,91,0,598,93
1,1317,1285,32,-1,44,115
-1,1702,1796,-94,0,25,86
-1,1756,1832,-76,-6,30,56
-1,1485,1394,91,-1,-402,136
1,1563,1413,150,15,401,53
1,1997,1500,497,9,280,55
1,1710,1539,171,0,-8,49
1,1409,1269,140,18,761,63
1,1506,1210,296,0,185,103
1,1690,1835,-145,0,130,85
1,1886,1777,109,-1,-36,55
1,2083,1876,207,1,511,137
-1,1474,1681,-207,-1,-13,50
1,1467,1497,-30,-2,-2,41
1,1808,1694,114,0,-90,105
-1,1599,1754,-155,0,19,42
-1,1601,1829,-228,0,-315,144
-1,1933,2117,-184,0,-191,100
-1,1584,1500,84,0,-337,86
1,1464,1649,-185,2,113,53
0,1762,1707,55,-1,59,129
-1,1300,1707,-407,0,-55,58
1,1417,1539,-122,0,-36,57
1,1281,1387,-106,11,619,87
-1,1401,1411,-10,-6,-211,160
1,1581,1395,186,7,134,47
1,1687,1819,-132,1,76,85
1,1746,1592,154,1,236,73
-1,1716,1687,29,-1,-60,74
-1,1342,1747,-405,2,-11,100
-1,1520,1517,3,-3,-106,80
1,1737,1569,168,-1,25,41
1,1330,1279,51,-2,-5,57
-1,1500,1504,-4,-2,-86,52
-1,1701,1647,54,0,-3,52
-1,1737,1550,187,-1,-541,128
-1,1721,1575,146,1,44,68
-1,1257,1842,-585,-17,-475,60
-1,1737,1882,-145,-3,-102,54
1,1708,1755,-47,0,-149,109
1,2090,1838,252,4,136,59
1,1490,1290,200,0,-274,73
-1,1798,1702,96,-7,-661,106
1,1437,1071,366,20,1144,67
1,1516,1442,74,2,100,65
-1,1612,1565,47,0,-2,58
-1,1639,1843,-204,0,-1,56
-1,1758,1752,6,1,163,74
-1,1562,1810,-248,-2,-32,64
-1,1205,1467,-262,-10,-309,56
-1,1833,2095,-262,-4,-82,96
-1,1709,1722,-13,0,24,50
1,1631,1529,102,7,226,61
1,1611,1685,-74,6,462,103
-1,1431,1645,-214,1,-251,98
-1,1715,1778,-63,1,156,80
1,1586,1753,-167,0,-5,65
-1,1633,1850,-217,-4,-155,62
1,1889,1730,159,-1,-50,57
-1,1699,1704,-5,-3,-75,74
-1,1181,1617,-436,-8,-172,42
-1,1510,1525,-15,2,37,150
-1,1733,1673,60,1,2,68
1,2123,1927,196,0,49,49
1,2100,1829,271,0,55,65
1,1659,1688,-29,-1,72,99
1,1340,1335,5,3,84,53
-1,1389,1587,-198,2,-16,46
0,1434,1199,235,4,287,117
-1,1897,1941,-44,0,-26,68
1,1691,1567,124,2,49,59
-1,1791,1706,85,0,-243,122
-1,1380,1857,-477,-1,-46,48
-1,1500,1269,231,-1,-37,64
-1,1509,1559,-50,-5,-334,90
-1,1579,1781,-202,-15,-458,58
-1,1625,1673,-48,6,80,68
1,1598,1573,25,2,307,90
1,1440,1301,139,0,183,77
1,1539,1200,339,-6,219,97
1,1434,1442,-8,-1,100,63
-1,1378,1713,-335,0,-87,106
-1,1824,2105,-281,-3,-163,72
1,1921,2128,-207,0,13,88
1,1973,1311,662,0,59,82
1,1814,1558,256,1,95,73
1,1720,1773,-53,0,467,119
-1,1736,1602,134,-4,311,86
1,1720,1380,340,1,134,61
1,2017,1627,390,1,99,57
1,1769,1760,9,10,117,43
-1,1715,1688,27,-4,-523,150
-1,1296,1500,-204,3,87,58
1,1422,1390,32,2,116,51
1,2064,1859,205,-2,61,133
-1,1897,1894,3,0,-82,86
-1,1615,1477,138,-15,-220,42
-1,1343,1277,66,7,96,48
1,1496,1419,77,5,320,71
-1,1625,2020,-395,-1,5,50
0,1717,1531,186,0,69,121
-1,1430,1445,-15,-3,-30,52
-1,1363,1339,24,0,-12,62
1,1568,1567,1,2,190,73
-1,1005,1371,-366,-1,-711,110
1,1787,1572,215,11,476,53
-1,1513,1721,-208,-10,-279,74
-1,1349,1429,-80,-2,-114,74
1,1586,1530,56,8,756,99
-1,1553,1819,-266,-1,-165,60
1,1592,1383,209,-4,-88,51
1,2023,1623,400,-5,7,81
1,1763,1746,17,1,97,155
-1,1765,1540,225,0,-19,52
1,1339,1500,-161,5,159,60
-1,1596,1756,-160,-3,-218,142
1,1645,1500,145,0,11,49
-1,1291,1382,-91,-1,-136,68
1,1508,1510,-2,-1,-61,102
-1,1617,1669,-52,-6,-87,64
1,1409,1558,-149,4,276,67
-1,1905,1886,19,0,37,70
-1,1195,1440,-245,-12,-720,78
1,2111,1939,172,-1,-31,45
-1,1620,2026,-406,-1,-133,54
1,1599,1578,21,0,627,99
1,1723,1574,149,-4,154,79
-1,1649,1770,-121,2,32,60
-1,1193,1599,-406,0,2,78
-1,1556,1579,-23,-1,-112,94
1,1589,1682,-93,7,457,75
-1,1764,1852,-88,0,-445,124
1,1824,1549,275,0,110,75
1,1609,1534,75,0,9,73
-1,1559,1698,-139,6,119,52
0,1388,1532,-144,0,137,101
1,2028,1326,702,12,464,55
-1,1603,1668,-65,-1,-38,74
-1,1788,1641,147,1,73,76
1,1843,1754,89,-4,87,61
1,1522,1540,-18,5,632,105
1,1678,1608,70,0,72,105
-1,1379,1713,-334,3,71,48
1,1932,2117,-185,-4,-77,77
-1,1897,1893,4,0,-6,50
1,1594,1677,-83,0,338,101
-1,1226,1864,-638,-6,-407,70
-1,1479,1604,-125,1,0,70
-1,1759,2029,-270,-1,-31,52
1,1657,1752,-95,1,45,81
-1,1189,1338,-149,-16,-551,64
-1,1220,1865,-645,-1,-6,50
-1,1282,1446,-164,-3,-121,56
-1,1507,1633,-126,-6,-180,76
-1,1765,2137,-372,0,-5,43
1,1087,1198,-111,4,437,93
-1,1351,1377,-26,-1,-146,88
1,1904,1886,18,5,63,49
1,2035,1755,280,0,82,127
1,1654,1760,-106,-5,-52,59
1,1861,1522,339,1,70,61
1,1545,1454,91,-1,125,77
1,1456,1410,46,8,107,47
-1,1528,1392,136,-3,-198,66
1,1845,1491,354,1,377,133
1,1866,1788,78,-1,361,91
1,1721,1671,50,3,245,91
1,1179,1102,77,-11,-419,47
1,1599,1362,237,7,349,67
1,1568,1524,44,1,99,77
-1,1522,1780,-258,-3,-104,62
1,1610,1390,220,1,165,75
1,1817,1609,208,3,271,65
1,1769,1648,121,4,110,45
1,1743,1878,-135,0,360,131
1,1853,1727,126,0,-37,67
-1,1180,1123,57,2,-3,44
1,1524,1500,24,-1,87,89
1,1921,1914,7,0,67,105
-1,1808,1557,251,0,-51,54
-1,1137,1839,-702,-7,-196,64
-1,1473,1197,276,-1,-100,72
-1,1539,1680,-141,-3,-53,45
1,1641,1578,63,0,1,91
-1,1556,1565,-9,0,55,94
-1,1601,1630,-29,0,-40,118
-1,1770,1544,226,1,66,60
1,1542,1851,-309,-1,-28,63
-1,1455,1603,-148,-7,-94,42
-1,1342,1700,-358,-1,128,80
-1,1809,2120,-311,-6,-120,54
1,1544,1610,-66,-4,-19,77
1,1295,1374,-79,0,83,63
1,1863,1377,486,4,203,63
1,1703,1170,533,4,265,101
1,1706,1538,168,1,154,86
-1,1280,1518,-238,-1,-379,106
-1,1539,1794,-255,-1,-66,68
1,1831,1563,268,0,197,79
1,1664,1749,-85,0,41,91
-1,1449,1610,-161,-1,-201,67
1,1594,1493,101,12,456,55
-1,1129,1840,-711,0,-15,48
-1,1531,1765,-234,0,-49,70
1,1583,1480,103,0,-3,72
-1,1740,1858,-118,-2,-70,74
1,1813,1387,426,9,717,104
1,1826,1833,-7,0,16,87
-1,1907,1776,131,1,71,72
-1,1310,1403,-93,-7,-467,68
1,1579,1640,-61,-2,222,81
-1,1689,1715,-26,-9,-765,100
-1,1542,1438,104,-3,-556,98
1,1558,1835,-277,-3,-120,61
1,1759,1667,92,1,0,47
-1,1806,2124,-318,1,-148,158
-1,1276,1728,-452,-3,-159,54
-1,1801,1648,153,-1,-99,66
0,1637,1864,-227,-2,60,105
1,1223,1454,-231,1,-104,135
1,1776,1621,155,2,38,47
1,1734,1449,285,3,1,135
1,1442,1617,-175,0,-54,135
-1,1715,1649,66,1,-171,100
1,1841,1126,715,11,209,49
-1,1585,1535,50,-1,-163,86
1,1815,1578,237,1,88,65
-1,1492,1658,-166,0,64,88
-1,1371,1802,-431,2,28,60
1,1487,1599,-112,0,-26,65
0,1514,1529,-15,-2,-45,100
-1,1539,1730,-191,-3,-197,72
1,1704,1672,32,5,692,103
-1,1545,1575,-30,4,259,80
1,1527,1274,253,3,1,53
-1,1822,1839,-17,-1,-225,138
-1,1902,1783,119,1,73,62
-1,1688,1460,228,-4,-250,66
0,1164,1704,-540,-1,8,218
-1,1245,1301,-56,0,-20,66
1,1867,1732,135,-1,-7,51
-1,1453,1738,-285,-6,-332,78
1,1602,1500,102,1,17,47
-1,1613,1783,-170,-2,11,102
1,1768,1585,183,0,-104,75
-1,1573,1820,-247,-15,-292,46
-1,1305,1889,-584,-3,-685,120
-1,1875,1892,-17,-1,3,47
-1,1122,1842,-720,-4,-172,50
1,1596,1569,27,-2,-23,41
-1,1806,1971,-165,0,-10,80
-1,1733,1795,-62,0,-173,118
1,1798,1628,170,-2,-274,105
1,1387,1410,-23,2,3,47
1,1474,1262,212,-2,430,117
-1,1485,1718,-233,-1,-32,52
1,1725,1920,-195,0,47,59
-1,1496,1620,-124,1,-67,92
-1,1519,1820,-301,-5,-220,56
1,1576,1486,90,0,433,129
1,2096,1843,253,0,-15,61
1,1744,1491,253,0,22,53
1,1644,1573,71,1,72,69
1,1657,1483,174,-4,6,45
-1,1677,1903,-226,0,-48,92
1,1843,1119,724,8,509,65
1,1588,1539,49,8,596,107
1,1774,1742,32,2,93,69
-1,1725,1874,-149,-3,-35,86
1,1856,1642,214,-2,54,71
1,1640,1489,151,0,50,43
1,1607,1622,-15,1,240,117
1,1437,1247,190,5,184,61
-1,1441,1580,-139,0,-157,94
-1,1532,1469,63,-1,21,126
-1,1413,1855,-442,-4,-108,48
-1,2016,2055,-39,-1,-146,86
0,1459,1600,-141,1,73,107
1,1472,1164,308,1,32,43
1,1908,1670,238,3,134,67
1,1310,1500,-190,10,251,43
0,1310,1269,41,3,91,103
0,1839,2102,-263,0,454,126
-1,1563,1576,-13,-3,-91,64
1,1659,1699,-40,2,427,131
-1,1623,1167,456,-10,-175,50
1,1732,1535,197,2,53,63
0,1529,1570,-41,0,36,74
-1,1636,1766,-130,0,175,114
-1,1500,1859,-359,-10,-209,44
1,1373,1379,-6,5,659,97
1,1500,1357,143,0,54,89
-1,1185,1397,-212,-6,-958,110
1,1476,1163,313,0,52,53
-1,1666,1958,-292,-1,-116,100
0,1431,0,1431,0,-44,147
-1,1448,1347,101,-2,-100,83
1,1529,1599,-70,-1,771,115
1,1529,1862,-333,4,109,61
1,1894,1690,204,2,220,105
-1,1561,1610,-49,-1,-76,64
1,1863,2127,-264,4,73,55
0,1987,1830,157,-3,86,152
1,1302,1476,-174,-3,27,61
1,2093,1845,248,1,153,181
-1,1891,1664,227,1,-81,78
1,1708,1573,135,0,36,63
1,1840,1549,291,-1,-35,83
-1,1321,1500,-179,-13,-209,48
1,1477,1539,-62,1,-42,59
1,1514,1350,164,-1,11,53
1,1784,1659,125,-1,-6,61
1,1682,1900,-218,0,-117,101
-1,1463,1596,-133,-1,-156,106
-1,1844,1545,299,0,-329,110
-1,1419,1547,-128,-5,-122,56
1,1435,1500,-65,1,105,97
1,1585,1543,42,-3,135,79
1,1702,1888,-186,0,20,51
-1,1348,1463,-115,-16,-560,56
1,1721,1360,361,0,6,61
-1,1835,1982,-147,0,-15,48
1,1403,1179,224,4,371,89
1,1481,1385,96,0,36,65
-1,1479,1239,240,0,40,72
1,1930,1923,7,0,23,115
1,1585,1294,291,6,138,63
0,1616,1866,-250,-3,31,139
1,1745,1638,107,0,17,62
1,1962,1662,300,-1,-61,71
1,1693,1215,478,1,115,79
1,1821,1565,256,-1,-152,105
-1,1016,1927,-911,-3,-422,71
-1,1316,1552,-236,-3,-69,48
-1,1427,1707,-280,-1,-18,40
1,2007,1707,300,-1,4,55
1,1569,1552,17,0,70,83
-1,1560,1827,-267,-2,-96,74
1,1552,1480,72,0,70,69
1,1616,1415,201,1,555,101
1,1309,1604,-295,1,84,99
-1,1722,1994,-272,-3,-194,94
1,2107,1887,220,-2,45,69
1,1712,1424,288,-2,165,69
1,1825,1850,-25,1,109,65
1,1997,1620,377,2,167,105
-1,1542,1533,9,-3,45,40
1,1841,2099,-258,0,1,41
1,1831,1556,275,-1,-41,81
-1,1507,1731,-224,0,-264,64
-1,1456,1603,-147,-4,-69,52
-1,1456,1490,-34,-3,-38,48
-1,1805,1687,118,-3,-171,84
1,1896,2075,-179,2,90,63
-1,1814,2022,-208,0,-3,50
-1,1839,1838,1,7,-141,96
-1,1687,1401,286,-1,-93,76
1,1552,1836,-284,2,202,83
1,1791,1717,74,-1,-15,53
-1,1208,1695,-487,-15,-363,46
1,1552,1555,-3,-1,15,69
-1,1408,1484,-76,3,-85,136
1,1462,1459,3,6,50,40
1,2044,1705,339,3,103,57
-1,1482,1388,94,-4,-27,58
-1,1529,1869,-340,-1,-49,56
1,1814,1572,242,3,328,93
0,1912,1859,53,0,91,124
-1,1651,1560,91,4,337,82
1,1545,1651,-106,1,254,61
1,1500,1446,54,4,194,69
-1,1701,2055,-354,-3,-386,130
-1,1905,2063,-158,-1,-17,70
1,1794,1624,170,4,145,51
1,1471,1561,-90,2,140,67
1,1792,1758,34,-3,-32,45
1,1520,1462,58,7,115,51
1,1758,1616,142,0,299,187
-1,1608,1561,47,-1,-18,64
1,1301,1448,-147,-1,-18,99
1,1682,1554,128,2,47,71
1,1726,1644,82,-5,-110,59
1,1473,1323,150,12,236,44
1,1819,1567,252,0,-37,75
1,1405,1168,237,2,613,97
1,1449,1403,46,1,41,65
1,1965,1804,161,0,87,89
-1,1527,1529,-2,-3,-140,56
1,1697,1798,-101,0,22,53
1,1458,1337,121,-2,59,63
-1,1450,1489,-39,0,-11,56
-1,1376,1477,-101,-1,-32,54
1,2065,1628,437,0,0,47
1,1965,1563,402,1,148,81
1,1816,1538,278,2,91,67
1,1562,1824,-262,0,10,81
1,1635,1560,75,-1,-38,43
1,1720,1498,222,0,-72,87
-1,1704,1793,-89,-1,15,64
1,1316,1052,264,-3,-45,57
1,1479,1317,162,-1,33,141
-1,1623,1500,123,-6,-180,54
1,1530,1439,91,4,112,57
-1,1799,1977,-178,0,-21,72
1,1911,1786,125,0,10,59
0,1704,1850,-146,0,-183,121
1,1803,1582,221,3,94,51
1,2071,1801,270,0,-5,43
1,1453,1637,-184,2,212,75
-1,1172,1115,57,2,39,76
-1,1454,1617,-163,-4,-162,58
1,1800,1693,107,0,-330,93
1,1899,1646,253,3,96,53
1,1873,1581,292,0,238,101
1,1459,1592,-133,2,25,47
1,1492,1329,163,1,4,41
-1,2085,2075,10,1,129,88
1,1809,1518,291,0,225,65
-1,1256,1197,59,-1,-23,56
1,1623,1422,201,4,81,45
-1,1551,1645,-94,-7,-128,41
1,1708,1683,25,0,152,91
1,1924,1861,63,1,-2,51
1,1813,1515,298,12,317,57
1,1436,1509,-73,0,395,117
-1,1202,1594,-392,-2,-101,64
-1,1397,1629,-232,-2,-222,70
1,2112,1793,319,0,-67,83
1,1427,1203,224,5,354,65
1,1538,1366,172,7,253,51
1,1877,1646,231,0,65,115
-1,1518,1688,-170,0,-3,44
-1,1817,1758,59,0,-37,74
1,1626,2049,-423,0,8,47
1,1636,1581,55,0,67,73
1,1465,1069,396,0,90,55
1,1918,1837,81,0,28,93
-1,1613,1737,-124,0,-16,54
1,1318,1188,130,12,428,59
1,1867,1670,197,0,92,75
1,1555,1291,264,-2,14,81
-1,1479,1445,34,2,104,60
-1,1304,1368,-64,0,-55,72
1,1903,1934,-31,1,367,123
-1,1363,1610,-247,0,-74,68
-1,1212,1470,-258,-1,-49,60
1,1646,1756,-110,1,109,81
-1,1399,1498,-99,-5,-105,48
-1,1500,1582,-82,-6,-33,40
-1,1663,1906,-243,1,-78,78
1,1588,1771,-183,0,-1,65
1,1808,1526,282,0,-157,79
1,2071,1559,512,0,-23,53
-1,1802,1788,14,1,28,60
-1,1409,1850,-441,-1,-20,40
1,1755,1993,-238,2,217,117
1,1641,1764,-123,0,-16,67
1,1497,1197,300,5,416,79
0,1673,1689,-16,-1,26,84
-1,1921,1915,6,-1,-621,118
1,1555,1501,54,13,302,49
1,1934,1568,366,-1,-17,65
-1,1617,1520,97,-4,-28,40
1,1496,1450,46,6,563,123
-1,1584,1558,26,1,-18,58
1,1319,1352,-33,4,157,85
-1,1804,2112,-308,-3,-94,68
-1,1852,1882,-30,1,80,58
1,1926,1818,108,-1,355,127
1,1538,1639,-101,1,124,81
-1,1555,1734,-179,2,27,99
1,1738,1752,-14,5,150,57
-1,1547,1670,-123,2,-43,90
-1,1614,1468,146,-8,-5,88
-1,1683,1645,38,-5,-613,109
1,1736,1358,378,13,618,75
1,1469,1506,-37,3,119,77
-1,1601,1791,-190,0,-31,74
1,1949,1749,200,0,6,53
-1,1927,1910,17,0,-2,134
-1,1553,1621,-68,0,-599,148
-1,1294,1590,-296,-8,-196,50
-1,1587,1873,-286,0,-15,96
-1,1269,1568,-299,4,-248,90
-1,1755,1606,149,-3,-66,111
1,1456,1536,-80,1,80,91
1,1800,1970,-170,1,12,47
1,1488,1492,-4,2,24,45
1,1991,1773,218,0,39,61
-1,1491,1570,-79,1,23,42
-1,1519,2001,-482,-2,-102,64
1,1620,1745,-125,-2,-163,87
-1,1143,1707,-564,-1,127,72
-1,1193,1500,-307,-5,-425,84
-1,1596,1728,-132,-1,-30,59
-1,1802,1933,-131,0,-156,146
-1,1646,2073,-427,1,28,47
0,1457,1564,-107,0,-309,178
-1,1455,1563,-108,-4,-91,46
1,1549,1004,545,0,274,77
-1,1767,1627,140,0,-91,74
1,1559,1483,76,-2,387,101
-1,1486,1500,-14,0,-181,80
1,1544,1773,-229,3,440,105
1,1454,1381,73,-1,-81,93
-1,1670,1507,163,-7,-189,80
1,1671,1679,-8,5,114,49
1,1674,1531,143,7,681,103
0,1878,1647,231,0,49,173
1,1339,1331,8,-2,519,169
-1,1791,1762,29,0,-448,148
-1,1689,1661,28,0,14,110
-1,1915,1954,-39,0,14,60
-1,1485,1599,-114,-1,75,104
-1,1877,1583,294,0,-50,50
1,1812,1755,57,0,-171,77
1,1597,1446,151,0,-3,51
-1,1725,1752,-27,-1,-48,76
1,1818,1768,50,0,-61,104
1,1739,1682,57,8,99,43
1,1708,1668,40,-1,103,75
1,1644,1550,94,-1,-35,59
0,1415,1204,211,3,237,103
1,1300,1424,-124,7,350,65
1,1500,1578,-78,1,289,93
1,1940,1847,93,1,82,73
-1,1905,1743,162,0,33,122
1,1550,1183,367,1,55,47
1,1475,1423,52,-1,-12,43
1,1677,1622,55,3,167,66
-1,1691,1901,-210,-8,-99,54
-1,1735,1634,101,1,25,60
1,1856,1745,111,-1,32,63
1,1460,1741,-281,0,113,53
1,1747,1614,133,1,139,77
1,1702,1788,-86,2,100,51
-1,1536,1725,-189,2,-14,56
1,2000,1964,36,-5,13,89
-1,1510,1569,-59,1,55,96
-1,1473,1855,-382,0,8,62
1,1983,1865,118,0,-17,79
-1,1996,1650,346,-1,-64,108
-1,1623,1719,-96,-2,-111,80
-1,1655,1798,-143,0,31,80
1,1738,1085,653,6,117,47
1,1553,1594,-41,1,201,115
1,1375,1323,52,-3,-315,121
1,1325,1315,10,7,188,53
1,1738,2116,-378,-1,71,73
1,1299,1353,-54,6,314,65
-1,1484,1563,-79,-1,-74,164
1,1715,1588,127,-3,-14,51
-1,1595,1581,14,0,9,64
1,1606,1476,130,3,172,85
-1,1856,1991,-135,-1,-18,47
1,1365,1329,36,1,56,44
1,1729,1643,86,-1,71,75
1,1440,1739,-299,-4,52,85
-1,1267,1324,-57,-3,-757,80
-1,1714,1661,53,1,190,84
-1,1607,1754,-147,4,61,50
1,1764,1525,239,0,7,47
-1,1797,1993,-196,-1,-570,118
-1,1828,1948,-120,0,-61,114
1,1758,1500,258,-1,-18,49
-1,1719,2087,-368,0,6,80
-1,1550,1480,70,-5,-955,132
-1,1858,1726,132,3,230,84
1,1848,1718,130,1,31,49
-1,1566,1769,-203,-7,-191,40
1,1318,1521,-203,5,327,81
1,1882,1838,44,-3,56,91
-1,1974,2093,-119,-3,-128,76
-1,1395,1355,40,-2,-233,86
1,1751,1398,353,3,164,69
-1,1722,1405,317,1,-72,80
1,2090,1998,92,0,21,95
1,1304,1385,-81,0,383,75
-1,1602,1669,-67,-8,-531,112
-1,1536,1763,-227,-4,-335,86
1,1642,1637,5,0,7,55
-1,1560,1697,-137,-4,-138,62
1,1715,1494,221,2,327,131
-1,1314,1531,-217,-2,-182,70
1,1635,1738,-103,5,463,99
1,1788,1775,13,-1,-42,59
1,1725,1760,-35,2,194,117
0,1469,1500,-31,3,715,123
-1,1827,1752,75,-3,-130,58
1,1869,1631,238,0,131,65
1,2048,1790,258,0,-8,57
1,1761,1600,161,1,210,89
-1,1653,1593,60,0,-61,72
1,2099,1768,331,0,-50,79
-1,1762,1657,105,-1,-37,92
-1,1434,1393,41,-5,-155,74
-1,1531,1721,-190,-1,-138,64
-1,1400,1489,-89,-11,-112,44
-1,1772,1813,-41,-1,-25,46
-1,1375,1500,-125,-1,-70,64
-1,1498,1390,108,1,-67,96
-1,1493,1600,-107,0,-214,132
-1,1689,1765,-76,0,-203,100
-1,1709,1909,-200,0,-22,90
1,1785,2054,-269,-3,15,75
1,1313,1512,-199,0,55,45
1,1818,1648,170,0,210,115
-1,1500,1510,-10,-2,-156,78
-1,1525,1544,-19,-4,-1399,150
1,2029,1805,224,1,160,113
-1,1727,1632,95,-6,-104,48
-1,1317,1723,-406,-2,-184,82
-1,1649,1745,-96,0,2,86
1,1251,1383,-132,2,659,135
1,1553,1359,194,1,70,87
-1,2069,2102,-33,1,-31,92
1,1593,1767,-174,-1,-40,85
1,1999,1727,272,4,197,63
-1,1703,1678,25,0,-19,62
-1,1321,1268,53,4,25,54
-1,1712,1716,-4,0,-385,192
1,1170,1391,-221,-3,-59,69
-1,1822,1775,47,-2,-16,40
1,1132,1270,-138,6,773,85
-1,1871,2075,-204,-1,-154,102
-1,1407,1483,-76,0,-81,64
1,1757,1393,364,8,112,41
-1,1728,1804,-76,0,-16,48
0,1499,1605,-106,0,-51,118
1,1732,1530,202,3,343,85
1,1514,1469,45,-6,-124,77
1,1833,1748,85,-3,7,43
1,1723,1656,67,0,509,109
1,1965,1641,324,4,56,45
0,1534,1347,187,-1,-166,112
1,1789,1156,633,14,326,45
-1,1749,1875,-126,-7,-81,50
1,1614,1640,-26,1,70,63
1,1626,1579,47,-1,10,77
1,1754,1725,29,-1,-12,71
-1,1700,1727,-27,-1,-80,78
-1,1404,1877,-473,-5,-116,48
-1,1603,1838,-235,0,1,72
1,1753,1517,236,4,405,93
1,1842,1309,533,-1,292,65
1,1405,1270,135,5,286,63
1,1689,1692,-3,1,43,75
-1,1148,1790,-642,-1,-66,42
1,1649,1491,158,6,121,49
-1,1436,1249,187,8,170,46
1,1802,1867,-65,-2,49,53
1,1969,1955,14,1,-8,43
1,1751,1610,141,6,311,71
1,1649,1500,149,2,98,65
-1,1072,1272,-200,-1,-54,50
-1,1393,1784,-391,0,2,66
1,1674,1561,113,-1,-71,127
-1,1821,1720,101,-1,-16,48
-1,1758,1928,-170,0,-2,48
-1,1569,1636,-67,0,-4,68
-1,1660,1849,-189,-3,-57,78
-1,1582,1689,-107,3,269,96
1,1714,1765,-51,0,47,55
1,1945,2082,-137,-3,209,137
-1,1498,1677,-179,-4,-56,50
-1,1401,1711,-310,-1,-273,78
1,1881,1500,381,1,28,61
-1,1369,1399,-30,-6,-443,86
1,1741,1370,371,0,16,57
1,1512,1759,-247,0,43,59
1,1792,1657,135,0,81,103
1,1645,1781,-136,-2,-94,59
-1,1734,1807,-73,-2,-101,64
1,1647,1732,-85,3,40,51
1,1642,1835,-193,0,-27,91
1,1484,1656,-172,0,44,69
-1,1981,1861,120,-1,14,62
1,1791,1615,176,0,70,97
1,1797,1616,181,-3,-11,121
1,1805,1863,-58,0,62,87
-1,1957,1752,205,1,6,44
-1,1913,1990,-77,0,-87,66
-1,1372,1198,174,0,63,72
1,1779,1916,-137,-1,106,113
-1,1500,1580,-80,-7,-298,62
-1,1500,1689,-189,-16,-461,50
-1,1325,1283,42,-2,-1,60
1,1854,1654,200,2,67,45
-1,1524,1458,66,-2,-49,98
1,1661,1816,-155,-1,-3,59
0,1360,1529,-169,0,-9,89
-1,1390,1439,-49,1,15,56
-1,1120,0,1120,-22,-454,46
1,1745,1492,253,1,1,45
-1,1799,2036,-237,-1,-54,78
1,1999,1904,95,1,3,49
1,1737,1531,206,2,54,49
0,1681,1700,-19,-5,63,125
-1,1714,1687,27,2,-23,62
-1,1624,1349,275,-5,-317,86
-1,1335,1668,-333,-3,-88,60
1,1903,1752,151,-2,82,109
-1,1897,2081,-184,-2,-84,64
-1,1366,1391,-25,-1,162,114
1,1858,1579,279,0,-21,67
-1,1843,2077,-234,-5,-186,86
-1,1706,1727,-21,-3,-80,144
-1,1470,1566,-96,-3,-227,80
-1,1424,1513,-89,-2,-248,62
1,1625,1551,74,-1,42,83
1,1408,1584,-176,2,50,52
1,1500,1708,-208,0,547,109
-1,1889,1935,-46,-3,52,62
1,1673,1700,-27,-2,105,145
1,1519,1715,-196,0,-71,93
1,2105,1891,214,0,5,61
1,1805,1791,14,-1,80,65
1,1842,1838,4,0,73,119
-1,1316,1400,-84,-8,-58,40
0,1429,1488,-59,3,34,125
-1,1748,1480,268,-1,-69,104
-1,1883,1459,424,-1,4,60
1,1491,1082,409,-1,-11,49
0,1647,1671,-24,-2,-55,106
-1,1826,1854,-28,0,-626,100
1,1568,1862,-294,0,206,83
-1,1674,1611,63,0,-26,58
-1,1567,1566,1,-7,-998,146
-1,1745,1795,-50,0,4,60
-1,1634,1908,-274,0,-10,58
-1,1207,1255,-48,-8,-275,60
-1,1611,1748,-137,0,-10,54
1,2180,1538,642,6,358,55
1,1736,1493,243,8,27,44
1,1483,1285,198,2,311,143
1,1865,1816,49,0,349,113
-1,1886,2125,-239,-1,-215,130
-1,1307,1409,-102,-4,-76,44
-1,1478,1409,69,1,17,83
1,1538,1786,-248,5,150,55
1,2047,1945,102,0,90,63
1,1863,1484,379,10,427,71
-1,1806,1875,-69,0,-158,74
1,1258,1221,37,-3,-74,47
0,1481,1533,-52,0,143,202
1,1231,1512,-281,-1,-116,87
-1,1768,1561,207,3,214,74
1,1735,1500,235,-1,9,57
1,1524,1596,-72,-2,-91,71
-1,1547,1842,-295,-4,-48,42
-1,1299,1651,-352,-8,-130,46
1,1684,1140,544,0,0,47
1,1736,1804,-68,1,50,101
1,1815,1540,275,0,16,57
-1,1301,1441,-140,3,102,54
1,1500,1532,-32,-5,-234,85
-1,1441,1291,150,-26,-1501,80
1,1372,1382,-10,3,355,95
0,1459,1519,-60,2,60,51
1,1593,1331,262,4,219,63
1,1470,1280,190,0,103,95
-1,1444,1421,23,-3,-124,64
1,1687,1506,181,5,440,71
-1,2141,1882,259,3,240,90
1,1178,0,1178,4,191,65
1,1846,1500,346,0,56,57
-1,1865,1880,-15,0,39,78
1,1523,1691,-168,-3,-57,49
-1,1264,1448,-184,-6,-163,112
-1,1537,1582,-45,-3,-213,86
1,1677,1723,-46,0,170,119
0,1473,1578,-105,0,445,95
-1,1630,1548,82,1,9,52
0,1670,1648,22,2,-397,121
-1,1524,1516,8,-1,281,116
0,1293,1634,-341,4,205,99
1,1694,1500,194,7,167,51
-1,1791,1749,42,-2,29,106
0,1392,1322,70,-17,-409,49
-1,1434,1450,-16,1,-575,114
-1,1500,1603,-103,-1,-49,68
-1,1819,1685,134,-1,-90,56
-1,1354,1393,-39,5,-39,128
1,1870,1664,206,-4,-201,99
-1,1649,1500,149,-9,6,40
1,1786,1986,-200,-1,-103,81
1,1854,1890,-36,1,27,43
1,1388,1325,63,2,305,79
1,1753,1536,217,2,98,54
1,1553,1682,-129,1,0,57
-1,1501,1453,48,0,35,88
-1,1530,1758,-228,1,-757,122
1,1611,1594,17,0,70,65
1,1500,1850,-350,0,21,53
1,1867,1878,-11,0,-3,69
1,1259,1439,-180,1,21,45
-1,1899,2080,-181,0,-79,88
1,1626,1542,84,-3,68,63
-1,1978,1868,110,0,-65,78
-1,1274,1408,-134,-1,-9,42
1,1492,1463,29,0,559,139
0,1822,1797,25,1,117,121
1,1586,1626,-40,15,291,53
-1,1699,1407,292,0,-114,110
-1,1910,1611,299,-10,-567,152
-1,1315,1288,27,-1,-111,60
-1,1684,1765,-81,1,-267,118
1,1763,1525,238,1,317,63
-1,1640,1670,-30,2,-131,122
0,1402,1315,87,4,601,78
1,1493,1253,240,1,192,65
1,1326,1052,274,4,317,104
1,1267,1132,135,2,-84,59
1,1837,1592,245,1,70,93
1,1804,1585,219,-1,23,61
1,1751,1797,-46,11,113,41
1,1917,1500,417,9,171,49
-1,1289,1464,-175,-4,-586,94
-1,1499,1301,198,4,287,72
-1,1520,1768,-248,-3,-109,82
1,1621,1848,-227,0,81,65
1,1785,1764,21,-1,-148,71
1,1751,1568,183,0,58,53
1,1408,1333,75,1,35,59
1,1667,1568,99,4,86,49
-1,1236,1354,-118,-3,-38,47
1,1479,1502,-23,0,220,111
1,1875,1893,-18,3,197,65
1,1469,1538,-69,1,63,79
-1,1498,1923,-425,-1,-45,50
0,1242,1351,-109,-15,-1907,100
-1,1451,1416,35,0,0,68
1,1444,1437,7,0,1,53
0,1783,1929,-146,-1,-1056,191
1,1772,1516,256,7,306,69
1,1496,1766,-270,-2,-256,85
-1,1659,1582,77,-7,-136,64
-1,1271,1680,-409,-1,-16,52
-1,1488,1361,127,3,-41,70
1,1625,1365,260,26,664,55
-1,1360,1629,-269,-8,-272,62
1,1631,1890,-259,2,166,93
-1,1273,1223,50,-1,-209,82
1,1916,1787,129,2,270,107
0,1998,1937,61,-1,2,99
-1,1511,1777,-266,-5,-344,80
-1,1693,1967,-274,0,19,84
-1,1846,1769,77,-2,-473,112
1,1590,1460,130,5,187,61
-1,1461,1601,-140,-1,-43,48
-1,1380,1474,-94,-18,-181,42
1,1619,1042,577,6,110,45
1,1685,1602,83,2,36,79
1,1700,1696,4,0,-16,81
1,1863,1677,186,2,29,45
-1,1574,1586,-12,-3,-17,58
1,1634,1355,279,8,863,83
-1,1282,1336,-54,3,1,68
-1,1780,1936,-156,0,8,92
1,1848,1623,225,0,17,91
-1,1881,1886,-5,0,-313,122
-1,1957,1803,154,0,68,90
-1,1239,1415,-176,-3,-67,46
-1,1638,1550,88,3,197,68
-1,1781,1507,274,1,104,94
-1,1403,1558,-155,-7,-101,42
-1,1498,1465,33,3,45,90
1,1620,1577,43,0,-51,61
1,1953,1773,180,7,385,95
1,1517,1334,183,1,1012,107
1,1202,1283,-81,-1,8,55
-1,1671,1914,-243,-10,-137,68
-1,1577,1555,22,-2,-7,60
-1,1565,1623,-58,1,-309,96
1,1829,1676,153,3,46,45
-1,1483,1608,-125,0,-44,108
1,1757,1604,153,1,195,105
-1,1204,1376,-172,-7,-419,108
1,1768,1968,-200,0,17,89
-1,1633,1555,78,-4,140,100
1,1891,1691,200,1,29,70
1,1638,1702,-64,4,115,48
-1,1896,1870,26,-2,-106,88
0,1695,1593,102,0,67,143
1,1831,1752,79,0,4,55
1,1809,1498,311,0,13,45
-1,1675,1425,250,-5,-180,56
-1,1315,1387,-72,-10,-135,46
-1,1652,1854,-202,0,-12,96
1,1546,1527,19,0,81,115
1,1667,1618,49,0,-45,61
1,1950,1597,353,7,97,75
1,1662,1675,-13,7,148,52
-1,1841,1779,62,-3,-53,76
1,1260,1248,12,1,587,137
1,1560,1630,-70,0,-210,105
1,1630,1418,212,0,42,73
1,2004,1452,552,12,168,45
1,1582,1483,99,6,151,59
1,1460,1454,6,-4,414,101
1,1784,1608,176,2,931,135
1,1383,1362,21,1,165,67
1,1939,1864,75,-1,-3,51
1,1948,1667,281,0,4,41
1,1651,1755,-104,0,31,47
1,1620,1649,-29,3,187,79
-1,1885,1882,3,0,-57,96
-1,1515,1565,-50,-2,173,84
1,1602,1790,-188,0,263,103
-1,1520,1645,-125,1,16,50
0,1635,1643,-8,2,57,55
1,1812,1549,263,0,47,65
-1,1586,1367,219,0,17,64
-1,1826,1662,164,0,-240,94
1,1855,1947,-92,0,69,97
1,1594,1666,-72,0,-41,63
1,1587,1685,-98,2,21,71
0,1954,1814,140,-10,-32,143
1,1523,1939,-416,0,-9,73
1,1352,1395,-43,5,1049,127
1,1630,1773,-143,0,9,47
1,1663,1290,373,0,-43,69
1,1300,1145,155,-1,-3,57
-1,1651,1674,-23,-1,-11,73
1,1758,1646,112,0,-9,45
-1,1636,1531,105,-2,-62,52
-1,1282,1385,-103,-1,-33,44
1,1671,1601,70,-1,168,69
-1,1893,1874,19,-4,-106,80
-1,1638,1766,-128,-1,192,92
1,1571,1606,-35,1,53,75
1,1884,1762,122,-8,-367,79
1,1495,1524,-29,3,86,53
-1,1818,1797,21,1,-152,112
-1,1809,1678,131,3,30,68
1,1694,1745,-51,0,-43,55
1,1437,1481,-44,0,-12,61
-1,1512,1276,236,0,-101,78
1,1596,1564,32,5,360,77
-1,1620,1713,-93,0,29,88
1,1773,1630,143,0,29,51
-1,1425,1426,-1,1,25,50
1,1754,1823,-69,1,42,71
1,1307,1304,3,-3,-89,67
-1,1632,1470,162,3,255,92
-1,1623,1780,-157,0,53,84
-1,1715,1792,-77,-4,-286,128
1,1933,1692,241,5,231,61
-1,1622,1592,30,0,7,52
-1,1885,1882,3,0,55,106
1,1595,1735,-140,4,5,71
1,1948,1756,192,2,37,45
1,1810,1768,42,0,-6,71
-1,1458,1657,-199,0,-373,135
-1,1567,1545,22,-3,-96,62
-1,1665,1600,65,1,-226,106
1,1616,1892,-276,0,-4,75
1,1793,1527,266,0,210,133
-1,1205,1284,-79,-3,-181,70
1,1447,1483,-36,0,3,51
1,1393,1426,-33,-7,-73,147
-1,1604,1610,-6,0,-269,96
1,1677,1639,38,0,170,121
-1,1458,1456,2,-5,-64,48
1,1721,1196,525,5,283,60
0,1955,1731,224,0,-554,122
1,2104,1633,471,1,113,89
1,1873,1636,237,1,15,81
-1,1520,1708,-188,-1,-41,60
-1,1566,1563,3,-1,-23,54
1,1582,1677,-95,-3,21,101
1,1860,1610,250,0,-1,49
-1,1709,1906,-197,0,23,84
-1,1721,1946,-225,0,-85,60
-1,1455,1544,-89,-1,13,44
-1,1553,1548,5,-5,-205,44
1,2196,1878,318,-6,-304,121
1,1495,1629,-134,-1,10,45
-1,1722,1750,-28,-5,-65,47
0,1843,1696,147,-6,-46,97
1,1616,1521,95,5,125,105
1,1267,1387,-120,1,48,47
-1,1488,1494,-6,-11,-66,42
1,1463,1352,111,2,434,83
1,1621,1593,28,0,130,75
1,1512,1569,-57,1,91,62
1,1542,1622,-80,-1,-5,55
1,1510,1559,-49,0,59,77
-1,1821,1874,-53,0,-31,88
-1,1606,1865,-259,-2,-83,76
1,1761,1711,50,0,129,73
-1,1875,1841,34,-3,2,44
-1,1194,1642,-448,-11,-491,66
-1,1438,1555,-117,-3,-51,106
-1,1629,1752,-123,-2,-188,92
-1,1884,1811,73,0,-199,138
1,1576,1583,-7,5,325,65
-1,1540,1615,-75,-3,-72,46
0,1706,1853,-147,-1,55,81
-1,1722,1342,380,1,-52,74
-1,1651,1625,26,1,107,88
-1,1218,1279,-61,-1,-2,40
-1,1513,1547,-34,1,20,70
1,1561,1625,-64,2,32,41
-1,1695,1604,91,0,3,116
1,1277,1500,-223,6,196,69
-1,1713,1930,-217,-1,-151,100
-1,1542,1548,-6,-5,-60,44
1,1950,1835,115,0,30,65
-1,1551,1853,-302,0,-301,138
1,1840,1701,139,-9,417,109
1,1655,1301,354,0,29,61
1,1579,1432,147,2,192,81
1,1749,1561,188,-1,-39,63
1,1934,1895,39,-2,142,99
-1,1827,1958,-131,0,1,46
-1,1775,1974,-199,0,-1,52
1,1806,1787,19,1,149,77
1,1540,1449,91,-3,83,59
-1,1659,1733,-74,-8,-76,78
1,1800,1642,158,2,191,95
1,1966,1820,146,2,449,113
1,1612,1575,37,0,1,69
1,1649,1288,361,4,182,69
1,1709,1707,2,-5,-63,67
1,1523,1498,25,-2,-42,41
1,1813,1973,-160,4,443,89
1,1944,1930,14,-1,155,93
-1,1847,1700,147,-1,-88,62
1,1411,1353,58,-8,-179,65
-1,1396,1342,54,-1,-294,86
1,1407,1567,-160,1,219,129
1,1500,1697,-197,-1,-22,71
1,1941,1597,344,2,60,67
-1,1702,1626,76,2,57,80
1,1569,1441,128,0,6,51
1,1717,1753,-36,2,177,81
1,1956,1829,127,0,-50,109
1,1401,1171,230,-2,-52,79
1,1295,1551,-256,6,289,72
-1,1481,1586,-105,-11,-364,114
1,1718,1816,-98,-1,238,103
-1,1848,1694,154,0,-25,106
1,1526,1563,-37,-2,-111,81
1,1566,1523,43,3,182,67
-1,1690,1731,-41,-1,-639,128
1,1487,1344,143,1,96,87
-1,1628,1723,-95,-3,-451,84
1,1822,1964,-142,3,173,89
1,2034,1648,386,1,20,51
1,1655,1500,155,-2,-18,57
-1,1577,1472,105,-1,-53,54
1,1927,1778,149,2,68,57
-1,1742,1646,96,0,-6,60
-1,1954,1919,35,0,-183,76
-1,1947,1837,110,-1,-70,98
-1,1696,1720,-24,0,14,68
1,1430,1545,-115,-2,-1,101
1,1742,1651,91,0,52,73
1,1493,1551,-58,17,796,61
1,1551,1538,13,-3,18,79
1,1801,1731,70,0,221,119
0,1728,1913,-185,0,-33,113
1,1702,1726,-24,0,-181,93
-1,1852,1932,-80,-5,-31,90
1,1448,1440,8,-3,-28,89
-1,1660,1820,-160,-3,42,132
-1,1435,1559,-124,-3,-82,82
-1,1406,1525,-119,0,134,58
1,1709,1548,161,4,140,63
0,1831,1857,-26,0,-31,78
-1,1615,1671,-56,2,67,64
1,1941,1843,98,0,6,83
1,1527,1562,-35,1,15,51
1,1600,1526,74,0,116,113
1,1688,1558,130,0,-18,53
1,1565,1440,125,0,11,55
1,1830,1603,227,2,81,69
-1,1352,1648,-296,-1,-64,66
-1,1835,1950,-115,2,124,66
1,1730,1686,44,-2,-76,61
1,1421,1652,-231,-1,709,111
-1,1641,1778,-137,2,34,50
-1,1643,1750,-107,-7,-77,44
-1,1958,1827,131,-8,-42,47
-1,1680,1605,75,0,-75,96
1,1723,1686,37,0,295,155
1,1842,1942,-100,0,109,93
-1,1500,1363,137,8,546,78
1,1648,1833,-185,1,8,43
1,1383,1542,-159,0,-138,99
-1,1494,1759,-265,0,-23,92
1,1637,1399,238,4,225,63
-1,1560,1716,-156,-10,-235,82
1,1927,1857,70,-5,-60,107
1,1816,1664,152,1,128,55
1,1705,1571,134,1,237,75
-1,1576,1629,-53,-3,-16,58
0,1250,1455,-205,0,-31,127
1,1816,1633,183,3,154,65
1,1595,1428,167,-1,-8,41
1,1931,1942,-11,2,62,63
1,1922,1861,61,-5,211,135
-1,1772,1952,-180,-1,-211,108
1,1701,1501,200,5,198,75
-1,1716,1723,-7,0,-31,90
-1,1550,1490,60,0,7,40
1,1627,1822,-195,0,11,45
-1,1759,1677,82,-1,-228,104
1,1541,1467,74,-2,-104,99
-1,1681,1590,91,0,-94,94
1,1822,1627,195,4,541,121
1,1430,1458,-28,4,178,99
1,1959,1754,205,0,15,51
1,1768,1808,-40,4,362,101
1,1504,1534,-30,-2,-197,79
0,1918,1866,52,0,-15,106
1,1620,1619,1,0,-10,90
-1,1739,1965,-226,0,-495,144
1,1602,1421,181,1,55,63
-1,1527,1676,-149,1,20,62
1,1579,1472,107,4,275,67
1,1867,1916,-49,-1,25,99
1,1607,1349,258,3,70,43
1,1582,1410,172,0,489,129
-1,1644,1805,-161,-5,-289,68
1,1382,1340,42,6,202,52
1,1857,1773,84,4,103,47
1,1929,1943,-14,0,20,55
1,1700,1553,147,6,366,73
-1,1636,1903,-267,0,13,48
-1,1568,1667,-99,1,-44,98
1,1607,1667,-60,-1,-13,47
-1,1744,1690,54,-1,-367,96
-1,1907,1632,275,-4,-301,60
1,1591,1621,-30,0,66,75
1,1478,1500,-22,0,19,53
1,1774,1683,91,3,160,113
1,1257,1161,96,5,625,113
1,1707,1520,187,7,251,62
0,1460,1696,-236,-1,-257,99
-1,1638,1566,72,-2,-52,44
1,1733,1658,75,1,108,77
-1,1650,1889,-239,1,52,66
1,1608,1514,94,1,43,71
-1,1726,1764,-38,-4,-85,62
-1,1329,1397,-68,1,-291,90
1,1637,1167,470,7,196,43
-1,1836,1847,-11,0,-166,104
1,1726,1500,226,7,370,67
-1,1940,1887,53,1,56,48
1,1893,1646,247,-5,-139,63
1,1587,1462,125,0,-11,43
-1,1712,1719,-7,0,-303,86
-1,1515,1700,-185,-2,-49,48
-1,1399,1405,-6,-9,-528,94
-1,1845,1373,472,-1,78,76
-1,1174,1736,-562,-4,-779,116
-1,1928,1901,27,0,-28,62
1,1715,1546,169,4,178,69
1,1707,1612,95,-1,3,91
1,1902,1637,265,1,23,47
1,1344,1525,-181,-1,-46,79
-1,1737,1639,98,-6,-1212,128
-1,1942,1821,121,1,52,78
-1,1739,1774,-35,0,-28,50
1,1633,1907,-274,4,106,41
-1,1754,1355,399,0,-169,114
1,1617,1506,111,5,196,59
1,1585,1593,-8,23,703,55
-1,1653,1686,-33,-4,-207,82
1,1634,1617,17,-2,47,91
-1,1474,1313,161,-1,-29,60
1,1595,1455,140,6,-273,91
1,1705,1509,196,6,152,61
-1,1394,1539,-145,-2,-104,68
-1,1701,1733,-32,1,39,80
1,1887,1652,235,0,-7,43
1,1787,1955,-168,0,-15,61
1,1621,1631,-10,-1,519,145
-1,1770,1649,121,0,-25,60
-1,1568,1498,70,5,135,62
1,1649,1297,352,1,138,97
1,1594,1500,94,-3,26,69
1,1892,1643,249,0,0,79
1,1654,1633,21,-1,27,64
-1,1675,1737,-62,-3,-20,42
-1,1656,1277,379,-4,-54,40
-1,1722,1868,-146,0,-52,80
-1,1388,1866,-478,1,0,55
1,1540,1387,153,-1,-25,47
1,1606,1550,56,1,14,55
-1,1795,2025,-230,2,73,64
1,1339,1500,-161,4,364,70
1,1438,1143,295,-3,10,47
0,1742,1782,-40,0,10,101
1,1689,1483,206,0,19,67
-1,1453,1540,-87,-2,-163,76
1,1638,1897,-259,0,483,131
-1,1784,1730,54,0,-23,62
-1,1661,1837,-176,0,4,44
1,1937,1664,273,0,468,111
1,1500,1462,38,3,135,67
0,1603,1603,0,-7,-136,70
1,1761,1696,65,-1,-91,69
-1,1657,1878,-221,-2,-34,46
-1,1612,1710,-98,-1,-203,124
-1,1747,1445,302,0,-30,64
1,1388,1199,189,2,329,73
0,1755,1732,23,0,129,126
-1,1536,1534,2,1,-39,70
1,1423,1208,215,2,71,55
1,1551,1603,-52,1,132,87
1,1330,1256,74,4,25,40
-1,1883,1652,231,3,92,68
-1,1645,1355,290,1,23,80
-1,1541,1666,-125,0,-206,124
-1,1388,1267,121,0,-67,68
1,1371,1441,-70,-3,-80,73
-1,1715,1604,111,-1,15,136
1,1385,1187,198,3,150,59
1,1453,1580,-127,-6,111,71
-1,1542,1593,-51,4,83,68
1,1844,1655,189,4,57,43
-1,1360,1491,-131,-6,-231,112
1,1758,1387,371,11,441,63
-1,1670,1864,-194,-2,-36,66
1,1624,1264,360,4,576,87
1,1547,1624,-77,4,282,71
1,1552,1733,-181,0,185,67
0,1447,1193,254,0,4,125
-1,1716,1876,-160,-3,-5,64
-1,1633,1679,-46,2,3,74
1,1615,1551,64,0,0,77
-1,1870,1664,206,2,43,50
1,1823,1695,128,-5,-80,81
1,1500,1391,109,1,118,64
-1,1742,1771,-29,-4,-235,78
-1,1546,1518,28,-1,-70,52
1,1682,1852,-170,-3,-38,63
-1,1603,1508,95,1,-32,103
1,1629,1386,243,-6,-352,95
-1,1431,1657,-226,-3,-40,76
1,1781,1850,-69,-1,105,59
1,1709,1546,163,5,160,53
1,1835,1698,137,1,194,99
1,1526,1455,71,5,76,65
-1,1380,1883,-503,0,143,88
-1,1753,1626,127,-2,-107,82
1,1388,1392,-4,2,262,71
1,1369,1435,-66,1,-34,71
1,1402,1428,-26,-2,-116,63
-1,1642,1594,48,0,-60,74
-1,1329,1282,47,0,-77,76
-1,1399,1416,-17,0,-6,66
-1,1733,1754,-21,0,-164,118
1,1716,1718,-2,4,62,55
-1,1652,1696,-44,0,-1,44
-1,1675,1741,-66,-1,-43,62
1,1602,1448,154,0,3,65
1,1626,1647,-21,0,27,57
-1,1691,1842,-151,0,45,100
1,1604,1553,51,-1,-12,49
1,1540,1618,-78,0,-2,85
1,1790,1653,137,0,-4,59
1,1849,1684,165,6,159,53
1,1781,1732,49,4,507,95
-1,1907,1716,191,0,-403,120
-1,1343,1458,-115,-1,79,74
-1,1698,1702,-4,-1,63,60
1,1833,2061,-228,-2,-78,71
1,1907,1622,285,0,51,69
1,1851,1217,634,4,164,53
-1,1535,1604,-69,-4,-12,40
-1,1715,1728,-13,-5,-274,72
1,1683,1666,17,0,23,95
-1,1565,1469,96,-5,-102,40
1,1678,1856,-178,0,161,101
1,1534,1504,30,-4,329,93
1,1388,1427,-39,0,149,107
-1,1344,1577,-233,-1,-14,56
1,1497,1625,-128,0,0,41
-1,1374,1328,46,2,168,94
1,1237,1446,-209,-1,85,131
1,1642,1549,93,5,175,54
1,1551,1534,17,5,454,107
0,1836,1812,24,1,1125,139
1,1466,1335,131,-3,73,103
1,1601,1658,-57,0,-25,77
-1,1385,1428,-43,3,84,118
-1,1512,1805,-293,-17,-799,80
1,1622,1500,122,-1,-2,43
0,1666,1852,-186,-4,-182,100
1,1526,1384,142,5,404,87
1,1774,1732,42,0,-599,123
-1,1395,1728,-333,1,-27,81
-1,1737,1500,237,-3,-13,46
1,1529,1488,41,1,40,58
-1,1395,1410,-15,-2,-89,88
-1,1647,1839,-192,0,-14,98
-1,1791,2041,-250,-2,-65,70
-1,1408,1594,-186,2,-359,112
-1,1622,1859,-237,-3,-17,40
1,1638,1549,89,-1,75,105
1,1701,1603,98,-3,-127,73
-1,1572,1287,285,-1,13,68
1,1736,1172,564,1,114,79
1,1845,1641,204,0,5,75
1,1941,2313,-372,-1,1,41
1,1422,1273,149,1,141,69
1,1608,1228,380,1,363,103
-1,1570,1666,-96,0,-155,134
1,1716,1656,60,0,82,77
1,1516,1327,189,-2,35,57
1,1692,1636,56,0,538,117
1,1597,1726,-129,0,5,51
1,1636,1850,-214,-2,365,65
1,1587,1856,-269,0,48,75
0,1931,2094,-163,-5,47,101
1,1732,1392,340,1,352,97
-1,1487,1834,-347,-5,-65,40
1,1592,1614,-22,1,53,67
-1,1652,1554,98,0,-935,164
1,1415,1401,14,3,263,91
-1,1551,1609,-58,0,-90,68
1,1349,1556,-207,0,-61,105
1,1551,1618,-67,0,-58,81
-1,1363,1345,18,-14,-617,90
-1,1149,1623,-474,-1,-619,128
-1,1480,1698,-218,0,-16,62
1,1832,1653,179,0,10,55
-1,1866,1911,-45,0,4,77
1,1498,1582,-84,2,124,101
-1,1814,1835,-21,-1,6,50
-1,1417,1716,-299,0,-63,94
1,1710,1612,98,0,93,97
-1,1779,2170,-391,-1,-157,108
1,1500,1590,-90,2,57,65
1,1542,1620,-78,5,192,71
1,1505,1870,-365,-1,-1,53
-1,1647,1838,-191,0,49,102
1,1651,1795,-144,2,153,97
-1,1710,1722,-12,0,-238,88
-1,1415,1431,-16,4,118,58
1,1960,2046,-86,-2,7,77
1,1396,1606,-210,2,4,127
-1,1319,1342,-23,0,155,62
1,1221,1158,63,5,79,75
-1,1541,1646,-105,-2,-76,54
1,1866,1356,510,0,10,63
0,1820,1660,160,0,-206,135
-1,1457,1505,-48,0,15,50
-1,1645,1545,100,-4,-104,54
1,1424,1163,261,1,8,47
1,1484,1362,122,0,22,47
-1,1245,1319,-74,-3,-181,80
1,1659,1826,-167,-2,534,95
1,2088,1936,152,0,100,99
-1,1389,1735,-346,-3,-154,66
-1,1532,1654,-122,0,-94,82
1,1322,1441,-119,-10,173,97
1,1742,1792,-50,0,463,129
-1,1418,1348,70,1,32,74
0,1668,1801,-133,0,8,69
-1,1322,1323,-1,3,336,138
-1,1876,1438,438,0,-13,50
1,1604,1719,-115,-1,-19,105
1,1561,1629,-68,7,678,99
1,1585,1744,-159,0,61,49
-1,1777,1809,-32,3,117,70
1,1348,1098,250,9,375,53
-1,1737,1855,-118,-4,-63,103
-1,1312,1421,-109,-4,-116,50
-1,1870,1469,401,0,34,60
-1,1733,1700,33,1,51,118
-1,1354,1492,-138,-14,-142,42
-1,1701,1500,201,-7,-387,72
-1,1500,1407,93,0,-113,76
1,1637,1552,85,0,-181,105
1,1853,2030,-177,-6,-68,63
-1,1537,1492,45,5,78,56
-1,1430,1489,-59,-3,-73,48
1,1739,1386,353,8,322,73
1,1738,1593,145,0,74,55
-1,1820,1766,54,-5,-111,70
-1,1339,1426,-87,-4,-37,40
-1,1377,1581,-204,-4,-375,82
1,1354,1561,-207,6,428,69
-1,1725,1759,-34,-1,-1,42
1,1370,1212,158,5,172,49
1,1382,1276,106,3,228,59
-1,1336,1500,-164,-4,-176,62
-1,1357,1515,-158,-1,10,62
1,1709,1593,116,11,616,73
-1,1929,1769,160,0,-22,54
1,1309,1063,246,6,234,51
1,1603,1604,-1,1,44,49
1,1654,1150,504,13,412,55
1,1401,1355,46,0,320,101
-1,1375,1687,-312,-3,-12,62
1,1588,1415,173,11,358,59
1,1539,1266,273,5,194,55
0,1468,1559,-91,-3,-33,54
1,1548,1556,-8,0,38,93
-1,1533,1494,39,-2,-77,52
1,1424,1075,349,2,143,53
1,1247,1149,98,3,581,107
-1,1807,1739,68,-11,-75,42
1,1704,1557,147,2,196,63
1,1533,1500,33,4,194,66
1,1499,1421,78,-1,146,99
1,1499,1404,95,-9,-33,41
-1,1527,1545,-18,-5,-181,76
1,1715,1591,124,-1,-33,65
-1,1752,1793,-41,1,221,114
-1,1141,1338,-197,-5,-182,52
1,1585,1500,85,-6,79,109
-1,1500,1573,-73,-3,7,42
1,1416,1223,193,5,100,41
-1,1232,1014,218,4,192,96
-1,1459,1507,-48,0,2,42
-1,1577,1633,-56,0,-69,70
-1,1646,1619,27,-3,-808,158
1,1655,1571,84,0,-279,149
1,1680,1495,185,2,27,67
-1,1033,1313,-280,-3,-54,54
1,1803,1742,61,0,-31,75
-1,1711,1721,-10,0,-33,54
-1,1520,1482,38,-2,-199,82
1,1577,1426,151,2,607,107
-1,1706,1794,-88,-2,-76,58
1,2096,1766,330,0,101,87
-1,1645,1457,188,1,2,90
1,1711,1671,40,3,276,77
1,1433,1467,-34,1,74,79
1,1726,1661,65,-2,247,99
-1,1432,1881,-449,-1,38,60
-1,1593,1613,-20,1,-16,50
-1,1542,1743,-201,-4,-126,52
-1,1208,1458,-250,2,39,66
-1,1696,1813,-117,0,-280,94
1,1802,1738,64,1,427,105
-1,1557,1553,4,0,-235,120
-1,1914,1846,68,0,-14,96
-1,1371,1507,-136,-8,-87,54
1,1616,1540,76,-1,166,93
1,1390,1425,-35,1,206,97
1,1584,1646,-62,-2,157,113
-1,1261,1258,3,-4,-287,66
1,1543,1544,-1,0,270,109
-1,1456,1398,58,-1,15,50
-1,1557,1517,40,0,-2,60
-1,1717,1829,-112,3,102,78
-1,1396,1148,248,0,272,84
1,1411,1330,81,1,126,89
-1,1732,1701,31,0,-108,100
1,1820,1811,9,3,143,69
1,1427,1375,52,-1,-53,67
-1,1780,1729,51,-2,-55,66
1,1649,1591,58,0,219,96
1,1564,1526,38,9,184,43
1,1698,1669,29,-3,-7,47
1,1761,1769,-8,-1,-11,59
1,1536,1560,-24,1,41,71
-1,1419,1584,-165,0,-44,58
1,2226,1665,561,2,121,67
1,1800,1831,-31,0,12,71
1,1729,1780,-51,1,250,83
1,1658,1709,-51,0,148,85
-1,1664,1972,-308,-1,-101,66
1,1318,1471,-153,-6,-112,77
1,1364,1514,-150,-2,46,49
1,1733,1742,-9,-1,153,103
1,1633,1630,3,-1,55,67
1,1819,1812,7,0,131,89
1,1544,1603,-59,-1,53,119
1,1900,2130,-230,0,33,125
-1,1396,1721,-325,2,20,62
1,1450,1257,193,0,86,67
-1,1533,1554,-21,0,23,50
1,1371,1164,207,5,184,56
1,1745,1535,210,5,150,45
-1,1508,1667,-159,-1,-152,80
1,1250,1452,-202,1,31,43
-1,1450,1387,63,-2,-45,72
1,1214,1249,-35,0,31,49
1,1743,1660,83,5,380,89
-1,1767,1730,37,-1,-77,82
1,1599,1123,476,2,423,131
-1,1591,1477,114,0,36,72
1,1285,1470,-185,2,142,63
-1,1412,1443,-31,-10,-24,40
-1,1802,1745,57,0,50,88
-1,1830,1892,-62,-1,29,114
1,1498,1531,-33,0,7,65
-1,1413,1402,11,4,85,46
-1,1597,1659,-62,-12,-413,58
1,2007,1782,225,0,24,71
1,1192,1269,-77,2,321,73
-1,1757,1789,-32,5,287,82
-1,1543,1523,20,-6,-19,44
-1,1671,1720,-49,1,36,62
1,1620,1645,-25,0,203,99
1,1730,1565,165,1,28,45
1,1458,1548,-90,3,239,93
0,1235,1300,-65,-7,-613,121
-1,1231,1223,8,-4,-309,90
1,1574,1540,34,4,107,55
0,1746,1419,327,-1,29,178
1,2111,1918,193,0,277,101
-1,1905,1820,85,0,-21,78
1,1300,1154,146,-9,-182,55
-1,1558,1479,79,1,-52,68
-1,1652,1550,102,-1,-365,178
1,1799,1747,52,0,9,91
-1,1834,1886,-52,0,14,86
-1,1238,1379,-141,-5,-56,74
-1,1377,1432,-55,-5,-176,46
-1,1727,1761,-34,-14,-234,72
1,1236,1469,-233,4,166,41
1,1227,1368,-141,3,148,59
-1,1518,1471,47,-2,-110,66
-1,1730,1921,-191,2,15,66
1,1587,1661,-74,2,238,77
-1,1530,1534,-4,-8,-42,78
-1,1482,1446,36,0,-16,52
1,1563,1338,225,0,440,85
1,1718,1727,-9,1,241,115
1,1541,1730,-189,-1,-28,67
-1,1424,1576,-152,-5,-68,50
-1,1608,1583,25,4,43,42
-1,1940,2144,-204,-1,-119,98
1,1796,1459,337,-1,128,73
-1,1456,1320,136,3,192,162
1,1331,1532,-201,5,148,63
1,1641,1290,351,0,111,73
1,2150,1935,215,-3,-15,95
-1,1573,1481,92,-1,-89,54
1,1345,1310,35,1,458,93
1,1385,1483,-98,-2,39,71
-1,1935,1882,53,-1,-208,86
1,1668,1712,-44,5,181,67
1,1667,1596,71,0,539,111
-1,1406,1390,16,-2,41,48
-1,1930,2156,-226,-4,-20,50
1,1497,1300,197,2,241,67
1,1557,1503,54,-1,33,57
1,1632,1539,93,-1,-49,57
1,1642,1268,374,11,101,40
1,1656,1630,26,0,-25,57
1,1925,1815,110,4,192,57
-1,1584,1605,-21,1,25,46
-1,1387,1484,-97,-5,-153,60
-1,1350,1565,-215,-4,-68,44
-1,1372,1241,131,0,-162,88
1,1328,1189,139,-3,-55,53
-1,1587,1709,-122,0,-291,116
1,1808,1933,-125,-2,-214,115
1,1544,1328,216,-1,57,73
-1,1463,1574,-111,0,-8,54
-1,1896,1923,-27,-2,-114,70
-1,1595,1631,-36,1,-11,50
1,1533,1683,-150,-4,40,115
1,1707,1548,159,5,69,48
-1,1615,1574,41,0,2,54
-1,1551,1755,-204,1,-69,126
1,1491,1415,76,0,99,111
-1,1618,1666,-48,1,-105,96
-1,1456,1800,-344,-3,-57,52
1,1922,1671,251,5,265,69
-1,1431,1403,28,3,109,46
-1,1569,1676,-107,-2,-117,90
-1,1399,1105,294,5,-331,94
0,1266,1494,-228,-3,-4,59
-1,1295,1503,-208,0,4,40
-1,1927,2020,-93,-3,-127,80
-1,1681,1608,73,-1,-31,72
0,1582,1480,102,2,149,138
-1,1536,1628,-92,-1,-118,64
1,1586,1603,-17,1,153,63
1,1857,1702,155,0,-9,61
1,1584,1714,-130,5,105,43
1,1531,1647,-116,1,151,71
1,2028,1918,110,0,79,69
-1,1478,1716,-238,2,33,46
-1,1702,1832,-130,-2,-38,44
1,1182,1335,-153,0,92,105
1,1432,1247,185,0,100,65
1,1508,1428,80,2,83,53
1,1646,1587,59,1,185,87
-1,1699,1599,100,-7,-88,46
1,1488,1277,211,3,466,81
1,1651,1543,108,1,-1,55
-1,1725,1727,-2,-1,27,90
-1,1549,1607,-58,0,-70,72
1,1592,1598,-6,-4,-27,97
1,1658,1270,388,1,105,109
-1,1549,1631,-82,-3,-166,72
-1,1416,1613,-197,-3,-297,86
0,1356,1260,96,-1,551,177
-1,1571,1686,-115,-1,-89,64
-1,1696,1670,26,-5,-48,44
-1,1613,1684,-71,-6,-235,72
-1,1532,1809,-277,0,-11,50
-1,1453,1566,-113,1,-82,66
1,1807,1500,307,12,162,41
-1,1634,1539,95,-1,-367,96
1,1570,1349,221,5,441,89
1,1526,1474,52,-2,-14,41
-1,1720,1874,-154,-2,-73,66
1,1428,1421,7,9,165,43
-1,1762,1545,217,-4,-180,76
1,1618,1540,78,1,28,53
-1,1587,1603,-16,-2,-56,80
-1,1688,1888,-200,0,-22,90
-1,1676,1730,-54,-2,0,44
1,1641,1540,101,-1,-56,69
1,1319,1195,124,4,529,95
1,1760,1749,11,5,-34,101
-1,1709,1627,82,0,64,46
1,1563,1562,1,-3,-167,63
0,1714,2036,-322,0,9,104
1,1247,1391,-144,3,531,105
1,1693,1604,89,-3,-101,51
-1,1834,2114,-280,-3,18,98
1,1684,1982,-298,0,-9,47
1,1410,1444,-34,4,115,51
1,1833,1306,527,-1,-19,97
-1,1370,1590,-220,-6,-520,74
1,1810,1602,208,2,247,115
1,1627,1650,-23,-9,281,133
1,2027,2156,-129,0,30,73
-1,1532,1644,-112,-2,-118,84
-1,1500,1621,-121,0,-31,166
-1,1739,1667,72,-2,-25,48
1,1536,1558,-22,2,173,99
1,1722,1667,55,5,169,55
-1,1563,1740,-177,-5,-65,42
-1,1890,1714,176,2,-22,184
-1,1580,1553,27,-14,-114,44
1,2139,2043,96,0,33,57
-1,1596,1702,-106,1,82,56
0,1574,1559,15,0,-6,84
-1,1567,1511,56,-1,-25,60
1,1748,1557,191,-1,-92,95
1,1517,1385,132,0,-359,109
-1,1893,1933,-40,0,-14,50
-1,1538,1475,63,5,54,88
-1,1419,1400,19,-3,-367,102
1,1667,1709,-42,4,308,102
-1,2091,2148,-57,0,-62,110
-1,1665,1500,165,0,-43,60
-1,1270,1385,-115,-7,-82,41
-1,1532,1648,-116,-1,-29,46
-1,1468,1356,112,-11,-254,60
-1,1709,1588,121,1,16,68
-1,1562,1436,126,-6,-231,56
-1,1459,1575,-116,-1,-267,146
-1,1738,1883,-145,-1,-38,60
1,1505,1410,95,4,336,63
1,1732,1713,19,0,14,67
1,1379,1390,-11,5,416,79
-1,1326,1456,-130,-6,-287,78
1,1753,1695,58,-1,-31,55
-1,1679,1590,89,-2,-419,134
1,1654,1535,119,6,138,51
1,1647,1462,185,-2,-8,57
-1,1490,1406,84,-2,-72,58
1,2159,2079,80,0,59,109
-1,1735,1772,-37,-6,-93,57
1,1900,1972,-72,0,29,75
0,1556,1413,143,1,84,111
1,1574,1546,28,0,95,87
1,1508,1542,-34,3,193,75
-1,1636,1676,-40,-1,-467,132
-1,1456,1656,-200,-1,-4,102
-1,1697,1785,-88,2,75,72
1,1574,1680,-106,-1,228,93
-1,1598,1780,-182,-2,-397,66
-1,1838,1885,-47,-3,-137,88
-1,1800,1500,300,1,-37,86
-1,1603,1695,-92,-4,-32,48
1,1749,1568,181,3,150,109
1,1650,1411,239,6,661,91
1,1662,1591,71,-4,193,111
0,2118,1942,176,0,-38,87
-1,1796,1579,217,-2,-252,98
1,1369,1379,-10,-12,-624,67
1,1762,1398,364,-3,93,65
1,1627,1565,62,3,323,149
1,1644,1476,168,2,363,95
-1,1665,2034,-369,-2,-170,62
-1,1458,1401,57,1,-20,48
1,1688,1575,113,1,77,93
1,1307,1389,-82,1,384,95
1,1913,1958,-45,-2,-9,45
1,1478,1318,160,3,242,82
0,1730,1890,-160,-4,-13,124
-1,1852,1887,-35,-4,-21,40
1,1567,1651,-84,5,286,65
1,1554,1470,84,-1,95,59
1,1666,1675,-9,0,11,97
1,2112,1947,165,3,14,41
-1,1455,1656,-201,0,-27,90
1,1395,1525,-130,-2,4,55
1,1547,1597,-50,0,103,90
1,1831,1938,-107,0,29,114
1,1755,2162,-407,-3,157,99
1,1945,1881,64,0,73,65
-1,1925,2092,-167,-10,-66,40
1,1524,1376,148,0,20,79
0,1583,1654,-71,1,3,99
-1,1661,1707,-46,2,-386,102
1,1369,1377,-8,0,113,69
1,1703,1594,109,1,97,71
-1,1349,1317,32,-13,-118,42
1,1835,1828,7,-2,-166,113
-1,1725,1651,74,0,-17,108
-1,1462,1563,-101,0,-9,58
1,1919,1835,84,0,140,111
-1,1635,2013,-378,-1,-31,120
1,1701,1729,-28,1,81,83
-1,1588,1568,20,0,-126,72
-1,1568,1651,-83,-3,-134,56
1,1696,1652,44,1,442,105
1,1672,1598,74,5,132,59
-1,1688,1620,68,1,-51,68
1,1717,1646,71,7,380,63
-1,1395,1765,-370,-1,-46,66
1,1582,1509,73,1,-33,56
1,1793,1734,59,9,450,83
1,1434,1552,-118,-1,-93,88
1,1822,1709,113,8,190,47
-1,1544,1163,381,1,-95,70
1,1454,1430,24,0,-158,119
1,1380,1198,182,-1,354,85
-1,1587,1711,-124,-5,-292,82
1,1652,1585,67,-2,-14,69
-1,1571,1667,-96,3,42,50
-1,1878,1948,-70,-4,-32,48
1,1336,1262,74,3,-23,74
1,1329,1378,-49,3,148,59
-1,1710,1777,-67,-4,-68,52
-1,1677,1727,-50,0,-2,116
-1,1919,1844,75,-2,-96,62
0,1954,1754,200,0,-232,169
1,1927,1885,42,0,9,55
-1,1634,1673,-39,-2,-143,108
0,1498,1497,1,-1,-41,126
-1,1731,1449,282,0,3,114
-1,1445,1620,-175,-1,-31,102
-1,1735,1818,-83,0,-35,50
1,1445,1503,-58,-5,-331,109
1,1922,1871,51,3,143,63
-1,1464,1675,-211,-3,-117,60
1,1527,1443,84,1,192,65
-1,1626,1779,-153,-6,38,47
1,1576,1580,-4,4,101,43
-1,1576,1661,-85,2,292,118
-1,1530,1414,116,0,-691,120
1,1659,1559,100,0,26,53
1,1910,2037,-127,-1,-114,55
-1,1584,1706,-122,-3,5,46
-1,1452,1547,-95,2,-59,100
-1,1702,1873,-171,-5,-93,54
-1,1431,1443,-12,2,41,48
-1,1450,1463,-13,3,72,50
1,1767,1787,-20,0,174,109
-1,1936,1931,5,-1,-93,82
1,1718,1580,138,2,271,117
1,1821,1951,-130,0,-13,49
0,1710,1817,-107,0,6,62
1,1342,1398,-56,0,8,61
1,1742,1638,104,-4,-82,61
1,1713,1663,50,1,64,81
-1,1773,1668,105,3,116,54
-1,1429,1418,11,-3,-124,58
-1,1456,1271,185,1,18,48
-1,1925,1680,245,4,28,54
-1,1803,1465,338,-4,-20,40
1,1366,1342,24,1,151,61
1,1587,1435,152,4,711,157
1,1386,1376,10,-1,-14,43
1,1740,1642,98,-1,-259,151
0,1551,1642,-91,-1,144,144
-1,1699,1880,-181,-2,-154,90
1,1925,1980,-55,0,1,121
-1,1792,1830,-38,1,-18,60
1,1603,1717,-114,-1,370,125
1,1666,1233,433,0,43,117
1,1679,1657,22,0,10,59
0,1567,1469,98,2,480,85
1,1698,1907,-209,2,161,75
-1,1943,1866,77,0,-62,150
-1,1497,1498,-1,-2,-113,78
-1,1432,1536,-104,-4,-175,80
1,1484,1591,-107,8,743,211
1,1645,1810,-165,-1,21,117
1,1696,1896,-200,2,-306,140
-1,1857,1793,64,-1,-5,48
1,1538,1498,40,3,219,93
0,1688,1713,-25,0,0,75
1,1726,1782,-56,1,43,81
1,1466,1401,65,2,184,57
1,1937,1815,122,8,238,67
1,1681,1352,329,2,263,69
-1,1779,2097,-318,0,-14,50
1,1889,1715,174,-1,-63,83
-1,1306,1723,-417,-4,-132,57
-1,1396,1463,-67,-10,-501,68
1,1711,1642,69,-1,-57,73
1,2123,1876,247,0,11,47
1,1782,1494,288,4,225,59
1,1664,1837,-173,-3,156,119
1,1573,1554,19,-3,417,97
-1,1588,1439,149,-5,-73,54
-1,1709,1896,-187,3,176,80
1,1670,1448,222,0,17,47
1,1671,1500,171,4,301,89
0,1938,1968,-30,1,56,77
0,1740,1725,15,-4,83,101
1,1687,1775,-88,0,37,67
-1,1698,1820,-122,-6,-171,54
-1,1439,1595,-156,-1,4,56
1,1929,1806,123,3,267,65
1,1845,2100,-255,-1,8,59
-1,1427,1797,-370,-1,-174,88
1,1944,1689,255,5,905,131
1,1509,1485,24,0,309,141
1,1720,1884,-164,5,104,51
1,1637,1632,5,0,4,51
1,1647,1626,21,2,87,81
1,1748,1685,63,1,141,69
-1,1376,1536,-160,1,23,46
1,1689,1367,322,0,539,111
1,1868,1735,133,-1,-28,89
1,1779,1712,67,3,154,67
-1,1544,1421,123,0,-116,74
0,1967,1939,28,0,-367,115
1,1799,1937,-138,8,417,57
-1,1562,1688,-126,-1,-44,62
-1,1581,1760,-179,-1,-306,100
1,1686,1670,16,-1,453,87
1,1424,1153,271,7,172,51
-1,1471,1418,53,0,-4,60
1,1524,1505,19,-2,27,113
-1,1728,1875,-147,2,79,74
1,1717,1526,191,0,1,48
-1,1728,1684,44,-1,-159,74
1,1345,1355,-10,-2,149,121
-1,1725,2132,-407,-2,-323,132
1,1660,1866,-206,-1,-30,44
1,1740,1583,157,2,193,97
1,1387,1314,73,0,-13,53
1,1882,1722,160,-2,-68,59
1,1657,1622,35,0,-6,85
1,1721,1714,7,-2,-12,69
-1,1928,2038,-110,0,-24,70
1,1582,1528,54,-4,-48,43
1,1695,1775,-80,3,919,123
1,1684,1523,161,10,238,47
-1,1308,1394,-86,2,86,54
1,1476,1436,40,2,234,75
1,1966,1829,137,0,17,71
1,1659,1676,-17,-1,253,73
-1,1702,1618,84,0,-204,116
-1,1715,1889,-174,-4,-3,64
1,1940,1732,208,1,80,101
1,1268,1417,-149,-5,-116,43
1,1779,1716,63,0,13,65
1,1677,1847,-170,-4,-86,53
1,1894,1426,468,8,172,45
-1,1554,1622,-68,0,-14,94
1,1583,1391,192,4,587,103
1,1895,1709,186,-2,-88,91
0,1691,1793,-102,0,-36,75
-1,1723,1805,-82,0,-32,92
-1,1693,1632,61,0,-4,66
-1,1591,1362,229,3,57,70
1,1661,1750,-89,-1,388,131
1,1542,1369,173,2,198,91
1,2155,1865,290,0,22,69
-1,1798,1698,100,-2,-51,86
-1,1398,1504,-106,-4,-174,76
-1,1665,1671,-6,-7,-197,66
1,1442,1548,-106,1,43,52
-1,1703,1901,-198,-2,177,72
1,1862,1796,66,0,19,79
-1,1531,1950,-419,0,-70,64
-1,1425,1895,-470,-4,-178,48
1,1400,1293,107,-1,156,61
-1,1735,1576,159,-1,-140,70
-1,1660,1824,-164,4,62,50
1,1748,1695,53,-3,-3,47
-1,1134,1124,10,4,31,64
1,1511,1500,11,1,80,45
1,1907,1698,209,-3,-40,115
-1,1667,1709,-42,-1,95,106
0,1629,1683,-54,-1,33,138
1,1261,1451,-190,6,494,81
1,1829,1715,114,-1,34,113
1,1535,1900,-365,0,-44,75
1,1895,1806,89,0,12,63
-1,1156,1262,-106,0,-41,50
-1,1953,2134,-181,0,-73,112
-1,1693,1912,-219,0,58,58
0,1529,1536,-7,0,-151,132
1,1575,1494,81,0,97,127
-1,1592,1602,-10,-7,-323,66
1,1645,1440,205,0,343,105
1,1904,1861,43,-1,-56,61
1,1642,1755,-113,2,91,53
-1,1671,1691,-20,-6,-356,81
-1,1481,1300,181,-6,-135,52
1,1822,1949,-127,0,9,95
1,1917,1688,229,1,3,53
-1,1732,1760,-28,-7,-270,130
-1,1401,1258,143,-1,-47,50
-1,1430,1419,11,-12,-244,54
1,1584,1681,-97,-3,56,83
-1,1682,1851,-169,-2,-68,52
1,1452,1219,233,9,401,67
1,1736,1674,62,0,-3,53
1,1889,2080,-191,-1,309,123
1,1628,1687,-59,1,156,93
-1,1404,1267,137,-10,-423,102
-1,1334,1328,6,-3,-171,66
-1,1716,1960,-244,-3,-15,42
-1,1947,2141,-194,0,19,116
1,1373,1529,-156,0,19,55
-1,1647,1837,-190,-7,-166,57
1,1829,1718,111,1,124,85
-1,1535,1529,6,0,-559,102
1,1382,1456,-74,8,716,103
-1,1657,1683,-26,-6,-275,74
-1,1756,1661,95,-4,-74,64
1,1564,1420,144,3,44,53
1,2022,1857,165,-2,-206,75
1,1500,1787,-287,1,49,75
1,1767,1421,346,-1,22,49
-1,1483,1736,-253,-1,-294,120
1,1628,1513,115,2,38,53
1,1758,1647,111,-5,225,145
-1,1527,1649,-122,1,23,44
1,1528,1443,85,7,213,59
-1,1851,2105,-254,0,8,88
-1,1368,1365,3,0,-5,64
1,1966,2147,-181,-3,-59,53
-1,1518,1665,-147,0,-175,108
-1,1433,1651,-218,0,-168,178
1,1933,1756,177,0,-23,45
1,1500,1464,36,0,113,75
-1,1662,1757,-95,-2,-277,112
-1,1799,1560,239,-1,-6,42
-1,1636,1745,-109,0,-136,90
1,1588,1363,225,1,266,115
-1,1399,1506,-107,-6,-117,50
-1,1521,1318,203,-2,-94,70
-1,1846,2028,-182,0,48,114
-1,1635,1515,120,0,40,64
-1,1673,1612,61,-1,8,70
-1,1660,1391,269,-2,-41,52
-1,1391,1443,-52,-2,-84,78
1,2129,1984,145,0,15,41
1,1251,1434,-183,4,608,103
-1,1694,1700,-6,0,-132,106
-1,1796,1682,114,-1,-35,98
-1,1417,1791,-374,-10,-239,64
1,1711,1838,-127,-3,-200,125
-1,1766,2034,-268,0,18,60
-1,1644,1548,96,-4,-328,84
-1,1703,1723,-20,-3,-7,52
-1,1746,1577,169,1,18,54
-1,1630,1556,74,-1,-133,79
1,1722,1907,-185,-8,110,93
1,1657,1501,156,4,117,55
1,1438,1096,342,0,-6,79
1,1947,1703,244,0,44,75
0,1389,1740,-351,1,163,155
1,1419,1285,134,5,365,69
-1,1757,1982,-225,0,-60,94
0,2068,2141,-73,-1,-81,139
1,1451,1530,-79,1,90,71
-1,1726,1722,4,-2,-24,40
-1,1628,1686,-58,-1,-252,162
-1,1572,1632,-60,0,3,54
-1,1551,1500,51,-1,-32,56
1,1496,1480,16,1,31,91
-1,1391,1507,-116,3,129,64
1,1533,1666,-133,-2,-18,85
1,1720,1592,128,1,34,53
1,1723,1578,145,-1,33,63
-1,1847,1686,161,-3,-314,80
1,1455,1204,251,0,24,73
-1,1183,1902,-719,-4,-233,118
-1,1470,1531,-61,-3,-619,106
-1,1663,1674,-11,-2,-92,72
1,1692,1697,-5,-1,-75,51
1,1598,1372,226,1,231,157
1,1619,1489,130,0,1,55
1,1748,1672,76,0,-9,49
1,2138,1830,308,0,51,47
-1,1289,1787,-498,-4,-254,72
1,1982,1875,107,0,37,75
-1,1443,1735,-292,-3,-285,112
1,1674,1521,153,-1,400,103
-1,1275,1326,-51,-4,-417,94
1,1798,1511,287,3,100,55
1,1473,1558,-85,4,250,73
-1,1689,1939,-250,0,7,72
-1,1733,1889,-156,0,-182,82
1,1514,1445,69,2,41,107
-1,1569,1617,-48,0,-69,88
1,1651,1548,103,1,81,65
1,1423,1343,80,-2,20,83
-1,1453,1345,108,-5,-29,52
-1,1383,1283,100,-9,-40,42
-1,1511,1731,-220,-3,-195,64
0,1542,1548,-6,1,-35,133
-1,1699,1952,-253,-1,-48,60
-1,1377,1517,-140,2,-28,57
1,1826,1646,180,1,244,93
-1,1790,1869,-79,2,5,44
1,1656,1427,229,0,126,93
-1,1382,1423,-41,0,-55,58
-1,1286,1637,-351,-6,-198,54
1,1685,1652,33,4,316,99
1,2136,1902,234,-10,11,117
-1,1627,1656,-29,0,-13,66
1,1979,1695,284,-2,-12,80
-1,1855,1702,153,-12,-469,66
-1,1342,1637,-295,-9,-129,41
1,1585,1525,60,1,51,69
1,1839,1674,165,0,223,131
-1,1575,1564,11,3,-125,82
-1,1758,1821,-63,-1,4,144
-1,1526,1678,-152,0,-439,154
-1,1178,1319,-141,1,272,137
1,1857,1275,582,0,362,69
-1,1418,1481,-63,2,13,60
0,1385,1488,-103,-3,-205,96
-1,1693,1739,-46,-9,-145,52
-1,1455,1595,-140,-1,-30,44
-1,1565,1452,113,-9,-281,110
1,1422,1191,231,-1,-45,87
1,1438,1487,-49,0,7,73
0,1435,1465,-30,-1,-259,193
1,1818,1685,133,1,72,83
-1,1633,1636,-3,5,391,92
1,1408,1490,-82,-2,-33,49
-1,1754,1689,65,-6,-104,60
1,1877,1163,714,1,166,99
-1,1769,1967,-198,0,15,116
-1,1891,1792,99,0,-4,52
-1,1596,1521,75,-1,-158,90
-1,1394,1250,144,2,16,64
-1,1471,1635,-164,-3,-96,60
-1,1739,1798,-59,-4,-60,54
-1,1424,1724,-300,-13,-310,48
1,1602,1844,-242,-1,-21,57
1,1734,1496,238,0,-14,65
-1,1522,1516,6,-1,-17,112
1,1683,1572,111,1,150,121
-1,1677,1769,-92,-3,-307,86
-1,1522,1698,-176,-3,-34,46
-1,1482,1515,-33,0,-307,112
-1,1482,1547,-65,-5,-701,106
-1,1653,1858,-205,0,10,114
1,1826,1626,200,1,37,73
-1,1651,2050,-399,-1,-79,56
-1,1416,1688,-272,-10,-379,62
-1,1307,1367,-60,-8,-12,40
1,1563,1528,35,-6,-137,61
-1,1661,1671,-10,0,-97,108
1,1737,1411,326,8,266,61
1,1592,1702,-110,-2,0,41
-1,1618,1832,-214,0,-114,80
1,1687,1500,187,6,133,55
-1,1451,1452,-1,0,-463,138
1,1808,1814,-6,0,15,57
1,1702,1742,-40,0,31,61
-1,993,1583,-590,-9,-237,52
1,1552,1500,52,1,278,75
0,1741,1490,251,-3,-75,76
-1,1407,1742,-335,-2,-367,104
-1,1547,1749,-202,-3,-48,50
1,1475,1249,226,13,612,63
1,1878,1831,47,0,62,117
-1,1500,1877,-377,-2,-43,54
-1,1383,1369,14,-1,-1,55
-1,1397,1693,-296,0,-42,62
-1,1372,1753,-381,-2,-105,64
1,1864,1647,217,0,0,41
1,1549,1398,151,-4,309,111
-1,1634,1679,-45,-4,-65,46
-1,1385,1444,-59,-2,-250,76
1,1428,1338,90,0,58,87
1,1677,1376,301,1,150,77
-1,1143,1413,-270,-1,-339,74
1,1754,1541,213,0,31,87
1,2052,1884,168,0,-10,61
1,1737,1784,-47,0,333,87
-1,1616,1697,-81,0,-6,50
1,1588,1730,-142,4,168,65
-1,1612,1738,-126,0,8,96
0,1629,1482,147,-5,-325,102
-1,1642,1870,-228,0,-118,86
-1,1458,1648,-190,-7,-93,42
1,1565,1584,-19,-2,-18,51
1,1705,1608,97,-5,117,119
1,1500,1328,172,1,125,81
-1,1748,1949,-201,-1,-133,86
-1,1688,1606,82,-3,-645,128
-1,1411,1486,-75,-2,-244,81
-1,1557,1473,84,4,108,63
-1,1619,1600,19,-7,-496,78
1,1771,1758,13,1,125,67
-1,1602,1745,-143,0,38,78
-1,1583,1643,-60,4,81,58
-1,1285,1305,-20,-7,-334,70
1,1762,1763,-1,0,-11,67
-1,1600,1713,-113,-5,-219,100
1,1740,1782,-42,7,311,65
0,1723,1880,-157,-3,9,99
1,1683,1558,125,-3,-153,69
1,1764,1715,49,0,-41,69
1,1752,1593,159,0,13,51
-1,1652,1573,79,4,291,72
1,1364,1500,-136,-6,-236,43
-1,1487,1624,-137,3,-91,132
-1,1659,1696,-37,-1,-107,97
-1,1721,1593,128,-11,-224,68
-1,1759,1761,-2,0,-34,94
1,1715,1510,205,0,87,78
-1,1463,1439,24,1,74,70
-1,1769,1760,9,0,-7,102
1,1572,1453,119,0,63,51
1,1585,1692,-107,0,4,79
1,1485,1514,-29,-7,-314,134
1,1752,1776,-24,0,-80,81
-1,1587,1639,-52,-11,-808,80
1,1607,1706,-99,-4,246,94
-1,1511,1604,-93,-1,-68,98
-1,1902,1962,-60,-6,-96,41
1,1619,1674,-55,1,42,57
1,1756,1370,386,-2,193,85
1,1833,1595,238,0,-1,53
-1,1726,1519,207,1,16,47
-1,1877,1803,74,0,-69,69
1,1648,1577,71,9,188,47
-1,1488,1406,82,-6,-55,54
-1,1678,1603,75,0,78,98
1,1653,1603,50,1,105,77
-1,1474,1691,-217,0,13,68
-1,1375,1579,-204,-8,-283,58
-1,1445,1551,-106,-1,-60,76
-1,1709,1604,105,-6,-373,76
-1,1568,1657,-89,-3,-102,50
1,1704,1678,26,0,99,72
-1,1487,1543,-56,0,-444,134
1,1559,1790,-231,-3,-101,56
-1,1640,1557,83,-3,12,68
1,1411,1580,-169,0,106,73
1,1618,1695,-77,-1,141,77
-1,1340,1228,112,-6,-72,40
1,1427,1479,-52,5,53,45
1,1751,1671,80,0,-21,77
-1,1374,1249,125,-9,81,122
1,1747,1854,-107,0,-9,55
-1,1663,1620,43,-3,-25,78
-1,1238,1376,-138,-1,-367,88
1,1743,1570,173,-1,171,111
-1,1696,1742,-46,0,-11,66
-1,1786,2058,-272,0,-33,100
1,1583,1297,286,0,28,51
1,1682,1631,51,-7,-146,43
1,1559,1665,-106,-1,-67,73
-1,1451,1536,-85,-5,-267,66
1,1454,1456,-2,3,426,77
-1,1521,1619,-98,0,85,84
-1,1650,1943,-293,-1,-192,92
-1,1734,1648,86,4,106,64
-1,1621,1691,-70,-6,-158,60
-1,1635,1651,-16,-1,-64,56
1,1706,1716,-10,0,223,151
-1,1443,1465,-22,-2,-330,66
1,1760,1662,98,2,7,73
1,1231,1468,-237,-9,-18,91
1,1710,1500,210,4,171,53
-1,1809,1384,425,-3,-224,90
1,1500,1156,344,16,388,51
1,1651,1574,77,9,325,63
-1,1605,1708,-103,-11,-584,70
-1,1622,1681,-59,1,82,92
1,1376,1518,-142,0,62,75
1,1997,1629,368,0,187,131
1,1685,1491,194,-1,-11,57
-1,1661,1653,8,-4,-487,108
-1,1716,1597,119,-4,-79,54
1,1559,1437,122,-2,51,47
-1,1565,1660,-95,-14,-622,76
1,1570,1626,-56,-1,102,99
-1,1572,1635,-63,1,42,52
1,1607,1622,-15,17,537,51
1,1564,1123,441,11,285,45
1,1754,1569,185,-1,-3,67
-1,1768,1611,157,2,54,98
1,1837,1782,55,1,804,127
1,1359,1230,129,15,407,51
-1,1431,1691,-260,5,32,76
1,1611,1702,-91,2,84,55
1,1887,1821,66,0,40,65
1,1665,1650,15,10,335,125
1,1566,1410,156,0,-62,85
-1,1106,1788,-682,-2,-292,96
-1,1774,1696,78,-6,135,100
1,1620,1608,12,4,88,49
1,1345,1297,48,2,98,53
1,1720,1808,-88,3,233,87
-1,1616,1697,-81,1,-118,84
-1,1797,1816,-19,-1,-192,104
-1,1503,1497,6,-6,-88,44
0,1589,1696,-107,0,-66,92
-1,1470,1640,-170,0,-118,88
-1,1429,1566,-137,-3,50,112
1,1572,1662,-90,0,1,55
0,1325,1344,-19,2,75,77
-1,1380,1358,22,-12,-373,56
-1,1691,1422,269,1,-336,84
1,1849,1662,187,0,122,89
1,1564,1389,175,0,26,70
-1,1705,1608,97,2,2,64
1,1630,1676,-46,0,33,77
1,1473,1254,219,0,132,71
0,1300,1336,-36,3,315,114
1,1500,1498,2,1,49,65
1,1717,1643,74,0,-22,79
-1,1431,1509,-78,0,-46,76
-1,1621,1692,-71,1,36,66
-1,1752,1664,88,2,227,88
-1,1700,1613,87,0,-2,42
1,1738,1451,287,-1,-18,55
1,1500,1575,-75,-1,-210,109
-1,1765,1667,98,0,97,92
-1,1626,1687,-61,3,199,70
0,1669,1812,-143,0,-361,137
-1,1577,1648,-71,-1,12,70
1,1947,1646,301,0,73,87
-1,1640,1644,-4,-3,-113,62
-1,1678,1738,-60,-4,-220,64
1,1492,1613,-121,4,118,71
-1,1768,2063,-295,-4,-411,110
-1,1696,1617,79,-10,-90,40
-1,1382,1570,-188,0,22,56
1,1678,1876,-198,0,-17,53
-1,1617,1696,-79,0,5,42
1,1341,1326,15,1,112,65
1,1371,1614,-243,-1,-20,40
1,1657,1629,28,1,36,67
1,1704,1609,95,-1,97,63
-1,1747,1669,78,0,-364,90
1,1693,1581,112,-1,-35,59
1,1709,1760,-51,-3,-12,45
-1,1413,1400,13,3,-129,148
-1,1443,1518,-75,-6,-170,52
-1,1723,1578,145,2,18,58
1,1895,1787,108,-2,-20,49
-1,1681,1818,-137,-1,-407,126
1,1773,1591,182,2,93,78
-1,1399,1857,-458,-1,-26,94
-1,1601,1712,-111,1,71,64
-1,1440,1672,-232,-4,-118,54
1,1270,1253,17,-1,296,65
-1,1619,1668,-49,0,-36,78
-1,1719,1594,125,0,-1,48
1,1682,1734,-52,2,221,103
1,1649,1614,35,0,37,79
1,1579,1415,164,3,48,53
1,1635,1554,81,0,0,69
0,1608,1705,-97,-1,189,121
1,1442,1105,337,16,386,55
0,1354,1457,-103,0,-577,120
-1,1734,1695,39,0,-40,72
1,1674,1825,-151,-1,26,93
1,1792,1716,76,0,209,137
-1,1525,1383,142,0,40,58
-1,1577,1349,228,0,-14,46
-1,1380,1248,132,0,-31,66
1,1596,1395,201,7,641,71
-1,1834,1695,139,-1,-19,48
-1,1483,1644,-161,-2,-53,48
0,1604,1500,104,-4,-88,101
1,2113,1770,343,2,216,87
1,1446,1426,20,8,75,40
1,1603,1710,-107,1,57,71
-1,1500,1416,84,1,-38,58
1,1788,1557,231,-1,15,51
1,1622,1664,-42,9,69,41
-1,1809,1759,50,-8,-187,64
1,1563,1527,36,0,264,115
0,1721,1782,-61,5,209,113
-1,1434,1484,-50,1,32,73
1,1698,1559,139,1,159,67
1,1365,1500,-135,-1,-51,57
-1,1524,1690,-166,0,-144,92
-1,1679,1610,69,0,-161,64
1,1552,1793,-241,-4,-132,61
-1,1409,1585,-176,-3,-90,46
-1,1767,2117,-350,2,39,96
1,1721,1696,25,7,130,55
-1,1546,1707,-161,-6,-459,168
1,1553,1500,53,3,157,57
1,1677,1435,242,5,181,54
1,1315,1388,-73,6,218,57
1,1919,1490,429,9,171,47
-1,1818,1797,21,-2,-125,68
-1,1658,1779,-121,-5,-46,46
1,1379,1517,-138,0,75,59
1,1578,1436,142,-3,-12,43
-1,1624,1662,-38,-1,-4,78
-1,1500,1764,-264,-4,-211,72
0,1731,1697,34,0,-91,97
-1,1650,1697,-47,0,-61,50
-1,1548,1574,-26,-4,-45,104
1,1564,1365,199,1,399,77
1,1365,1244,121,2,-1,51
-1,1488,1921,-433,0,-28,90
1,1673,1615,58,1,78,53
1,1372,1651,-279,-1,9,109
-1,1425,1591,-166,-8,-367,73
-1,1559,1768,-209,1,108,58
0,1809,2045,-236,0,85,122
1,1534,1601,-67,-1,-51,57
1,1559,1408,151,-4,-21,51
-1,1806,1698,108,5,222,64
1,1950,1998,-48,0,16,141
1,1642,1638,4,0,11,63
-1,1606,1683,-77,-4,-210,62
-1,1585,1643,-58,-4,-316,92
-1,1730,1597,133,-1,-100,80
1,1774,1554,220,-4,-16,69
-1,1787,1826,-39,0,-169,123
0,1903,1805,98,5,462,112
1,1360,1167,193,2,-107,63
-1,1419,1692,-273,0,-22,80
-1,1791,1713,78,2,168,70
-1,1681,1779,-98,-2,-93,62
-1,1548,1779,-231,-1,-493,104
1,1682,1411,271,0,0,45
-1,1704,1772,-68,0,5,50
-1,1460,1739,-279,-6,-37,74
-1,1418,1663,-245,1,9,44
-1,1007,1287,-280,-5,-431,72
1,1473,1457,16,11,908,97
-1,1715,1802,-87,-2,-49,64
-1,1502,1395,107,-5,-200,58
1,1784,1543,241,-1,1053,125
-1,1532,1696,-164,0,6,56
0,1717,1887,-170,0,-52,110
1,2038,1815,223,4,77,59
-1,1441,1401,40,-1,-56,66
1,1923,1486,437,1,150,65
1,1707,1810,-103,-1,472,109
1,1406,1353,53,1,16,67
1,1687,1476,211,-3,-3,45
-1,1585,1512,73,1,-123,72
1,1667,1414,253,0,-31,61
1,1432,1567,-135,-7,-223,45
1,1772,1722,50,-2,38,71
-1,1284,1482,-198,-4,-158,79
-1,1788,1900,-112,-1,-339,110
1,1570,1696,-126,7,271,63
1,1547,1582,-35,1,474,147
1,1726,1877,-151,0,-8,91
-1,1345,1517,-172,-4,-323,74
1,1465,1696,-231,0,40,75
1,1686,1450,236,6,434,83
1,2043,1995,48,-1,37,57
-1,1682,1586,96,0,-111,60
-1,1673,1919,-246,-3,-7,46
-1,1484,1386,98,-5,-118,48
-1,1362,1538,-176,-1,-16,54
-1,1819,1737,82,0,-70,152
1,1677,1780,-103,1,464,115
1,1401,1566,-165,1,77,93
-1,1582,1955,-373,-2,-114,58
1,1696,1760,-64,0,10,57
1,1721,1777,-56,-5,17,59
1,1810,1721,89,-8,185,67
1,1473,1378,95,18,777,71
-1,1402,1575,-173,-7,-450,78
-1,1620,1654,-34,-2,-68,90
-1,1443,1801,-358,-2,-120,62
1,1754,1723,31,5,161,53
1,1544,1500,44,1,12,57
1,1500,1356,144,1,347,157
1,1777,1783,-6,0,-133,121
1,1275,1366,-91,-1,-30,61
-1,1410,1672,-262,-1,-129,87
1,1338,1500,-162,14,459,55
-1,1500,1681,-181,0,-831,110
-1,1141,1557,-416,1,214,94
1,1903,2067,-164,0,187,151
-1,1766,1693,73,-1,-24,74
1,1652,1451,201,5,561,97
-1,1343,1370,-27,0,20,98
1,1836,1807,29,-2,252,114
-1,1694,1598,96,-3,-131,52
1,1632,1564,68,-1,-1,47
-1,1328,1454,-126,-8,-340,80
1,1642,1681,-39,0,-3,47
1,1734,1607,127,0,22,83
1,1416,1429,-13,-3,203,103
0,1707,1752,-45,-1,-1,115
1,1712,1498,214,-2,-34,63
-1,1493,1644,-151,0,-53,60
-1,1681,1772,-91,0,-41,74
1,1602,1607,-5,0,-82,75
1,1218,1500,-282,5,154,50
-1,1708,1746,-38,0,-10,62
1,1742,1478,264,2,253,93
-1,1539,1621,-82,2,60,54
-1,1578,1518,60,-9,-472,68
1,1856,1771,85,1,-152,69
-1,1985,2053,-68,0,-8,70
1,1457,1613,-156,1,35,67
1,1741,1599,142,-1,263,91
-1,1539,1743,-204,1,-208,116
-1,1425,1278,147,-4,-610,106
1,1476,1419,57,1,6,45
-1,1676,1768,-92,2,48,58
1,1557,1284,273,3,65,47
1,1751,1708,43,4,297,111
1,1762,1864,-102,0,284,95
-1,1545,1592,-47,-3,-245,98
-1,1377,1392,-15,0,-212,98
1,1716,1716,0,2,79,60
-1,1451,1350,101,0,11,52
-1,1595,1614,-19,-5,-39,56
1,1698,1760,-62,0,3,55
-1,2114,2048,66,0,-8,52
-1,1819,2061,-242,-10,-198,50
1,1748,1592,156,5,316,85
1,1654,1717,-63,10,153,43
-1,1368,1559,-191,3,41,50
-1,1501,1767,-266,-1,-39,87
-1,1814,1751,63,1,-82,70
-1,1540,1852,-312,-4,-242,108
-1,1564,1219,345,0,12,64
1,1484,1505,-21,-2,-265,119
1,1747,1712,35,-4,-79,43
-1,1768,1859,-91,2,-69,76
1,1624,1584,40,0,-5,71
1,1646,1500,146,2,431,135
-1,1500,1589,-89,-6,-194,58
1,1365,1470,-105,1,583,133
1,1336,1398,-62,0,73,83
1,1687,1500,187,0,67,73
1,1699,1533,166,0,98,95
1,1605,1664,-59,0,9,53
-1,1701,1757,-56,0,-15,42
1,1703,1666,37,-2,-82,121
-1,1754,1586,168,-10,-121,54
-1,1704,1787,-83,-3,-27,40
-1,1759,1867,-108,1,-1,64
1,1642,1396,246,3,92,71
0,1797,1846,-49,0,39,110
1,2100,2100,0,0,-2,49
1,1692,1767,-75,-3,101,89
1,1485,1404,81,2,50,57
-1,1746,1757,-11,0,-13,70
1,1958,1764,194,-1,51,41
1,1701,1658,43,1,25,59
-1,1658,1526,132,0,-145,108
-1,1726,1710,16,-1,-19,68
-1,1874,2120,-246,-1,-302,96
-1,1565,1630,-65,0,-188,112
-1,1753,1705,48,-1,133,114
-1,1332,1583,-251,-9,-215,116
0,1709,1740,-31,2,105,118
1,1976,1759,217,1,78,79
1,1380,1500,-120,17,407,53
0,1416,1393,23,-11,-234,49
1,1723,1500,223,2,34,49
1,2126,1870,256,0,456,107
-1,1539,1651,-112,1,9,48
1,1718,1741,-23,0,100,97
-1,2059,2111,-52,1,-15,46
-1,1727,1857,-130,0,-69,76
-1,1357,1402,-45,0,20,74
-1,1714,1516,198,0,-229,114
-1,1500,1530,-30,-1,18,46
-1,1471,1583,-112,-3,-72,54
-1,1396,1497,-101,-1,-12,42
1,1866,1728,138,-1,-12,61
1,1426,1455,-29,2,74,45
-1,1444,1624,-180,-1,-815,126
1,1620,1384,236,4,545,95
-1,1907,2089,-182,-1,-78,64
1,1104,1082,22,0,30,83
-1,1357,1506,-149,-18,-635,58
1,1729,1730,-1,1,-165,87
-1,1747,1760,-13,0,-210,82
1,1427,1454,-27,-6,-76,43
0,1365,1267,98,1,-320,104
-1,1720,1873,-153,-4,-137,90
1,1438,1500,-62,1,52,53
-1,2000,2016,-16,0,11,56
-1,1715,1655,60,0,-350,106
1,1649,1560,89,0,56,91
-1,1776,1503,273,-4,-54,44
-1,1691,1607,84,2,85,52
1,1696,1534,162,-5,230,79
-1,1710,1735,-25,-3,-819,108
1,1522,1493,29,0,76,61
1,1380,1075,305,-2,-44,43
1,1768,1735,33,0,66,93
1,1981,1879,102,1,74,63
-1,1500,1669,-169,1,-172,88
1,1668,1702,-34,-4,-5,105
-1,1788,1688,100,0,-281,92
1,1864,1698,166,6,232,60
1,1881,1676,205,-1,-13,49
-1,1428,1432,-4,-1,-203,158
-1,1505,1602,-97,2,40,64
1,1394,1415,-21,8,181,59
-1,1325,1852,-527,-1,-392,84
1,1901,1928,-27,3,81,64
1,1868,1720,148,0,1,75
0,1496,1551,-55,0,-26,121
1,1463,1591,-128,2,18,45
0,1750,1708,42,0,-169,115
-1,1522,1758,-236,0,1,70
-1,1690,1680,10,-1,-211,82
-1,1397,1692,-295,-2,-116,82
0,1270,1311,-41,1,-287,184
1,1751,1965,-214,0,-65,67
-1,1624,1676,-52,-3,-363,108
1,1541,1500,41,2,129,115
1,1571,1475,96,11,134,45
1,1706,1692,14,0,204,129
1,1691,1679,12,0,-49,95
-1,1434,1631,-197,0,18,62
-1,1710,1749,-39,0,-20,60
1,1774,1610,164,-2,-18,73
1,1392,1461,-69,1,327,143
-1,1296,1713,-417,2,163,40
-1,1484,1421,63,-5,-81,42
1,1913,1903,10,1,-5,53
1,1759,1700,59,0,113,127
-1,1508,1749,-241,-1,-16,46
-1,1669,1701,-32,3,95,72
-1,1878,1859,19,3,40,92
1,1441,1499,-58,10,142,43
-1,1222,1646,-424,-2,-214,74
-1,1865,1974,-109,0,-118,120
-1,1738,1573,165,0,-384,122
-1,1588,1506,82,0,-29,68
1,1586,1657,-71,-2,64,91
1,1499,1638,-139,0,3,45
-1,1922,1511,411,0,-182,98
1,1514,1134,380,-2,-32,49
-1,1283,1494,-211,-1,-27,70
-1,2063,1792,271,-5,-67,50
-1,1208,1892,-684,-1,-1,48
-1,1701,1761,-60,-4,-290,94
1,1693,1414,279,0,63,79
-1,1649,1803,-154,-7,-97,57
-1,2041,2188,-147,0,-16,51
-1,1595,1433,162,-11,-50,40
1,1922,1786,136,0,-118,153
1,1857,1686,171,8,112,47
-1,1487,1552,-65,0,18,60
1,1659,1319,340,2,126,55
-1,1255,1537,-282,-5,-201,60
1,1488,1584,-96,1,12,46
-1,1512,1649,-137,0,-44,73
1,2033,1943,90,6,219,55
-1,1640,1624,16,-10,-192,58
-1,1600,1515,85,1,-70,76
1,1572,1587,-15,0,23,63
1,1384,1356,28,3,683,97
-1,1786,1933,-147,-1,-62,60
-1,1829,1682,147,0,9,74
0,1506,1454,52,1,29,155
1,1768,1640,128,1,-17,87
1,1607,1848,-241,3,21,41
-1,1711,1867,-156,0,-191,96
1,1716,1454,262,9,653,85
1,1707,1725,-18,0,-19,57
1,1579,1747,-168,0,70,81
-1,1981,1856,125,0,-28,98
1,1864,1653,211,7,186,65
-1,1527,1490,37,0,18,88
-1,1319,1293,26,4,67,50
1,1560,1348,212,-5,-166,53
1,1870,1551,319,2,29,43
1,1785,1170,615,-1,99,51
1,1573,1635,-62,3,315,109
1,1643,1599,44,0,-7,45
1,1501,1624,-123,0,190,146
-1,1207,1651,-444,-1,-369,66
1,1720,1678,42,1,53,63
-1,1264,1464,-200,-1,-50,64
-1,1544,1499,45,-2,-114,59
1,1515,1484,31,1,461,145
-1,1715,1785,-70,-3,-55,48
-1,1629,1545,84,-1,4,52
1,1720,1305,415,10,650,75
-1,1648,1498,150,-1,-194,68
1,1645,1603,42,0,-17,51
1,1345,1394,-49,8,69,41
1,1600,1627,-27,-2,44,77
-1,1500,1552,-52,-18,-398,50
1,1838,1562,276,7,272,65
-1,1583,1528,55,0,7,56
-1,1758,1729,29,0,-32,46
-1,1540,1719,-179,-1,-673,158
-1,1194,1786,-592,0,-65,60
1,1873,1967,-94,0,-37,105
-1,1720,1762,-42,-3,-59,66
-1,1442,1639,-197,-2,-47,112
1,1653,1201,452,4,355,79
-1,1722,1940,-218,-5,-13,40
-1,1493,1490,3,1,-13,54
1,1500,1504,-4,1,52,63
-1,1538,1600,-62,0,-66,88
1,1871,1463,408,-1,41,81
-1,1746,1664,82,1,-22,54
-1,1622,1610,12,0,-88,94
-1,1704,1593,111,0,3,114
1,1182,1468,-286,0,-6,61
1,1619,1311,308,0,307,95
1,1526,1479,47,7,112,47
1,1803,1711,92,2,57,63
1,1658,1449,209,0,-18,71
-1,1548,1874,-326,0,-42,76
-1,1643,1702,-59,-7,-195,94
-1,1639,1679,-40,0,-413,118
-1,1763,1161,602,5,305,56
0,1632,1776,-144,0,-154,122
-1,1390,1320,70,-7,-246,56
1,1622,1494,128,0,16,57
-1,1609,1515,94,0,-132,96
1,1438,1574,-136,-10,29,79
1,1731,1579,152,0,471,129
1,1667,1798,-131,0,5,53
1,1779,1513,266,0,112,85
1,1259,1486,-227,6,300,59
1,1320,1456,-136,4,245,63
1,1954,1889,65,-2,-58,47
1,2061,1837,224,3,90,53
1,1843,1495,348,4,277,83
1,1786,1496,290,0,206,85
1,1655,1500,155,1,188,75
-1,1677,1615,62,1,156,104
-1,1626,1609,17,-8,-412,100
-1,1688,1779,-91,3,-87,130
-1,1636,1607,29,-1,-40,70
1,1556,1610,-54,6,191,65
1,1850,1653,197,0,-9,101
1,1577,1311,266,3,158,75
1,1487,1629,-142,0,4,77
-1,1879,1962,-83,1,-111,84
1,1671,1486,185,1,109,66
-1,1342,1379,-37,-8,-420,68
1,1898,2039,-141,0,249,103
0,1506,1504,2,2,153,115
-1,1461,1873,-412,0,-30,64
1,1833,1619,214,0,9,59
1,1683,1684,-1,1,23,59
-1,1274,1374,-100,-2,98,82
1,2043,1666,377,1,105,67
-1,1405,1614,-209,1,51,52
-1,1569,1596,-27,1,-30,66
1,1608,1366,242,0,70,75
-1,1375,1627,-252,-2,-134,112
1,1544,1561,-17,-1,309,135
1,2046,1657,389,3,274,59
1,1787,1679,108,0,194,67
1,1698,1761,-63,0,98,113
1,1621,1434,187,3,109,53
-1,1529,1596,-67,-11,-77,46
-1,1277,1326,-49,2,105,58
1,1614,1837,-223,0,8,57
1,1677,1480,197,-1,93,79
-1,1771,1637,134,0,-347,116
1,1971,1869,102,0,-57,81
1,2050,1570,480,-1,-4,43
-1,1630,1851,-221,-4,-82,66
1,1875,1533,342,-5,-46,80
-1,1783,1534,249,2,31,63
1,1642,1724,-82,1,155,105
0,1731,1472,259,-1,-261,128
-1,1644,1419,225,-3,172,110
-1,1410,1500,-90,-6,-179,48
1,1648,1856,-208,6,332,83
1,2052,1622,430,0,6,57
1,1569,1245,324,2,76,57
-1,1086,1192,-106,1,98,50
1,1607,1559,48,4,560,95
1,1265,1438,-173,2,345,111
-1,1639,1693,-54,0,-511,106
-1,1647,1547,100,-2,-209,116
1,1439,1457,-18,-3,-24,53
-1,1869,1598,271,2,-40,86
0,1421,1553,-132,-1,-42,115
-1,1504,1506,-2,-1,-146,104
-1,1619,1604,15,-2,-43,54
-1,1740,1809,-69,-3,-5,42
-1,1382,1175,207,0,132,72
1,1982,1915,67,-3,72,101
-1,1795,1673,122,0,-42,92
-1,1218,1426,-208,0,-39,58
1,1861,1978,-117,0,-25,67
-1,1286,1635,-349,-1,25,64
1,1443,1411,32,8,121,43
-1,1336,1267,69,6,144,44
0,1561,1730,-169,-1,-77,141
-1,1682,1474,208,1,59,79
1,1549,1617,-68,1,47,73
-1,1710,1700,10,-2,-46,58
0,1797,1860,-63,0,-64,90
1,1531,1214,317,0,124,91
-1,1445,1403,42,-1,-526,136
-1,1500,1540,-40,-9,-332,56
-1,1702,1604,98,0,-14,66
1,1714,1569,145,0,118,110
1,1607,1530,77,3,101,49
1,1310,1207,103,8,253,51
-1,1482,1724,-242,-6,-232,58
1,1616,1607,9,7,466,95
-1,1635,1609,26,0,-70,60
-1,1594,1631,-37,0,-16,49
-1,1964,1877,87,-4,-166,74
1,1711,1748,-37,0,33,83
-1,1730,1942,-212,-11,-135,46
-1,1633,1585,48,0,-112,82
1,1365,1706,-341,-4,-163,71
1,1386,1396,-10,4,64,45
-1,1011,1502,-491,-5,-531,96
-1,1498,1451,47,-4,50,60
1,1681,1856,-175,-3,340,131
-1,1281,1323,-42,0,37,72
-1,1695,1568,127,1,102,68
0,1688,1789,-101,1,-13,67
1,1485,1585,-100,0,-22,69
1,1425,1372,53,3,175,61
1,1728,1476,252,4,106,55
-1,1584,1679,-95,-1,22,60
1,1633,1689,-56,-1,-123,137
-1,1616,1616,0,-1,-42,64
-1,1294,1281,13,-9,-401,96
-1,1641,1584,57,-2,-6,50
-1,1858,1799,59,-1,-280,144
-1,1396,1404,-8,1,-327,78
1,1652,1755,-103,2,282,67
1,1665,1491,174,0,97,71
1,1603,1532,71,0,16,67
0,1392,1487,-95,3,1199,203
1,1700,1733,-33,-5,3,109
1,1388,1717,-329,0,25,57
-1,1882,1872,10,-1,-4,92
-1,1781,2001,-220,-2,-108,62
1,1879,1675,204,3,174,107
-1,1634,1521,113,-3,-53,54
0,1827,1934,-107,-3,545,204
1,1009,1052,-43,-6,-123,45
-1,1196,1336,-140,-6,-231,72
1,1697,1625,72,-7,-86,77
1,1540,1289,251,2,211,67
1,1750,1699,51,2,42,49
1,1898,1799,99,-3,153,103
1,1730,1775,-45,0,33,63
-1,1605,1723,-118,-3,5,112
-1,1594,1492,102,-3,-465,88
1,1310,1391,-81,0,-11,59
-1,1205,1500,-295,-2,-171,80
-1,1599,1626,-27,0,10,76
1,1671,1646,25,-1,-37,75
-1,1724,1606,118,7,192,56
-1,1498,1464,34,0,-43,150
1,1656,1601,55,1,76,71
1,1586,1308,278,1,9,51
1,1599,1706,-107,1,106,77
1,1470,1386,84,-1,297,88
1,1844,1659,185,-3,43,57
-1,1651,1750,-99,0,-270,98
1,1271,1032,239,6,496,65
1,1721,1712,9,0,59,119
-1,1760,1818,-58,0,-179,143
1,1620,1500,120,8,361,61
1,1763,1811,-48,-1,-63,101
1,1740,1666,74,-2,-31,51
-1,1941,1884,57,-1,-36,62
1,1454,1355,99,-2,-50,43
1,1491,1350,141,0,56,115
-1,1522,1612,-90,0,-39,112
1,1708,1763,-55,-1,-59,63
1,1668,1677,-9,4,139,47
-1,1492,1284,208,-1,-12,48
-1,1691,1882,-191,-4,8,58
1,2054,1554,500,0,-8,43
-1,2056,1840,216,-6,-133,90
-1,1692,1731,-39,0,3,54
-1,1843,1498,345,0,-17,64
1,1368,1401,-33,8,406,79
-1,1472,1676,-204,0,-56,72
-1,1646,1658,-12,-5,-249,88
1,1632,1593,39,-1,14,53
0,1537,1693,-156,-1,-38,68
1,1618,1506,112,0,198,94
-1,1906,2112,-206,0,-394,96
-1,1883,1871,12,-5,-144,48
-1,1885,1711,174,0,-250,130
0,1850,1511,339,0,-67,75
1,1477,1397,80,0,190,66
1,1814,1682,132,-1,-13,49
-1,1375,1626,-251,-9,-298,50
1,1123,1171,-48,1,279,97
1,1406,1022,384,10,172,43
-1,1496,1477,19,1,115,106
1,1380,1358,22,2,206,73
1,1224,1514,-290,-10,-127,49
-1,1758,1626,132,-1,40,74
1,1275,1248,27,2,105,63
1,1666,1675,-9,2,137,65
1,2034,2197,-163,2,13,43
-1,1459,1348,111,-2,-168,80
1,1888,1685,203,1,5,41
1,1349,1318,31,7,953,117
1,1688,1578,110,5,228,59
0,1335,1437,-102,-1,33,115
-1,1682,1631,51,5,47,62
-1,1731,1797,-66,-2,-7,40
1,1505,1500,5,-1,-24,93
1,1674,1455,219,0,-12,45
-1,1640,1840,-200,-1,0,44
1,1859,1680,179,3,278,103
1,1701,1450,251,3,412,103
1,1745,1307,438,3,86,55
1,1841,1519,322,-1,157,71
-1,1570,1696,-126,0,27,66
-1,1901,1891,10,-1,-5,40
1,1592,1583,9,2,105,63
1,1661,1703,-42,0,126,101
1,1806,1642,164,0,278,124
-1,1337,1627,-290,-1,-38,60
1,1817,1555,262,-2,2,81
-1,1343,1504,-161,-4,-63,60
-1,1681,1424,257,-3,-38,42
-1,1004,1408,-404,-5,-358,90
1,1856,1521,335,0,437,113
-1,1882,1996,-114,-1,-29,52
-1,1635,1669,-34,-10,-468,76
-1,1623,1725,-102,0,22,78
-1,1584,1677,-93,-2,-330,93
1,1890,2024,-134,0,-32,79
-1,1590,1607,-17,3,61,50
-1,1625,1680,-55,-1,-73,72
1,1274,1248,26,-6,-266,99
-1,1722,1828,-106,0,-166,142
1,1909,1732,177,0,32,65
-1,1893,1823,70,-1,-43,64
1,1817,1679,138,-1,58,81
1,1655,1187,468,10,495,69
-1,1548,1634,-86,0,-80,66
1,1845,1450,395,2,91,67
1,1250,1250,0,0,5,47
1,1710,1440,270,0,444,122
-1,1668,1692,-24,3,31,96
1,1669,1743,-74,2,28,60
0,1831,1772,59,1,76,118
1,1280,1417,-137,-3,11,101
1,1326,1183,143,4,61,43
-1,1915,1895,20,-3,-64,70
1,1558,1614,-56,0,19,55
1,1561,1665,-104,2,14,45
-1,1905,1886,19,-6,-240,66
-1,1447,1847,-400,-2,-101,58
-1,1572,1602,-30,-1,-51,50
-1,1692,1636,56,-4,359,80
1,1672,1579,93,5,341,79
-1,1332,1422,-90,-1,-9,50
1,1516,1313,203,1,82,82
1,1656,1506,150,0,68,63
1,1564,1417,147,0,311,79
1,1575,1554,21,2,-4,53
-1,1676,1903,-227,-1,-128,84
-1,1390,1490,-100,-3,-255,82
-1,1669,1750,-81,0,-281,103
1,1879,1910,-31,0,15,69
-1,1712,1634,78,-6,-87,72
-1,1640,1709,-69,-1,-167,110
1,1272,1173,99,-2,-42,63
1,2056,1973,83,-4,183,103
0,1685,1643,42,-1,-556,181
-1,1405,1516,-111,-14,-81,40
1,1489,1621,-132,2,37,55
1,1448,1051,397,2,93,55
-1,1600,2025,-425,-2,-82,46
-1,1495,1571,-76,0,-159,100
1,1651,1679,-28,0,-5,97
1,1747,1640,107,0,61,69
1,1648,1679,-31,0,27,61
-1,1443,1195,248,0,1,46
-1,1893,1849,44,1,-253,136
1,1478,1652,-174,2,59,67
-1,1680,1621,59,-6,-354,76
-1,1654,1750,-96,4,96,58
-1,1707,1500,207,-3,26,80
1,1286,1240,46,1,76,55
1,1504,1605,-101,-4,-263,81
-1,1586,1903,-317,-9,-246,52
-1,1878,1895,-17,0,-15,108
1,1670,1048,622,-2,46,67
1,1469,1500,-31,11,744,95
1,1477,1524,-47,9,45,147
-1,1668,1660,8,2,196,80
-1,1640,1630,10,-2,-187,126
1,1397,1024,373,7,245,43
-1,1382,1553,-171,-3,-54,42
1,1733,1632,101,0,280,97
-1,1531,1486,45,-2,-79,60
-1,1615,1539,76,-4,-80,56
1,1424,1425,-1,4,750,97
1,1571,1670,-99,5,86,42
1,1667,1821,-154,0,-77,91
1,1201,1162,39,3,-22,97
0,1169,1301,-132,0,22,42
1,1825,2033,-208,0,-10,91
-1,1421,1414,7,-3,-417,90
-1,1301,1359,-58,-4,-153,57
-1,1376,1782,-406,2,-35,86
1,1631,1519,112,1,-177,109
-1,1965,1914,51,-3,-147,86
1,1409,1731,-322,1,52,77
1,1562,1237,325,1,14,45
1,1494,1503,-9,5,283,61
-1,1047,1671,-624,-3,-124,62
-1,1625,1598,27,-3,65,112
-1,1910,2038,-128,-3,-51,44
1,1684,1500,184,-1,-5,45
-1,1375,1624,-249,-3,-209,64
-1,1263,1540,-277,-5,-328,84
1,1570,1683,-113,-2,-63,88
1,1646,1666,-20,-4,-86,83
-1,1381,1635,-254,0,-16,50
0,1297,1500,-203,3,-69,114
-1,1534,1892,-358,0,-4,54
1,1875,1668,207,1,11,41
-1,1792,1902,-110,-2,-161,66
-1,1102,1620,-518,-8,-505,78
-1,1566,1810,-244,-4,-134,64
1,1675,1184,491,1,82,63
-1,1320,1425,-105,2,-73,76
1,1689,1206,483,10,556,73
1,1877,1591,286,0,-21,73
1,1866,1668,198,-9,-137,41
-1,1511,1489,22,-1,-12,46
0,1071,1301,-230,0,39,123
-1,1410,1628,-218,-15,-327,58
-1,1414,1437,-23,1,-214,119
-1,1668,1465,203,1,-3,50
1,1645,1618,27,6,406,97
1,1530,1213,317,4,160,52
1,1371,1253,118,4,47,42
-1,1927,1881,46,0,77,74
-1,1668,1698,-30,0,-34,68
1,1560,1529,31,-4,41,63
1,1400,1344,56,-1,-15,61
1,1318,1260,58,0,204,73
1,1526,1324,202,0,202,126
1,1338,1498,-160,2,124,93
1,1501,1394,107,3,530,99
1,1500,1575,-75,1,28,41
1,1912,1784,128,3,89,53
1,1353,1242,111,8,361,81
-1,1599,1436,163,-5,-41,56
0,1615,1768,-153,-1,-67,87
-1,1330,1437,-107,-3,-25,40
1,1952,1908,44,-1,-241,111
1,1895,1405,490,0,57,95
-1,1652,1716,-64,-1,-82,66
-1,1296,1634,-338,-5,-124,72
1,1758,1819,-61,3,113,73
-1,1783,1743,40,0,7,40
1,1551,1611,-60,0,36,81
1,1432,1608,-176,-1,39,59
-1,1653,1701,-48,0,-53,88
1,1677,1657,20,0,-15,79
-1,1671,1646,25,1,9,48
0,1389,1500,-111,4,78,45
-1,1695,1791,-96,1,-36,80
-1,1604,2081,-477,0,-28,57
-1,1488,1285,203,2,79,52
1,1247,1752,-505,-2,-126,61
-1,1500,1514,-14,0,1,81
-1,1377,1293,84,-7,-38,42
1,1624,1742,-118,1,148,69
-1,1694,1334,360,-2,-288,92
1,1618,1404,214,4,486,73
1,1649,1843,-194,0,95,89
1,1507,1509,-2,9,120,41
1,1567,1637,-70,0,147,109
-1,1898,1914,-16,-1,-31,50
-1,1628,1743,-115,-4,-309,126
-1,1517,1745,-228,5,115,52
-1,1448,1426,22,-3,-141,52
1,1711,1728,-17,-10,-62,69
1,1702,1657,45,-2,-8,65
-1,1868,1677,191,0,-118,72
1,1640,1469,171,0,-86,79
-1,1438,1289,149,2,192,72
1,1671,1258,413,5,146,49
1,1750,1511,239,0,34,63
-1,1544,1483,61,-2,-124,82
-1,1605,1627,-22,-3,-30,54
1,1403,1329,74,7,91,41
-1,1312,1465,-153,-5,-131,52
-1,1711,1643,68,0,-57,150
1,1500,1490,10,0,228,61
-1,1572,1639,-67,-8,-142,60
1,1892,1925,-33,2,28,49
1,1390,1206,184,-7,-39,113
-1,1724,2085,-361,0,-48,52
-1,1486,1623,-137,-4,-919,250
-1,1295,1446,-151,1,10,46
-1,1777,1896,-119,-1,-38,48
-1,1659,1679,-20,0,-70,54
1,1546,1699,-153,-1,-23,65
1,1989,1733,256,0,57,101
1,1293,1418,-125,0,-9,119
-1,1569,1728,-159,-4,-198,70
1,1633,1522,111,1,71,111
-1,1566,1486,80,-14,-72,40
-1,1890,1980,-90,-5,-160,62
-1,1765,1922,-157,-2,-127,70
-1,1904,1770,134,1,20,84
-1,1403,1906,-503,-4,-312,88
-1,1879,1805,74,0,11,82
0,1666,1564,102,0,21,133
1,1535,1026,509,4,280,63
1,1028,0,1028,7,77,45
-1,1650,1386,264,-3,-149,67
1,1535,1329,206,8,351,73
-1,1453,1474,-21,-11,-100,40
1,1412,1336,76,14,210,45
-1,1339,1582,-243,1,88,82
1,1499,1223,276,10,373,57
0,1361,1530,-169,1,-183,141
-1,1683,1500,183,-1,-322,116
-1,1430,1495,-65,0,-519,112
1,1908,1397,511,0,200,75
1,1418,1390,28,1,466,87
-1,1499,1726,-227,1,-87,58
-1,1656,1697,-41,-1,-43,76
1,1930,1759,171,4,159,61
1,1863,1771,92,-2,-68,71
1,1631,1284,347,13,640,59
-1,1819,1758,61,0,24,110
-1,1642,1472,170,-1,-107,64
0,2200,1870,330,0,11,120
-1,1687,1695,-8,1,7,48
-1,1555,1711,-156,-1,-116,104
1,1553,1446,107,-1,19,109
1,1556,1511,45,-1,34,51
1,1702,1509,193,0,161,103
1,1624,1512,112,2,63,51
1,1474,1542,-68,2,193,57
-1,1540,1136,404,-17,-589,58
-1,1192,1588,-396,-10,-541,64
1,1759,1622,137,1,170,57
1,1944,2127,-183,0,8,53
0,1621,1716,-95,-1,-165,120
-1,1707,2189,-482,1,-84,70
1,1523,1377,146,-1,371,105
1,1536,1178,358,2,191,77
-1,1807,1771,36,0,7,42
1,1501,1392,109,3,119,49
1,1565,1610,-45,1,48,43
-1,1487,1880,-393,0,-26,54
-1,1323,1512,-189,-2,-378,84
1,1682,1287,395,11,338,49
1,1663,1597,66,0,111,95
1,1289,1165,124,-3,-67,47
-1,1634,1617,17,-5,-368,98
-1,1797,1762,35,0,-154,108
0,1784,1795,-11,0,194,132
1,1523,1541,-18,-1,-23,57
1,1676,1484,192,2,297,81
1,1871,1935,-64,1,129,89
-1,1528,1489,39,2,-45,54
1,1912,1644,268,1,23,73
1,2083,1961,122,0,47,97
1,1288,1289,-1,4,125,55
-1,1578,1515,63,-2,-74,46
1,1710,1609,101,0,224,97
-1,1707,1598,109,0,9,60
1,1590,1477,113,4,184,71
1,1680,1521,159,0,3,57
1,1718,1384,334,0,94,61
-1,1189,1355,-166,-6,-185,56
1,1632,1370,262,3,170,61
-1,1784,1775,9,0,-806,102
0,1794,1784,10,-1,-10,123
1,1702,1451,251,0,58,93
1,1348,1386,-38,4,235,93
1,1622,1568,54,0,79,89
-1,1557,1648,-91,-2,-69,48
1,1685,1483,202,2,174,83
-1,1846,1910,-64,1,119,152
-1,1355,1879,-524,0,19,48
1,1565,1329,236,1,35,61
-1,1629,1708,-79,0,-120,116
1,1681,1569,112,0,-10,57
1,1468,1583,-115,-5,-128,49
1,1636,1565,71,-1,-8,45
1,1534,1529,5,1,18,55
1,1403,1177,226,2,106,79
1,1689,1478,211,11,804,93
1,1738,1837,-99,2,94,75
1,1365,1330,35,0,21,62
1,1900,1570,330,0,7,49
1,1721,1515,206,0,10,43
1,1772,1736,36,0,-43,121
-1,1880,2191,-311,0,-34,70
-1,1381,1612,-231,-3,-161,84
1,1953,2102,-149,0,50,95
1,1388,1463,-75,7,172,51
0,1181,1374,-193,-3,-78,57
-1,1694,1472,222,0,-202,80
-1,1570,1490,80,-6,-141,46
1,1716,1570,146,6,239,79
1,1677,1593,84,0,75,77
1,1719,1571,148,-1,209,113
1,1672,1571,101,0,161,89
1,1882,1974,-92,0,-21,81
0,1405,1308,97,0,-571,156
1,1632,1556,76,0,273,149
1,2196,1861,335,-1,-86,79
-1,1521,1607,-86,0,44,65
0,1693,1749,-56,0,-191,150
1,1580,1582,-2,-3,-24,45
1,1645,1528,117,1,155,101
1,1764,1615,149,-1,-30,43
-1,1473,1496,-23,-1,-239,100
-1,1500,1468,32,-7,-193,46
-1,1568,1593,-25,-6,-85,70
-1,1515,1617,-102,-8,-162,50
-1,1858,2200,-342,0,-7,54
1,1312,1503,-191,0,-81,133
1,1691,1509,182,2,85,57
1,1545,1625,-80,0,-87,89
1,1707,1541,166,-2,-43,93
-1,1540,1167,373,-2,-81,58
1,1878,1929,-51,-7,461,137
1,1782,1800,-18,0,16,69
1,1368,1188,180,2,267,65
1,1882,2056,-174,1,204,93
1,1311,1461,-150,0,-175,101
-1,1310,1314,-4,-6,-77,42
1,1408,1412,-4,0,-20,69
1,1784,1851,-67,0,7,49
1,2065,1969,96,-1,12,81
-1,1825,1794,31,2,1,48
1,1604,1556,48,-1,-18,49
0,1460,1740,-280,2,41,89
1,1625,1507,118,6,442,93
1,1194,1887,-693,-1,-152,67
1,1838,1663,175,-3,-58,57
1,1938,1920,18,-3,-55,43
1,1698,1124,574,-3,-8,73
1,1895,1895,0,0,15,77
1,1697,1587,110,7,519,109
1,1753,1723,30,-1,-8,47
0,1810,1834,-24,1,95,109
1,1515,1653,-138,1,486,93
-1,1640,1806,-166,-2,-500,108
-1,1806,1812,-6,0,-675,122
1,1556,1230,326,2,70,55
-1,1705,1865,-160,-5,-206,94
-1,1548,1694,-146,0,-118,76
-1,1717,1620,97,0,-188,134
-1,1578,1833,-255,-2,-67,78
0,1500,1087,413,-3,-406,105
1,1325,1290,35,-2,-64,67
-1,1764,1908,-144,0,-31,52
1,1598,1611,-13,0,45,101
1,1558,1564,-6,-4,-51,45
1,1396,1438,-42,-5,34,51
-1,1699,1574,125,-2,-89,60
-1,1838,2211,-373,-1,-137,92
-1,1948,1836,112,-3,-83,42
-1,1346,1564,-218,1,30,44
1,1679,1630,49,0,-13,100
-1,1180,1168,12,-7,-233,52
1,1497,1401,96,-2,-50,143
1,1684,1527,157,15,516,55
-1,1949,1813,136,1,-51,96
-1,1519,1752,-233,-1,-58,70
-1,1366,1590,-224,-13,-811,70
0,1916,1971,-55,0,639,156
1,1633,1757,-124,-3,-17,43
1,1709,1559,150,4,345,83
1,2083,1477,606,0,-5,51
0,1570,1541,29,0,390,241
-1,1885,1949,-64,0,8,66
1,1634,1523,111,4,224,69
1,1470,1533,-63,-2,-10,59
-1,1638,1540,98,-1,-13,40
-1,1713,1909,-196,-2,-243,122
1,1585,1513,72,1,24,41
1,1615,1547,68,-3,-30,45
-1,1355,1600,-245,0,-17,42
-1,1795,1786,9,0,-59,62
1,1624,1476,148,-1,55,69
-1,1569,1792,-223,-3,-23,46
-1,1883,1835,48,-4,-528,126
1,1432,1376,56,1,53,127
-1,1350,1690,-340,-19,-210,42
-1,1704,1706,-2,-3,-181,74
1,1833,1605,228,1,-4,59
-1,1320,1208,112,-1,37,76
1,1867,1832,35,1,579,159
-1,1553,1543,10,-4,-219,68
-1,1166,1476,-310,-3,-267,78
-1,1628,2085,-457,-1,-56,72
0,1515,1642,-127,2,246,120
1,1730,1652,78,-5,115,104
-1,1561,1665,-104,-2,-154,80
1,1562,1499,63,-2,288,81
-1,1783,1741,42,0,-1233,152
-1,1600,1838,-238,13,785,92
-1,1272,1335,-63,-4,-352,70
1,1693,1713,-20,0,21,61
1,1555,1409,146,1,261,99
1,1807,1848,-41,0,-34,59
-1,1502,1375,127,0,40,58
-1,1347,1530,-183,-8,-247,50
1,1933,1798,135,2,86,77
1,1487,1363,124,7,314,73
-1,1631,1843,-212,-1,-31,96
-1,1329,1181,148,0,-301,118
-1,1340,1595,-255,-4,-27,60
1,1568,1460,108,0,57,59
-1,1425,1500,-75,2,11,42
-1,1634,1703,-69,-1,7,42
-1,1331,1588,-257,-1,-65,56
-1,1712,1876,-164,-1,-26,60
-1,1335,1600,-265,-6,78,46
1,2089,1624,465,1,30,63
-1,1374,1360,14,3,-49,74
-1,1625,1849,-224,1,-85,66
1,1705,1604,101,7,1104,125
-1,1353,1460,-107,-2,-5,82
1,1947,1918,29,-4,19,61
1,1370,1463,-93,9,583,65
1,1480,1550,-70,0,187,67
1,1602,1308,294,8,532,81
-1,1638,1519,119,-2,-67,68
1,1892,1664,228,1,48,56
1,1855,1620,235,-1,353,147
1,1460,1567,-107,11,534,67
1,1523,1700,-177,0,-34,67
-1,1770,1791,-21,0,-367,112
-1,1535,1563,-28,-1,-88,74
1,1614,1717,-103,0,63,105
-1,1697,1604,93,0,-14,90
1,1754,1812,-58,-6,-78,87
-1,1403,1516,-113,-5,-414,88
1,1545,1562,-17,-3,231,129
-1,1490,1576,-86,0,-178,74
1,1969,1940,29,0,-41,87
1,1882,1581,301,2,80,47
-1,1451,1425,26,-1,-54,66
1,1908,1706,202,-1,-62,97
-1,1355,1494,-139,-2,-45,58
1,1257,1286,-29,2,153,55
0,1957,1906,51,0,-3,79
-1,1707,1545,162,-2,-28,42
-1,1629,1759,-130,0,54,90
-1,1569,1726,-157,-1,-252,108
1,1712,1625,87,1,10,51
-1,1180,1215,-35,1,-7,48
-1,1441,1437,4,-3,-31,44
-1,1713,1595,118,-1,-68,64
0,1943,1686,257,0,121,104
1,1606,1469,137,5,102,43
-1,1835,1819,16,2,117,64
-1,1620,2092,-472,-9,-9,52
-1,1632,1691,-59,-11,-377,58
-1,1534,1623,-89,-4,-69,48
1,1631,1615,16,5,282,69
-1,1956,1801,155,3,68,74
1,1560,1886,-326,0,10,69
-1,1536,1534,2,0,-118,82
-1,1513,1282,231,-5,-208,70
1,1759,1647,112,-3,-267,97
-1,1694,1537,157,4,318,82
1,1691,1733,-42,-2,-121,121
-1,1224,1145,79,1,13,58
-1,1326,1430,-104,-5,-675,102
1,1707,1605,102,4,302,97
-1,1114,1307,-193,-1,48,42
1,1632,1525,107,0,592,113
1,1573,1442,131,-1,109,167
-1,1501,1348,153,-6,-180,56
1,1681,1732,-51,0,170,151
-1,1497,1588,-91,-7,-91,70
-1,1162,1335,-173,2,89,160
1,1605,1483,122,7,679,93
-1,1685,1615,70,-1,-58,76
1,2096,1616,480,1,71,71
-1,1771,1576,195,0,6,70
-1,1866,1795,71,2,108,108
1,1767,1577,190,0,-11,83
-1,1671,1629,42,1,-283,96
1,1940,1817,123,1,32,63
1,1616,1551,65,3,166,59
-1,1529,1562,-33,-2,-194,92
-1,1556,1517,39,0,-141,66
1,1564,1640,-76,-3,11,91
-1,1623,1700,-77,-5,113,86
1,1915,1732,183,-5,-176,67
-1,1701,1866,-165,-3,-245,74
-1,1341,1122,219,0,-412,88
-1,1979,2079,-100,0,-116,102
-1,1739,1908,-169,-3,-121,56
-1,1413,1420,-7,1,281,104
1,1897,1630,267,10,292,57
1,1364,1486,-122,-1,48,69
1,1545,1525,20,-3,176,89
-1,1471,1642,-171,-3,-87,62
1,1948,1810,138,1,17,43
-1,1639,1620,19,-1,-11,54
-1,1767,1772,-5,-1,-433,88
1,1641,1604,37,0,234,133
-1,1542,1626,-84,0,-42,64
-1,1852,1808,44,-1,-52,104
1,1702,1649,53,3,83,61
1,1693,1500,193,1,469,99
1,1572,1387,185,3,37,51
1,1519,1323,196,0,23,72
1,1822,1500,322,10,290,51
-1,1318,1611,-293,-13,-242,46
-1,1500,1878,-378,-1,-127,80
-1,1479,1517,-38,-5,-664,102
1,1634,1533,101,-1,53,89
-1,1438,1463,-25,1,31,44
-1,1390,1380,10,-3,-89,42
-1,2042,1823,219,0,-248,94
-1,1471,1379,92,3,324,104
-1,1333,1359,-26,0,-75,96
1,1680,1466,214,-3,50,51
1,1588,1669,-81,0,-26,51
1,1881,1446,435,-1,91,87
1,1797,1701,96,0,110,102
1,1757,1604,153,2,188,103
1,1593,1236,357,0,262,95
1,1720,1579,141,1,56,47
-1,1545,1525,20,-1,-373,116
1,1514,1555,-41,7,251,56
-1,1314,1695,-381,-3,-415,108
1,1781,1647,134,0,-31,77
-1,1628,1500,128,0,-258,140
0,1525,1489,36,-1,97,93
-1,1486,1553,-67,-5,-212,64
1,1773,1668,105,0,10,79
1,1820,1840,-20,0,-44,76
-1,1526,1643,-117,0,-53,126
-1,1694,1657,37,-7,-365,68
1,1971,1921,50,-1,-145,127
1,1756,1708,48,-1,-35,71
-1,1413,1883,-470,-1,-81,88
0,1778,1712,66,-3,-9,74
-1,1592,1578,14,-2,-98,108
1,1378,1391,-13,-4,154,85
-1,1632,1795,-163,0,-2,60
-1,1461,1690,-229,0,-15,70
1,1759,1661,98,0,-75,75
-1,1232,1321,-89,3,-72,86
1,1382,1534,-152,-1,-61,91
1,1481,1693,-212,0,88,57
-1,1043,1219,-176,-1,-13,40
-1,1651,1663,-12,-2,-52,68
-1,1471,1307,164,0,-91,68
1,1885,1389,496,0,-3,55
-1,1313,1309,4,-4,-267,74
-1,1539,1527,12,0,-90,68
1,1469,1657,-188,4,601,91
1,1841,1805,36,-1,-168,81
-1,1554,1733,-179,-4,-36,52
-1,1328,1500,-172,1,-117,78
1,1767,1569,198,-1,12,59
-1,1613,1872,-259,0,11,44
1,1851,1831,20,3,212,83
1,1475,1648,-173,-3,-48,67
1,1918,1753,165,-1,223,77
1,1681,1650,31,-4,-117,43
-1,1524,1597,-73,0,19,56
-1,1690,1739,-49,0,-231,68
-1,1393,1457,-64,-1,-226,76
1,1525,1542,-17,0,128,77
1,1783,1916,-133,1,22,87
1,1698,1518,180,0,550,93
-1,1619,1562,57,-2,-389,124
1,1312,1330,-18,6,110,40
1,1765,1699,66,0,10,71
-1,1500,1811,-311,-1,-524,110
-1,1209,1216,-7,5,141,44
-1,1773,1806,-33,0,-26,50
-1,1435,1369,66,0,-33,54
0,1606,1572,34,1,7,84
-1,1484,1368,116,3,22,44
1,1320,1302,18,3,94,47
1,1600,1500,100,3,149,65
1,1603,1699,-96,0,365,173
1,1931,1787,144,1,11,51
-1,1626,1506,120,-1,15,82
1,1816,1891,-75,0,3,55
-1,1311,1334,-23,-15,-239,40
1,1749,1720,29,0,197,113
1,1748,1235,513,1,55,59
1,1491,1631,-140,6,39,41
1,1323,1296,27,7,301,55
-1,1528,1612,-84,-1,-26,206
1,1905,1394,511,0,248,79
-1,1877,1981,-104,2,22,52
1,1763,1875,-112,0,9,53
1,1624,1542,82,4,48,41
-1,1521,1611,-90,-2,-381,82
1,1428,1545,-117,0,28,51
-1,1704,1669,35,-1,-173,110
-1,1533,1645,-112,-16,-257,40
-1,1821,1862,-41,-2,-11,42
-1,1440,1623,-183,-1,-30,44
-1,1182,1191,-9,0,4,44
-1,1563,1859,-296,-4,-162,66
-1,1513,1560,-47,0,-79,54
1,1633,1478,155,-1,462,121
1,1663,1619,44,6,203,45
-1,1361,1506,-145,0,-2,80
-1,1734,1872,-138,0,-11,58
1,1776,1645,131,-2,28,211
1,1653,1474,179,0,-23,75
-1,1515,1531,-16,1,148,140
1,1318,1324,-6,0,0,49
-1,1593,1569,24,1,-264,126
-1,1764,1715,49,3,57,78
0,1512,1705,-193,-1,-31,178
1,1816,1527,289,-5,147,71
-1,1368,1609,-241,-5,-357,66
-1,1777,1628,149,0,2,68
1,1412,1303,109,-1,405,173
-1,1430,1498,-68,4,175,78
-1,1798,1873,-75,-5,-433,104
-1,1538,1857,-319,2,16,62
1,1606,1574,32,-8,-240,59
-1,1284,1333,-49,0,23,84
-1,1827,1989,-162,1,-53,90
-1,1697,1611,86,-5,-162,51
-1,1385,1506,-121,0,12,80
1,1672,1677,-5,1,80,83
-1,1527,1401,126,-6,-262,78
-1,1680,1648,32,0,23,90
1,1747,1661,86,1,87,63
-1,1442,1605,-163,-2,-26,56
-1,1033,1749,-716,-2,-36,46
1,1660,1703,-43,2,228,117
1,1890,1634,256,2,68,49
1,1252,1284,-32,4,162,93
0,1641,1362,279,-2,-151,133
1,1615,1311,304,13,144,47
-1,1747,1930,-183,-8,-74,60
-1,1503,1716,-213,-10,-94,52
1,1652,1755,-103,1,194,67
1,1534,1630,-96,0,-17,71
1,1669,1859,-190,4,408,121
-1,1781,1861,-80,-1,-79,64
0,1514,1456,58,0,449,132
-1,1882,1789,93,-9,-224,60
1,1580,1453,127,-1,15,76
-1,1955,1995,-40,-2,-107,96
-1,1877,1941,-64,-2,-100,55
1,1727,1570,157,-2,24,55
0,1495,1507,-12,-5,349,121
-1,1522,1735,-213,0,-181,66
-1,1741,1863,-122,2,-81,70
1,1136,1148,-12,-1,-1,89
1,1500,1518,-18,-6,-48,99
-1,1354,1329,25,2,-22,62
-1,1312,1699,-387,0,-402,112
-1,1625,1964,-339,-1,-6,86
1,1699,1572,127,1,57,63
-1,1843,1712,131,-9,-752,110
1,1695,1669,26,0,12,73
-1,1573,1620,-47,-2,-30,112
-1,1464,1692,-228,1,26,44
1,1734,1753,-19,2,35,51
-1,1323,1342,-19,-7,-699,124
1,1906,1399,507,2,28,51
-1,1593,1291,302,-3,-100,70
-1,1830,2217,-387,0,-43,78
1,1436,1400,36,-2,26,82
-1,1712,1871,-159,9,-94,144
-1,1503,1608,-105,-3,94,58
-1,1213,1556,-343,-1,-147,66
-1,1716,1745,-29,-1,27,82
-1,1803,1867,-64,-5,-98,53
-1,1751,1691,60,-2,-8,118
1,1457,1520,-63,0,-4,41
-1,1945,1812,133,0,-43,84
-1,1559,1426,133,-1,-193,110
1,1161,1129,32,6,304,63
1,1402,1512,-110,2,15,53
1,1477,1032,445,-2,-104,59
-1,1230,1655,-425,1,-39,82
1,1525,1674,-149,3,354,145
-1,1878,2047,-169,-1,-63,66
-1,1755,1687,68,0,-371,114
1,1728,1878,-150,-1,64,69
-1,1457,1621,-164,-2,-86,68
1,1760,1377,383,0,289,107
1,1899,1507,392,1,61,61
-1,1496,1639,-143,0,1,90
-1,1564,1624,-60,0,2,76
1,1385,1436,-51,5,142,75
1,1402,1057,345,-3,-75,47
-1,1877,1794,83,4,75,58
1,1534,1457,77,-3,-33,63
-1,1705,1734,-29,-4,-132,52
-1,1989,1870,119,-4,-361,78
1,1552,1616,-64,2,149,71
1,1740,1634,106,7,331,61
1,1461,1303,158,1,332,113
-1,1828,2163,-335,-2,-68,56
-1,1701,1615,86,1,-46,135
1,1868,1956,-88,2,36,45
1,1722,1742,-20,2,-82,71
1,1601,1563,38,0,209,95
-1,1488,1648,-160,0,5,74
1,2167,1825,342,0,61,91
-1,1337,1437,-100,-3,-49,46
1,1210,1272,-62,0,13,55
1,1499,1607,-108,4,138,43
1,1731,1751,-20,0,0,51
1,1660,1507,153,3,134,61
-1,1872,1930,-58,0,28,96
-1,1701,1505,196,2,119,74
-1,1360,1522,-162,-4,-449,138
1,1572,1382,190,0,-64,63
1,1724,1742,-18,-2,-112,71
1,1744,1679,65,1,6,51
-1,1808,1862,-54,-4,-271,75
-1,1688,1916,-228,-1,-93,90
1,1618,1634,-16,1,212,111
-1,1310,1382,-72,-4,-162,62
1,1627,1612,15,0,11,57
1,1826,1757,69,0,27,67
1,1743,1610,133,3,51,44
1,1735,1673,62,-3,48,61
1,1614,1565,49,-3,-7,75
1,1308,1420,-112,11,434,57
-1,1731,1750,-19,2,-102,82
1,1908,1709,199,1,109,63
-1,1478,1499,-21,0,-85,70
1,1514,1185,329,8,620,85
-1,1542,1510,32,0,19,76
1,1774,1714,60,0,48,51
1,1363,1272,91,-4,-66,69
1,1482,1366,116,-2,103,97
1,1939,1803,136,-2,271,105
1,1772,1721,51,6,58,47
-1,1848,1835,13,-1,6,40
-1,1881,1898,-17,-6,-31,50
1,1872,1799,73,4,175,67
-1,1729,1934,-205,-1,-18,54
-1,1864,1500,364,1,-37,86
-1,1712,1790,-78,-6,-211,54
1,1750,1671,79,0,91,153
-1,1439,1510,-71,-15,-680,66
-1,1846,1835,11,1,-129,132
-1,1492,1500,-8,0,-34,68
1,1259,1223,36,2,-37,53
-1,1194,1087,107,-1,35,72
1,1548,1629,-81,-1,44,77
-1,1349,1542,-193,-1,-135,60
1,1416,1581,-165,3,-14,41
1,1807,1704,103,0,83,83
1,1715,1513,202,2,110,81
-1,1329,1362,-33,2,101,72
-1,1847,1835,12,-1,-5,68
0,1729,1654,75,0,86,140
1,1618,1468,150,-5,60,87
-1,1946,1835,111,-3,-93,76
-1,1629,1958,-329,-4,-158,64
1,1509,1467,42,1,40,59
1,1696,1711,-15,1,165,67
-1,1799,1625,174,-1,-123,82
1,1632,1522,110,0,-93,105
-1,1539,1536,3,-6,-231,98
1,1500,1334,166,-1,-56,63
-1,1824,1857,-33,3,78,48
1,1790,1882,-92,0,-19,46
1,1334,1494,-160,-5,-39,65
-1,1578,1569,9,-4,-88,48
-1,1343,1553,-210,-7,-155,42
-1,1676,1720,-44,-3,-47,92
1,1867,1813,54,-3,-55,53
-1,1974,1949,25,-1,-11,90
1,1598,1579,19,2,619,111
-1,1368,1457,-89,1,33,45
-1,1300,1096,204,0,-17,64
1,1744,1635,109,0,68,111
1,1530,1650,-120,-4,-114,55
-1,1662,1826,-164,1,85,50
-1,1827,1753,74,-2,-24,58
1,1171,1295,-124,9,296,53
-1,1803,1876,-73,0,-4,78
-1,1699,1821,-122,-4,-8,68
1,1704,1658,46,4,142,44
1,1707,1625,82,0,0,49
1,1643,1838,-195,1,109,61
-1,1263,1371,-108,-12,-117,48
1,1441,1500,-59,11,274,41
1,1848,1932,-84,4,354,87
0,1646,1317,329,-3,-175,155
-1,1785,1893,-108,0,-83,74
1,1965,1970,-5,0,-114,155
-1,1881,1519,362,0,-54,88
1,1553,1339,214,-1,5,59
-1,1521,1624,-103,0,-101,86
-1,1617,1716,-99,0,-210,104
-1,1527,1664,-137,0,-296,134
1,1635,1545,90,0,24,45
-1,1759,1692,67,0,189,128
1,1777,1901,-124,-1,275,97
-1,1289,1627,-338,-2,-38,72
-1,1292,1511,-219,-1,-387,80
-1,1388,1592,-204,0,-10,44
-1,1597,1633,-36,-2,-53,70
-1,1567,1481,86,-4,-290,65
-1,1662,1793,-131,-4,-108,45
1,1537,1644,-107,-8,-33,59
1,1834,1657,177,1,483,119
1,1680,1643,37,2,21,43
1,1489,1595,-106,0,-2,57
-1,1962,1987,-25,-3,-42,48
-1,1508,1721,-213,-1,-77,102
-1,1762,1894,-132,0,-101,106
1,1723,1609,114,1,44,71
-1,1539,1344,195,-6,-627,116
1,1541,1591,-50,0,155,155
1,1651,1845,-194,1,-5,103
1,1594,1889,-295,2,136,79
-1,1705,1443,262,1,18,76
0,1658,1500,158,0,23,121
1,1948,1861,87,0,33,131
1,1657,1667,-10,-2,-31,63
1,1317,1235,82,17,680,61
1,1503,1500,3,2,81,61
-1,1284,1390,-106,1,25,72
-1,1627,1476,151,-7,-322,58
-1,1640,1500,140,1,214,92
-1,1629,1551,78,0,-71,60
1,1901,1755,146,-2,-54,49
1,1580,1504,76,0,23,65
1,1817,1667,150,6,295,57
1,1807,1792,15,-3,-28,129
1,1746,1601,145,4,182,65
-1,1351,1399,-48,-4,-57,40
0,1748,1908,-160,0,27,112
1,1319,1448,-129,-8,213,85
1,1731,1676,55,2,-139,107
1,1583,1519,64,0,-6,61
-1,1364,1520,-156,2,179,84
-1,1457,1644,-187,0,-108,82
-1,1383,1371,12,3,201,84
-1,1660,1828,-168,-6,-459,66
1,1634,1608,26,1,17,71
-1,1450,1509,-59,1,-6,62
-1,1627,1631,-4,12,434,66
1,1903,1753,150,5,86,53
1,1838,1654,184,9,177,53
-1,1560,1648,-88,0,-57,66
1,1463,1465,-2,0,-17,41
-1,1869,1613,256,0,-6,56
-1,1525,1704,-179,-1,2,42
1,1552,1287,265,0,-110,79
1,1740,1500,240,3,144,109
0,1746,1910,-164,0,-145,144
1,1629,1456,173,1,273,119
-1,1500,1395,105,-4,-479,86
-1,1330,1631,-301,0,-96,88
1,1460,1430,30,1,417,165
-1,1649,1847,-198,-1,-44,74
-1,1500,1838,-338,0,-18,64
-1,1495,1564,-69,-2,-91,54
1,1666,1740,-74,4,102,57
-1,1527,1356,171,1,-36,60
-1,1729,1894,-165,-5,-93,56
1,1801,1655,146,6,256,65
1,1726,1503,223,-2,46,67
-1,1555,1612,-57,0,-92,126
0,1471,1686,-215,0,108,128
-1,1488,1676,-188,-2,-19,46
1,1218,1331,-113,0,210,119
1,1418,1276,142,2,359,89
1,1744,1911,-167,0,31,89
1,1375,1509,-134,4,75,51
-1,1603,1643,-40,0,-175,70
-1,1380,1593,-213,-2,25,40
1,1276,1544,-268,4,-4,41
1,1551,1547,4,1,38,57
1,1639,1284,355,8,296,69
-1,1895,1760,135,0,6,62
-1,1510,1592,-82,-2,-4,40
-1,1037,1498,-461,-1,-250,84
1,1424,1286,138,1,815,183
-1,1526,1386,140,-2,-48,44
-1,1727,1587,140,0,189,76
-1,1764,1657,107,3,146,78
1,1650,1751,-101,-3,-206,89
-1,1776,1880,-104,-2,2,44
-1,1698,1671,27,0,2,46
0,1518,1636,-118,0,97,108
-1,1860,1822,38,0,-2,78
-1,1524,1842,-318,-1,-507,126
1,1665,1643,22,0,255,81
0,1609,1658,-49,-10,-52,136
1,1760,1896,-136,-7,31,69
1,1748,1382,366,1,927,125
1,1852,1494,358,-2,35,44
-1,1591,1562,29,-5,-112,78
1,1558,1638,-80,-2,101,75
1,1485,1392,93,-6,-386,97
1,1435,1433,2,3,24,49
-1,1918,1904,14,-1,1,70
-1,1776,1881,-105,-1,-64,50
1,1495,1778,-283,4,53,41
-1,1573,1663,-90,-1,-50,82
1,1644,1689,-45,2,335,105
-1,1305,1334,-29,-4,-171,168
-1,1738,1730,8,1,71,108
1,1464,1409,55,1,42,111
1,1760,1896,-136,3,218,75
1,1614,1564,50,4,145,57
-1,1501,1554,-53,-1,-79,84
1,1550,1113,437,4,45,51
-1,1494,1383,111,-1,-120,102
-1,1740,1839,-99,0,11,94
0,1953,1853,100,-1,-147,185
-1,1767,1889,-122,-6,-38,40
-1,1046,1909,-863,0,9,90
-1,1600,1671,-71,0,-135,102
-1,1282,1556,-274,-13,-292,52
1,1269,1019,250,13,853,71
1,1486,1324,162,7,110,41
-1,1509,1683,-174,-3,-68,60
-1,1896,1760,136,1,23,51
-1,1907,2120,-213,0,-178,122
-1,1316,1589,-273,-8,-487,68
-1,1527,1409,118,-1,-189,102
1,1675,1749,-74,0,238,149
-1,1287,1503,-216,0,-547,106
-1,1562,1500,62,-2,-1,46
1,1775,1881,-106,1,124,75
1,1345,1422,-77,5,310,85
1,1696,1536,160,-3,-292,107
1,1360,1482,-122,-4,-6,59
-1,1736,1996,-260,2,40,54
1,1475,1867,-392,0,-18,66
1,1709,1554,155,1,402,97
1,1631,1522,109,0,100,77
1,1847,1713,134,1,60,51
-1,1665,1602,63,-1,68,70
-1,1479,1399,80,-4,-76,45
1,1867,1790,77,-4,-86,103
-1,1977,1893,84,-1,-112,82
-1,1466,1437,29,-9,-273,60
1,1928,1833,95,0,346,139
1,1846,1507,339,0,7,63
1,1649,1686,-37,-1,-4,75
1,1752,1508,244,2,43,51
-1,1417,1461,-44,2,-18,56
-1,1781,1875,-94,0,-497,142
1,1593,1312,281,2,204,69
1,1234,1046,188,8,356,69
1,1828,1910,-82,-1,-16,57
-1,1833,1820,13,0,-6,52
1,1902,2130,-228,1,144,105
1,1466,1317,149,7,958,133
1,1098,0,1098,7,533,67
1,2114,1624,490,0,12,123
1,1342,1491,-149,4,53,47
-1,1274,1499,-225,-10,-202,46
1,1884,1773,111,-1,-34,49
-1,1677,1656,21,0,-21,86
1,1765,1891,-126,6,289,83
1,1514,1450,64,0,410,81
-1,1308,1597,-289,-4,-124,63
-1,1648,1500,148,0,0,48
-1,1856,1855,1,-5,-48,54
-1,1653,1724,-71,0,30,50
0,1732,1550,182,0,-691,153
-1,1602,1712,-110,6,39,138
-1,1776,1511,265,-1,-89,86
1,1876,1780,96,0,84,79
1,1282,1120,162,0,-6,41
1,1816,1849,-33,0,-49,71
0,1472,1649,-177,-3,293,139
1,1733,1644,89,-1,481,119
-1,1594,2111,-517,-6,-107,68
-1,1553,1391,162,-6,-104,52
1,1772,1884,-112,-1,31,85
-1,1358,1476,-118,-7,-343,76
1,1269,1500,-231,2,242,73
1,1601,1305,296,0,-17,75
1,1400,1474,-74,-1,185,93
-1,1679,1591,88,4,43,40
1,1726,1534,192,-3,63,93
-1,1750,1741,9,-7,-203,43
1,1919,1842,77,0,236,121
1,1396,1341,55,7,179,47
1,1867,1846,21,4,185,65
1,1832,1772,60,0,3,53
1,1453,1284,169,3,-13,83
-1,1870,1786,84,0,-28,64
1,1682,1504,178,-2,-50,91
-1,1357,1849,-492,-3,-359,90
-1,1477,1362,115,0,-243,122
1,1800,1857,-57,0,3,53
1,1528,1492,36,0,148,75
-1,1561,1397,164,-1,-118,86
1,1669,1720,-51,0,375,121
1,1563,1625,-62,0,113,63
1,1448,1540,-92,4,226,73
1,1301,1605,-304,-4,-76,55
-1,1519,1545,-26,0,-118,84
-1,1942,1908,34,-4,-67,52
1,1500,1289,211,0,93,115
-1,1834,1854,-20,0,-1,46
-1,1523,1440,83,2,22,44
0,2109,1706,403,-5,13,119
-1,1605,2098,-493,-1,-209,78
-1,1928,1833,95,0,-149,146
-1,1478,1559,-81,-7,-132,58
-1,1310,1498,-188,-3,-41,42
-1,1405,1332,73,-7,-248,74
-1,1836,1877,-41,2,-31,90
1,1525,1504,21,0,36,51
1,1407,1536,-129,4,60,51
-1,1463,1541,-78,-7,-186,61
-1,1415,1603,-188,0,3,52
1,1660,1666,-6,-1,-30,83
-1,1437,1433,4,-9,-165,50
1,1510,1666,-156,-1,-16,55
1,1421,1376,45,0,67,75
-1,1703,1585,118,2,-114,136
-1,1504,1542,-38,-1,-4,44
1,1816,2001,-185,-4,-62,123
1,1566,1397,169,4,484,97
1,1255,1056,199,5,246,64
-1,1625,1768,-143,-9,-193,47
-1,1535,1722,-187,-12,-135,44
-1,1280,1613,-333,-7,-651,132
1,1726,1717,9,-3,-86,75
1,1482,1537,-55,-1,35,77
1,1914,1869,45,5,58,53
1,1851,1408,443,0,31,75
1,1514,1385,129,0,-18,77
1,1500,1725,-225,-6,-91,42
-1,1503,1490,13,0,170,96
-1,1713,1832,-119,0,-234,100
1,1445,1337,108,1,223,93
-1,1689,1683,6,0,-3,44
1,1460,1259,201,0,94,55
-1,1392,1277,115,-10,-509,67
-1,1426,1362,64,1,-88,64
1,1856,1668,188,0,6,87
-1,1893,1825,68,1,26,90
-1,1924,2181,-257,0,27,108
-1,1493,1519,-26,1,18,62
1,1637,1707,-70,-1,-13,97
1,1738,1635,103,-3,15,81
1,1919,1729,190,-1,-21,51
-1,1655,1922,-267,0,-240,118
1,1444,1426,18,0,144,75
-1,1500,1485,15,-4,-363,68
1,1662,1862,-200,0,114,97
1,1456,1548,-92,-3,70,79
-1,1544,1344,200,0,36,56
-1,1363,1563,-200,3,87,90
1,1638,1774,-136,-3,-287,133
1,1688,1693,-5,0,7,71
1,1465,1169,296,-1,-10,47
1,1577,1612,-35,-1,248,83
-1,1283,1598,-315,-2,-161,74
1,1268,1146,122,1,60,65
1,2186,1920,266,0,29,69
0,1428,1296,132,3,96,61
1,1674,1697,-23,0,108,99
0,1460,1321,139,1,124,97
1,1732,1630,102,0,13,59
1,1611,1432,179,9,1107,103
0,1500,1633,-133,1,-13,164
-1,1587,1812,-225,0,4,66
-1,1304,1394,-90,-1,-122,76
1,1720,1175,545,-1,33,55
-1,1377,1729,-352,-5,-167,56
1,1277,1500,-223,4,444,103
-1,1698,1859,-161,0,-118,82
-1,1526,1554,-28,2,29,66
1,1285,1470,-185,-1,-211,83
1,1623,1699,-76,4,378,77
1,1495,1534,-39,-5,-73,59
-1,2099,1853,246,-2,-17,74
1,1920,1893,27,1,139,85
-1,1627,1746,-119,-2,-33,68
1,1809,1562,247,0,158,132
-1,1408,1360,48,-5,-38,50
1,1474,1500,-26,-4,-79,89
-1,1542,1676,-134,-9,-91,52
0,1916,1888,28,-7,-189,99
-1,1837,1699,138,0,-42,118
1,1651,1683,-32,1,437,139
-1,1534,1512,22,-11,-359,60
-1,1326,1456,-130,1,-177,70
-1,1552,1483,69,-7,-230,58
1,1686,1636,50,11,345,61
-1,1692,1769,-77,0,9,78
-1,1012,1317,-305,-4,-101,50
1,1469,1347,122,4,53,46
1,1740,1837,-97,0,-15,51
1,1894,2171,-277,0,29,115
-1,1358,1619,-261,-1,-40,50
-1,1785,1765,20,0,-17,66
1,1695,1627,68,-1,454,107
-1,1631,1567,64,0,6,64
1,2146,1916,230,-1,78,65
-1,1375,1390,-15,-1,-53,58
0,1722,1691,31,0,-291,208
1,1944,1825,119,0,32,73
-1,1915,1888,27,0,-489,144
-1,1568,1488,80,1,39,62
0,1727,1795,-68,0,-1,73
1,1303,1278,25,2,659,133
1,1515,1446,69,0,401,110
-1,1910,2152,-242,-1,-142,106
-1,1692,1847,-155,-1,36,138
1,1656,1556,100,1,99,61
1,1749,1426,323,-3,-189,113
-1,1714,1513,201,-1,-167,102
-1,1754,1778,-24,-4,-131,64
-1,1345,1292,53,-9,-401,100
-1,1729,2116,-387,-10,-181,56
1,1824,1773,51,0,24,63
-1,1713,1621,92,0,25,48
-1,1296,1153,143,1,20,50
1,1477,1490,-13,0,150,69
-1,1470,1570,-100,2,147,80
-1,1706,1929,-223,1,-79,100
1,1618,1703,-85,0,323,137
-1,1727,2118,-391,2,-44,76
-1,1341,1781,-440,-8,-567,68
1,1901,1715,186,0,18,107
1,1843,1926,-83,0,66,75
1,1903,1817,86,-1,-28,61
1,1489,1255,234,-1,-57,89
0,1469,1907,-438,-1,-24,97
-1,1521,1696,-175,-2,-141,92
1,1463,1486,-23,1,-4,81
1,2121,1725,396,0,213,95
0,1280,1500,-220,5,392,67
1,1401,1538,-137,1,25,44
-1,1495,1513,-18,0,-8,42
-1,1154,1252,-98,-11,-582,64
-1,983,1577,-594,-2,-31,50
-1,1451,1571,-120,5,287,155
1,1633,1596,37,7,598,87
-1,1837,1848,-11,0,-38,62
1,1671,1663,8,0,-3,105
1,1685,1833,-148,0,31,97
-1,1763,1617,146,0,-45,82
-1,1747,1854,-107,-4,-140,62
1,1575,1534,41,-9,5,83
-1,1690,1631,59,0,-318,94
1,1676,1498,178,0,235,109
-1,1733,1803,-70,0,-35,100
-1,1548,1664,-116,0,8,60
1,1688,1332,356,1,145,73
-1,1699,1958,-259,-1,-129,72
1,1578,1520,58,0,250,81
-1,1437,1524,-87,-1,-8,76
-1,1526,1462,64,0,16,50
-1,1709,1906,-197,-5,-91,58
1,1631,1416,215,7,990,108
-1,1821,1642,179,-5,-101,82
-1,1345,1478,-133,-3,-181,62
1,1379,1519,-140,2,309,69
-1,1606,1752,-146,-4,-69,46
-1,1919,2079,-160,0,-38,102
-1,1889,2123,-234,0,-7,72
1,1797,1322,475,0,46,77
-1,1284,1453,-169,-6,-144,48
-1,1231,1623,-392,-4,-84,54
-1,1644,1678,-34,0,213,102
1,1701,1739,-38,-3,-137,75
1,1474,1609,-135,0,65,71
-1,1926,1626,300,0,-879,156
1,1972,2056,-84,1,106,85
1,1415,1215,200,-3,73,57
-1,1748,1893,-145,0,-37,70
1,1870,1818,52,0,30,67
1,1513,1529,-16,3,121,61
1,1694,1515,179,-2,-61,89
-1,1386,1652,-266,-3,-29,58
1,1816,1855,-39,5,152,57
-1,1675,1896,-221,1,56,62
-1,1486,1710,-224,0,-176,108
1,1498,1582,-84,0,-54,109
-1,1552,1579,-27,-3,-229,82
-1,1275,1460,-185,-7,-26,40
-1,1842,1829,13,-2,-126,92
1,1913,2144,-231,0,-104,127
1,1656,1381,275,0,154,77
-1,1578,1668,-90,0,-4,64
0,1511,1599,-88,-3,-429,141
-1,1533,1779,-246,-2,-205,82
1,1561,1489,72,-9,169,149
1,1994,1703,291,-2,153,116
1,1318,1143,175,1,867,115
-1,1512,1568,-56,-2,-569,110
1,1687,1634,53,-1,368,111
-1,1672,1704,-32,-3,-43,120
1,1901,1741,160,0,341,145
1,1841,1830,11,6,200,69
-1,1523,1572,-49,-2,-96,78
-1,1373,1532,-159,-1,2,62
1,1693,1702,-9,-2,-83,53
1,1903,1917,-14,5,308,99
1,1724,1891,-167,0,50,91
-1,1376,1660,-284,-1,-393,94
-1,1366,1266,100,2,4,72
1,1999,1827,172,0,133,149
-1,1614,1727,-113,0,-68,64
1,1819,1851,-32,-3,-346,81
1,1917,1906,11,2,347,119
1,1683,1500,183,1,71,72
-1,1713,1809,-96,-3,-11,42
1,1451,1373,78,-4,-86,43
-1,1632,1700,-68,-9,-334,63
1,1664,1372,292,0,-2,49
1,1647,1895,-248,-3,165,71
-1,1839,1831,8,-1,-190,100
1,2126,1930,196,4,644,119
-1,1529,1810,-281,-2,-95,50
-1,1391,1454,-63,2,-12,82
1,1464,1323,141,1,169,99
-1,1494,1366,128,0,34,54
1,1625,1696,-71,1,212,85
-1,1881,1825,56,-2,-104,60
1,1606,1825,-219,0,-28,71
-1,1250,1503,-253,-2,15,90
0,1466,1456,10,0,97,97
-1,1589,1505,84,4,58,60
-1,1500,1262,238,1,121,84
1,1665,1816,-151,-9,-6,97
1,1734,1909,-175,0,16,49
1,1734,1738,-4,2,67,55
-1,1843,1828,15,-2,-430,102
1,1628,1253,375,3,532,85
1,1404,1352,52,0,99,41
-1,1173,1372,-199,-3,-69,52
-1,1482,1395,87,1,46,64
-1,1705,1704,1,-3,-182,82
-1,1499,1511,-12,-1,-64,50
-1,1500,1636,-136,0,-3,94
-1,1379,1786,-407,3,-121,92
1,1874,1740,134,3,57,45
-1,1136,1041,95,-9,-212,52
1,1556,1547,9,3,169,61
1,1804,1659,145,-1,-36,59
-1,1930,1793,137,2,85,82
1,1839,1831,8,2,43,47
0,1500,1528,-28,2,225,126
1,1555,1500,55,7,277,63
1,1688,1582,106,4,597,111
0,1523,1444,79,-3,-118,48
-1,1596,1514,82,0,19,52
1,1890,1751,139,0,33,73
-1,1925,2132,-207,-5,-252,68
-1,1709,1648,61,-1,-18,62
1,1480,1587,-107,5,105,53
1,1684,1638,46,0,-100,95
1,1820,1850,-30,-1,-84,69
-1,1365,1505,-140,-1,-41,50
-1,1788,1376,412,2,190,78
-1,1355,1867,-512,-1,-131,128
-1,1895,1808,87,-1,-374,126
-1,1733,1882,-149,1,42,62
-1,1244,1508,-264,0,-222,82
1,1784,1626,158,1,63,67
-1,1652,1811,-159,0,-4,58
-1,1527,1583,-56,-1,-235,114
1,1539,1525,14,6,221,55
1,1657,1557,100,-1,28,57
1,1838,1832,6,1,163,71
-1,1754,1622,132,0,0,50
0,1314,1475,-161,0,-150,114
1,1437,1419,18,-1,29,55
-1,1644,1701,-57,-3,-92,126
1,1821,1882,-61,6,163,43
-1,1498,1446,52,0,-20,100
1,1830,1548,282,0,16,57
1,1744,1898,-154,1,4,41
-1,1713,1662,51,0,-52,82
1,2016,1696,320,0,26,103
1,1696,1509,187,-1,5,59
1,1821,1849,-28,6,249,71
-1,1818,1646,172,1,57,64
0,1664,1697,-33,2,-231,98
-1,1679,1488,191,0,-18,54
-1,1629,1693,-64,-1,-23,56
0,1424,1562,-138,-1,-165,113
1,1250,1160,90,2,62,67
1,1715,1481,234,0,98,59
-1,1213,1184,29,0,-380,128
1,1550,1471,79,-1,-28,45
1,1524,1315,209,-1,295,85
1,1515,1545,-30,-2,-56,67
-1,1637,1698,-61,0,-28,70
-1,1534,1366,168,-4,-288,102
0,1512,1514,-2,-5,-417,122
-1,1821,2137,-316,-1,-34,54
-1,1694,1665,29,-2,-83,66
1,1485,1431,54,-1,153,89
1,1340,1540,-200,-1,0,53
1,1958,1802,156,1,-37,103
1,1753,1474,279,-1,63,67
-1,1702,1620,82,-3,6,52
-1,1313,1842,-529,-1,-357,126
1,1697,1381,316,0,-72,81
1,1726,1500,226,0,-45,93
-1,1642,1594,48,1,188,100
1,1444,1471,-27,0,-169,69
1,1592,1518,74,1,87,67
-1,1821,1633,188,1,50,62
1,1319,1324,-5,0,86,76
-1,1501,1464,37,2,67,66
-1,1391,1462,-71,-13,-162,46
-1,1633,1689,-56,-1,-276,94
-1,1936,1947,-11,0,-792,130
-1,1568,1602,-34,-2,-14,102
1,1559,1459,100,-1,-124,101
-1,1622,1514,108,-1,-73,90
-1,1353,1584,-231,-7,-82,48
1,1711,1635,76,3,228,93
-1,1503,1578,-75,0,71,90
-1,1309,1844,-535,-5,-212,56
1,1756,1259,497,0,126,75
-1,1504,1874,-370,0,-11,74
1,1141,1720,-579,-5,-70,50
1,1674,1680,-6,3,135,87
1,1957,1926,31,-1,-181,73
1,1673,1601,72,0,8,77
1,1731,1502,229,14,916,85
-1,1394,1500,-106,0,-10,54
-1,1119,1513,-394,-4,-198,48
-1,1757,2081,-324,0,-37,82
-1,1549,1665,-116,-2,-43,58
1,1313,1295,18,0,-27,59
1,1578,1618,-40,0,30,73
-1,1791,1500,291,-6,-155,60
1,1306,1847,-541,0,7,43
1,1582,1490,92,1,131,73
-1,1205,1322,-117,-3,-164,58
0,1691,1720,-29,0,-7,134
-1,1431,1630,-199,3,17,70
1,1657,1401,256,1,87,49
1,1821,1340,481,1,263,119
1,1667,1805,-138,-1,31,103
1,1607,1630,-23,2,88,111
-1,1355,1534,-179,-3,-182,58
-1,1296,1519,-223,-5,-696,99
-1,1451,1689,-238,-1,-94,106
-1,1348,1635,-287,-1,-46,74
-1,2141,2153,-12,0,-8,52
-1,1513,1700,-187,-1,-63,70
-1,1396,1661,-265,2,123,80
1,1437,996,441,13,290,43
1,1383,1323,60,4,53,43
1,1754,1665,89,1,22,53
-1,1923,1783,140,-3,-20,42
-1,1567,1530,37,-6,-163,50
1,1685,1555,130,0,-24,91
-1,1258,1699,-441,-6,-90,45
-1,1676,1530,146,-3,-377,122
-1,1522,1536,-14,-12,-324,52
-1,1497,1736,-239,-7,-287,78
-1,1592,1688,-96,-2,-88,60
1,1673,1231,442,1,-54,91
-1,1753,1678,75,1,25,58
1,1328,1278,50,18,1019,61
1,1642,1693,-51,2,58,55
-1,1400,1823,-423,-4,-184,70
1,1327,1482,-155,-9,-13,57
-1,1624,1501,123,-9,-390,90
-1,1548,1752,-204,-1,-76,74
-1,1701,1951,-250,-4,-447,90
-1,1480,1877,-397,0,-99,65
1,1346,1297,49,5,302,95
1,1719,1728,-9,-3,-52,67
1,1761,1391,370,0,43,71
-1,1878,1778,100,-2,-46,69
-1,1454,1463,-9,-5,-108,42
1,1287,1447,-160,-2,-57,69
1,1444,1587,-143,0,-21,65
-1,1392,1434,-42,8,315,82
-1,1878,1867,11,-3,-86,100
1,1694,1378,316,3,106,53
-1,1825,1735,90,-6,-61,44
1,1495,1515,-20,-4,63,73
-1,1702,1912,-210,-4,-28,74
1,1589,1579,10,1,49,51
1,1698,1679,19,2,29,49
-1,1706,1352,354,0,-105,70
1,1792,1542,250,1,20,45
-1,1382,1439,-57,0,-82,48
1,1484,1418,66,1,274,103
1,1411,1375,36,16,320,51
-1,1508,1749,-241,2,46,98
-1,1838,1823,15,-1,-23,41
1,1756,1808,-52,8,506,81
1,1701,1505,196,2,11,50
-1,1500,1795,-295,1,23,54
1,1741,1502,239,-2,-103,93
-1,1511,1252,259,-6,-145,72
-1,1345,1281,64,-11,-309,54
1,1363,1424,-61,-2,-3,49
1,1460,1521,-61,0,10,51
1,2185,1773,412,-1,202,55
1,1444,1382,62,0,-57,97
-1,1793,1747,46,-1,129,134
-1,1706,1581,125,-5,-24,80
-1,1308,1500,-192,-2,-251,78
-1,1619,1803,-184,0,-104,84
1,1821,1694,127,0,115,97
1,1956,1697,259,-2,-26,71
1,1695,1880,-185,1,-83,83
-1,1678,1545,133,0,-5,73
1,1763,1573,190,5,258,59
-1,1222,1500,-278,-4,-222,64
1,1509,1692,-183,7,449,81
1,1622,1544,78,1,0,46
1,1473,1668,-195,3,25,51
1,1487,1223,264,10,197,45
1,1366,1420,-54,4,72,47
-1,1447,1606,-159,-5,-226,56
-1,1422,1222,200,-3,-87,72
-1,1771,1687,84,1,45,62
1,1400,1357,43,0,169,61
-1,1736,1449,287,-1,-602,114
-1,1757,1878,-121,1,66,66
1,1917,1693,224,-2,86,51
0,1867,1799,68,0,-87,158
0,1619,1500,119,2,-339,126
1,1375,1499,-124,4,164,63
-1,1672,1542,130,0,-112,150
-1,1468,1492,-24,1,-121,102
1,1685,1654,31,0,0,45
1,1490,1500,-10,-3,-7,87
1,1754,1503,251,1,4,43
1,1301,1317,-16,9,224,45
-1,1189,1788,-599,0,-114,68
-1,1734,1713,21,-2,-191,140
1,1860,1711,149,4,416,107
1,1876,1538,338,2,29,63
-1,1770,1695,75,0,-140,134
1,1661,1569,92,8,828,91
-1,1520,1449,71,2,108,98
-1,1382,1401,-19,4,170,64
-1,1481,1515,-34,-3,-73,50
-1,1319,1453,-134,3,89,40
1,1686,1922,-236,0,-67,101
1,1746,1663,83,0,41,77
-1,1560,1789,-229,1,-106,60
-1,1678,1603,75,0,-27,100
1,1719,1725,-6,0,112,107
1,1415,1346,69,0,-12,67
1,1682,1668,14,2,94,64
0,1622,1530,92,-9,33,80
1,1327,1343,-16,16,600,63
-1,1564,1305,259,-1,13,48
-1,1034,1635,-601,4,51,54
1,1719,1500,219,0,11,50
-1,1669,1643,26,-1,-22,58
-1,1695,1909,-214,-1,-44,70
1,1489,1513,-24,2,136,79
1,1316,1232,84,4,8,57
-1,1714,1733,-19,-2,-17,46
-1,1801,1865,-64,-2,-144,82
-1,1365,1789,-424,2,-5,66
1,1503,1506,-3,0,25,59
1,1693,1868,-175,2,283,105
-1,1568,1566,2,-4,-81,68
1,1891,1571,320,1,29,57
1,1407,1312,95,0,0,52
1,1593,1727,-134,-1,-26,51
1,1835,1666,169,0,18,47
1,1309,1227,82,1,146,51
1,1497,1559,-62,-2,-29,41
1,1669,1666,3,2,107,67
-1,1552,1662,-110,-6,-85,50
-1,1347,1410,-63,1,17,56
-1,1553,1721,-168,0,-9,62
-1,1905,1712,193,0,-50,56
1,1509,1657,-148,0,82,57
1,1621,1366,255,0,-22,47
-1,1327,1458,-131,10,424,70
-1,1608,1962,-354,-1,-102,62
1,1755,1761,-6,0,12,75
1,1424,1336,88,-3,-1,53
1,1907,1687,220,-1,-25,75
0,1059,993,66,-1,-327,215
1,1670,1545,125,1,58,57
-1,1775,1633,142,3,96,54
1,1595,1706,-111,-1,-107,63
1,1835,1568,267,-5,6,65
1,1655,1575,80,11,542,71
-1,1704,1801,-97,-1,-73,66
1,1904,1713,191,1,49,71
1,1719,1724,-5,5,463,109
1,1452,1421,31,0,203,151
1,1408,1362,46,1,29,57
-1,1656,1716,-60,0,-17,138
-1,1692,1991,-299,-3,-63,104
-1,1309,1472,-163,-1,-47,62
1,1517,1547,-30,-3,59,65
1,1685,1442,243,1,69,67
-1,1707,1658,49,-1,-73,88
1,1462,1506,-44,5,947,121
1,1791,1361,430,10,181,51
-1,1432,1327,105,-2,-34,50
-1,1500,1476,24,-13,-554,64
-1,1567,1663,-96,-6,-161,56
-1,1684,1783,-99,-1,-138,78
-1,1675,1996,-321,0,2,52
-1,1332,1509,-177,-7,0,40
1,1441,1346,95,0,17,43
-1,1302,1478,-176,0,-751,162
-1,1849,1709,140,-1,-81,74
0,1431,1582,-151,1,533,151
1,1295,1212,83,11,1291,113
1,1867,1484,383,-4,-132,77
-1,1188,1351,-163,0,-7,54
1,1722,1727,-5,-2,-459,109
-1,2084,2135,-51,0,-27,64
1,1286,1343,-57,6,65,44
1,2000,1564,436,1,473,89
-1,1577,1500,77,0,-145,74
1,1515,1326,189,1,41,49
-1,1419,1337,82,0,2,54
-1,1691,1610,81,2,24,50
1,1640,1451,189,0,14,81
-1,1705,1910,-205,1,-10,82
-1,1347,1376,-29,-4,-228,70
1,2072,1716,356,0,4,53
1,1750,2008,-258,-1,-29,53
1,1511,1390,121,-4,-3,43
1,1381,1379,2,0,24,57
1,1751,1647,104,0,29,97
1,1500,1410,90,-7,-332,55
-1,1547,1793,-246,1,-43,78
1,2075,1713,362,-3,-53,43
1,1954,1500,454,7,80,43
1,1537,1728,-191,1,6,43
-1,1300,1329,-29,2,48,46
1,1428,1340,88,6,442,99
1,1495,1514,-19,1,342,109
1,1734,1723,11,2,74,53
-1,1665,1549,116,-8,-277,54
-1,1611,1677,-66,-1,-58,66
-1,1534,1946,-412,-5,-265,68
1,1674,1695,-21,1,16,43
1,1885,1689,196,2,135,63
-1,1713,1745,-32,-4,-78,50
1,1533,1552,-19,-3,-154,139
1,1631,1635,-4,1,105,135
-1,1708,1696,12,-2,3,50
-1,1327,1449,-122,-3,-175,88
-1,1384,1407,-23,-6,-111,42
1,1916,1697,219,1,38,57
1,1501,1483,18,1,374,115
1,1755,1703,52,1,284,71
-1,1575,1435,140,-1,-25,52
-1,1634,1527,107,-1,-21,48
-1,1748,1826,-78,0,19,80
1,1707,1300,407,2,86,56
-1,1729,1957,-228,-5,-500,94
-1,1730,1778,-48,-1,-43,76
-1,1175,1522,-347,2,32,46
1,1531,1165,366,3,80,53
1,1413,1088,325,3,771,107
-1,1764,2079,-315,-4,-141,66
1,1465,1340,125,0,22,63
-1,1289,1279,10,0,9,54
-1,1453,1640,-187,0,-303,130
0,1710,1549,161,0,-3,106
1,1687,1493,194,0,43,81
1,1450,1519,-69,0,53,67
0,1761,1869,-108,4,466,98
-1,1683,1692,-9,0,-33,116
1,1773,1413,360,1,34,81
-1,1307,1285,22,12,627,74
-1,2083,2112,-29,-1,-13,52
0,1326,1192,134,-3,-73,74
1,1765,1777,-12,0,16,57
1,1281,1475,-194,12,824,85
1,1364,1684,-320,0,372,105
-1,1563,1651,-88,-7,-302,72
-1,1640,1868,-228,-3,-97,68
1,1734,1769,-35,0,15,67
-1,2070,1866,204,1,37,66
-1,1764,2124,-360,0,-11,64
-1,1419,1236,183,1,-347,118
0,1842,1326,516,0,-9,112
0,1527,1471,56,-2,-366,118
1,1589,1265,324,-2,-171,73
0,1474,1485,-11,2,83,88
1,2026,1487,539,1,37,47
1,1762,1666,96,0,10,59
-1,1653,1539,114,-1,-57,70
-1,2057,1876,181,0,-16,78
1,1179,1497,-318,0,94,81
1,1382,1435,-53,0,15,63
-1,1256,1597,-341,-6,-88,50
1,1692,1484,208,0,12,63
1,1684,1799,-115,0,288,129
-1,1682,1242,440,-1,-11,56
-1,1645,1437,208,0,75,98
-1,1635,1718,-83,-3,-48,44
1,1703,1369,334,1,124,71
1,2036,1892,144,-1,33,57
1,1559,1770,-211,-6,11,63
1,1706,1569,137,-8,46,73
-1,1765,1777,-12,-2,-17,60
1,1686,1750,-64,1,217,133
-1,1500,1959,-459,0,-104,88
-1,1736,1746,-10,0,3,40
-1,1560,1541,19,-3,-56,54
0,1863,1758,105,4,641,161
1,1600,1238,362,1,194,59
-1,1776,1410,366,-7,-1019,146
1,1569,1381,188,0,615,147
1,1705,1510,195,1,188,87
1,2053,1879,174,-1,254,131
-1,1537,1246,291,-1,-52,74
-1,1338,1830,-492,0,-68,62
1,1727,1876,-149,0,-17,67
-1,1503,1994,-491,-7,-117,52
-1,1319,1626,-307,-2,-93,68
-1,1673,1702,-29,-1,-96,86
-1,1515,1668,-153,0,73,106
-1,1494,1615,-121,-1,-336,104
-1,1873,2060,-187,0,-509,138
-1,1485,1962,-477,-2,-227,58
1,1659,1555,104,6,458,87
1,1753,1636,117,-3,-65,45
1,1787,1754,33,0,14,73
1,1479,1254,225,5,301,71
1,1481,1629,-148,-9,14,55
1,1590,1431,159,-5,-120,77
-1,1397,1498,-101,0,-19,48
-1,1478,1698,-220,0,-20,100
1,1760,1760,0,-8,15,75
-1,1162,1371,-209,2,129,66
1,2067,1867,200,-3,303,117
-1,1761,2086,-325,-1,-81,98
-1,1832,1336,496,-1,-81,100
-1,1756,1709,47,0,-126,86
-1,1293,1367,-74,-1,-49,52
1,1639,1555,84,0,-29,40
1,1758,1428,330,-2,280,117
1,1842,1545,297,0,159,107
1,1872,1797,75,-3,41,61
-1,1486,1630,-144,0,11,60
-1,1498,1629,-131,2,131,84
1,1537,1609,-72,-1,-58,51
-1,1586,1548,38,2,-206,202
-1,1484,1502,-18,-2,-6,66
1,1835,1745,90,0,64,81
1,1385,1293,92,0,-4,83
1,1711,1663,48,1,-29,45
1,1862,2073,-211,0,-14,55
1,1778,2127,-349,0,12,53
1,1636,1562,74,9,218,51
1,1742,1509,233,4,263,83
1,1442,1435,7,7,261,52
-1,1884,2104,-220,0,-381,164
-1,1473,1555,-82,-2,-571,124
-1,1880,2098,-218,1,-690,112
1,2060,1873,187,-1,192,79
1,1394,1599,-205,1,77,63
1,2053,1879,174,1,73,63
-1,1694,1717,-23,-13,-318,56
-1,1717,1694,23,6,0,94
1,1647,917,730,2,71,49
1,1948,1838,110,0,67,91
-1,1205,1872,-667,-10,-309,50
1,1758,1843,-85,-1,-19,49
1,1223,1500,-277,-3,-83,83
-1,1425,1761,-336,-1,0,42
-1,1636,1729,-93,-5,-379,92
1,1847,1473,374,-1,-26,53
1,1452,1142,310,3,210,77
-1,1720,1738,-18,0,-33,72
-1,1500,1550,-50,-7,-66,52
-1,1421,1473,-52,1,-241,70
-1,1653,1530,123,-2,-72,66
1,1684,1817,-133,6,393,79
1,1433,1390,43,0,39,79
-1,1647,1815,-168,-2,-205,86
1,1500,1524,-24,0,-6,43
-1,1875,1782,93,1,6,42
1,2030,2104,-74,1,69,61
1,1739,1916,-177,-7,85,65
1,1428,1519,-91,1,92,47
1,1628,1739,-111,4,112,49
1,1711,1543,168,0,219,115
-1,1554,1629,-75,1,-38,64
1,1645,1553,92,0,103,77
-1,960,1012,-52,4,365,133
1,1722,1642,80,13,316,51
-1,1542,1600,-58,0,-411,110
1,1500,1617,-117,6,178,51
1,1635,1500,135,0,212,77
-1,1732,1633,99,6,838,82
1,1500,1285,215,1,50,42
1,1702,1802,-100,-1,9,52
1,1472,1306,166,12,372,57
-1,1500,1737,-237,-15,-224,47
1,1685,1879,-194,-3,139,131
-1,2074,1961,113,0,16,56
1,1619,1445,174,6,239,65
1,1971,1759,212,0,183,131
1,1483,1510,-27,-2,138,63
1,1699,1545,154,1,36,45
-1,1639,1711,-72,0,-138,102
1,1608,1422,186,6,157,48
-1,1461,1440,21,-8,-270,59
1,1829,2090,-261,-1,131,105
1,1772,1921,-149,0,-23,51
-1,1500,1654,-154,0,-55,68
1,1463,1638,-175,-1,21,53
1,1442,1464,-22,-1,635,111
-1,1784,1762,22,1,-28,66
-1,1731,1965,-234,-2,-176,74
-1,1582,1964,-382,-2,-66,70
-1,1378,1508,-130,-6,-568,86
1,1474,1274,200,1,2,87
-1,1380,1500,-120,3,85,142
-1,1706,1694,12,0,-39,80
-1,1547,1716,-169,-2,-48,54
1,1622,1478,144,-2,-65,65
1,1974,1996,-22,0,187,139
1,1647,1837,-190,-2,-91,67
1,1860,1701,159,0,117,125
1,1487,1615,-128,-3,-122,111
0,1500,1506,-6,0,-303,114
1,1500,1470,30,0,18,55
1,1788,1905,-117,1,-9,55
1,1500,1495,5,0,123,83
1,1538,1347,191,-8,-549,79
-1,1664,1661,3,-7,-38,44
-1,1653,1866,-213,-1,-4,48
1,1847,1753,94,0,142,77
-1,1489,1498,-9,0,106,94
-1,1495,1481,14,-1,-34,60
1,1783,1702,81,0,134,82
1,1779,1679,100,10,291,45
-1,1713,1655,58,-2,-41,48
-1,1627,1339,288,-10,-289,52
1,1628,1271,357,2,220,73
1,1403,1242,161,17,870,73
1,1708,1604,104,2,311,175
-1,1057,1486,-429,4,78,46
-1,1803,1890,-87,0,-116,62
-1,1397,1759,-362,-14,-306,46
-1,2022,1982,40,0,-53,140
0,1555,1675,-120,1,-242,114
1,1648,1723,-75,-4,-77,110
-1,1694,1651,43,-10,-83,40
1,1778,1655,123,-2,237,129
1,1587,1660,-73,4,118,61
1,1695,1867,-172,0,23,89
1,1981,1234,747,-4,208,69
1,1744,1855,-111,0,106,113
1,1631,1321,310,4,182,65
-1,1667,1700,-33,2,70,150
-1,1664,1682,-18,2,-124,62
-1,1457,1408,49,-2,-88,78
1,1400,1800,-400,-1,13,49
-1,1831,1818,13,0,2,56
1,1722,1802,-80,6,306,69
1,1594,1488,106,2,98,75
1,1374,1638,-264,-1,-1,57
1,1492,1483,9,1,44,49
-1,1794,1898,-104,0,-186,92
-1,1500,1152,348,-9,-383,64
1,2067,1872,195,0,76,69
1,1330,1317,13,6,96,45
1,1693,1653,40,0,37,87
-1,1154,1500,-346,-14,-229,56
-1,1663,1558,105,0,-128,110
-1,1706,1759,-53,-1,-31,52
1,1849,1710,139,0,76,93
0,1648,1849,-201,-1,-877,108
-1,1969,1805,164,1,20,48
-1,1310,1635,-325,0,-95,68
-1,1472,1683,-211,-2,-51,42
1,1650,1537,113,1,152,77
-1,1907,1763,144,1,-9,52
-1,1503,1662,-159,-13,-819,84
1,1304,1456,-152,9,83,43
1,1653,1501,152,1,6,41
1,1826,1879,-53,-1,-27,53
-1,1707,1667,40,1,-41,88
-1,1388,1643,-255,-7,-263,54
1,1798,1659,139,5,267,67
1,1496,1480,16,0,451,105
-1,1460,1445,15,-3,-127,50
-1,1777,1860,-83,-6,-45,46
-1,1578,2110,-532,-10,-288,84
-1,1530,1658,-128,0,-23,60
1,1472,1403,69,0,66,55
-1,1704,1857,-153,0,-5,82
-1,1298,1517,-219,-5,-415,82
-1,1707,1466,241,-10,-162,52
-1,1805,1657,148,-3,-122,84
-1,1640,1500,140,0,-356,94
-1,1226,1234,-8,-6,-165,62
1,1668,1646,22,0,57,67
-1,1722,1602,120,-10,-195,100
-1,1706,1383,323,-9,-247,74
1,2073,1652,421,12,423,59
-1,1619,1572,47,-1,-16,41
1,1526,1322,204,4,243,69
1,1821,1867,-46,-1,330,123
-1,1789,2111,-322,-8,-419,72
-1,1854,1937,-83,0,-41,76
-1,1500,1266,234,-7,-79,42
-1,1431,1523,-92,1,-118,102
1,1693,1479,214,1,60,43
-1,1744,1762,-18,0,-195,128
